district,age,sex,rural,urban,total
ABBOTTABAD DISTRICT,<1,Male,13768,3270,17038
ABBOTTABAD DISTRICT,<1,Female,13093,3164,16257
ABBOTTABAD DISTRICT,<1,Transgender,0,0,0
ABBOTTABAD DISTRICT,1,Male,13259,3409,16668
ABBOTTABAD DISTRICT,1,Female,12434,3234,15668
ABBOTTABAD DISTRICT,1,Transgender,0,0,0
ABBOTTABAD DISTRICT,2,Male,13308,3444,16752
ABBOTTABAD DISTRICT,2,Female,12436,3258,15694
ABBOTTABAD DISTRICT,2,Transgender,0,0,0
ABBOTTABAD DISTRICT,3,Male,14126,3653,17779
ABBOTTABAD DISTRICT,3,Female,13169,3468,16637
ABBOTTABAD DISTRICT,3,Transgender,0,0,0
ABBOTTABAD DISTRICT,4,Male,13346,3435,16781
ABBOTTABAD DISTRICT,4,Female,12539,3281,15820
ABBOTTABAD DISTRICT,4,Transgender,0,0,0
ABBOTTABAD DISTRICT,5,Male,13258,3420,16678
ABBOTTABAD DISTRICT,5,Female,12974,3292,16266
ABBOTTABAD DISTRICT,5,Transgender,0,0,0
ABBOTTABAD DISTRICT,6,Male,13219,3568,16787
ABBOTTABAD DISTRICT,6,Female,12085,3192,15277
ABBOTTABAD DISTRICT,6,Transgender,0,0,0
ABBOTTABAD DISTRICT,7,Male,14547,3745,18292
ABBOTTABAD DISTRICT,7,Female,13597,3572,17169
ABBOTTABAD DISTRICT,7,Transgender,0,0,0
ABBOTTABAD DISTRICT,8,Male,12795,3294,16089
ABBOTTABAD DISTRICT,8,Female,12085,2904,14989
ABBOTTABAD DISTRICT,8,Transgender,0,0,0
ABBOTTABAD DISTRICT,9,Male,14343,3947,18290
ABBOTTABAD DISTRICT,9,Female,13149,3434,16583
ABBOTTABAD DISTRICT,9,Transgender,0,0,0
ABBOTTABAD DISTRICT,10,Male,11075,2992,14067
ABBOTTABAD DISTRICT,10,Female,10620,2779,13399
ABBOTTABAD DISTRICT,10,Transgender,0,0,0
ABBOTTABAD DISTRICT,11,Male,13348,3729,17077
ABBOTTABAD DISTRICT,11,Female,12156,3255,15411
ABBOTTABAD DISTRICT,11,Transgender,0,0,0
ABBOTTABAD DISTRICT,12,Male,11323,3316,14639
ABBOTTABAD DISTRICT,12,Female,10297,2746,13043
ABBOTTABAD DISTRICT,12,Transgender,0,0,0
ABBOTTABAD DISTRICT,13,Male,12059,3777,15836
ABBOTTABAD DISTRICT,13,Female,10846,2979,13825
ABBOTTABAD DISTRICT,13,Transgender,0,0,0
ABBOTTABAD DISTRICT,14,Male,11153,3336,14489
ABBOTTABAD DISTRICT,14,Female,10041,2780,12821
ABBOTTABAD DISTRICT,14,Transgender,0,0,0
ABBOTTABAD DISTRICT,15,Male,11142,3257,14399
ABBOTTABAD DISTRICT,15,Female,10370,2914,13284
ABBOTTABAD DISTRICT,15,Transgender,0,0,0
ABBOTTABAD DISTRICT,16,Male,11202,3384,14586
ABBOTTABAD DISTRICT,16,Female,10488,2883,13371
ABBOTTABAD DISTRICT,16,Transgender,1,0,1
ABBOTTABAD DISTRICT,17,Male,11534,3640,15174
ABBOTTABAD DISTRICT,17,Female,11009,3064,14073
ABBOTTABAD DISTRICT,17,Transgender,1,0,1
ABBOTTABAD DISTRICT,18,Male,10018,3199,13217
ABBOTTABAD DISTRICT,18,Female,9325,2402,11727
ABBOTTABAD DISTRICT,18,Transgender,0,0,0
ABBOTTABAD DISTRICT,19,Male,10924,3913,14837
ABBOTTABAD DISTRICT,19,Female,10509,3003,13512
ABBOTTABAD DISTRICT,19,Transgender,0,1,1
ABBOTTABAD DISTRICT,20,Male,9200,3719,12919
ABBOTTABAD DISTRICT,20,Female,8568,2251,10819
ABBOTTABAD DISTRICT,20,Transgender,0,0,0
ABBOTTABAD DISTRICT,21,Male,10339,4236,14575
ABBOTTABAD DISTRICT,21,Female,10235,2980,13215
ABBOTTABAD DISTRICT,21,Transgender,0,0,0
ABBOTTABAD DISTRICT,22,Male,9509,3528,13037
ABBOTTABAD DISTRICT,22,Female,9796,2711,12507
ABBOTTABAD DISTRICT,22,Transgender,1,0,1
ABBOTTABAD DISTRICT,23,Male,9532,3338,12870
ABBOTTABAD DISTRICT,23,Female,10427,2830,13257
ABBOTTABAD DISTRICT,23,Transgender,0,0,0
ABBOTTABAD DISTRICT,24,Male,9466,3100,12566
ABBOTTABAD DISTRICT,24,Female,10091,2770,12861
ABBOTTABAD DISTRICT,24,Transgender,0,0,0
ABBOTTABAD DISTRICT,25,Male,7928,2445,10373
ABBOTTABAD DISTRICT,25,Female,8340,2293,10633
ABBOTTABAD DISTRICT,25,Transgender,1,1,2
ABBOTTABAD DISTRICT,26,Male,8210,2688,10898
ABBOTTABAD DISTRICT,26,Female,9692,2642,12334
ABBOTTABAD DISTRICT,26,Transgender,0,4,4
ABBOTTABAD DISTRICT,27,Male,7709,2513,10222
ABBOTTABAD DISTRICT,27,Female,9122,2630,11752
ABBOTTABAD DISTRICT,27,Transgender,1,0,1
ABBOTTABAD DISTRICT,28,Male,7759,2510,10269
ABBOTTABAD DISTRICT,28,Female,8995,2493,11488
ABBOTTABAD DISTRICT,28,Transgender,0,0,0
ABBOTTABAD DISTRICT,29,Male,7122,2448,9570
ABBOTTABAD DISTRICT,29,Female,8737,2480,11217
ABBOTTABAD DISTRICT,29,Transgender,0,0,0
ABBOTTABAD DISTRICT,30,Male,7162,2279,9441
ABBOTTABAD DISTRICT,30,Female,8056,2259,10315
ABBOTTABAD DISTRICT,30,Transgender,0,3,3
ABBOTTABAD DISTRICT,31,Male,7480,2462,9942
ABBOTTABAD DISTRICT,31,Female,8426,2302,10728
ABBOTTABAD DISTRICT,31,Transgender,1,0,1
ABBOTTABAD DISTRICT,32,Male,7319,2434,9753
ABBOTTABAD DISTRICT,32,Female,8165,2371,10536
ABBOTTABAD DISTRICT,32,Transgender,0,0,0
ABBOTTABAD DISTRICT,33,Male,7082,2299,9381
ABBOTTABAD DISTRICT,33,Female,7558,2152,9710
ABBOTTABAD DISTRICT,33,Transgender,1,1,2
ABBOTTABAD DISTRICT,34,Male,6850,2021,8871
ABBOTTABAD DISTRICT,34,Female,7376,2028,9404
ABBOTTABAD DISTRICT,34,Transgender,0,0,0
ABBOTTABAD DISTRICT,35,Male,5942,1920,7862
ABBOTTABAD DISTRICT,35,Female,6341,1853,8194
ABBOTTABAD DISTRICT,35,Transgender,1,0,1
ABBOTTABAD DISTRICT,36,Male,6468,1942,8410
ABBOTTABAD DISTRICT,36,Female,6705,1951,8656
ABBOTTABAD DISTRICT,36,Transgender,0,2,2
ABBOTTABAD DISTRICT,37,Male,5654,1676,7330
ABBOTTABAD DISTRICT,37,Female,5991,1651,7642
ABBOTTABAD DISTRICT,37,Transgender,0,0,0
ABBOTTABAD DISTRICT,38,Male,6838,2149,8987
ABBOTTABAD DISTRICT,38,Female,6387,2050,8437
ABBOTTABAD DISTRICT,38,Transgender,2,2,4
ABBOTTABAD DISTRICT,39,Male,5909,1765,7674
ABBOTTABAD DISTRICT,39,Female,6120,1704,7824
ABBOTTABAD DISTRICT,39,Transgender,0,0,0
ABBOTTABAD DISTRICT,40,Male,5621,1944,7565
ABBOTTABAD DISTRICT,40,Female,5479,1736,7215
ABBOTTABAD DISTRICT,40,Transgender,0,0,0
ABBOTTABAD DISTRICT,41,Male,5094,1567,6661
ABBOTTABAD DISTRICT,41,Female,5266,1461,6727
ABBOTTABAD DISTRICT,41,Transgender,1,0,1
ABBOTTABAD DISTRICT,42,Male,4923,1646,6569
ABBOTTABAD DISTRICT,42,Female,4827,1492,6319
ABBOTTABAD DISTRICT,42,Transgender,0,1,1
ABBOTTABAD DISTRICT,43,Male,4888,1499,6387
ABBOTTABAD DISTRICT,43,Female,4815,1490,6305
ABBOTTABAD DISTRICT,43,Transgender,0,0,0
ABBOTTABAD DISTRICT,44,Male,4618,1381,5999
ABBOTTABAD DISTRICT,44,Female,4715,1388,6103
ABBOTTABAD DISTRICT,44,Transgender,0,0,0
ABBOTTABAD DISTRICT,45,Male,4083,1460,5543
ABBOTTABAD DISTRICT,45,Female,4416,1347,5763
ABBOTTABAD DISTRICT,45,Transgender,2,0,2
ABBOTTABAD DISTRICT,46,Male,4242,1282,5524
ABBOTTABAD DISTRICT,46,Female,4547,1176,5723
ABBOTTABAD DISTRICT,46,Transgender,1,0,1
ABBOTTABAD DISTRICT,47,Male,3789,1117,4906
ABBOTTABAD DISTRICT,47,Female,3852,951,4803
ABBOTTABAD DISTRICT,47,Transgender,1,0,1
ABBOTTABAD DISTRICT,48,Male,4589,1307,5896
ABBOTTABAD DISTRICT,48,Female,4952,1271,6223
ABBOTTABAD DISTRICT,48,Transgender,0,0,0
ABBOTTABAD DISTRICT,49,Male,4139,1136,5275
ABBOTTABAD DISTRICT,49,Female,4545,1192,5737
ABBOTTABAD DISTRICT,49,Transgender,0,0,0
ABBOTTABAD DISTRICT,50,Male,4013,1381,5394
ABBOTTABAD DISTRICT,50,Female,4382,1258,5640
ABBOTTABAD DISTRICT,50,Transgender,1,1,2
ABBOTTABAD DISTRICT,51,Male,3840,1086,4926
ABBOTTABAD DISTRICT,51,Female,4092,1049,5141
ABBOTTABAD DISTRICT,51,Transgender,0,0,0
ABBOTTABAD DISTRICT,52,Male,4003,1186,5189
ABBOTTABAD DISTRICT,52,Female,3966,1122,5088
ABBOTTABAD DISTRICT,52,Transgender,0,1,1
ABBOTTABAD DISTRICT,53,Male,3947,1089,5036
ABBOTTABAD DISTRICT,53,Female,4043,1066,5109
ABBOTTABAD DISTRICT,53,Transgender,0,0,0
ABBOTTABAD DISTRICT,54,Male,3773,1075,4848
ABBOTTABAD DISTRICT,54,Female,3759,999,4758
ABBOTTABAD DISTRICT,54,Transgender,0,0,0
ABBOTTABAD DISTRICT,55,Male,3506,1087,4593
ABBOTTABAD DISTRICT,55,Female,3355,928,4283
ABBOTTABAD DISTRICT,55,Transgender,0,0,0
ABBOTTABAD DISTRICT,56,Male,3349,931,4280
ABBOTTABAD DISTRICT,56,Female,2860,750,3610
ABBOTTABAD DISTRICT,56,Transgender,0,0,0
ABBOTTABAD DISTRICT,57,Male,2881,799,3680
ABBOTTABAD DISTRICT,57,Female,2163,537,2700
ABBOTTABAD DISTRICT,57,Transgender,0,0,0
ABBOTTABAD DISTRICT,58,Male,3159,853,4012
ABBOTTABAD DISTRICT,58,Female,2727,728,3455
ABBOTTABAD DISTRICT,58,Transgender,0,0,0
ABBOTTABAD DISTRICT,59,Male,2703,742,3445
ABBOTTABAD DISTRICT,59,Female,2434,570,3004
ABBOTTABAD DISTRICT,59,Transgender,0,0,0
ABBOTTABAD DISTRICT,60,Male,2722,899,3621
ABBOTTABAD DISTRICT,60,Female,2727,757,3484
ABBOTTABAD DISTRICT,60,Transgender,0,0,0
ABBOTTABAD DISTRICT,61,Male,2721,699,3420
ABBOTTABAD DISTRICT,61,Female,2672,595,3267
ABBOTTABAD DISTRICT,61,Transgender,0,0,0
ABBOTTABAD DISTRICT,62,Male,2781,743,3524
ABBOTTABAD DISTRICT,62,Female,2609,641,3250
ABBOTTABAD DISTRICT,62,Transgender,0,0,0
ABBOTTABAD DISTRICT,63,Male,2719,669,3388
ABBOTTABAD DISTRICT,63,Female,2663,618,3281
ABBOTTABAD DISTRICT,63,Transgender,0,0,0
ABBOTTABAD DISTRICT,64,Male,2442,641,3083
ABBOTTABAD DISTRICT,64,Female,2277,548,2825
ABBOTTABAD DISTRICT,64,Transgender,0,0,0
ABBOTTABAD DISTRICT,65,Male,2198,651,2849
ABBOTTABAD DISTRICT,65,Female,2156,503,2659
ABBOTTABAD DISTRICT,65,Transgender,0,0,0
ABBOTTABAD DISTRICT,66,Male,1947,456,2403
ABBOTTABAD DISTRICT,66,Female,1834,338,2172
ABBOTTABAD DISTRICT,66,Transgender,0,1,1
ABBOTTABAD DISTRICT,67,Male,1852,425,2277
ABBOTTABAD DISTRICT,67,Female,1754,272,2026
ABBOTTABAD DISTRICT,67,Transgender,0,0,0
ABBOTTABAD DISTRICT,68,Male,2073,472,2545
ABBOTTABAD DISTRICT,68,Female,1931,400,2331
ABBOTTABAD DISTRICT,68,Transgender,0,0,0
ABBOTTABAD DISTRICT,69,Male,1640,351,1991
ABBOTTABAD DISTRICT,69,Female,1600,320,1920
ABBOTTABAD DISTRICT,69,Transgender,0,0,0
ABBOTTABAD DISTRICT,70,Male,1564,424,1988
ABBOTTABAD DISTRICT,70,Female,1499,361,1860
ABBOTTABAD DISTRICT,70,Transgender,0,0,0
ABBOTTABAD DISTRICT,71,Male,1519,343,1862
ABBOTTABAD DISTRICT,71,Female,1424,277,1701
ABBOTTABAD DISTRICT,71,Transgender,0,0,0
ABBOTTABAD DISTRICT,72,Male,1460,353,1813
ABBOTTABAD DISTRICT,72,Female,1424,263,1687
ABBOTTABAD DISTRICT,72,Transgender,1,0,1
ABBOTTABAD DISTRICT,73,Male,1430,291,1721
ABBOTTABAD DISTRICT,73,Female,1327,282,1609
ABBOTTABAD DISTRICT,73,Transgender,0,0,0
ABBOTTABAD DISTRICT,74,Male,1161,245,1406
ABBOTTABAD DISTRICT,74,Female,1017,232,1249
ABBOTTABAD DISTRICT,74,Transgender,0,0,0
ABBOTTABAD DISTRICT,>=75,Male,7978,1835,9813
ABBOTTABAD DISTRICT,>=75,Female,8035,1779,9814
ABBOTTABAD DISTRICT,>=75,Transgender,1,0,1
ATTOCK DISTRICT,<1,Male,16161,5278,21439
ATTOCK DISTRICT,<1,Female,15140,5103,20243
ATTOCK DISTRICT,<1,Transgender,0,0,0
ATTOCK DISTRICT,1,Male,16889,6240,23129
ATTOCK DISTRICT,1,Female,16082,5930,22012
ATTOCK DISTRICT,1,Transgender,0,0,0
ATTOCK DISTRICT,2,Male,16839,5774,22613
ATTOCK DISTRICT,2,Female,15871,5326,21197
ATTOCK DISTRICT,2,Transgender,0,0,0
ATTOCK DISTRICT,3,Male,17966,6300,24266
ATTOCK DISTRICT,3,Female,16795,5951,22746
ATTOCK DISTRICT,3,Transgender,0,0,0
ATTOCK DISTRICT,4,Male,17218,5761,22979
ATTOCK DISTRICT,4,Female,16014,5387,21401
ATTOCK DISTRICT,4,Transgender,0,0,0
ATTOCK DISTRICT,5,Male,16271,5901,22172
ATTOCK DISTRICT,5,Female,15662,5482,21144
ATTOCK DISTRICT,5,Transgender,0,0,0
ATTOCK DISTRICT,6,Male,16284,5901,22185
ATTOCK DISTRICT,6,Female,15311,5271,20582
ATTOCK DISTRICT,6,Transgender,0,0,0
ATTOCK DISTRICT,7,Male,17246,6179,23425
ATTOCK DISTRICT,7,Female,16342,5802,22144
ATTOCK DISTRICT,7,Transgender,0,0,0
ATTOCK DISTRICT,8,Male,14862,5420,20282
ATTOCK DISTRICT,8,Female,14629,5062,19691
ATTOCK DISTRICT,8,Transgender,0,0,0
ATTOCK DISTRICT,9,Male,17517,6356,23873
ATTOCK DISTRICT,9,Female,16375,5943,22318
ATTOCK DISTRICT,9,Transgender,0,0,0
ATTOCK DISTRICT,10,Male,13730,4922,18652
ATTOCK DISTRICT,10,Female,13183,4657,17840
ATTOCK DISTRICT,10,Transgender,0,0,0
ATTOCK DISTRICT,11,Male,16861,6335,23196
ATTOCK DISTRICT,11,Female,15922,5672,21594
ATTOCK DISTRICT,11,Transgender,0,0,0
ATTOCK DISTRICT,12,Male,13729,4913,18642
ATTOCK DISTRICT,12,Female,12603,4557,17160
ATTOCK DISTRICT,12,Transgender,0,0,0
ATTOCK DISTRICT,13,Male,15568,5804,21372
ATTOCK DISTRICT,13,Female,14304,5092,19396
ATTOCK DISTRICT,13,Transgender,0,0,0
ATTOCK DISTRICT,14,Male,13730,5109,18839
ATTOCK DISTRICT,14,Female,12611,4619,17230
ATTOCK DISTRICT,14,Transgender,0,0,0
ATTOCK DISTRICT,15,Male,14441,5034,19475
ATTOCK DISTRICT,15,Female,13491,4815,18306
ATTOCK DISTRICT,15,Transgender,1,0,1
ATTOCK DISTRICT,16,Male,14831,5142,19973
ATTOCK DISTRICT,16,Female,13958,4799,18757
ATTOCK DISTRICT,16,Transgender,0,0,0
ATTOCK DISTRICT,17,Male,15024,5366,20390
ATTOCK DISTRICT,17,Female,14431,5143,19574
ATTOCK DISTRICT,17,Transgender,1,1,2
ATTOCK DISTRICT,18,Male,11973,4602,16575
ATTOCK DISTRICT,18,Female,11601,3900,15501
ATTOCK DISTRICT,18,Transgender,2,1,3
ATTOCK DISTRICT,19,Male,14505,5658,20163
ATTOCK DISTRICT,19,Female,14177,4875,19052
ATTOCK DISTRICT,19,Transgender,1,1,2
ATTOCK DISTRICT,20,Male,11746,4592,16338
ATTOCK DISTRICT,20,Female,10985,3654,14639
ATTOCK DISTRICT,20,Transgender,1,4,5
ATTOCK DISTRICT,21,Male,13884,5792,19676
ATTOCK DISTRICT,21,Female,14725,5112,19837
ATTOCK DISTRICT,21,Transgender,1,1,2
ATTOCK DISTRICT,22,Male,11294,4652,15946
ATTOCK DISTRICT,22,Female,12123,4177,16300
ATTOCK DISTRICT,22,Transgender,4,3,7
ATTOCK DISTRICT,23,Male,11852,4785,16637
ATTOCK DISTRICT,23,Female,13284,4660,17944
ATTOCK DISTRICT,23,Transgender,1,1,2
ATTOCK DISTRICT,24,Male,11500,4374,15874
ATTOCK DISTRICT,24,Female,13526,4537,18063
ATTOCK DISTRICT,24,Transgender,0,3,3
ATTOCK DISTRICT,25,Male,9192,3591,12783
ATTOCK DISTRICT,25,Female,10544,3556,14100
ATTOCK DISTRICT,25,Transgender,4,3,7
ATTOCK DISTRICT,26,Male,10733,4090,14823
ATTOCK DISTRICT,26,Female,13241,4588,17829
ATTOCK DISTRICT,26,Transgender,2,2,4
ATTOCK DISTRICT,27,Male,10163,4089,14252
ATTOCK DISTRICT,27,Female,13185,4690,17875
ATTOCK DISTRICT,27,Transgender,2,3,5
ATTOCK DISTRICT,28,Male,9632,3772,13404
ATTOCK DISTRICT,28,Female,11776,4233,16009
ATTOCK DISTRICT,28,Transgender,0,2,2
ATTOCK DISTRICT,29,Male,10221,4073,14294
ATTOCK DISTRICT,29,Female,12956,4354,17310
ATTOCK DISTRICT,29,Transgender,0,5,5
ATTOCK DISTRICT,30,Male,8693,3506,12199
ATTOCK DISTRICT,30,Female,10004,3612,13616
ATTOCK DISTRICT,30,Transgender,0,2,2
ATTOCK DISTRICT,31,Male,10187,4037,14224
ATTOCK DISTRICT,31,Female,12976,4437,17413
ATTOCK DISTRICT,31,Transgender,3,0,3
ATTOCK DISTRICT,32,Male,9007,3626,12633
ATTOCK DISTRICT,32,Female,10932,3947,14879
ATTOCK DISTRICT,32,Transgender,0,2,2
ATTOCK DISTRICT,33,Male,9648,3776,13424
ATTOCK DISTRICT,33,Female,11144,4056,15200
ATTOCK DISTRICT,33,Transgender,0,1,1
ATTOCK DISTRICT,34,Male,9545,3638,13183
ATTOCK DISTRICT,34,Female,11016,3916,14932
ATTOCK DISTRICT,34,Transgender,0,3,3
ATTOCK DISTRICT,35,Male,7260,2939,10199
ATTOCK DISTRICT,35,Female,8191,2980,11171
ATTOCK DISTRICT,35,Transgender,2,0,2
ATTOCK DISTRICT,36,Male,8729,3494,12223
ATTOCK DISTRICT,36,Female,10350,3624,13974
ATTOCK DISTRICT,36,Transgender,4,0,4
ATTOCK DISTRICT,37,Male,7823,3154,10977
ATTOCK DISTRICT,37,Female,8907,3294,12201
ATTOCK DISTRICT,37,Transgender,1,0,1
ATTOCK DISTRICT,38,Male,8538,3503,12041
ATTOCK DISTRICT,38,Female,9360,3475,12835
ATTOCK DISTRICT,38,Transgender,2,2,4
ATTOCK DISTRICT,39,Male,8226,3429,11655
ATTOCK DISTRICT,39,Female,9362,3374,12736
ATTOCK DISTRICT,39,Transgender,3,0,3
ATTOCK DISTRICT,40,Male,6736,2987,9723
ATTOCK DISTRICT,40,Female,7306,2720,10026
ATTOCK DISTRICT,40,Transgender,3,0,3
ATTOCK DISTRICT,41,Male,7250,3026,10276
ATTOCK DISTRICT,41,Female,8725,2938,11663
ATTOCK DISTRICT,41,Transgender,0,0,0
ATTOCK DISTRICT,42,Male,6526,2764,9290
ATTOCK DISTRICT,42,Female,7230,2578,9808
ATTOCK DISTRICT,42,Transgender,0,1,1
ATTOCK DISTRICT,43,Male,7004,2950,9954
ATTOCK DISTRICT,43,Female,8099,2729,10828
ATTOCK DISTRICT,43,Transgender,1,1,2
ATTOCK DISTRICT,44,Male,6779,2409,9188
ATTOCK DISTRICT,44,Female,7441,2633,10074
ATTOCK DISTRICT,44,Transgender,4,1,5
ATTOCK DISTRICT,45,Male,5286,1991,7277
ATTOCK DISTRICT,45,Female,5753,2070,7823
ATTOCK DISTRICT,45,Transgender,2,1,3
ATTOCK DISTRICT,46,Male,6414,2172,8586
ATTOCK DISTRICT,46,Female,7027,2308,9335
ATTOCK DISTRICT,46,Transgender,0,1,1
ATTOCK DISTRICT,47,Male,5928,2083,8011
ATTOCK DISTRICT,47,Female,6012,1891,7903
ATTOCK DISTRICT,47,Transgender,0,0,0
ATTOCK DISTRICT,48,Male,6496,2332,8828
ATTOCK DISTRICT,48,Female,6916,2314,9230
ATTOCK DISTRICT,48,Transgender,1,0,1
ATTOCK DISTRICT,49,Male,6364,2225,8589
ATTOCK DISTRICT,49,Female,7095,2302,9397
ATTOCK DISTRICT,49,Transgender,1,2,3
ATTOCK DISTRICT,50,Male,5348,1911,7259
ATTOCK DISTRICT,50,Female,5806,2021,7827
ATTOCK DISTRICT,50,Transgender,2,0,2
ATTOCK DISTRICT,51,Male,6328,2174,8502
ATTOCK DISTRICT,51,Female,6786,2111,8897
ATTOCK DISTRICT,51,Transgender,0,0,0
ATTOCK DISTRICT,52,Male,5888,1986,7874
ATTOCK DISTRICT,52,Female,5762,1873,7635
ATTOCK DISTRICT,52,Transgender,0,0,0
ATTOCK DISTRICT,53,Male,6411,2127,8538
ATTOCK DISTRICT,53,Female,6290,2006,8296
ATTOCK DISTRICT,53,Transgender,2,0,2
ATTOCK DISTRICT,54,Male,5864,1944,7808
ATTOCK DISTRICT,54,Female,5519,1757,7276
ATTOCK DISTRICT,54,Transgender,0,0,0
ATTOCK DISTRICT,55,Male,4510,1665,6175
ATTOCK DISTRICT,55,Female,3857,1378,5235
ATTOCK DISTRICT,55,Transgender,3,0,3
ATTOCK DISTRICT,56,Male,4989,1760,6749
ATTOCK DISTRICT,56,Female,4438,1320,5758
ATTOCK DISTRICT,56,Transgender,2,0,2
ATTOCK DISTRICT,57,Male,4309,1585,5894
ATTOCK DISTRICT,57,Female,3657,1069,4726
ATTOCK DISTRICT,57,Transgender,1,1,2
ATTOCK DISTRICT,58,Male,4375,1456,5831
ATTOCK DISTRICT,58,Female,4141,1276,5417
ATTOCK DISTRICT,58,Transgender,1,0,1
ATTOCK DISTRICT,59,Male,4089,1380,5469
ATTOCK DISTRICT,59,Female,4110,1225,5335
ATTOCK DISTRICT,59,Transgender,0,0,0
ATTOCK DISTRICT,60,Male,3483,1159,4642
ATTOCK DISTRICT,60,Female,3547,1089,4636
ATTOCK DISTRICT,60,Transgender,2,1,3
ATTOCK DISTRICT,61,Male,4495,1428,5923
ATTOCK DISTRICT,61,Female,4655,1339,5994
ATTOCK DISTRICT,61,Transgender,2,0,2
ATTOCK DISTRICT,62,Male,4280,1304,5584
ATTOCK DISTRICT,62,Female,4161,1221,5382
ATTOCK DISTRICT,62,Transgender,1,0,1
ATTOCK DISTRICT,63,Male,4308,1284,5592
ATTOCK DISTRICT,63,Female,4226,1236,5462
ATTOCK DISTRICT,63,Transgender,1,0,1
ATTOCK DISTRICT,64,Male,4152,1127,5279
ATTOCK DISTRICT,64,Female,3905,1070,4975
ATTOCK DISTRICT,64,Transgender,1,0,1
ATTOCK DISTRICT,65,Male,2993,943,3936
ATTOCK DISTRICT,65,Female,2872,848,3720
ATTOCK DISTRICT,65,Transgender,1,0,1
ATTOCK DISTRICT,66,Male,3266,875,4141
ATTOCK DISTRICT,66,Female,3178,765,3943
ATTOCK DISTRICT,66,Transgender,0,0,0
ATTOCK DISTRICT,67,Male,3373,893,4266
ATTOCK DISTRICT,67,Female,3148,681,3829
ATTOCK DISTRICT,67,Transgender,0,0,0
ATTOCK DISTRICT,68,Male,3420,845,4265
ATTOCK DISTRICT,68,Female,3219,790,4009
ATTOCK DISTRICT,68,Transgender,0,0,0
ATTOCK DISTRICT,69,Male,2822,775,3597
ATTOCK DISTRICT,69,Female,2666,680,3346
ATTOCK DISTRICT,69,Transgender,0,0,0
ATTOCK DISTRICT,70,Male,2239,640,2879
ATTOCK DISTRICT,70,Female,2196,585,2781
ATTOCK DISTRICT,70,Transgender,2,1,3
ATTOCK DISTRICT,71,Male,2677,653,3330
ATTOCK DISTRICT,71,Female,2674,640,3314
ATTOCK DISTRICT,71,Transgender,0,0,0
ATTOCK DISTRICT,72,Male,2461,649,3110
ATTOCK DISTRICT,72,Female,2528,617,3145
ATTOCK DISTRICT,72,Transgender,1,1,2
ATTOCK DISTRICT,73,Male,2229,567,2796
ATTOCK DISTRICT,73,Female,2285,571,2856
ATTOCK DISTRICT,73,Transgender,0,0,0
ATTOCK DISTRICT,74,Male,1832,420,2252
ATTOCK DISTRICT,74,Female,1753,405,2158
ATTOCK DISTRICT,74,Transgender,1,0,1
ATTOCK DISTRICT,>=75,Male,13635,3177,16812
ATTOCK DISTRICT,>=75,Female,15243,3564,18807
ATTOCK DISTRICT,>=75,Transgender,8,2,10
AWARAN DISTRICT,<1,Male,1233,327,1560
AWARAN DISTRICT,<1,Female,1317,338,1655
AWARAN DISTRICT,<1,Transgender,0,0,0
AWARAN DISTRICT,1,Male,1196,546,1742
AWARAN DISTRICT,1,Female,1159,492,1651
AWARAN DISTRICT,1,Transgender,0,0,0
AWARAN DISTRICT,2,Male,1498,571,2069
AWARAN DISTRICT,2,Female,1678,562,2240
AWARAN DISTRICT,2,Transgender,0,0,0
AWARAN DISTRICT,3,Male,1328,614,1942
AWARAN DISTRICT,3,Female,1308,604,1912
AWARAN DISTRICT,3,Transgender,0,0,0
AWARAN DISTRICT,4,Male,1871,633,2504
AWARAN DISTRICT,4,Female,1938,644,2582
AWARAN DISTRICT,4,Transgender,0,0,0
AWARAN DISTRICT,5,Male,1459,687,2146
AWARAN DISTRICT,5,Female,1387,565,1952
AWARAN DISTRICT,5,Transgender,0,0,0
AWARAN DISTRICT,6,Male,1975,603,2578
AWARAN DISTRICT,6,Female,1812,584,2396
AWARAN DISTRICT,6,Transgender,0,0,0
AWARAN DISTRICT,7,Male,1481,634,2115
AWARAN DISTRICT,7,Female,1188,507,1695
AWARAN DISTRICT,7,Transgender,0,0,0
AWARAN DISTRICT,8,Male,2143,728,2871
AWARAN DISTRICT,8,Female,1783,603,2386
AWARAN DISTRICT,8,Transgender,0,0,0
AWARAN DISTRICT,9,Male,1380,480,1860
AWARAN DISTRICT,9,Female,1168,447,1615
AWARAN DISTRICT,9,Transgender,0,0,0
AWARAN DISTRICT,10,Male,2130,642,2772
AWARAN DISTRICT,10,Female,1707,548,2255
AWARAN DISTRICT,10,Transgender,0,0,0
AWARAN DISTRICT,11,Male,1042,419,1461
AWARAN DISTRICT,11,Female,799,394,1193
AWARAN DISTRICT,11,Transgender,0,0,0
AWARAN DISTRICT,12,Male,1474,483,1957
AWARAN DISTRICT,12,Female,1177,442,1619
AWARAN DISTRICT,12,Transgender,0,0,0
AWARAN DISTRICT,13,Male,941,432,1373
AWARAN DISTRICT,13,Female,637,333,970
AWARAN DISTRICT,13,Transgender,0,0,0
AWARAN DISTRICT,14,Male,1124,423,1547
AWARAN DISTRICT,14,Female,885,376,1261
AWARAN DISTRICT,14,Transgender,0,0,0
AWARAN DISTRICT,15,Male,913,337,1250
AWARAN DISTRICT,15,Female,637,337,974
AWARAN DISTRICT,15,Transgender,0,0,0
AWARAN DISTRICT,16,Male,813,340,1153
AWARAN DISTRICT,16,Female,647,279,926
AWARAN DISTRICT,16,Transgender,1,0,1
AWARAN DISTRICT,17,Male,613,277,890
AWARAN DISTRICT,17,Female,520,305,825
AWARAN DISTRICT,17,Transgender,0,0,0
AWARAN DISTRICT,18,Male,784,313,1097
AWARAN DISTRICT,18,Female,671,297,968
AWARAN DISTRICT,18,Transgender,0,0,0
AWARAN DISTRICT,19,Male,642,276,918
AWARAN DISTRICT,19,Female,577,263,840
AWARAN DISTRICT,19,Transgender,0,0,0
AWARAN DISTRICT,20,Male,1041,344,1385
AWARAN DISTRICT,20,Female,919,350,1269
AWARAN DISTRICT,20,Transgender,0,0,0
AWARAN DISTRICT,21,Male,625,297,922
AWARAN DISTRICT,21,Female,637,286,923
AWARAN DISTRICT,21,Transgender,0,0,0
AWARAN DISTRICT,22,Male,708,339,1047
AWARAN DISTRICT,22,Female,577,272,849
AWARAN DISTRICT,22,Transgender,1,0,1
AWARAN DISTRICT,23,Male,507,244,751
AWARAN DISTRICT,23,Female,384,203,587
AWARAN DISTRICT,23,Transgender,0,1,1
AWARAN DISTRICT,24,Male,439,261,700
AWARAN DISTRICT,24,Female,422,194,616
AWARAN DISTRICT,24,Transgender,0,0,0
AWARAN DISTRICT,25,Male,672,235,907
AWARAN DISTRICT,25,Female,784,285,1069
AWARAN DISTRICT,25,Transgender,1,0,1
AWARAN DISTRICT,26,Male,476,190,666
AWARAN DISTRICT,26,Female,484,263,747
AWARAN DISTRICT,26,Transgender,0,0,0
AWARAN DISTRICT,27,Male,542,278,820
AWARAN DISTRICT,27,Female,566,288,854
AWARAN DISTRICT,27,Transgender,0,0,0
AWARAN DISTRICT,28,Male,547,272,819
AWARAN DISTRICT,28,Female,676,280,956
AWARAN DISTRICT,28,Transgender,0,0,0
AWARAN DISTRICT,29,Male,489,237,726
AWARAN DISTRICT,29,Female,644,279,923
AWARAN DISTRICT,29,Transgender,1,0,1
AWARAN DISTRICT,30,Male,812,309,1121
AWARAN DISTRICT,30,Female,855,282,1137
AWARAN DISTRICT,30,Transgender,2,0,2
AWARAN DISTRICT,31,Male,630,271,901
AWARAN DISTRICT,31,Female,725,310,1035
AWARAN DISTRICT,31,Transgender,0,0,0
AWARAN DISTRICT,32,Male,497,240,737
AWARAN DISTRICT,32,Female,495,250,745
AWARAN DISTRICT,32,Transgender,0,0,0
AWARAN DISTRICT,33,Male,438,219,657
AWARAN DISTRICT,33,Female,553,218,771
AWARAN DISTRICT,33,Transgender,0,0,0
AWARAN DISTRICT,34,Male,401,191,592
AWARAN DISTRICT,34,Female,451,189,640
AWARAN DISTRICT,34,Transgender,0,0,0
AWARAN DISTRICT,35,Male,544,217,761
AWARAN DISTRICT,35,Female,570,177,747
AWARAN DISTRICT,35,Transgender,0,0,0
AWARAN DISTRICT,36,Male,467,195,662
AWARAN DISTRICT,36,Female,413,186,599
AWARAN DISTRICT,36,Transgender,0,0,0
AWARAN DISTRICT,37,Male,477,233,710
AWARAN DISTRICT,37,Female,380,257,637
AWARAN DISTRICT,37,Transgender,0,0,0
AWARAN DISTRICT,38,Male,387,179,566
AWARAN DISTRICT,38,Female,488,160,648
AWARAN DISTRICT,38,Transgender,0,0,0
AWARAN DISTRICT,39,Male,389,179,568
AWARAN DISTRICT,39,Female,391,168,559
AWARAN DISTRICT,39,Transgender,0,0,0
AWARAN DISTRICT,40,Male,524,128,652
AWARAN DISTRICT,40,Female,583,150,733
AWARAN DISTRICT,40,Transgender,0,0,0
AWARAN DISTRICT,41,Male,370,156,526
AWARAN DISTRICT,41,Female,388,129,517
AWARAN DISTRICT,41,Transgender,0,0,0
AWARAN DISTRICT,42,Male,368,151,519
AWARAN DISTRICT,42,Female,297,127,424
AWARAN DISTRICT,42,Transgender,0,0,0
AWARAN DISTRICT,43,Male,351,127,478
AWARAN DISTRICT,43,Female,389,111,500
AWARAN DISTRICT,43,Transgender,0,0,0
AWARAN DISTRICT,44,Male,332,114,446
AWARAN DISTRICT,44,Female,328,121,449
AWARAN DISTRICT,44,Transgender,0,0,0
AWARAN DISTRICT,45,Male,375,92,467
AWARAN DISTRICT,45,Female,333,100,433
AWARAN DISTRICT,45,Transgender,0,0,0
AWARAN DISTRICT,46,Male,319,99,418
AWARAN DISTRICT,46,Female,285,83,368
AWARAN DISTRICT,46,Transgender,0,0,0
AWARAN DISTRICT,47,Male,319,118,437
AWARAN DISTRICT,47,Female,275,120,395
AWARAN DISTRICT,47,Transgender,0,0,0
AWARAN DISTRICT,48,Male,287,86,373
AWARAN DISTRICT,48,Female,312,84,396
AWARAN DISTRICT,48,Transgender,0,0,0
AWARAN DISTRICT,49,Male,312,106,418
AWARAN DISTRICT,49,Female,323,102,425
AWARAN DISTRICT,49,Transgender,0,0,0
AWARAN DISTRICT,50,Male,368,101,469
AWARAN DISTRICT,50,Female,359,101,460
AWARAN DISTRICT,50,Transgender,0,0,0
AWARAN DISTRICT,51,Male,285,105,390
AWARAN DISTRICT,51,Female,229,112,341
AWARAN DISTRICT,51,Transgender,0,0,0
AWARAN DISTRICT,52,Male,219,81,300
AWARAN DISTRICT,52,Female,153,95,248
AWARAN DISTRICT,52,Transgender,0,0,0
AWARAN DISTRICT,53,Male,242,85,327
AWARAN DISTRICT,53,Female,211,70,281
AWARAN DISTRICT,53,Transgender,0,0,0
AWARAN DISTRICT,54,Male,227,91,318
AWARAN DISTRICT,54,Female,202,95,297
AWARAN DISTRICT,54,Transgender,0,0,0
AWARAN DISTRICT,55,Male,193,61,254
AWARAN DISTRICT,55,Female,244,59,303
AWARAN DISTRICT,55,Transgender,0,0,0
AWARAN DISTRICT,56,Male,189,51,240
AWARAN DISTRICT,56,Female,157,60,217
AWARAN DISTRICT,56,Transgender,0,0,0
AWARAN DISTRICT,57,Male,218,83,301
AWARAN DISTRICT,57,Female,122,67,189
AWARAN DISTRICT,57,Transgender,0,0,0
AWARAN DISTRICT,58,Male,180,69,249
AWARAN DISTRICT,58,Female,160,69,229
AWARAN DISTRICT,58,Transgender,0,0,0
AWARAN DISTRICT,59,Male,214,93,307
AWARAN DISTRICT,59,Female,155,72,227
AWARAN DISTRICT,59,Transgender,0,0,0
AWARAN DISTRICT,60,Male,205,71,276
AWARAN DISTRICT,60,Female,274,70,344
AWARAN DISTRICT,60,Transgender,1,0,1
AWARAN DISTRICT,61,Male,154,57,211
AWARAN DISTRICT,61,Female,187,60,247
AWARAN DISTRICT,61,Transgender,0,0,0
AWARAN DISTRICT,62,Male,125,43,168
AWARAN DISTRICT,62,Female,127,59,186
AWARAN DISTRICT,62,Transgender,0,0,0
AWARAN DISTRICT,63,Male,157,61,218
AWARAN DISTRICT,63,Female,156,56,212
AWARAN DISTRICT,63,Transgender,0,0,0
AWARAN DISTRICT,64,Male,218,79,297
AWARAN DISTRICT,64,Female,175,68,243
AWARAN DISTRICT,64,Transgender,0,0,0
AWARAN DISTRICT,65,Male,125,51,176
AWARAN DISTRICT,65,Female,166,53,219
AWARAN DISTRICT,65,Transgender,0,0,0
AWARAN DISTRICT,66,Male,128,59,187
AWARAN DISTRICT,66,Female,100,50,150
AWARAN DISTRICT,66,Transgender,0,0,0
AWARAN DISTRICT,67,Male,126,42,168
AWARAN DISTRICT,67,Female,77,45,122
AWARAN DISTRICT,67,Transgender,0,0,0
AWARAN DISTRICT,68,Male,137,50,187
AWARAN DISTRICT,68,Female,94,37,131
AWARAN DISTRICT,68,Transgender,0,0,0
AWARAN DISTRICT,69,Male,169,69,238
AWARAN DISTRICT,69,Female,87,33,120
AWARAN DISTRICT,69,Transgender,0,0,0
AWARAN DISTRICT,70,Male,107,31,138
AWARAN DISTRICT,70,Female,124,42,166
AWARAN DISTRICT,70,Transgender,0,0,0
AWARAN DISTRICT,71,Male,76,39,115
AWARAN DISTRICT,71,Female,67,34,101
AWARAN DISTRICT,71,Transgender,0,0,0
AWARAN DISTRICT,72,Male,57,29,86
AWARAN DISTRICT,72,Female,59,28,87
AWARAN DISTRICT,72,Transgender,1,0,1
AWARAN DISTRICT,73,Male,91,23,114
AWARAN DISTRICT,73,Female,76,24,100
AWARAN DISTRICT,73,Transgender,0,0,0
AWARAN DISTRICT,74,Male,88,36,124
AWARAN DISTRICT,74,Female,76,16,92
AWARAN DISTRICT,74,Transgender,0,0,0
AWARAN DISTRICT,>=75,Male,455,193,648
AWARAN DISTRICT,>=75,Female,379,192,571
AWARAN DISTRICT,>=75,Transgender,0,0,0
BADIN DISTRICT,<1,Male,17884,4574,22458
BADIN DISTRICT,<1,Female,16611,4258,20869
BADIN DISTRICT,<1,Transgender,0,0,0
BADIN DISTRICT,1,Male,20355,5047,25402
BADIN DISTRICT,1,Female,20092,4840,24932
BADIN DISTRICT,1,Transgender,0,0,0
BADIN DISTRICT,2,Male,25385,6031,31416
BADIN DISTRICT,2,Female,25255,5827,31082
BADIN DISTRICT,2,Transgender,0,0,0
BADIN DISTRICT,3,Male,26490,6547,33037
BADIN DISTRICT,3,Female,25855,6219,32074
BADIN DISTRICT,3,Transgender,0,0,0
BADIN DISTRICT,4,Male,28027,6393,34420
BADIN DISTRICT,4,Female,27390,6244,33634
BADIN DISTRICT,4,Transgender,0,0,0
BADIN DISTRICT,5,Male,27827,6697,34524
BADIN DISTRICT,5,Female,25694,6411,32105
BADIN DISTRICT,5,Transgender,0,0,0
BADIN DISTRICT,6,Male,27366,6531,33897
BADIN DISTRICT,6,Female,25323,5832,31155
BADIN DISTRICT,6,Transgender,0,0,0
BADIN DISTRICT,7,Male,23950,6019,29969
BADIN DISTRICT,7,Female,21211,5561,26772
BADIN DISTRICT,7,Transgender,0,0,0
BADIN DISTRICT,8,Male,28642,6556,35198
BADIN DISTRICT,8,Female,25689,6125,31814
BADIN DISTRICT,8,Transgender,0,0,0
BADIN DISTRICT,9,Male,20508,5496,26004
BADIN DISTRICT,9,Female,17987,4995,22982
BADIN DISTRICT,9,Transgender,0,0,0
BADIN DISTRICT,10,Male,25564,5833,31397
BADIN DISTRICT,10,Female,22286,5192,27478
BADIN DISTRICT,10,Transgender,0,0,0
BADIN DISTRICT,11,Male,16379,4486,20865
BADIN DISTRICT,11,Female,13987,4186,18173
BADIN DISTRICT,11,Transgender,0,0,0
BADIN DISTRICT,12,Male,19956,4915,24871
BADIN DISTRICT,12,Female,16431,4448,20879
BADIN DISTRICT,12,Transgender,0,0,0
BADIN DISTRICT,13,Male,14674,4255,18929
BADIN DISTRICT,13,Female,11737,3672,15409
BADIN DISTRICT,13,Transgender,0,0,0
BADIN DISTRICT,14,Male,14809,4174,18983
BADIN DISTRICT,14,Female,12343,3817,16160
BADIN DISTRICT,14,Transgender,0,0,0
BADIN DISTRICT,15,Male,15970,4540,20510
BADIN DISTRICT,15,Female,12200,3899,16099
BADIN DISTRICT,15,Transgender,2,0,2
BADIN DISTRICT,16,Male,14310,4079,18389
BADIN DISTRICT,16,Female,11973,3691,15664
BADIN DISTRICT,16,Transgender,3,3,6
BADIN DISTRICT,17,Male,12369,4158,16527
BADIN DISTRICT,17,Female,10550,3826,14376
BADIN DISTRICT,17,Transgender,2,0,2
BADIN DISTRICT,18,Male,16768,4411,21179
BADIN DISTRICT,18,Female,16134,4230,20364
BADIN DISTRICT,18,Transgender,6,3,9
BADIN DISTRICT,19,Male,11800,3737,15537
BADIN DISTRICT,19,Female,12207,3821,16028
BADIN DISTRICT,19,Transgender,0,0,0
BADIN DISTRICT,20,Male,16204,4011,20215
BADIN DISTRICT,20,Female,14313,3830,18143
BADIN DISTRICT,20,Transgender,1,5,6
BADIN DISTRICT,21,Male,9782,3412,13194
BADIN DISTRICT,21,Female,10004,3296,13300
BADIN DISTRICT,21,Transgender,3,1,4
BADIN DISTRICT,22,Male,11294,3410,14704
BADIN DISTRICT,22,Female,9888,3021,12909
BADIN DISTRICT,22,Transgender,1,4,5
BADIN DISTRICT,23,Male,9102,3153,12255
BADIN DISTRICT,23,Female,9162,3081,12243
BADIN DISTRICT,23,Transgender,1,2,3
BADIN DISTRICT,24,Male,8244,2823,11067
BADIN DISTRICT,24,Female,8671,2861,11532
BADIN DISTRICT,24,Transgender,0,3,3
BADIN DISTRICT,25,Male,12469,3238,15707
BADIN DISTRICT,25,Female,11065,3161,14226
BADIN DISTRICT,25,Transgender,5,4,9
BADIN DISTRICT,26,Male,8881,2947,11828
BADIN DISTRICT,26,Female,9313,3123,12436
BADIN DISTRICT,26,Transgender,1,1,2
BADIN DISTRICT,27,Male,9951,3284,13235
BADIN DISTRICT,27,Female,10867,3349,14216
BADIN DISTRICT,27,Transgender,5,1,6
BADIN DISTRICT,28,Male,9801,2984,12785
BADIN DISTRICT,28,Female,11482,3269,14751
BADIN DISTRICT,28,Transgender,6,0,6
BADIN DISTRICT,29,Male,9978,3068,13046
BADIN DISTRICT,29,Female,11438,3321,14759
BADIN DISTRICT,29,Transgender,2,0,2
BADIN DISTRICT,30,Male,10879,2922,13801
BADIN DISTRICT,30,Female,10350,2921,13271
BADIN DISTRICT,30,Transgender,6,4,10
BADIN DISTRICT,31,Male,9843,3138,12981
BADIN DISTRICT,31,Female,10540,3286,13826
BADIN DISTRICT,31,Transgender,1,2,3
BADIN DISTRICT,32,Male,9815,3092,12907
BADIN DISTRICT,32,Female,9957,3095,13052
BADIN DISTRICT,32,Transgender,2,3,5
BADIN DISTRICT,33,Male,8355,2727,11082
BADIN DISTRICT,33,Female,8812,2610,11422
BADIN DISTRICT,33,Transgender,0,1,1
BADIN DISTRICT,34,Male,7612,2561,10173
BADIN DISTRICT,34,Female,8267,2481,10748
BADIN DISTRICT,34,Transgender,3,1,4
BADIN DISTRICT,35,Male,9376,2563,11939
BADIN DISTRICT,35,Female,8583,2291,10874
BADIN DISTRICT,35,Transgender,5,5,10
BADIN DISTRICT,36,Male,8399,2689,11088
BADIN DISTRICT,36,Female,7586,2219,9805
BADIN DISTRICT,36,Transgender,0,1,1
BADIN DISTRICT,37,Male,11693,2887,14580
BADIN DISTRICT,37,Female,10180,2758,12938
BADIN DISTRICT,37,Transgender,2,2,4
BADIN DISTRICT,38,Male,7653,2340,9993
BADIN DISTRICT,38,Female,7142,2075,9217
BADIN DISTRICT,38,Transgender,3,3,6
BADIN DISTRICT,39,Male,8209,2414,10623
BADIN DISTRICT,39,Female,7575,2247,9822
BADIN DISTRICT,39,Transgender,2,3,5
BADIN DISTRICT,40,Male,7084,1993,9077
BADIN DISTRICT,40,Female,6569,1935,8504
BADIN DISTRICT,40,Transgender,5,6,11
BADIN DISTRICT,41,Male,6182,1919,8101
BADIN DISTRICT,41,Female,6134,1841,7975
BADIN DISTRICT,41,Transgender,4,2,6
BADIN DISTRICT,42,Male,5809,1789,7598
BADIN DISTRICT,42,Female,6741,1949,8690
BADIN DISTRICT,42,Transgender,2,2,4
BADIN DISTRICT,43,Male,5703,1760,7463
BADIN DISTRICT,43,Female,5204,1553,6757
BADIN DISTRICT,43,Transgender,1,1,2
BADIN DISTRICT,44,Male,5283,1665,6948
BADIN DISTRICT,44,Female,4842,1471,6313
BADIN DISTRICT,44,Transgender,3,0,3
BADIN DISTRICT,45,Male,5324,1559,6883
BADIN DISTRICT,45,Female,4805,1379,6184
BADIN DISTRICT,45,Transgender,1,1,2
BADIN DISTRICT,46,Male,5064,1611,6675
BADIN DISTRICT,46,Female,4391,1306,5697
BADIN DISTRICT,46,Transgender,0,0,0
BADIN DISTRICT,47,Male,5952,1756,7708
BADIN DISTRICT,47,Female,6052,1672,7724
BADIN DISTRICT,47,Transgender,2,1,3
BADIN DISTRICT,48,Male,4914,1466,6380
BADIN DISTRICT,48,Female,4400,1279,5679
BADIN DISTRICT,48,Transgender,4,0,4
BADIN DISTRICT,49,Male,5154,1584,6738
BADIN DISTRICT,49,Female,4448,1328,5776
BADIN DISTRICT,49,Transgender,0,0,0
BADIN DISTRICT,50,Male,4891,1415,6306
BADIN DISTRICT,50,Female,3912,1120,5032
BADIN DISTRICT,50,Transgender,4,2,6
BADIN DISTRICT,51,Male,4060,1398,5458
BADIN DISTRICT,51,Female,3512,1071,4583
BADIN DISTRICT,51,Transgender,0,1,1
BADIN DISTRICT,52,Male,3767,1202,4969
BADIN DISTRICT,52,Female,3462,1042,4504
BADIN DISTRICT,52,Transgender,3,1,4
BADIN DISTRICT,53,Male,3377,1148,4525
BADIN DISTRICT,53,Female,2673,851,3524
BADIN DISTRICT,53,Transgender,0,0,0
BADIN DISTRICT,54,Male,3070,978,4048
BADIN DISTRICT,54,Female,2390,770,3160
BADIN DISTRICT,54,Transgender,0,0,0
BADIN DISTRICT,55,Male,2929,887,3816
BADIN DISTRICT,55,Female,2591,736,3327
BADIN DISTRICT,55,Transgender,2,2,4
BADIN DISTRICT,56,Male,2368,780,3148
BADIN DISTRICT,56,Female,2240,643,2883
BADIN DISTRICT,56,Transgender,1,0,1
BADIN DISTRICT,57,Male,2821,791,3612
BADIN DISTRICT,57,Female,3336,915,4251
BADIN DISTRICT,57,Transgender,0,1,1
BADIN DISTRICT,58,Male,2375,740,3115
BADIN DISTRICT,58,Female,2596,791,3387
BADIN DISTRICT,58,Transgender,0,1,1
BADIN DISTRICT,59,Male,2801,835,3636
BADIN DISTRICT,59,Female,2661,830,3491
BADIN DISTRICT,59,Transgender,0,0,0
BADIN DISTRICT,60,Male,2986,683,3669
BADIN DISTRICT,60,Female,2793,694,3487
BADIN DISTRICT,60,Transgender,2,2,4
BADIN DISTRICT,61,Male,2341,804,3145
BADIN DISTRICT,61,Female,2540,773,3313
BADIN DISTRICT,61,Transgender,0,0,0
BADIN DISTRICT,62,Male,2277,734,3011
BADIN DISTRICT,62,Female,2696,730,3426
BADIN DISTRICT,62,Transgender,1,1,2
BADIN DISTRICT,63,Male,2372,740,3112
BADIN DISTRICT,63,Female,2325,680,3005
BADIN DISTRICT,63,Transgender,0,1,1
BADIN DISTRICT,64,Male,2711,682,3393
BADIN DISTRICT,64,Female,2327,680,3007
BADIN DISTRICT,64,Transgender,0,0,0
BADIN DISTRICT,65,Male,2404,528,2932
BADIN DISTRICT,65,Female,1970,562,2532
BADIN DISTRICT,65,Transgender,2,0,2
BADIN DISTRICT,66,Male,1800,568,2368
BADIN DISTRICT,66,Female,1723,498,2221
BADIN DISTRICT,66,Transgender,0,0,0
BADIN DISTRICT,67,Male,1628,484,2112
BADIN DISTRICT,67,Female,1993,537,2530
BADIN DISTRICT,67,Transgender,0,0,0
BADIN DISTRICT,68,Male,1564,453,2017
BADIN DISTRICT,68,Female,1543,457,2000
BADIN DISTRICT,68,Transgender,0,0,0
BADIN DISTRICT,69,Male,1880,475,2355
BADIN DISTRICT,69,Female,1782,434,2216
BADIN DISTRICT,69,Transgender,0,1,1
BADIN DISTRICT,70,Male,1679,375,2054
BADIN DISTRICT,70,Female,1534,364,1898
BADIN DISTRICT,70,Transgender,4,3,7
BADIN DISTRICT,71,Male,1281,356,1637
BADIN DISTRICT,71,Female,1208,343,1551
BADIN DISTRICT,71,Transgender,0,0,0
BADIN DISTRICT,72,Male,923,260,1183
BADIN DISTRICT,72,Female,1208,308,1516
BADIN DISTRICT,72,Transgender,1,0,1
BADIN DISTRICT,73,Male,1046,284,1330
BADIN DISTRICT,73,Female,983,321,1304
BADIN DISTRICT,73,Transgender,0,0,0
BADIN DISTRICT,74,Male,1228,273,1501
BADIN DISTRICT,74,Female,1009,258,1267
BADIN DISTRICT,74,Transgender,0,0,0
BADIN DISTRICT,>=75,Male,6773,1666,8439
BADIN DISTRICT,>=75,Female,7370,1966,9336
BADIN DISTRICT,>=75,Transgender,3,4,7
BAHAWALNAGAR DISTRICT,<1,Male,28711,7143,35854
BAHAWALNAGAR DISTRICT,<1,Female,27321,6889,34210
BAHAWALNAGAR DISTRICT,<1,Transgender,0,0,0
BAHAWALNAGAR DISTRICT,1,Male,33190,8118,41308
BAHAWALNAGAR DISTRICT,1,Female,31776,7865,39641
BAHAWALNAGAR DISTRICT,1,Transgender,0,0,0
BAHAWALNAGAR DISTRICT,2,Male,33809,7985,41794
BAHAWALNAGAR DISTRICT,2,Female,32304,7498,39802
BAHAWALNAGAR DISTRICT,2,Transgender,0,0,0
BAHAWALNAGAR DISTRICT,3,Male,35750,8424,44174
BAHAWALNAGAR DISTRICT,3,Female,34404,8098,42502
BAHAWALNAGAR DISTRICT,3,Transgender,0,0,0
BAHAWALNAGAR DISTRICT,4,Male,36593,8390,44983
BAHAWALNAGAR DISTRICT,4,Female,34998,7814,42812
BAHAWALNAGAR DISTRICT,4,Transgender,0,0,0
BAHAWALNAGAR DISTRICT,5,Male,36222,8255,44477
BAHAWALNAGAR DISTRICT,5,Female,33846,7819,41665
BAHAWALNAGAR DISTRICT,5,Transgender,0,0,0
BAHAWALNAGAR DISTRICT,6,Male,34787,8265,43052
BAHAWALNAGAR DISTRICT,6,Female,32948,7569,40517
BAHAWALNAGAR DISTRICT,6,Transgender,0,0,0
BAHAWALNAGAR DISTRICT,7,Male,37264,8672,45936
BAHAWALNAGAR DISTRICT,7,Female,35156,8155,43311
BAHAWALNAGAR DISTRICT,7,Transgender,0,0,0
BAHAWALNAGAR DISTRICT,8,Male,35492,7781,43273
BAHAWALNAGAR DISTRICT,8,Female,33036,7251,40287
BAHAWALNAGAR DISTRICT,8,Transgender,0,0,0
BAHAWALNAGAR DISTRICT,9,Male,34207,8577,42784
BAHAWALNAGAR DISTRICT,9,Female,31961,8134,40095
BAHAWALNAGAR DISTRICT,9,Transgender,0,0,0
BAHAWALNAGAR DISTRICT,10,Male,32299,7227,39526
BAHAWALNAGAR DISTRICT,10,Female,29903,6777,36680
BAHAWALNAGAR DISTRICT,10,Transgender,0,0,0
BAHAWALNAGAR DISTRICT,11,Male,30235,8468,38703
BAHAWALNAGAR DISTRICT,11,Female,28125,7745,35870
BAHAWALNAGAR DISTRICT,11,Transgender,0,0,0
BAHAWALNAGAR DISTRICT,12,Male,28328,6977,35305
BAHAWALNAGAR DISTRICT,12,Female,26127,6348,32475
BAHAWALNAGAR DISTRICT,12,Transgender,0,0,0
BAHAWALNAGAR DISTRICT,13,Male,26410,7663,34073
BAHAWALNAGAR DISTRICT,13,Female,23833,7111,30944
BAHAWALNAGAR DISTRICT,13,Transgender,0,0,0
BAHAWALNAGAR DISTRICT,14,Male,25684,6994,32678
BAHAWALNAGAR DISTRICT,14,Female,23559,6416,29975
BAHAWALNAGAR DISTRICT,14,Transgender,0,0,0
BAHAWALNAGAR DISTRICT,15,Male,24486,6765,31251
BAHAWALNAGAR DISTRICT,15,Female,23109,6708,29817
BAHAWALNAGAR DISTRICT,15,Transgender,2,0,2
BAHAWALNAGAR DISTRICT,16,Male,24679,6817,31496
BAHAWALNAGAR DISTRICT,16,Female,23147,6478,29625
BAHAWALNAGAR DISTRICT,16,Transgender,3,3,6
BAHAWALNAGAR DISTRICT,17,Male,23643,6784,30427
BAHAWALNAGAR DISTRICT,17,Female,21342,6476,27818
BAHAWALNAGAR DISTRICT,17,Transgender,5,0,5
BAHAWALNAGAR DISTRICT,18,Male,23374,6210,29584
BAHAWALNAGAR DISTRICT,18,Female,22248,5861,28109
BAHAWALNAGAR DISTRICT,18,Transgender,6,2,8
BAHAWALNAGAR DISTRICT,19,Male,21126,6418,27544
BAHAWALNAGAR DISTRICT,19,Female,21016,6738,27754
BAHAWALNAGAR DISTRICT,19,Transgender,0,3,3
BAHAWALNAGAR DISTRICT,20,Male,21566,5633,27199
BAHAWALNAGAR DISTRICT,20,Female,22609,5500,28109
BAHAWALNAGAR DISTRICT,20,Transgender,9,2,11
BAHAWALNAGAR DISTRICT,21,Male,19723,6055,25778
BAHAWALNAGAR DISTRICT,21,Female,20414,6474,26888
BAHAWALNAGAR DISTRICT,21,Transgender,3,2,5
BAHAWALNAGAR DISTRICT,22,Male,19535,5453,24988
BAHAWALNAGAR DISTRICT,22,Female,20953,5973,26926
BAHAWALNAGAR DISTRICT,22,Transgender,9,4,13
BAHAWALNAGAR DISTRICT,23,Male,17582,5170,22752
BAHAWALNAGAR DISTRICT,23,Female,18353,5785,24138
BAHAWALNAGAR DISTRICT,23,Transgender,2,4,6
BAHAWALNAGAR DISTRICT,24,Male,16661,5159,21820
BAHAWALNAGAR DISTRICT,24,Female,17366,5565,22931
BAHAWALNAGAR DISTRICT,24,Transgender,3,4,7
BAHAWALNAGAR DISTRICT,25,Male,16745,4615,21360
BAHAWALNAGAR DISTRICT,25,Female,19948,4888,24836
BAHAWALNAGAR DISTRICT,25,Transgender,4,6,10
BAHAWALNAGAR DISTRICT,26,Male,16130,4942,21072
BAHAWALNAGAR DISTRICT,26,Female,17891,5492,23383
BAHAWALNAGAR DISTRICT,26,Transgender,7,2,9
BAHAWALNAGAR DISTRICT,27,Male,16025,4779,20804
BAHAWALNAGAR DISTRICT,27,Female,17533,5398,22931
BAHAWALNAGAR DISTRICT,27,Transgender,5,2,7
BAHAWALNAGAR DISTRICT,28,Male,16424,4671,21095
BAHAWALNAGAR DISTRICT,28,Female,18111,5181,23292
BAHAWALNAGAR DISTRICT,28,Transgender,3,4,7
BAHAWALNAGAR DISTRICT,29,Male,17403,4930,22333
BAHAWALNAGAR DISTRICT,29,Female,18215,5254,23469
BAHAWALNAGAR DISTRICT,29,Transgender,1,0,1
BAHAWALNAGAR DISTRICT,30,Male,15497,4168,19665
BAHAWALNAGAR DISTRICT,30,Female,18759,4527,23286
BAHAWALNAGAR DISTRICT,30,Transgender,7,7,14
BAHAWALNAGAR DISTRICT,31,Male,16877,4618,21495
BAHAWALNAGAR DISTRICT,31,Female,17203,4977,22180
BAHAWALNAGAR DISTRICT,31,Transgender,4,0,4
BAHAWALNAGAR DISTRICT,32,Male,15298,4283,19581
BAHAWALNAGAR DISTRICT,32,Female,15728,4523,20251
BAHAWALNAGAR DISTRICT,32,Transgender,6,4,10
BAHAWALNAGAR DISTRICT,33,Male,14083,4077,18160
BAHAWALNAGAR DISTRICT,33,Female,14912,4214,19126
BAHAWALNAGAR DISTRICT,33,Transgender,6,1,7
BAHAWALNAGAR DISTRICT,34,Male,14312,3945,18257
BAHAWALNAGAR DISTRICT,34,Female,14142,4233,18375
BAHAWALNAGAR DISTRICT,34,Transgender,1,3,4
BAHAWALNAGAR DISTRICT,35,Male,13164,3357,16521
BAHAWALNAGAR DISTRICT,35,Female,14236,3450,17686
BAHAWALNAGAR DISTRICT,35,Transgender,4,5,9
BAHAWALNAGAR DISTRICT,36,Male,14791,3676,18467
BAHAWALNAGAR DISTRICT,36,Female,13652,3908,17560
BAHAWALNAGAR DISTRICT,36,Transgender,4,2,6
BAHAWALNAGAR DISTRICT,37,Male,14734,3651,18385
BAHAWALNAGAR DISTRICT,37,Female,13109,3502,16611
BAHAWALNAGAR DISTRICT,37,Transgender,4,4,8
BAHAWALNAGAR DISTRICT,38,Male,12616,3649,16265
BAHAWALNAGAR DISTRICT,38,Female,12248,3572,15820
BAHAWALNAGAR DISTRICT,38,Transgender,5,2,7
BAHAWALNAGAR DISTRICT,39,Male,13195,3600,16795
BAHAWALNAGAR DISTRICT,39,Female,13076,3592,16668
BAHAWALNAGAR DISTRICT,39,Transgender,3,1,4
BAHAWALNAGAR DISTRICT,40,Male,10750,3165,13915
BAHAWALNAGAR DISTRICT,40,Female,11938,3097,15035
BAHAWALNAGAR DISTRICT,40,Transgender,12,5,17
BAHAWALNAGAR DISTRICT,41,Male,12352,3467,15819
BAHAWALNAGAR DISTRICT,41,Female,12509,3479,15988
BAHAWALNAGAR DISTRICT,41,Transgender,1,0,1
BAHAWALNAGAR DISTRICT,42,Male,11109,3167,14276
BAHAWALNAGAR DISTRICT,42,Female,11053,3201,14254
BAHAWALNAGAR DISTRICT,42,Transgender,3,1,4
BAHAWALNAGAR DISTRICT,43,Male,10277,3138,13415
BAHAWALNAGAR DISTRICT,43,Female,10028,2972,13000
BAHAWALNAGAR DISTRICT,43,Transgender,5,1,6
BAHAWALNAGAR DISTRICT,44,Male,10458,3202,13660
BAHAWALNAGAR DISTRICT,44,Female,10256,2994,13250
BAHAWALNAGAR DISTRICT,44,Transgender,0,2,2
BAHAWALNAGAR DISTRICT,45,Male,8856,2589,11445
BAHAWALNAGAR DISTRICT,45,Female,9342,2371,11713
BAHAWALNAGAR DISTRICT,45,Transgender,6,3,9
BAHAWALNAGAR DISTRICT,46,Male,11153,3064,14217
BAHAWALNAGAR DISTRICT,46,Female,10408,2957,13365
BAHAWALNAGAR DISTRICT,46,Transgender,1,2,3
BAHAWALNAGAR DISTRICT,47,Male,10651,2818,13469
BAHAWALNAGAR DISTRICT,47,Female,9891,2642,12533
BAHAWALNAGAR DISTRICT,47,Transgender,2,3,5
BAHAWALNAGAR DISTRICT,48,Male,10319,2870,13189
BAHAWALNAGAR DISTRICT,48,Female,9553,2809,12362
BAHAWALNAGAR DISTRICT,48,Transgender,1,1,2
BAHAWALNAGAR DISTRICT,49,Male,10789,2972,13761
BAHAWALNAGAR DISTRICT,49,Female,9912,2824,12736
BAHAWALNAGAR DISTRICT,49,Transgender,2,1,3
BAHAWALNAGAR DISTRICT,50,Male,9186,2488,11674
BAHAWALNAGAR DISTRICT,50,Female,8749,2384,11133
BAHAWALNAGAR DISTRICT,50,Transgender,6,2,8
BAHAWALNAGAR DISTRICT,51,Male,10738,2884,13622
BAHAWALNAGAR DISTRICT,51,Female,9966,2728,12694
BAHAWALNAGAR DISTRICT,51,Transgender,0,0,0
BAHAWALNAGAR DISTRICT,52,Male,9582,2750,12332
BAHAWALNAGAR DISTRICT,52,Female,8476,2394,10870
BAHAWALNAGAR DISTRICT,52,Transgender,8,5,13
BAHAWALNAGAR DISTRICT,53,Male,9364,2607,11971
BAHAWALNAGAR DISTRICT,53,Female,7790,2323,10113
BAHAWALNAGAR DISTRICT,53,Transgender,3,1,4
BAHAWALNAGAR DISTRICT,54,Male,8357,2403,10760
BAHAWALNAGAR DISTRICT,54,Female,6967,2118,9085
BAHAWALNAGAR DISTRICT,54,Transgender,3,0,3
BAHAWALNAGAR DISTRICT,55,Male,6846,1934,8780
BAHAWALNAGAR DISTRICT,55,Female,5799,1538,7337
BAHAWALNAGAR DISTRICT,55,Transgender,1,4,5
BAHAWALNAGAR DISTRICT,56,Male,6837,1981,8818
BAHAWALNAGAR DISTRICT,56,Female,6225,1732,7957
BAHAWALNAGAR DISTRICT,56,Transgender,3,2,5
BAHAWALNAGAR DISTRICT,57,Male,6241,1637,7878
BAHAWALNAGAR DISTRICT,57,Female,5487,1293,6780
BAHAWALNAGAR DISTRICT,57,Transgender,0,0,0
BAHAWALNAGAR DISTRICT,58,Male,5358,1583,6941
BAHAWALNAGAR DISTRICT,58,Female,4876,1417,6293
BAHAWALNAGAR DISTRICT,58,Transgender,1,2,3
BAHAWALNAGAR DISTRICT,59,Male,5518,1616,7134
BAHAWALNAGAR DISTRICT,59,Female,5257,1526,6783
BAHAWALNAGAR DISTRICT,59,Transgender,3,1,4
BAHAWALNAGAR DISTRICT,60,Male,4978,1261,6239
BAHAWALNAGAR DISTRICT,60,Female,5206,1216,6422
BAHAWALNAGAR DISTRICT,60,Transgender,2,4,6
BAHAWALNAGAR DISTRICT,61,Male,5933,1656,7589
BAHAWALNAGAR DISTRICT,61,Female,5476,1471,6947
BAHAWALNAGAR DISTRICT,61,Transgender,4,2,6
BAHAWALNAGAR DISTRICT,62,Male,5397,1493,6890
BAHAWALNAGAR DISTRICT,62,Female,5079,1283,6362
BAHAWALNAGAR DISTRICT,62,Transgender,3,1,4
BAHAWALNAGAR DISTRICT,63,Male,5055,1411,6466
BAHAWALNAGAR DISTRICT,63,Female,4644,1206,5850
BAHAWALNAGAR DISTRICT,63,Transgender,0,0,0
BAHAWALNAGAR DISTRICT,64,Male,4829,1166,5995
BAHAWALNAGAR DISTRICT,64,Female,4374,1114,5488
BAHAWALNAGAR DISTRICT,64,Transgender,3,1,4
BAHAWALNAGAR DISTRICT,65,Male,4349,947,5296
BAHAWALNAGAR DISTRICT,65,Female,4332,903,5235
BAHAWALNAGAR DISTRICT,65,Transgender,4,1,5
BAHAWALNAGAR DISTRICT,66,Male,4614,987,5601
BAHAWALNAGAR DISTRICT,66,Female,4258,945,5203
BAHAWALNAGAR DISTRICT,66,Transgender,1,0,1
BAHAWALNAGAR DISTRICT,67,Male,4270,849,5119
BAHAWALNAGAR DISTRICT,67,Female,3744,833,4577
BAHAWALNAGAR DISTRICT,67,Transgender,1,1,2
BAHAWALNAGAR DISTRICT,68,Male,4075,852,4927
BAHAWALNAGAR DISTRICT,68,Female,3649,867,4516
BAHAWALNAGAR DISTRICT,68,Transgender,2,0,2
BAHAWALNAGAR DISTRICT,69,Male,3751,799,4550
BAHAWALNAGAR DISTRICT,69,Female,3438,759,4197
BAHAWALNAGAR DISTRICT,69,Transgender,0,0,0
BAHAWALNAGAR DISTRICT,70,Male,3587,719,4306
BAHAWALNAGAR DISTRICT,70,Female,3365,685,4050
BAHAWALNAGAR DISTRICT,70,Transgender,3,1,4
BAHAWALNAGAR DISTRICT,71,Male,3893,831,4724
BAHAWALNAGAR DISTRICT,71,Female,3353,761,4114
BAHAWALNAGAR DISTRICT,71,Transgender,5,1,6
BAHAWALNAGAR DISTRICT,72,Male,3622,711,4333
BAHAWALNAGAR DISTRICT,72,Female,2875,696,3571
BAHAWALNAGAR DISTRICT,72,Transgender,1,0,1
BAHAWALNAGAR DISTRICT,73,Male,2992,669,3661
BAHAWALNAGAR DISTRICT,73,Female,2557,663,3220
BAHAWALNAGAR DISTRICT,73,Transgender,1,0,1
BAHAWALNAGAR DISTRICT,74,Male,2494,510,3004
BAHAWALNAGAR DISTRICT,74,Female,2095,487,2582
BAHAWALNAGAR DISTRICT,74,Transgender,0,1,1
BAHAWALNAGAR DISTRICT,>=75,Male,19861,3776,23637
BAHAWALNAGAR DISTRICT,>=75,Female,17127,3783,20910
BAHAWALNAGAR DISTRICT,>=75,Transgender,11,5,16
BAHAWALPUR DISTRICT,<1,Male,33285,14144,47429
BAHAWALPUR DISTRICT,<1,Female,31800,13376,45176
BAHAWALPUR DISTRICT,<1,Transgender,0,0,0
BAHAWALPUR DISTRICT,1,Male,36265,15112,51377
BAHAWALPUR DISTRICT,1,Female,34514,14090,48604
BAHAWALPUR DISTRICT,1,Transgender,0,0,0
BAHAWALPUR DISTRICT,2,Male,36886,14565,51451
BAHAWALPUR DISTRICT,2,Female,35490,13872,49362
BAHAWALPUR DISTRICT,2,Transgender,0,0,0
BAHAWALPUR DISTRICT,3,Male,40497,15862,56359
BAHAWALPUR DISTRICT,3,Female,38821,15367,54188
BAHAWALPUR DISTRICT,3,Transgender,0,0,0
BAHAWALPUR DISTRICT,4,Male,41966,15862,57828
BAHAWALPUR DISTRICT,4,Female,40094,15053,55147
BAHAWALPUR DISTRICT,4,Transgender,0,0,0
BAHAWALPUR DISTRICT,5,Male,40934,15504,56438
BAHAWALPUR DISTRICT,5,Female,38605,14772,53377
BAHAWALPUR DISTRICT,5,Transgender,0,0,0
BAHAWALPUR DISTRICT,6,Male,39774,15305,55079
BAHAWALPUR DISTRICT,6,Female,36629,13975,50604
BAHAWALPUR DISTRICT,6,Transgender,0,0,0
BAHAWALPUR DISTRICT,7,Male,42534,16883,59417
BAHAWALPUR DISTRICT,7,Female,39733,15451,55184
BAHAWALPUR DISTRICT,7,Transgender,0,0,0
BAHAWALPUR DISTRICT,8,Male,42552,15221,57773
BAHAWALPUR DISTRICT,8,Female,38447,14019,52466
BAHAWALPUR DISTRICT,8,Transgender,0,0,0
BAHAWALPUR DISTRICT,9,Male,38480,16170,54650
BAHAWALPUR DISTRICT,9,Female,35228,15067,50295
BAHAWALPUR DISTRICT,9,Transgender,0,0,0
BAHAWALPUR DISTRICT,10,Male,38084,14125,52209
BAHAWALPUR DISTRICT,10,Female,33618,12747,46365
BAHAWALPUR DISTRICT,10,Transgender,0,0,0
BAHAWALPUR DISTRICT,11,Male,31863,15481,47344
BAHAWALPUR DISTRICT,11,Female,28309,13967,42276
BAHAWALPUR DISTRICT,11,Transgender,0,0,0
BAHAWALPUR DISTRICT,12,Male,32895,13631,46526
BAHAWALPUR DISTRICT,12,Female,28566,11931,40497
BAHAWALPUR DISTRICT,12,Transgender,0,0,0
BAHAWALPUR DISTRICT,13,Male,27976,14102,42078
BAHAWALPUR DISTRICT,13,Female,24451,12573,37024
BAHAWALPUR DISTRICT,13,Transgender,0,0,0
BAHAWALPUR DISTRICT,14,Male,27419,12890,40309
BAHAWALPUR DISTRICT,14,Female,24348,11673,36021
BAHAWALPUR DISTRICT,14,Transgender,0,0,0
BAHAWALPUR DISTRICT,15,Male,25932,12885,38817
BAHAWALPUR DISTRICT,15,Female,23260,11671,34931
BAHAWALPUR DISTRICT,15,Transgender,3,1,4
BAHAWALPUR DISTRICT,16,Male,25025,12863,37888
BAHAWALPUR DISTRICT,16,Female,23483,11425,34908
BAHAWALPUR DISTRICT,16,Transgender,6,3,9
BAHAWALPUR DISTRICT,17,Male,22797,13363,36160
BAHAWALPUR DISTRICT,17,Female,20912,11645,32557
BAHAWALPUR DISTRICT,17,Transgender,2,1,3
BAHAWALPUR DISTRICT,18,Male,25724,12402,38126
BAHAWALPUR DISTRICT,18,Female,24954,11427,36381
BAHAWALPUR DISTRICT,18,Transgender,6,0,6
BAHAWALPUR DISTRICT,19,Male,22172,12710,34882
BAHAWALPUR DISTRICT,19,Female,22318,12769,35087
BAHAWALPUR DISTRICT,19,Transgender,5,2,7
BAHAWALPUR DISTRICT,20,Male,24289,11790,36079
BAHAWALPUR DISTRICT,20,Female,24536,11476,36012
BAHAWALPUR DISTRICT,20,Transgender,5,7,12
BAHAWALPUR DISTRICT,21,Male,20148,12387,32535
BAHAWALPUR DISTRICT,21,Female,20680,12623,33303
BAHAWALPUR DISTRICT,21,Transgender,2,2,4
BAHAWALPUR DISTRICT,22,Male,20764,11496,32260
BAHAWALPUR DISTRICT,22,Female,21376,11566,32942
BAHAWALPUR DISTRICT,22,Transgender,2,6,8
BAHAWALPUR DISTRICT,23,Male,17883,11044,28927
BAHAWALPUR DISTRICT,23,Female,18511,11344,29855
BAHAWALPUR DISTRICT,23,Transgender,2,3,5
BAHAWALPUR DISTRICT,24,Male,17446,10370,27816
BAHAWALPUR DISTRICT,24,Female,18122,10393,28515
BAHAWALPUR DISTRICT,24,Transgender,7,3,10
BAHAWALPUR DISTRICT,25,Male,19137,9493,28630
BAHAWALPUR DISTRICT,25,Female,21228,9914,31142
BAHAWALPUR DISTRICT,25,Transgender,8,10,18
BAHAWALPUR DISTRICT,26,Male,17410,10127,27537
BAHAWALPUR DISTRICT,26,Female,18815,10260,29075
BAHAWALPUR DISTRICT,26,Transgender,3,4,7
BAHAWALPUR DISTRICT,27,Male,17488,9946,27434
BAHAWALPUR DISTRICT,27,Female,18368,10130,28498
BAHAWALPUR DISTRICT,27,Transgender,2,2,4
BAHAWALPUR DISTRICT,28,Male,17986,9909,27895
BAHAWALPUR DISTRICT,28,Female,18773,9594,28367
BAHAWALPUR DISTRICT,28,Transgender,4,2,6
BAHAWALPUR DISTRICT,29,Male,18109,10593,28702
BAHAWALPUR DISTRICT,29,Female,18859,9739,28598
BAHAWALPUR DISTRICT,29,Transgender,6,0,6
BAHAWALPUR DISTRICT,30,Male,16843,9067,25910
BAHAWALPUR DISTRICT,30,Female,18466,8667,27133
BAHAWALPUR DISTRICT,30,Transgender,6,7,13
BAHAWALPUR DISTRICT,31,Male,16799,9778,26577
BAHAWALPUR DISTRICT,31,Female,18463,9194,27657
BAHAWALPUR DISTRICT,31,Transgender,0,3,3
BAHAWALPUR DISTRICT,32,Male,14656,8713,23369
BAHAWALPUR DISTRICT,32,Female,16362,8171,24533
BAHAWALPUR DISTRICT,32,Transgender,4,6,10
BAHAWALPUR DISTRICT,33,Male,13898,8526,22424
BAHAWALPUR DISTRICT,33,Female,15412,7979,23391
BAHAWALPUR DISTRICT,33,Transgender,0,3,3
BAHAWALPUR DISTRICT,34,Male,15617,8383,24000
BAHAWALPUR DISTRICT,34,Female,15837,7630,23467
BAHAWALPUR DISTRICT,34,Transgender,1,3,4
BAHAWALPUR DISTRICT,35,Male,15277,7625,22902
BAHAWALPUR DISTRICT,35,Female,14220,6908,21128
BAHAWALPUR DISTRICT,35,Transgender,9,4,13
BAHAWALPUR DISTRICT,36,Male,17674,8221,25895
BAHAWALPUR DISTRICT,36,Female,16332,7454,23786
BAHAWALPUR DISTRICT,36,Transgender,6,3,9
BAHAWALPUR DISTRICT,37,Male,15814,7328,23142
BAHAWALPUR DISTRICT,37,Female,14714,6651,21365
BAHAWALPUR DISTRICT,37,Transgender,4,3,7
BAHAWALPUR DISTRICT,38,Male,13867,7728,21595
BAHAWALPUR DISTRICT,38,Female,13635,7079,20714
BAHAWALPUR DISTRICT,38,Transgender,2,3,5
BAHAWALPUR DISTRICT,39,Male,13635,7316,20951
BAHAWALPUR DISTRICT,39,Female,13687,6702,20389
BAHAWALPUR DISTRICT,39,Transgender,3,1,4
BAHAWALPUR DISTRICT,40,Male,11534,6585,18119
BAHAWALPUR DISTRICT,40,Female,11573,5897,17470
BAHAWALPUR DISTRICT,40,Transgender,4,10,14
BAHAWALPUR DISTRICT,41,Male,13302,6638,19940
BAHAWALPUR DISTRICT,41,Female,13688,6270,19958
BAHAWALPUR DISTRICT,41,Transgender,3,2,5
BAHAWALPUR DISTRICT,42,Male,11676,6002,17678
BAHAWALPUR DISTRICT,42,Female,11838,5653,17491
BAHAWALPUR DISTRICT,42,Transgender,3,4,7
BAHAWALPUR DISTRICT,43,Male,9849,5749,15598
BAHAWALPUR DISTRICT,43,Female,9859,5459,15318
BAHAWALPUR DISTRICT,43,Transgender,1,5,6
BAHAWALPUR DISTRICT,44,Male,10219,5567,15786
BAHAWALPUR DISTRICT,44,Female,9892,5196,15088
BAHAWALPUR DISTRICT,44,Transgender,0,0,0
BAHAWALPUR DISTRICT,45,Male,8969,5022,13991
BAHAWALPUR DISTRICT,45,Female,8616,4648,13264
BAHAWALPUR DISTRICT,45,Transgender,8,5,13
BAHAWALPUR DISTRICT,46,Male,10784,5185,15969
BAHAWALPUR DISTRICT,46,Female,10721,4987,15708
BAHAWALPUR DISTRICT,46,Transgender,4,4,8
BAHAWALPUR DISTRICT,47,Male,10551,4865,15416
BAHAWALPUR DISTRICT,47,Female,9741,4349,14090
BAHAWALPUR DISTRICT,47,Transgender,4,2,6
BAHAWALPUR DISTRICT,48,Male,9563,5219,14782
BAHAWALPUR DISTRICT,48,Female,8766,4859,13625
BAHAWALPUR DISTRICT,48,Transgender,4,2,6
BAHAWALPUR DISTRICT,49,Male,9735,5200,14935
BAHAWALPUR DISTRICT,49,Female,8820,4777,13597
BAHAWALPUR DISTRICT,49,Transgender,2,2,4
BAHAWALPUR DISTRICT,50,Male,9163,4757,13920
BAHAWALPUR DISTRICT,50,Female,7771,4280,12051
BAHAWALPUR DISTRICT,50,Transgender,3,1,4
BAHAWALPUR DISTRICT,51,Male,10033,4940,14973
BAHAWALPUR DISTRICT,51,Female,9430,4417,13847
BAHAWALPUR DISTRICT,51,Transgender,2,2,4
BAHAWALPUR DISTRICT,52,Male,8760,4511,13271
BAHAWALPUR DISTRICT,52,Female,7808,4020,11828
BAHAWALPUR DISTRICT,52,Transgender,3,0,3
BAHAWALPUR DISTRICT,53,Male,8159,4499,12658
BAHAWALPUR DISTRICT,53,Female,6699,3833,10532
BAHAWALPUR DISTRICT,53,Transgender,1,0,1
BAHAWALPUR DISTRICT,54,Male,7273,4091,11364
BAHAWALPUR DISTRICT,54,Female,5897,3395,9292
BAHAWALPUR DISTRICT,54,Transgender,1,3,4
BAHAWALPUR DISTRICT,55,Male,6401,3525,9926
BAHAWALPUR DISTRICT,55,Female,5161,2750,7911
BAHAWALPUR DISTRICT,55,Transgender,2,3,5
BAHAWALPUR DISTRICT,56,Male,6536,3573,10109
BAHAWALPUR DISTRICT,56,Female,6067,2885,8952
BAHAWALPUR DISTRICT,56,Transgender,1,2,3
BAHAWALPUR DISTRICT,57,Male,5881,3051,8932
BAHAWALPUR DISTRICT,57,Female,5596,2348,7944
BAHAWALPUR DISTRICT,57,Transgender,2,1,3
BAHAWALPUR DISTRICT,58,Male,4941,2952,7893
BAHAWALPUR DISTRICT,58,Female,4945,2622,7567
BAHAWALPUR DISTRICT,58,Transgender,0,2,2
BAHAWALPUR DISTRICT,59,Male,4995,2719,7714
BAHAWALPUR DISTRICT,59,Female,5084,2503,7587
BAHAWALPUR DISTRICT,59,Transgender,0,1,1
BAHAWALPUR DISTRICT,60,Male,5108,2640,7748
BAHAWALPUR DISTRICT,60,Female,5207,2487,7694
BAHAWALPUR DISTRICT,60,Transgender,5,4,9
BAHAWALPUR DISTRICT,61,Male,5671,2766,8437
BAHAWALPUR DISTRICT,61,Female,6240,2677,8917
BAHAWALPUR DISTRICT,61,Transgender,1,3,4
BAHAWALPUR DISTRICT,62,Male,5107,2614,7721
BAHAWALPUR DISTRICT,62,Female,5325,2304,7629
BAHAWALPUR DISTRICT,62,Transgender,2,1,3
BAHAWALPUR DISTRICT,63,Male,4765,2441,7206
BAHAWALPUR DISTRICT,63,Female,4870,2422,7292
BAHAWALPUR DISTRICT,63,Transgender,0,0,0
BAHAWALPUR DISTRICT,64,Male,4427,2069,6496
BAHAWALPUR DISTRICT,64,Female,4374,2028,6402
BAHAWALPUR DISTRICT,64,Transgender,1,0,1
BAHAWALPUR DISTRICT,65,Male,4225,1970,6195
BAHAWALPUR DISTRICT,65,Female,4190,1683,5873
BAHAWALPUR DISTRICT,65,Transgender,4,1,5
BAHAWALPUR DISTRICT,66,Male,4737,1677,6414
BAHAWALPUR DISTRICT,66,Female,4617,1520,6137
BAHAWALPUR DISTRICT,66,Transgender,2,1,3
BAHAWALPUR DISTRICT,67,Male,4357,1605,5962
BAHAWALPUR DISTRICT,67,Female,4002,1424,5426
BAHAWALPUR DISTRICT,67,Transgender,1,0,1
BAHAWALPUR DISTRICT,68,Male,3614,1548,5162
BAHAWALPUR DISTRICT,68,Female,3351,1474,4825
BAHAWALPUR DISTRICT,68,Transgender,0,1,1
BAHAWALPUR DISTRICT,69,Male,3330,1311,4641
BAHAWALPUR DISTRICT,69,Female,3150,1244,4394
BAHAWALPUR DISTRICT,69,Transgender,0,0,0
BAHAWALPUR DISTRICT,70,Male,3355,1264,4619
BAHAWALPUR DISTRICT,70,Female,3047,1187,4234
BAHAWALPUR DISTRICT,70,Transgender,2,1,3
BAHAWALPUR DISTRICT,71,Male,3658,1244,4902
BAHAWALPUR DISTRICT,71,Female,3375,1199,4574
BAHAWALPUR DISTRICT,71,Transgender,0,0,0
BAHAWALPUR DISTRICT,72,Male,3106,1241,4347
BAHAWALPUR DISTRICT,72,Female,2746,1052,3798
BAHAWALPUR DISTRICT,72,Transgender,2,0,2
BAHAWALPUR DISTRICT,73,Male,2608,1090,3698
BAHAWALPUR DISTRICT,73,Female,2336,1029,3365
BAHAWALPUR DISTRICT,73,Transgender,1,0,1
BAHAWALPUR DISTRICT,74,Male,2109,806,2915
BAHAWALPUR DISTRICT,74,Female,1943,769,2712
BAHAWALPUR DISTRICT,74,Transgender,0,0,0
BAHAWALPUR DISTRICT,>=75,Male,17595,5950,23545
BAHAWALPUR DISTRICT,>=75,Female,16222,6214,22436
BAHAWALPUR DISTRICT,>=75,Transgender,8,6,14
BAJAUR AGENCY,<1,Male,15868,0,15868
BAJAUR AGENCY,<1,Female,14817,0,14817
BAJAUR AGENCY,<1,Transgender,0,0,0
BAJAUR AGENCY,1,Male,18896,0,18896
BAJAUR AGENCY,1,Female,17825,0,17825
BAJAUR AGENCY,1,Transgender,0,0,0
BAJAUR AGENCY,2,Male,22498,0,22498
BAJAUR AGENCY,2,Female,21566,0,21566
BAJAUR AGENCY,2,Transgender,0,0,0
BAJAUR AGENCY,3,Male,21860,0,21860
BAJAUR AGENCY,3,Female,20395,0,20395
BAJAUR AGENCY,3,Transgender,0,0,0
BAJAUR AGENCY,4,Male,24017,0,24017
BAJAUR AGENCY,4,Female,22845,0,22845
BAJAUR AGENCY,4,Transgender,0,0,0
BAJAUR AGENCY,5,Male,21301,0,21301
BAJAUR AGENCY,5,Female,19844,0,19844
BAJAUR AGENCY,5,Transgender,0,0,0
BAJAUR AGENCY,6,Male,23414,0,23414
BAJAUR AGENCY,6,Female,21380,0,21380
BAJAUR AGENCY,6,Transgender,0,0,0
BAJAUR AGENCY,7,Male,20985,0,20985
BAJAUR AGENCY,7,Female,18432,0,18432
BAJAUR AGENCY,7,Transgender,0,0,0
BAJAUR AGENCY,8,Male,23761,0,23761
BAJAUR AGENCY,8,Female,21304,0,21304
BAJAUR AGENCY,8,Transgender,0,0,0
BAJAUR AGENCY,9,Male,20221,0,20221
BAJAUR AGENCY,9,Female,17521,0,17521
BAJAUR AGENCY,9,Transgender,0,0,0
BAJAUR AGENCY,10,Male,20769,0,20769
BAJAUR AGENCY,10,Female,18720,0,18720
BAJAUR AGENCY,10,Transgender,0,0,0
BAJAUR AGENCY,11,Male,16624,0,16624
BAJAUR AGENCY,11,Female,14025,0,14025
BAJAUR AGENCY,11,Transgender,0,0,0
BAJAUR AGENCY,12,Male,16967,0,16967
BAJAUR AGENCY,12,Female,14974,0,14974
BAJAUR AGENCY,12,Transgender,0,0,0
BAJAUR AGENCY,13,Male,14301,0,14301
BAJAUR AGENCY,13,Female,12304,0,12304
BAJAUR AGENCY,13,Transgender,0,0,0
BAJAUR AGENCY,14,Male,13788,0,13788
BAJAUR AGENCY,14,Female,12732,0,12732
BAJAUR AGENCY,14,Transgender,0,0,0
BAJAUR AGENCY,15,Male,12209,0,12209
BAJAUR AGENCY,15,Female,11629,0,11629
BAJAUR AGENCY,15,Transgender,5,0,5
BAJAUR AGENCY,16,Male,10788,0,10788
BAJAUR AGENCY,16,Female,10516,0,10516
BAJAUR AGENCY,16,Transgender,1,0,1
BAJAUR AGENCY,17,Male,8200,0,8200
BAJAUR AGENCY,17,Female,8860,0,8860
BAJAUR AGENCY,17,Transgender,3,0,3
BAJAUR AGENCY,18,Male,11362,0,11362
BAJAUR AGENCY,18,Female,9695,0,9695
BAJAUR AGENCY,18,Transgender,6,0,6
BAJAUR AGENCY,19,Male,9973,0,9973
BAJAUR AGENCY,19,Female,7724,0,7724
BAJAUR AGENCY,19,Transgender,3,0,3
BAJAUR AGENCY,20,Male,10255,0,10255
BAJAUR AGENCY,20,Female,11051,0,11051
BAJAUR AGENCY,20,Transgender,1,0,1
BAJAUR AGENCY,21,Male,8403,0,8403
BAJAUR AGENCY,21,Female,8544,0,8544
BAJAUR AGENCY,21,Transgender,1,0,1
BAJAUR AGENCY,22,Male,8416,0,8416
BAJAUR AGENCY,22,Female,8166,0,8166
BAJAUR AGENCY,22,Transgender,2,0,2
BAJAUR AGENCY,23,Male,8235,0,8235
BAJAUR AGENCY,23,Female,9587,0,9587
BAJAUR AGENCY,23,Transgender,2,0,2
BAJAUR AGENCY,24,Male,7414,0,7414
BAJAUR AGENCY,24,Female,8126,0,8126
BAJAUR AGENCY,24,Transgender,4,0,4
BAJAUR AGENCY,25,Male,9268,0,9268
BAJAUR AGENCY,25,Female,9034,0,9034
BAJAUR AGENCY,25,Transgender,1,0,1
BAJAUR AGENCY,26,Male,8333,0,8333
BAJAUR AGENCY,26,Female,7639,0,7639
BAJAUR AGENCY,26,Transgender,1,0,1
BAJAUR AGENCY,27,Male,8652,0,8652
BAJAUR AGENCY,27,Female,8835,0,8835
BAJAUR AGENCY,27,Transgender,1,0,1
BAJAUR AGENCY,28,Male,6856,0,6856
BAJAUR AGENCY,28,Female,7893,0,7893
BAJAUR AGENCY,28,Transgender,1,0,1
BAJAUR AGENCY,29,Male,7050,0,7050
BAJAUR AGENCY,29,Female,7709,0,7709
BAJAUR AGENCY,29,Transgender,0,0,0
BAJAUR AGENCY,30,Male,6802,0,6802
BAJAUR AGENCY,30,Female,6910,0,6910
BAJAUR AGENCY,30,Transgender,1,0,1
BAJAUR AGENCY,31,Male,6378,0,6378
BAJAUR AGENCY,31,Female,6181,0,6181
BAJAUR AGENCY,31,Transgender,0,0,0
BAJAUR AGENCY,32,Male,5610,0,5610
BAJAUR AGENCY,32,Female,5671,0,5671
BAJAUR AGENCY,32,Transgender,1,0,1
BAJAUR AGENCY,33,Male,5712,0,5712
BAJAUR AGENCY,33,Female,6046,0,6046
BAJAUR AGENCY,33,Transgender,0,0,0
BAJAUR AGENCY,34,Male,4437,0,4437
BAJAUR AGENCY,34,Female,4858,0,4858
BAJAUR AGENCY,34,Transgender,0,0,0
BAJAUR AGENCY,35,Male,4924,0,4924
BAJAUR AGENCY,35,Female,4679,0,4679
BAJAUR AGENCY,35,Transgender,0,0,0
BAJAUR AGENCY,36,Male,3836,0,3836
BAJAUR AGENCY,36,Female,4030,0,4030
BAJAUR AGENCY,36,Transgender,1,0,1
BAJAUR AGENCY,37,Male,4607,0,4607
BAJAUR AGENCY,37,Female,4681,0,4681
BAJAUR AGENCY,37,Transgender,2,0,2
BAJAUR AGENCY,38,Male,4049,0,4049
BAJAUR AGENCY,38,Female,5073,0,5073
BAJAUR AGENCY,38,Transgender,0,0,0
BAJAUR AGENCY,39,Male,4109,0,4109
BAJAUR AGENCY,39,Female,4359,0,4359
BAJAUR AGENCY,39,Transgender,0,0,0
BAJAUR AGENCY,40,Male,4464,0,4464
BAJAUR AGENCY,40,Female,4955,0,4955
BAJAUR AGENCY,40,Transgender,4,0,4
BAJAUR AGENCY,41,Male,3855,0,3855
BAJAUR AGENCY,41,Female,3814,0,3814
BAJAUR AGENCY,41,Transgender,0,0,0
BAJAUR AGENCY,42,Male,3426,0,3426
BAJAUR AGENCY,42,Female,3675,0,3675
BAJAUR AGENCY,42,Transgender,0,0,0
BAJAUR AGENCY,43,Male,3328,0,3328
BAJAUR AGENCY,43,Female,3986,0,3986
BAJAUR AGENCY,43,Transgender,1,0,1
BAJAUR AGENCY,44,Male,2939,0,2939
BAJAUR AGENCY,44,Female,3456,0,3456
BAJAUR AGENCY,44,Transgender,0,0,0
BAJAUR AGENCY,45,Male,3139,0,3139
BAJAUR AGENCY,45,Female,3407,0,3407
BAJAUR AGENCY,45,Transgender,4,0,4
BAJAUR AGENCY,46,Male,2750,0,2750
BAJAUR AGENCY,46,Female,2510,0,2510
BAJAUR AGENCY,46,Transgender,0,0,0
BAJAUR AGENCY,47,Male,2958,0,2958
BAJAUR AGENCY,47,Female,3080,0,3080
BAJAUR AGENCY,47,Transgender,0,0,0
BAJAUR AGENCY,48,Male,2645,0,2645
BAJAUR AGENCY,48,Female,3141,0,3141
BAJAUR AGENCY,48,Transgender,0,0,0
BAJAUR AGENCY,49,Male,2637,0,2637
BAJAUR AGENCY,49,Female,2740,0,2740
BAJAUR AGENCY,49,Transgender,1,0,1
BAJAUR AGENCY,50,Male,3092,0,3092
BAJAUR AGENCY,50,Female,3583,0,3583
BAJAUR AGENCY,50,Transgender,2,0,2
BAJAUR AGENCY,51,Male,2373,0,2373
BAJAUR AGENCY,51,Female,2405,0,2405
BAJAUR AGENCY,51,Transgender,0,0,0
BAJAUR AGENCY,52,Male,2291,0,2291
BAJAUR AGENCY,52,Female,2337,0,2337
BAJAUR AGENCY,52,Transgender,0,0,0
BAJAUR AGENCY,53,Male,2308,0,2308
BAJAUR AGENCY,53,Female,2440,0,2440
BAJAUR AGENCY,53,Transgender,0,0,0
BAJAUR AGENCY,54,Male,2123,0,2123
BAJAUR AGENCY,54,Female,2174,0,2174
BAJAUR AGENCY,54,Transgender,0,0,0
BAJAUR AGENCY,55,Male,2230,0,2230
BAJAUR AGENCY,55,Female,2432,0,2432
BAJAUR AGENCY,55,Transgender,0,0,0
BAJAUR AGENCY,56,Male,1739,0,1739
BAJAUR AGENCY,56,Female,1594,0,1594
BAJAUR AGENCY,56,Transgender,0,0,0
BAJAUR AGENCY,57,Male,2185,0,2185
BAJAUR AGENCY,57,Female,1993,0,1993
BAJAUR AGENCY,57,Transgender,0,0,0
BAJAUR AGENCY,58,Male,1606,0,1606
BAJAUR AGENCY,58,Female,1922,0,1922
BAJAUR AGENCY,58,Transgender,0,0,0
BAJAUR AGENCY,59,Male,1670,0,1670
BAJAUR AGENCY,59,Female,1504,0,1504
BAJAUR AGENCY,59,Transgender,0,0,0
BAJAUR AGENCY,60,Male,1839,0,1839
BAJAUR AGENCY,60,Female,2140,0,2140
BAJAUR AGENCY,60,Transgender,2,0,2
BAJAUR AGENCY,61,Male,1346,0,1346
BAJAUR AGENCY,61,Female,1378,0,1378
BAJAUR AGENCY,61,Transgender,0,0,0
BAJAUR AGENCY,62,Male,1481,0,1481
BAJAUR AGENCY,62,Female,1555,0,1555
BAJAUR AGENCY,62,Transgender,0,0,0
BAJAUR AGENCY,63,Male,1430,0,1430
BAJAUR AGENCY,63,Female,1426,0,1426
BAJAUR AGENCY,63,Transgender,0,0,0
BAJAUR AGENCY,64,Male,1363,0,1363
BAJAUR AGENCY,64,Female,1274,0,1274
BAJAUR AGENCY,64,Transgender,0,0,0
BAJAUR AGENCY,65,Male,1234,0,1234
BAJAUR AGENCY,65,Female,1429,0,1429
BAJAUR AGENCY,65,Transgender,1,0,1
BAJAUR AGENCY,66,Male,1034,0,1034
BAJAUR AGENCY,66,Female,1036,0,1036
BAJAUR AGENCY,66,Transgender,1,0,1
BAJAUR AGENCY,67,Male,1439,0,1439
BAJAUR AGENCY,67,Female,1298,0,1298
BAJAUR AGENCY,67,Transgender,0,0,0
BAJAUR AGENCY,68,Male,932,0,932
BAJAUR AGENCY,68,Female,996,0,996
BAJAUR AGENCY,68,Transgender,0,0,0
BAJAUR AGENCY,69,Male,991,0,991
BAJAUR AGENCY,69,Female,757,0,757
BAJAUR AGENCY,69,Transgender,0,0,0
BAJAUR AGENCY,70,Male,955,0,955
BAJAUR AGENCY,70,Female,1038,0,1038
BAJAUR AGENCY,70,Transgender,1,0,1
BAJAUR AGENCY,71,Male,652,0,652
BAJAUR AGENCY,71,Female,699,0,699
BAJAUR AGENCY,71,Transgender,0,0,0
BAJAUR AGENCY,72,Male,800,0,800
BAJAUR AGENCY,72,Female,669,0,669
BAJAUR AGENCY,72,Transgender,0,0,0
BAJAUR AGENCY,73,Male,649,0,649
BAJAUR AGENCY,73,Female,586,0,586
BAJAUR AGENCY,73,Transgender,0,0,0
BAJAUR AGENCY,74,Male,607,0,607
BAJAUR AGENCY,74,Female,537,0,537
BAJAUR AGENCY,74,Transgender,0,0,0
BAJAUR AGENCY,>=75,Male,4378,0,4378
BAJAUR AGENCY,>=75,Female,4749,0,4749
BAJAUR AGENCY,>=75,Transgender,2,0,2
BAJAUR AGENCY,65 & ABOVE,Male,19291,0,19291
BAJAUR AGENCY,65 & ABOVE,Female,19427,0,19427
BAJAUR AGENCY,65 & ABOVE,Transgender,5,0,5
BANNU DISTRICT,<1,Male,15250,523,15773
BANNU DISTRICT,<1,Female,13999,485,14484
BANNU DISTRICT,<1,Transgender,0,0,0
BANNU DISTRICT,1,Male,17078,539,17617
BANNU DISTRICT,1,Female,16079,504,16583
BANNU DISTRICT,1,Transgender,0,0,0
BANNU DISTRICT,2,Male,20352,633,20985
BANNU DISTRICT,2,Female,19197,599,19796
BANNU DISTRICT,2,Transgender,0,0,0
BANNU DISTRICT,3,Male,21118,675,21793
BANNU DISTRICT,3,Female,19966,633,20599
BANNU DISTRICT,3,Transgender,0,0,0
BANNU DISTRICT,4,Male,21625,661,22286
BANNU DISTRICT,4,Female,20700,614,21314
BANNU DISTRICT,4,Transgender,0,0,0
BANNU DISTRICT,5,Male,21693,678,22371
BANNU DISTRICT,5,Female,19452,629,20081
BANNU DISTRICT,5,Transgender,0,0,0
BANNU DISTRICT,6,Male,21016,632,21648
BANNU DISTRICT,6,Female,19160,598,19758
BANNU DISTRICT,6,Transgender,0,0,0
BANNU DISTRICT,7,Male,20486,731,21217
BANNU DISTRICT,7,Female,17635,645,18280
BANNU DISTRICT,7,Transgender,0,0,0
BANNU DISTRICT,8,Male,21264,660,21924
BANNU DISTRICT,8,Female,18586,534,19120
BANNU DISTRICT,8,Transgender,0,0,0
BANNU DISTRICT,9,Male,18544,679,19223
BANNU DISTRICT,9,Female,15642,581,16223
BANNU DISTRICT,9,Transgender,0,0,0
BANNU DISTRICT,10,Male,18500,652,19152
BANNU DISTRICT,10,Female,16558,505,17063
BANNU DISTRICT,10,Transgender,0,0,0
BANNU DISTRICT,11,Male,15447,664,16111
BANNU DISTRICT,11,Female,12825,553,13378
BANNU DISTRICT,11,Transgender,0,0,0
BANNU DISTRICT,12,Male,15297,609,15906
BANNU DISTRICT,12,Female,14238,491,14729
BANNU DISTRICT,12,Transgender,0,0,0
BANNU DISTRICT,13,Male,14121,652,14773
BANNU DISTRICT,13,Female,12121,534,12655
BANNU DISTRICT,13,Transgender,0,0,0
BANNU DISTRICT,14,Male,13646,615,14261
BANNU DISTRICT,14,Female,12056,488,12544
BANNU DISTRICT,14,Transgender,0,0,0
BANNU DISTRICT,15,Male,13461,603,14064
BANNU DISTRICT,15,Female,11894,491,12385
BANNU DISTRICT,15,Transgender,1,0,1
BANNU DISTRICT,16,Male,12402,610,13012
BANNU DISTRICT,16,Female,11342,482,11824
BANNU DISTRICT,16,Transgender,0,0,0
BANNU DISTRICT,17,Male,10711,655,11366
BANNU DISTRICT,17,Female,10387,505,10892
BANNU DISTRICT,17,Transgender,0,0,0
BANNU DISTRICT,18,Male,12361,564,12925
BANNU DISTRICT,18,Female,11842,472,12314
BANNU DISTRICT,18,Transgender,0,0,0
BANNU DISTRICT,19,Male,10333,586,10919
BANNU DISTRICT,19,Female,9650,484,10134
BANNU DISTRICT,19,Transgender,0,0,0
BANNU DISTRICT,20,Male,10714,568,11282
BANNU DISTRICT,20,Female,12903,445,13348
BANNU DISTRICT,20,Transgender,1,0,1
BANNU DISTRICT,21,Male,8593,615,9208
BANNU DISTRICT,21,Female,9716,452,10168
BANNU DISTRICT,21,Transgender,0,0,0
BANNU DISTRICT,22,Male,8958,561,9519
BANNU DISTRICT,22,Female,10456,467,10923
BANNU DISTRICT,22,Transgender,0,0,0
BANNU DISTRICT,23,Male,8424,582,9006
BANNU DISTRICT,23,Female,9414,423,9837
BANNU DISTRICT,23,Transgender,0,0,0
BANNU DISTRICT,24,Male,7572,531,8103
BANNU DISTRICT,24,Female,8708,409,9117
BANNU DISTRICT,24,Transgender,0,0,0
BANNU DISTRICT,25,Male,9585,593,10178
BANNU DISTRICT,25,Female,11817,472,12289
BANNU DISTRICT,25,Transgender,2,0,2
BANNU DISTRICT,26,Male,7473,570,8043
BANNU DISTRICT,26,Female,8431,386,8817
BANNU DISTRICT,26,Transgender,0,0,0
BANNU DISTRICT,27,Male,7292,554,7846
BANNU DISTRICT,27,Female,8735,435,9170
BANNU DISTRICT,27,Transgender,2,0,2
BANNU DISTRICT,28,Male,7973,565,8538
BANNU DISTRICT,28,Female,8927,398,9325
BANNU DISTRICT,28,Transgender,0,0,0
BANNU DISTRICT,29,Male,6286,547,6833
BANNU DISTRICT,29,Female,8387,403,8790
BANNU DISTRICT,29,Transgender,0,0,0
BANNU DISTRICT,30,Male,8415,520,8935
BANNU DISTRICT,30,Female,9717,406,10123
BANNU DISTRICT,30,Transgender,0,0,0
BANNU DISTRICT,31,Male,5975,500,6475
BANNU DISTRICT,31,Female,6877,322,7199
BANNU DISTRICT,31,Transgender,0,0,0
BANNU DISTRICT,32,Male,5383,462,5845
BANNU DISTRICT,32,Female,5981,295,6276
BANNU DISTRICT,32,Transgender,0,0,0
BANNU DISTRICT,33,Male,5467,490,5957
BANNU DISTRICT,33,Female,5869,322,6191
BANNU DISTRICT,33,Transgender,0,0,0
BANNU DISTRICT,34,Male,4432,391,4823
BANNU DISTRICT,34,Female,4668,238,4906
BANNU DISTRICT,34,Transgender,1,0,1
BANNU DISTRICT,35,Male,5956,396,6352
BANNU DISTRICT,35,Female,6903,316,7219
BANNU DISTRICT,35,Transgender,2,0,2
BANNU DISTRICT,36,Male,3865,337,4202
BANNU DISTRICT,36,Female,4098,234,4332
BANNU DISTRICT,36,Transgender,0,0,0
BANNU DISTRICT,37,Male,3705,336,4041
BANNU DISTRICT,37,Female,4425,242,4667
BANNU DISTRICT,37,Transgender,1,0,1
BANNU DISTRICT,38,Male,4835,371,5206
BANNU DISTRICT,38,Female,4824,272,5096
BANNU DISTRICT,38,Transgender,0,0,0
BANNU DISTRICT,39,Male,4129,315,4444
BANNU DISTRICT,39,Female,4603,237,4840
BANNU DISTRICT,39,Transgender,0,0,0
BANNU DISTRICT,40,Male,6003,370,6373
BANNU DISTRICT,40,Female,7219,309,7528
BANNU DISTRICT,40,Transgender,3,0,3
BANNU DISTRICT,41,Male,3935,271,4206
BANNU DISTRICT,41,Female,4443,198,4641
BANNU DISTRICT,41,Transgender,0,0,0
BANNU DISTRICT,42,Male,3473,275,3748
BANNU DISTRICT,42,Female,4038,220,4258
BANNU DISTRICT,42,Transgender,0,0,0
BANNU DISTRICT,43,Male,3873,229,4102
BANNU DISTRICT,43,Female,4223,229,4452
BANNU DISTRICT,43,Transgender,1,0,1
BANNU DISTRICT,44,Male,3244,212,3456
BANNU DISTRICT,44,Female,3361,182,3543
BANNU DISTRICT,44,Transgender,0,0,0
BANNU DISTRICT,45,Male,4216,243,4459
BANNU DISTRICT,45,Female,4891,210,5101
BANNU DISTRICT,45,Transgender,1,0,1
BANNU DISTRICT,46,Male,3014,158,3172
BANNU DISTRICT,46,Female,2935,143,3078
BANNU DISTRICT,46,Transgender,0,0,0
BANNU DISTRICT,47,Male,3141,185,3326
BANNU DISTRICT,47,Female,3214,183,3397
BANNU DISTRICT,47,Transgender,1,0,1
BANNU DISTRICT,48,Male,3211,170,3381
BANNU DISTRICT,48,Female,3401,160,3561
BANNU DISTRICT,48,Transgender,0,0,0
BANNU DISTRICT,49,Male,2801,174,2975
BANNU DISTRICT,49,Female,3294,163,3457
BANNU DISTRICT,49,Transgender,0,0,0
BANNU DISTRICT,50,Male,4485,244,4729
BANNU DISTRICT,50,Female,5116,230,5346
BANNU DISTRICT,50,Transgender,2,0,2
BANNU DISTRICT,51,Male,2663,159,2822
BANNU DISTRICT,51,Female,2865,137,3002
BANNU DISTRICT,51,Transgender,1,0,1
BANNU DISTRICT,52,Male,2668,179,2847
BANNU DISTRICT,52,Female,2714,129,2843
BANNU DISTRICT,52,Transgender,0,0,0
BANNU DISTRICT,53,Male,3000,163,3163
BANNU DISTRICT,53,Female,2900,127,3027
BANNU DISTRICT,53,Transgender,0,0,0
BANNU DISTRICT,54,Male,2688,165,2853
BANNU DISTRICT,54,Female,2512,121,2633
BANNU DISTRICT,54,Transgender,0,0,0
BANNU DISTRICT,55,Male,3484,158,3642
BANNU DISTRICT,55,Female,3391,145,3536
BANNU DISTRICT,55,Transgender,1,1,2
BANNU DISTRICT,56,Male,2391,120,2511
BANNU DISTRICT,56,Female,1951,90,2041
BANNU DISTRICT,56,Transgender,0,0,0
BANNU DISTRICT,57,Male,2342,145,2487
BANNU DISTRICT,57,Female,1951,68,2019
BANNU DISTRICT,57,Transgender,0,0,0
BANNU DISTRICT,58,Male,2599,120,2719
BANNU DISTRICT,58,Female,2117,92,2209
BANNU DISTRICT,58,Transgender,0,0,0
BANNU DISTRICT,59,Male,2311,130,2441
BANNU DISTRICT,59,Female,1905,105,2010
BANNU DISTRICT,59,Transgender,0,0,0
BANNU DISTRICT,60,Male,3353,125,3478
BANNU DISTRICT,60,Female,2735,108,2843
BANNU DISTRICT,60,Transgender,0,0,0
BANNU DISTRICT,61,Male,2339,118,2457
BANNU DISTRICT,61,Female,2004,88,2092
BANNU DISTRICT,61,Transgender,0,0,0
BANNU DISTRICT,62,Male,2256,97,2353
BANNU DISTRICT,62,Female,1830,63,1893
BANNU DISTRICT,62,Transgender,0,0,0
BANNU DISTRICT,63,Male,2307,130,2437
BANNU DISTRICT,63,Female,1916,77,1993
BANNU DISTRICT,63,Transgender,0,0,0
BANNU DISTRICT,64,Male,1965,101,2066
BANNU DISTRICT,64,Female,1559,72,1631
BANNU DISTRICT,64,Transgender,0,0,0
BANNU DISTRICT,65,Male,2143,83,2226
BANNU DISTRICT,65,Female,1588,65,1653
BANNU DISTRICT,65,Transgender,1,0,1
BANNU DISTRICT,66,Male,1436,75,1511
BANNU DISTRICT,66,Female,1002,48,1050
BANNU DISTRICT,66,Transgender,0,0,0
BANNU DISTRICT,67,Male,1489,71,1560
BANNU DISTRICT,67,Female,1055,63,1118
BANNU DISTRICT,67,Transgender,0,0,0
BANNU DISTRICT,68,Male,1359,47,1406
BANNU DISTRICT,68,Female,991,57,1048
BANNU DISTRICT,68,Transgender,0,0,0
BANNU DISTRICT,69,Male,1086,56,1142
BANNU DISTRICT,69,Female,983,52,1035
BANNU DISTRICT,69,Transgender,0,0,0
BANNU DISTRICT,70,Male,1417,67,1484
BANNU DISTRICT,70,Female,1062,35,1097
BANNU DISTRICT,70,Transgender,1,0,1
BANNU DISTRICT,71,Male,982,44,1026
BANNU DISTRICT,71,Female,746,22,768
BANNU DISTRICT,71,Transgender,0,0,0
BANNU DISTRICT,72,Male,887,34,921
BANNU DISTRICT,72,Female,738,23,761
BANNU DISTRICT,72,Transgender,0,0,0
BANNU DISTRICT,73,Male,935,42,977
BANNU DISTRICT,73,Female,703,36,739
BANNU DISTRICT,73,Transgender,0,0,0
BANNU DISTRICT,74,Male,678,20,698
BANNU DISTRICT,74,Female,563,29,592
BANNU DISTRICT,74,Transgender,1,0,1
BANNU DISTRICT,>=75,Male,5086,223,5309
BANNU DISTRICT,>=75,Female,5399,239,5638
BANNU DISTRICT,>=75,Transgender,0,0,0
BARKHAN DISTRICT,<1,Male,2726,162,2888
BARKHAN DISTRICT,<1,Female,2365,150,2515
BARKHAN DISTRICT,<1,Transgender,0,0,0
BARKHAN DISTRICT,1,Male,2689,151,2840
BARKHAN DISTRICT,1,Female,2685,175,2860
BARKHAN DISTRICT,1,Transgender,0,0,0
BARKHAN DISTRICT,2,Male,3656,249,3905
BARKHAN DISTRICT,2,Female,3503,239,3742
BARKHAN DISTRICT,2,Transgender,0,0,0
BARKHAN DISTRICT,3,Male,3196,199,3395
BARKHAN DISTRICT,3,Female,2974,187,3161
BARKHAN DISTRICT,3,Transgender,0,0,0
BARKHAN DISTRICT,4,Male,3669,249,3918
BARKHAN DISTRICT,4,Female,3732,260,3992
BARKHAN DISTRICT,4,Transgender,0,0,0
BARKHAN DISTRICT,5,Male,3150,205,3355
BARKHAN DISTRICT,5,Female,2782,186,2968
BARKHAN DISTRICT,5,Transgender,0,0,0
BARKHAN DISTRICT,6,Male,3900,238,4138
BARKHAN DISTRICT,6,Female,3309,201,3510
BARKHAN DISTRICT,6,Transgender,0,0,0
BARKHAN DISTRICT,7,Male,2684,183,2867
BARKHAN DISTRICT,7,Female,2372,167,2539
BARKHAN DISTRICT,7,Transgender,0,0,0
BARKHAN DISTRICT,8,Male,3791,224,4015
BARKHAN DISTRICT,8,Female,2941,206,3147
BARKHAN DISTRICT,8,Transgender,0,0,0
BARKHAN DISTRICT,9,Male,2598,178,2776
BARKHAN DISTRICT,9,Female,2122,168,2290
BARKHAN DISTRICT,9,Transgender,0,0,0
BARKHAN DISTRICT,10,Male,3102,220,3322
BARKHAN DISTRICT,10,Female,2549,212,2761
BARKHAN DISTRICT,10,Transgender,0,0,0
BARKHAN DISTRICT,11,Male,1788,183,1971
BARKHAN DISTRICT,11,Female,1516,149,1665
BARKHAN DISTRICT,11,Transgender,0,0,0
BARKHAN DISTRICT,12,Male,2157,212,2369
BARKHAN DISTRICT,12,Female,1798,147,1945
BARKHAN DISTRICT,12,Transgender,0,0,0
BARKHAN DISTRICT,13,Male,1424,134,1558
BARKHAN DISTRICT,13,Female,1143,139,1282
BARKHAN DISTRICT,13,Transgender,0,0,0
BARKHAN DISTRICT,14,Male,1711,160,1871
BARKHAN DISTRICT,14,Female,1423,133,1556
BARKHAN DISTRICT,14,Transgender,0,0,0
BARKHAN DISTRICT,15,Male,1453,145,1598
BARKHAN DISTRICT,15,Female,1076,120,1196
BARKHAN DISTRICT,15,Transgender,0,0,0
BARKHAN DISTRICT,16,Male,1515,148,1663
BARKHAN DISTRICT,16,Female,1145,110,1255
BARKHAN DISTRICT,16,Transgender,0,0,0
BARKHAN DISTRICT,17,Male,978,140,1118
BARKHAN DISTRICT,17,Female,856,121,977
BARKHAN DISTRICT,17,Transgender,2,0,2
BARKHAN DISTRICT,18,Male,1777,118,1895
BARKHAN DISTRICT,18,Female,1435,94,1529
BARKHAN DISTRICT,18,Transgender,1,0,1
BARKHAN DISTRICT,19,Male,1200,123,1323
BARKHAN DISTRICT,19,Female,947,79,1026
BARKHAN DISTRICT,19,Transgender,0,0,0
BARKHAN DISTRICT,20,Male,1545,101,1646
BARKHAN DISTRICT,20,Female,1410,86,1496
BARKHAN DISTRICT,20,Transgender,1,1,2
BARKHAN DISTRICT,21,Male,1048,114,1162
BARKHAN DISTRICT,21,Female,953,68,1021
BARKHAN DISTRICT,21,Transgender,0,0,0
BARKHAN DISTRICT,22,Male,1107,90,1197
BARKHAN DISTRICT,22,Female,835,81,916
BARKHAN DISTRICT,22,Transgender,0,0,0
BARKHAN DISTRICT,23,Male,1022,90,1112
BARKHAN DISTRICT,23,Female,842,72,914
BARKHAN DISTRICT,23,Transgender,0,0,0
BARKHAN DISTRICT,24,Male,940,94,1034
BARKHAN DISTRICT,24,Female,822,91,913
BARKHAN DISTRICT,24,Transgender,1,0,1
BARKHAN DISTRICT,25,Male,1410,84,1494
BARKHAN DISTRICT,25,Female,1416,82,1498
BARKHAN DISTRICT,25,Transgender,0,0,0
BARKHAN DISTRICT,26,Male,952,74,1026
BARKHAN DISTRICT,26,Female,922,86,1008
BARKHAN DISTRICT,26,Transgender,0,0,0
BARKHAN DISTRICT,27,Male,1003,88,1091
BARKHAN DISTRICT,27,Female,1098,88,1186
BARKHAN DISTRICT,27,Transgender,0,0,0
BARKHAN DISTRICT,28,Male,1109,83,1192
BARKHAN DISTRICT,28,Female,1139,99,1238
BARKHAN DISTRICT,28,Transgender,0,0,0
BARKHAN DISTRICT,29,Male,1166,107,1273
BARKHAN DISTRICT,29,Female,1316,97,1413
BARKHAN DISTRICT,29,Transgender,0,0,0
BARKHAN DISTRICT,30,Male,1216,75,1291
BARKHAN DISTRICT,30,Female,1155,81,1236
BARKHAN DISTRICT,30,Transgender,0,0,0
BARKHAN DISTRICT,31,Male,1069,76,1145
BARKHAN DISTRICT,31,Female,1129,109,1238
BARKHAN DISTRICT,31,Transgender,0,0,0
BARKHAN DISTRICT,32,Male,1014,49,1063
BARKHAN DISTRICT,32,Female,971,75,1046
BARKHAN DISTRICT,32,Transgender,0,0,0
BARKHAN DISTRICT,33,Male,813,82,895
BARKHAN DISTRICT,33,Female,841,67,908
BARKHAN DISTRICT,33,Transgender,0,0,0
BARKHAN DISTRICT,34,Male,715,66,781
BARKHAN DISTRICT,34,Female,683,44,727
BARKHAN DISTRICT,34,Transgender,0,0,0
BARKHAN DISTRICT,35,Male,876,48,924
BARKHAN DISTRICT,35,Female,817,48,865
BARKHAN DISTRICT,35,Transgender,0,0,0
BARKHAN DISTRICT,36,Male,788,66,854
BARKHAN DISTRICT,36,Female,681,71,752
BARKHAN DISTRICT,36,Transgender,0,0,0
BARKHAN DISTRICT,37,Male,1139,70,1209
BARKHAN DISTRICT,37,Female,993,71,1064
BARKHAN DISTRICT,37,Transgender,1,0,1
BARKHAN DISTRICT,38,Male,819,76,895
BARKHAN DISTRICT,38,Female,728,52,780
BARKHAN DISTRICT,38,Transgender,0,0,0
BARKHAN DISTRICT,39,Male,904,77,981
BARKHAN DISTRICT,39,Female,692,58,750
BARKHAN DISTRICT,39,Transgender,0,0,0
BARKHAN DISTRICT,40,Male,787,54,841
BARKHAN DISTRICT,40,Female,815,59,874
BARKHAN DISTRICT,40,Transgender,0,0,0
BARKHAN DISTRICT,41,Male,633,71,704
BARKHAN DISTRICT,41,Female,655,74,729
BARKHAN DISTRICT,41,Transgender,0,0,0
BARKHAN DISTRICT,42,Male,624,45,669
BARKHAN DISTRICT,42,Female,644,51,695
BARKHAN DISTRICT,42,Transgender,0,0,0
BARKHAN DISTRICT,43,Male,478,45,523
BARKHAN DISTRICT,43,Female,530,44,574
BARKHAN DISTRICT,43,Transgender,0,0,0
BARKHAN DISTRICT,44,Male,407,33,440
BARKHAN DISTRICT,44,Female,480,32,512
BARKHAN DISTRICT,44,Transgender,0,0,0
BARKHAN DISTRICT,45,Male,581,37,618
BARKHAN DISTRICT,45,Female,545,35,580
BARKHAN DISTRICT,45,Transgender,1,0,1
BARKHAN DISTRICT,46,Male,534,44,578
BARKHAN DISTRICT,46,Female,494,46,540
BARKHAN DISTRICT,46,Transgender,0,0,0
BARKHAN DISTRICT,47,Male,674,48,722
BARKHAN DISTRICT,47,Female,715,47,762
BARKHAN DISTRICT,47,Transgender,1,0,1
BARKHAN DISTRICT,48,Male,487,56,543
BARKHAN DISTRICT,48,Female,394,45,439
BARKHAN DISTRICT,48,Transgender,0,0,0
BARKHAN DISTRICT,49,Male,555,41,596
BARKHAN DISTRICT,49,Female,448,41,489
BARKHAN DISTRICT,49,Transgender,0,0,0
BARKHAN DISTRICT,50,Male,561,39,600
BARKHAN DISTRICT,50,Female,533,36,569
BARKHAN DISTRICT,50,Transgender,1,0,1
BARKHAN DISTRICT,51,Male,469,43,512
BARKHAN DISTRICT,51,Female,380,44,424
BARKHAN DISTRICT,51,Transgender,0,0,0
BARKHAN DISTRICT,52,Male,398,34,432
BARKHAN DISTRICT,52,Female,390,28,418
BARKHAN DISTRICT,52,Transgender,0,0,0
BARKHAN DISTRICT,53,Male,359,28,387
BARKHAN DISTRICT,53,Female,293,23,316
BARKHAN DISTRICT,53,Transgender,0,0,0
BARKHAN DISTRICT,54,Male,355,30,385
BARKHAN DISTRICT,54,Female,275,22,297
BARKHAN DISTRICT,54,Transgender,0,0,0
BARKHAN DISTRICT,55,Male,363,28,391
BARKHAN DISTRICT,55,Female,304,22,326
BARKHAN DISTRICT,55,Transgender,0,0,0
BARKHAN DISTRICT,56,Male,281,35,316
BARKHAN DISTRICT,56,Female,289,31,320
BARKHAN DISTRICT,56,Transgender,0,0,0
BARKHAN DISTRICT,57,Male,424,40,464
BARKHAN DISTRICT,57,Female,424,28,452
BARKHAN DISTRICT,57,Transgender,0,0,0
BARKHAN DISTRICT,58,Male,267,16,283
BARKHAN DISTRICT,58,Female,220,29,249
BARKHAN DISTRICT,58,Transgender,0,0,0
BARKHAN DISTRICT,59,Male,360,32,392
BARKHAN DISTRICT,59,Female,294,24,318
BARKHAN DISTRICT,59,Transgender,0,0,0
BARKHAN DISTRICT,60,Male,351,23,374
BARKHAN DISTRICT,60,Female,308,26,334
BARKHAN DISTRICT,60,Transgender,1,0,1
BARKHAN DISTRICT,61,Male,291,22,313
BARKHAN DISTRICT,61,Female,275,28,303
BARKHAN DISTRICT,61,Transgender,0,0,0
BARKHAN DISTRICT,62,Male,235,17,252
BARKHAN DISTRICT,62,Female,280,17,297
BARKHAN DISTRICT,62,Transgender,0,0,0
BARKHAN DISTRICT,63,Male,235,30,265
BARKHAN DISTRICT,63,Female,242,32,274
BARKHAN DISTRICT,63,Transgender,0,0,0
BARKHAN DISTRICT,64,Male,326,22,348
BARKHAN DISTRICT,64,Female,263,22,285
BARKHAN DISTRICT,64,Transgender,0,0,0
BARKHAN DISTRICT,65,Male,247,31,278
BARKHAN DISTRICT,65,Female,194,17,211
BARKHAN DISTRICT,65,Transgender,0,0,0
BARKHAN DISTRICT,66,Male,172,19,191
BARKHAN DISTRICT,66,Female,155,20,175
BARKHAN DISTRICT,66,Transgender,0,0,0
BARKHAN DISTRICT,67,Male,234,11,245
BARKHAN DISTRICT,67,Female,264,22,286
BARKHAN DISTRICT,67,Transgender,0,0,0
BARKHAN DISTRICT,68,Male,203,15,218
BARKHAN DISTRICT,68,Female,138,13,151
BARKHAN DISTRICT,68,Transgender,0,1,1
BARKHAN DISTRICT,69,Male,274,15,289
BARKHAN DISTRICT,69,Female,184,11,195
BARKHAN DISTRICT,69,Transgender,0,0,0
BARKHAN DISTRICT,70,Male,188,9,197
BARKHAN DISTRICT,70,Female,183,13,196
BARKHAN DISTRICT,70,Transgender,0,0,0
BARKHAN DISTRICT,71,Male,165,9,174
BARKHAN DISTRICT,71,Female,116,11,127
BARKHAN DISTRICT,71,Transgender,0,0,0
BARKHAN DISTRICT,72,Male,111,9,120
BARKHAN DISTRICT,72,Female,141,9,150
BARKHAN DISTRICT,72,Transgender,0,0,0
BARKHAN DISTRICT,73,Male,96,3,99
BARKHAN DISTRICT,73,Female,115,11,126
BARKHAN DISTRICT,73,Transgender,0,0,0
BARKHAN DISTRICT,74,Male,149,6,155
BARKHAN DISTRICT,74,Female,138,7,145
BARKHAN DISTRICT,74,Transgender,0,0,0
BARKHAN DISTRICT,>=75,Male,883,64,947
BARKHAN DISTRICT,>=75,Female,1003,74,1077
BARKHAN DISTRICT,>=75,Transgender,1,1,2
BATAGRAM DISTRICT,<1,Male,7360,0,7360
BATAGRAM DISTRICT,<1,Female,6866,0,6866
BATAGRAM DISTRICT,<1,Transgender,0,0,0
BATAGRAM DISTRICT,1,Male,7266,0,7266
BATAGRAM DISTRICT,1,Female,6944,0,6944
BATAGRAM DISTRICT,1,Transgender,0,0,0
BATAGRAM DISTRICT,2,Male,8500,0,8500
BATAGRAM DISTRICT,2,Female,7899,0,7899
BATAGRAM DISTRICT,2,Transgender,0,0,0
BATAGRAM DISTRICT,3,Male,8078,0,8078
BATAGRAM DISTRICT,3,Female,7966,0,7966
BATAGRAM DISTRICT,3,Transgender,0,0,0
BATAGRAM DISTRICT,4,Male,8800,0,8800
BATAGRAM DISTRICT,4,Female,8560,0,8560
BATAGRAM DISTRICT,4,Transgender,0,0,0
BATAGRAM DISTRICT,5,Male,8249,0,8249
BATAGRAM DISTRICT,5,Female,7663,0,7663
BATAGRAM DISTRICT,5,Transgender,0,0,0
BATAGRAM DISTRICT,6,Male,8782,0,8782
BATAGRAM DISTRICT,6,Female,8125,0,8125
BATAGRAM DISTRICT,6,Transgender,0,0,0
BATAGRAM DISTRICT,7,Male,8604,0,8604
BATAGRAM DISTRICT,7,Female,7842,0,7842
BATAGRAM DISTRICT,7,Transgender,0,0,0
BATAGRAM DISTRICT,8,Male,9301,0,9301
BATAGRAM DISTRICT,8,Female,8433,0,8433
BATAGRAM DISTRICT,8,Transgender,0,0,0
BATAGRAM DISTRICT,9,Male,8043,0,8043
BATAGRAM DISTRICT,9,Female,7596,0,7596
BATAGRAM DISTRICT,9,Transgender,0,0,0
BATAGRAM DISTRICT,10,Male,7924,0,7924
BATAGRAM DISTRICT,10,Female,7501,0,7501
BATAGRAM DISTRICT,10,Transgender,0,0,0
BATAGRAM DISTRICT,11,Male,7077,0,7077
BATAGRAM DISTRICT,11,Female,6346,0,6346
BATAGRAM DISTRICT,11,Transgender,0,0,0
BATAGRAM DISTRICT,12,Male,7323,0,7323
BATAGRAM DISTRICT,12,Female,6439,0,6439
BATAGRAM DISTRICT,12,Transgender,0,0,0
BATAGRAM DISTRICT,13,Male,6445,0,6445
BATAGRAM DISTRICT,13,Female,5651,0,5651
BATAGRAM DISTRICT,13,Transgender,0,0,0
BATAGRAM DISTRICT,14,Male,5907,0,5907
BATAGRAM DISTRICT,14,Female,5532,0,5532
BATAGRAM DISTRICT,14,Transgender,0,0,0
BATAGRAM DISTRICT,15,Male,5801,0,5801
BATAGRAM DISTRICT,15,Female,5328,0,5328
BATAGRAM DISTRICT,15,Transgender,0,0,0
BATAGRAM DISTRICT,16,Male,5262,0,5262
BATAGRAM DISTRICT,16,Female,4793,0,4793
BATAGRAM DISTRICT,16,Transgender,0,0,0
BATAGRAM DISTRICT,17,Male,4643,0,4643
BATAGRAM DISTRICT,17,Female,4572,0,4572
BATAGRAM DISTRICT,17,Transgender,2,0,2
BATAGRAM DISTRICT,18,Male,4807,0,4807
BATAGRAM DISTRICT,18,Female,5028,0,5028
BATAGRAM DISTRICT,18,Transgender,1,0,1
BATAGRAM DISTRICT,19,Male,4883,0,4883
BATAGRAM DISTRICT,19,Female,4458,0,4458
BATAGRAM DISTRICT,19,Transgender,0,0,0
BATAGRAM DISTRICT,20,Male,4372,0,4372
BATAGRAM DISTRICT,20,Female,4916,0,4916
BATAGRAM DISTRICT,20,Transgender,0,0,0
BATAGRAM DISTRICT,21,Male,4061,0,4061
BATAGRAM DISTRICT,21,Female,4234,0,4234
BATAGRAM DISTRICT,21,Transgender,1,0,1
BATAGRAM DISTRICT,22,Male,3595,0,3595
BATAGRAM DISTRICT,22,Female,3817,0,3817
BATAGRAM DISTRICT,22,Transgender,0,0,0
BATAGRAM DISTRICT,23,Male,3387,0,3387
BATAGRAM DISTRICT,23,Female,3323,0,3323
BATAGRAM DISTRICT,23,Transgender,1,0,1
BATAGRAM DISTRICT,24,Male,3301,0,3301
BATAGRAM DISTRICT,24,Female,3303,0,3303
BATAGRAM DISTRICT,24,Transgender,3,0,3
BATAGRAM DISTRICT,25,Male,3085,0,3085
BATAGRAM DISTRICT,25,Female,3804,0,3804
BATAGRAM DISTRICT,25,Transgender,3,0,3
BATAGRAM DISTRICT,26,Male,3268,0,3268
BATAGRAM DISTRICT,26,Female,3751,0,3751
BATAGRAM DISTRICT,26,Transgender,0,0,0
BATAGRAM DISTRICT,27,Male,2644,0,2644
BATAGRAM DISTRICT,27,Female,3184,0,3184
BATAGRAM DISTRICT,27,Transgender,1,0,1
BATAGRAM DISTRICT,28,Male,2651,0,2651
BATAGRAM DISTRICT,28,Female,3418,0,3418
BATAGRAM DISTRICT,28,Transgender,1,0,1
BATAGRAM DISTRICT,29,Male,2922,0,2922
BATAGRAM DISTRICT,29,Female,3579,0,3579
BATAGRAM DISTRICT,29,Transgender,0,0,0
BATAGRAM DISTRICT,30,Male,2649,0,2649
BATAGRAM DISTRICT,30,Female,3189,0,3189
BATAGRAM DISTRICT,30,Transgender,2,0,2
BATAGRAM DISTRICT,31,Male,3091,0,3091
BATAGRAM DISTRICT,31,Female,3939,0,3939
BATAGRAM DISTRICT,31,Transgender,0,0,0
BATAGRAM DISTRICT,32,Male,2396,0,2396
BATAGRAM DISTRICT,32,Female,2801,0,2801
BATAGRAM DISTRICT,32,Transgender,0,0,0
BATAGRAM DISTRICT,33,Male,2270,0,2270
BATAGRAM DISTRICT,33,Female,2699,0,2699
BATAGRAM DISTRICT,33,Transgender,0,0,0
BATAGRAM DISTRICT,34,Male,2184,0,2184
BATAGRAM DISTRICT,34,Female,2514,0,2514
BATAGRAM DISTRICT,34,Transgender,0,0,0
BATAGRAM DISTRICT,35,Male,1694,0,1694
BATAGRAM DISTRICT,35,Female,2283,0,2283
BATAGRAM DISTRICT,35,Transgender,2,0,2
BATAGRAM DISTRICT,36,Male,2403,0,2403
BATAGRAM DISTRICT,36,Female,3126,0,3126
BATAGRAM DISTRICT,36,Transgender,1,0,1
BATAGRAM DISTRICT,37,Male,1959,0,1959
BATAGRAM DISTRICT,37,Female,2460,0,2460
BATAGRAM DISTRICT,37,Transgender,0,0,0
BATAGRAM DISTRICT,38,Male,1980,0,1980
BATAGRAM DISTRICT,38,Female,2174,0,2174
BATAGRAM DISTRICT,38,Transgender,2,0,2
BATAGRAM DISTRICT,39,Male,1841,0,1841
BATAGRAM DISTRICT,39,Female,2070,0,2070
BATAGRAM DISTRICT,39,Transgender,0,0,0
BATAGRAM DISTRICT,40,Male,1511,0,1511
BATAGRAM DISTRICT,40,Female,1997,0,1997
BATAGRAM DISTRICT,40,Transgender,3,0,3
BATAGRAM DISTRICT,41,Male,1962,0,1962
BATAGRAM DISTRICT,41,Female,2636,0,2636
BATAGRAM DISTRICT,41,Transgender,0,0,0
BATAGRAM DISTRICT,42,Male,1521,0,1521
BATAGRAM DISTRICT,42,Female,1853,0,1853
BATAGRAM DISTRICT,42,Transgender,1,0,1
BATAGRAM DISTRICT,43,Male,1630,0,1630
BATAGRAM DISTRICT,43,Female,1749,0,1749
BATAGRAM DISTRICT,43,Transgender,1,0,1
BATAGRAM DISTRICT,44,Male,1609,0,1609
BATAGRAM DISTRICT,44,Female,1637,0,1637
BATAGRAM DISTRICT,44,Transgender,0,0,0
BATAGRAM DISTRICT,45,Male,1161,0,1161
BATAGRAM DISTRICT,45,Female,1288,0,1288
BATAGRAM DISTRICT,45,Transgender,0,0,0
BATAGRAM DISTRICT,46,Male,1533,0,1533
BATAGRAM DISTRICT,46,Female,2127,0,2127
BATAGRAM DISTRICT,46,Transgender,0,0,0
BATAGRAM DISTRICT,47,Male,1331,0,1331
BATAGRAM DISTRICT,47,Female,1466,0,1466
BATAGRAM DISTRICT,47,Transgender,0,0,0
BATAGRAM DISTRICT,48,Male,1478,0,1478
BATAGRAM DISTRICT,48,Female,1350,0,1350
BATAGRAM DISTRICT,48,Transgender,0,0,0
BATAGRAM DISTRICT,49,Male,1449,0,1449
BATAGRAM DISTRICT,49,Female,1345,0,1345
BATAGRAM DISTRICT,49,Transgender,0,0,0
BATAGRAM DISTRICT,50,Male,1075,0,1075
BATAGRAM DISTRICT,50,Female,1295,0,1295
BATAGRAM DISTRICT,50,Transgender,0,0,0
BATAGRAM DISTRICT,51,Male,1456,0,1456
BATAGRAM DISTRICT,51,Female,1527,0,1527
BATAGRAM DISTRICT,51,Transgender,0,0,0
BATAGRAM DISTRICT,52,Male,1164,0,1164
BATAGRAM DISTRICT,52,Female,998,0,998
BATAGRAM DISTRICT,52,Transgender,0,0,0
BATAGRAM DISTRICT,53,Male,1317,0,1317
BATAGRAM DISTRICT,53,Female,1077,0,1077
BATAGRAM DISTRICT,53,Transgender,0,0,0
BATAGRAM DISTRICT,54,Male,1154,0,1154
BATAGRAM DISTRICT,54,Female,883,0,883
BATAGRAM DISTRICT,54,Transgender,0,0,0
BATAGRAM DISTRICT,55,Male,776,0,776
BATAGRAM DISTRICT,55,Female,788,0,788
BATAGRAM DISTRICT,55,Transgender,0,0,0
BATAGRAM DISTRICT,56,Male,946,0,946
BATAGRAM DISTRICT,56,Female,995,0,995
BATAGRAM DISTRICT,56,Transgender,0,0,0
BATAGRAM DISTRICT,57,Male,807,0,807
BATAGRAM DISTRICT,57,Female,706,0,706
BATAGRAM DISTRICT,57,Transgender,0,0,0
BATAGRAM DISTRICT,58,Male,798,0,798
BATAGRAM DISTRICT,58,Female,683,0,683
BATAGRAM DISTRICT,58,Transgender,0,0,0
BATAGRAM DISTRICT,59,Male,816,0,816
BATAGRAM DISTRICT,59,Female,736,0,736
BATAGRAM DISTRICT,59,Transgender,0,0,0
BATAGRAM DISTRICT,60,Male,676,0,676
BATAGRAM DISTRICT,60,Female,825,0,825
BATAGRAM DISTRICT,60,Transgender,3,0,3
BATAGRAM DISTRICT,61,Male,987,0,987
BATAGRAM DISTRICT,61,Female,1105,0,1105
BATAGRAM DISTRICT,61,Transgender,1,0,1
BATAGRAM DISTRICT,62,Male,836,0,836
BATAGRAM DISTRICT,62,Female,765,0,765
BATAGRAM DISTRICT,62,Transgender,0,0,0
BATAGRAM DISTRICT,63,Male,829,0,829
BATAGRAM DISTRICT,63,Female,794,0,794
BATAGRAM DISTRICT,63,Transgender,1,0,1
BATAGRAM DISTRICT,64,Male,770,0,770
BATAGRAM DISTRICT,64,Female,742,0,742
BATAGRAM DISTRICT,64,Transgender,0,0,0
BATAGRAM DISTRICT,65,Male,520,0,520
BATAGRAM DISTRICT,65,Female,600,0,600
BATAGRAM DISTRICT,65,Transgender,1,0,1
BATAGRAM DISTRICT,66,Male,949,0,949
BATAGRAM DISTRICT,66,Female,936,0,936
BATAGRAM DISTRICT,66,Transgender,0,0,0
BATAGRAM DISTRICT,67,Male,739,0,739
BATAGRAM DISTRICT,67,Female,703,0,703
BATAGRAM DISTRICT,67,Transgender,1,0,1
BATAGRAM DISTRICT,68,Male,714,0,714
BATAGRAM DISTRICT,68,Female,542,0,542
BATAGRAM DISTRICT,68,Transgender,0,0,0
BATAGRAM DISTRICT,69,Male,563,0,563
BATAGRAM DISTRICT,69,Female,513,0,513
BATAGRAM DISTRICT,69,Transgender,0,0,0
BATAGRAM DISTRICT,70,Male,475,0,475
BATAGRAM DISTRICT,70,Female,517,0,517
BATAGRAM DISTRICT,70,Transgender,1,0,1
BATAGRAM DISTRICT,71,Male,810,0,810
BATAGRAM DISTRICT,71,Female,777,0,777
BATAGRAM DISTRICT,71,Transgender,0,0,0
BATAGRAM DISTRICT,72,Male,639,0,639
BATAGRAM DISTRICT,72,Female,503,0,503
BATAGRAM DISTRICT,72,Transgender,0,0,0
BATAGRAM DISTRICT,73,Male,497,0,497
BATAGRAM DISTRICT,73,Female,378,0,378
BATAGRAM DISTRICT,73,Transgender,1,0,1
BATAGRAM DISTRICT,74,Male,387,0,387
BATAGRAM DISTRICT,74,Female,318,0,318
BATAGRAM DISTRICT,74,Transgender,0,0,0
BATAGRAM DISTRICT,>=75,Male,3709,0,3709
BATAGRAM DISTRICT,>=75,Female,3032,0,3032
BATAGRAM DISTRICT,>=75,Transgender,1,0,1
BHAKKAR DISTRICT,<1,Male,16688,2946,19634
BHAKKAR DISTRICT,<1,Female,15421,2903,18324
BHAKKAR DISTRICT,<1,Transgender,0,0,0
BHAKKAR DISTRICT,1,Male,19174,3242,22416
BHAKKAR DISTRICT,1,Female,17976,3042,21018
BHAKKAR DISTRICT,1,Transgender,0,0,0
BHAKKAR DISTRICT,2,Male,19692,3340,23032
BHAKKAR DISTRICT,2,Female,18882,3128,22010
BHAKKAR DISTRICT,2,Transgender,0,0,0
BHAKKAR DISTRICT,3,Male,21226,3425,24651
BHAKKAR DISTRICT,3,Female,20252,3287,23539
BHAKKAR DISTRICT,3,Transgender,0,0,0
BHAKKAR DISTRICT,4,Male,22050,3416,25466
BHAKKAR DISTRICT,4,Female,20601,3219,23820
BHAKKAR DISTRICT,4,Transgender,0,0,0
BHAKKAR DISTRICT,5,Male,21174,3343,24517
BHAKKAR DISTRICT,5,Female,19722,3179,22901
BHAKKAR DISTRICT,5,Transgender,0,0,0
BHAKKAR DISTRICT,6,Male,20025,3188,23213
BHAKKAR DISTRICT,6,Female,18556,3022,21578
BHAKKAR DISTRICT,6,Transgender,0,0,0
BHAKKAR DISTRICT,7,Male,22024,3392,25416
BHAKKAR DISTRICT,7,Female,19942,3120,23062
BHAKKAR DISTRICT,7,Transgender,0,0,0
BHAKKAR DISTRICT,8,Male,20494,3193,23687
BHAKKAR DISTRICT,8,Female,19026,2930,21956
BHAKKAR DISTRICT,8,Transgender,0,0,0
BHAKKAR DISTRICT,9,Male,20444,3567,24011
BHAKKAR DISTRICT,9,Female,18702,3168,21870
BHAKKAR DISTRICT,9,Transgender,0,0,0
BHAKKAR DISTRICT,10,Male,18856,2973,21829
BHAKKAR DISTRICT,10,Female,17249,2582,19831
BHAKKAR DISTRICT,10,Transgender,0,0,0
BHAKKAR DISTRICT,11,Male,18284,3538,21822
BHAKKAR DISTRICT,11,Female,16521,3113,19634
BHAKKAR DISTRICT,11,Transgender,0,0,0
BHAKKAR DISTRICT,12,Male,17078,2920,19998
BHAKKAR DISTRICT,12,Female,15580,2622,18202
BHAKKAR DISTRICT,12,Transgender,0,0,0
BHAKKAR DISTRICT,13,Male,16374,3286,19660
BHAKKAR DISTRICT,13,Female,14669,2827,17496
BHAKKAR DISTRICT,13,Transgender,0,0,0
BHAKKAR DISTRICT,14,Male,15901,3026,18927
BHAKKAR DISTRICT,14,Female,14707,2668,17375
BHAKKAR DISTRICT,14,Transgender,0,0,0
BHAKKAR DISTRICT,15,Male,15547,3022,18569
BHAKKAR DISTRICT,15,Female,14443,2743,17186
BHAKKAR DISTRICT,15,Transgender,3,0,3
BHAKKAR DISTRICT,16,Male,15847,3056,18903
BHAKKAR DISTRICT,16,Female,14480,2717,17197
BHAKKAR DISTRICT,16,Transgender,3,0,3
BHAKKAR DISTRICT,17,Male,15645,3119,18764
BHAKKAR DISTRICT,17,Female,14826,2991,17817
BHAKKAR DISTRICT,17,Transgender,3,3,6
BHAKKAR DISTRICT,18,Male,13536,2724,16260
BHAKKAR DISTRICT,18,Female,13025,2443,15468
BHAKKAR DISTRICT,18,Transgender,3,0,3
BHAKKAR DISTRICT,19,Male,13179,2910,16089
BHAKKAR DISTRICT,19,Female,12912,2869,15781
BHAKKAR DISTRICT,19,Transgender,4,0,4
BHAKKAR DISTRICT,20,Male,12238,2529,14767
BHAKKAR DISTRICT,20,Female,13589,2492,16081
BHAKKAR DISTRICT,20,Transgender,2,0,2
BHAKKAR DISTRICT,21,Male,12458,2810,15268
BHAKKAR DISTRICT,21,Female,12493,2888,15381
BHAKKAR DISTRICT,21,Transgender,2,0,2
BHAKKAR DISTRICT,22,Male,11654,2389,14043
BHAKKAR DISTRICT,22,Female,11899,2550,14449
BHAKKAR DISTRICT,22,Transgender,3,0,3
BHAKKAR DISTRICT,23,Male,11997,2530,14527
BHAKKAR DISTRICT,23,Female,11562,2614,14176
BHAKKAR DISTRICT,23,Transgender,1,0,1
BHAKKAR DISTRICT,24,Male,11225,2426,13651
BHAKKAR DISTRICT,24,Female,11494,2543,14037
BHAKKAR DISTRICT,24,Transgender,1,1,2
BHAKKAR DISTRICT,25,Male,10251,2179,12430
BHAKKAR DISTRICT,25,Female,11464,2213,13677
BHAKKAR DISTRICT,25,Transgender,3,4,7
BHAKKAR DISTRICT,26,Male,10925,2306,13231
BHAKKAR DISTRICT,26,Female,11555,2273,13828
BHAKKAR DISTRICT,26,Transgender,2,1,3
BHAKKAR DISTRICT,27,Male,10854,2249,13103
BHAKKAR DISTRICT,27,Female,11119,2433,13552
BHAKKAR DISTRICT,27,Transgender,2,0,2
BHAKKAR DISTRICT,28,Male,9909,2117,12026
BHAKKAR DISTRICT,28,Female,10270,2166,12436
BHAKKAR DISTRICT,28,Transgender,1,4,5
BHAKKAR DISTRICT,29,Male,10531,2171,12702
BHAKKAR DISTRICT,29,Female,10667,2192,12859
BHAKKAR DISTRICT,29,Transgender,1,0,1
BHAKKAR DISTRICT,30,Male,8437,1718,10155
BHAKKAR DISTRICT,30,Female,9832,1774,11606
BHAKKAR DISTRICT,30,Transgender,4,0,4
BHAKKAR DISTRICT,31,Male,9240,1898,11138
BHAKKAR DISTRICT,31,Female,9775,1990,11765
BHAKKAR DISTRICT,31,Transgender,2,0,2
BHAKKAR DISTRICT,32,Male,8065,1726,9791
BHAKKAR DISTRICT,32,Female,9156,1830,10986
BHAKKAR DISTRICT,32,Transgender,1,1,2
BHAKKAR DISTRICT,33,Male,8018,1739,9757
BHAKKAR DISTRICT,33,Female,7867,1581,9448
BHAKKAR DISTRICT,33,Transgender,1,0,1
BHAKKAR DISTRICT,34,Male,9235,1717,10952
BHAKKAR DISTRICT,34,Female,8524,1693,10217
BHAKKAR DISTRICT,34,Transgender,1,0,1
BHAKKAR DISTRICT,35,Male,7835,1554,9389
BHAKKAR DISTRICT,35,Female,8075,1461,9536
BHAKKAR DISTRICT,35,Transgender,2,2,4
BHAKKAR DISTRICT,36,Male,9418,1661,11079
BHAKKAR DISTRICT,36,Female,9393,1686,11079
BHAKKAR DISTRICT,36,Transgender,3,1,4
BHAKKAR DISTRICT,37,Male,8491,1523,10014
BHAKKAR DISTRICT,37,Female,8906,1607,10513
BHAKKAR DISTRICT,37,Transgender,1,3,4
BHAKKAR DISTRICT,38,Male,7497,1533,9030
BHAKKAR DISTRICT,38,Female,7497,1460,8957
BHAKKAR DISTRICT,38,Transgender,2,2,4
BHAKKAR DISTRICT,39,Male,7807,1481,9288
BHAKKAR DISTRICT,39,Female,7665,1518,9183
BHAKKAR DISTRICT,39,Transgender,0,2,2
BHAKKAR DISTRICT,40,Male,5773,1213,6986
BHAKKAR DISTRICT,40,Female,6440,1207,7647
BHAKKAR DISTRICT,40,Transgender,2,1,3
BHAKKAR DISTRICT,41,Male,6555,1333,7888
BHAKKAR DISTRICT,41,Female,7464,1318,8782
BHAKKAR DISTRICT,41,Transgender,2,1,3
BHAKKAR DISTRICT,42,Male,5848,1190,7038
BHAKKAR DISTRICT,42,Female,6473,1212,7685
BHAKKAR DISTRICT,42,Transgender,2,1,3
BHAKKAR DISTRICT,43,Male,5972,1206,7178
BHAKKAR DISTRICT,43,Female,5746,1164,6910
BHAKKAR DISTRICT,43,Transgender,0,0,0
BHAKKAR DISTRICT,44,Male,6124,1221,7345
BHAKKAR DISTRICT,44,Female,5615,1133,6748
BHAKKAR DISTRICT,44,Transgender,1,0,1
BHAKKAR DISTRICT,45,Male,5002,978,5980
BHAKKAR DISTRICT,45,Female,4908,924,5832
BHAKKAR DISTRICT,45,Transgender,1,1,2
BHAKKAR DISTRICT,46,Male,6114,1137,7251
BHAKKAR DISTRICT,46,Female,6199,1173,7372
BHAKKAR DISTRICT,46,Transgender,1,0,1
BHAKKAR DISTRICT,47,Male,5722,1112,6834
BHAKKAR DISTRICT,47,Female,5827,1055,6882
BHAKKAR DISTRICT,47,Transgender,1,0,1
BHAKKAR DISTRICT,48,Male,5955,1246,7201
BHAKKAR DISTRICT,48,Female,5159,1053,6212
BHAKKAR DISTRICT,48,Transgender,0,0,0
BHAKKAR DISTRICT,49,Male,6186,1218,7404
BHAKKAR DISTRICT,49,Female,5425,1160,6585
BHAKKAR DISTRICT,49,Transgender,1,0,1
BHAKKAR DISTRICT,50,Male,5184,1071,6255
BHAKKAR DISTRICT,50,Female,4738,965,5703
BHAKKAR DISTRICT,50,Transgender,2,0,2
BHAKKAR DISTRICT,51,Male,6126,1194,7320
BHAKKAR DISTRICT,51,Female,5544,1050,6594
BHAKKAR DISTRICT,51,Transgender,2,1,3
BHAKKAR DISTRICT,52,Male,5278,1065,6343
BHAKKAR DISTRICT,52,Female,4664,938,5602
BHAKKAR DISTRICT,52,Transgender,2,1,3
BHAKKAR DISTRICT,53,Male,5663,1068,6731
BHAKKAR DISTRICT,53,Female,4405,961,5366
BHAKKAR DISTRICT,53,Transgender,2,0,2
BHAKKAR DISTRICT,54,Male,5139,1019,6158
BHAKKAR DISTRICT,54,Female,4009,867,4876
BHAKKAR DISTRICT,54,Transgender,0,0,0
BHAKKAR DISTRICT,55,Male,3994,880,4874
BHAKKAR DISTRICT,55,Female,3066,676,3742
BHAKKAR DISTRICT,55,Transgender,2,0,2
BHAKKAR DISTRICT,56,Male,4153,967,5120
BHAKKAR DISTRICT,56,Female,3343,765,4108
BHAKKAR DISTRICT,56,Transgender,1,0,1
BHAKKAR DISTRICT,57,Male,3344,827,4171
BHAKKAR DISTRICT,57,Female,2967,605,3572
BHAKKAR DISTRICT,57,Transgender,0,1,1
BHAKKAR DISTRICT,58,Male,3130,711,3841
BHAKKAR DISTRICT,58,Female,2689,645,3334
BHAKKAR DISTRICT,58,Transgender,0,0,0
BHAKKAR DISTRICT,59,Male,3273,708,3981
BHAKKAR DISTRICT,59,Female,2828,648,3476
BHAKKAR DISTRICT,59,Transgender,2,0,2
BHAKKAR DISTRICT,60,Male,2789,566,3355
BHAKKAR DISTRICT,60,Female,2633,506,3139
BHAKKAR DISTRICT,60,Transgender,4,0,4
BHAKKAR DISTRICT,61,Male,3319,662,3981
BHAKKAR DISTRICT,61,Female,3025,643,3668
BHAKKAR DISTRICT,61,Transgender,0,1,1
BHAKKAR DISTRICT,62,Male,3065,644,3709
BHAKKAR DISTRICT,62,Female,2740,632,3372
BHAKKAR DISTRICT,62,Transgender,0,0,0
BHAKKAR DISTRICT,63,Male,3072,664,3736
BHAKKAR DISTRICT,63,Female,2713,582,3295
BHAKKAR DISTRICT,63,Transgender,0,1,1
BHAKKAR DISTRICT,64,Male,2930,559,3489
BHAKKAR DISTRICT,64,Female,2691,501,3192
BHAKKAR DISTRICT,64,Transgender,0,0,0
BHAKKAR DISTRICT,65,Male,2365,370,2735
BHAKKAR DISTRICT,65,Female,2170,379,2549
BHAKKAR DISTRICT,65,Transgender,2,1,3
BHAKKAR DISTRICT,66,Male,2723,442,3165
BHAKKAR DISTRICT,66,Female,2377,404,2781
BHAKKAR DISTRICT,66,Transgender,0,0,0
BHAKKAR DISTRICT,67,Male,2407,396,2803
BHAKKAR DISTRICT,67,Female,2051,335,2386
BHAKKAR DISTRICT,67,Transgender,0,0,0
BHAKKAR DISTRICT,68,Male,2280,387,2667
BHAKKAR DISTRICT,68,Female,1836,372,2208
BHAKKAR DISTRICT,68,Transgender,0,0,0
BHAKKAR DISTRICT,69,Male,2299,312,2611
BHAKKAR DISTRICT,69,Female,1948,310,2258
BHAKKAR DISTRICT,69,Transgender,0,0,0
BHAKKAR DISTRICT,70,Male,1776,282,2058
BHAKKAR DISTRICT,70,Female,1502,246,1748
BHAKKAR DISTRICT,70,Transgender,0,0,0
BHAKKAR DISTRICT,71,Male,2119,297,2416
BHAKKAR DISTRICT,71,Female,1789,311,2100
BHAKKAR DISTRICT,71,Transgender,0,0,0
BHAKKAR DISTRICT,72,Male,1641,288,1929
BHAKKAR DISTRICT,72,Female,1428,240,1668
BHAKKAR DISTRICT,72,Transgender,2,0,2
BHAKKAR DISTRICT,73,Male,1598,269,1867
BHAKKAR DISTRICT,73,Female,1255,270,1525
BHAKKAR DISTRICT,73,Transgender,2,0,2
BHAKKAR DISTRICT,74,Male,1371,212,1583
BHAKKAR DISTRICT,74,Female,1112,161,1273
BHAKKAR DISTRICT,74,Transgender,0,0,0
BHAKKAR DISTRICT,>=75,Male,10300,1548,11848
BHAKKAR DISTRICT,>=75,Female,9120,1528,10648
BHAKKAR DISTRICT,>=75,Transgender,8,0,8
BUNER DISTRICT,<1,Male,12012,0,12012
BUNER DISTRICT,<1,Female,11274,0,11274
BUNER DISTRICT,<1,Transgender,0,0,0
BUNER DISTRICT,1,Male,13468,0,13468
BUNER DISTRICT,1,Female,12315,0,12315
BUNER DISTRICT,1,Transgender,0,0,0
BUNER DISTRICT,2,Male,14951,0,14951
BUNER DISTRICT,2,Female,14064,0,14064
BUNER DISTRICT,2,Transgender,0,0,0
BUNER DISTRICT,3,Male,15276,0,15276
BUNER DISTRICT,3,Female,15113,0,15113
BUNER DISTRICT,3,Transgender,0,0,0
BUNER DISTRICT,4,Male,16024,0,16024
BUNER DISTRICT,4,Female,15106,0,15106
BUNER DISTRICT,4,Transgender,0,0,0
BUNER DISTRICT,5,Male,16225,0,16225
BUNER DISTRICT,5,Female,14945,0,14945
BUNER DISTRICT,5,Transgender,0,0,0
BUNER DISTRICT,6,Male,14884,0,14884
BUNER DISTRICT,6,Female,13820,0,13820
BUNER DISTRICT,6,Transgender,0,0,0
BUNER DISTRICT,7,Male,15746,0,15746
BUNER DISTRICT,7,Female,14230,0,14230
BUNER DISTRICT,7,Transgender,0,0,0
BUNER DISTRICT,8,Male,15364,0,15364
BUNER DISTRICT,8,Female,14522,0,14522
BUNER DISTRICT,8,Transgender,0,0,0
BUNER DISTRICT,9,Male,15267,0,15267
BUNER DISTRICT,9,Female,13630,0,13630
BUNER DISTRICT,9,Transgender,0,0,0
BUNER DISTRICT,10,Male,14015,0,14015
BUNER DISTRICT,10,Female,12976,0,12976
BUNER DISTRICT,10,Transgender,0,0,0
BUNER DISTRICT,11,Male,14253,0,14253
BUNER DISTRICT,11,Female,11842,0,11842
BUNER DISTRICT,11,Transgender,0,0,0
BUNER DISTRICT,12,Male,12922,0,12922
BUNER DISTRICT,12,Female,11409,0,11409
BUNER DISTRICT,12,Transgender,0,0,0
BUNER DISTRICT,13,Male,13276,0,13276
BUNER DISTRICT,13,Female,11718,0,11718
BUNER DISTRICT,13,Transgender,0,0,0
BUNER DISTRICT,14,Male,11857,0,11857
BUNER DISTRICT,14,Female,10838,0,10838
BUNER DISTRICT,14,Transgender,0,0,0
BUNER DISTRICT,15,Male,12135,0,12135
BUNER DISTRICT,15,Female,11213,0,11213
BUNER DISTRICT,15,Transgender,0,0,0
BUNER DISTRICT,16,Male,10838,0,10838
BUNER DISTRICT,16,Female,10047,0,10047
BUNER DISTRICT,16,Transgender,0,0,0
BUNER DISTRICT,17,Male,10325,0,10325
BUNER DISTRICT,17,Female,10946,0,10946
BUNER DISTRICT,17,Transgender,3,0,3
BUNER DISTRICT,18,Male,9869,0,9869
BUNER DISTRICT,18,Female,9747,0,9747
BUNER DISTRICT,18,Transgender,0,0,0
BUNER DISTRICT,19,Male,9588,0,9588
BUNER DISTRICT,19,Female,8434,0,8434
BUNER DISTRICT,19,Transgender,2,0,2
BUNER DISTRICT,20,Male,8303,0,8303
BUNER DISTRICT,20,Female,9805,0,9805
BUNER DISTRICT,20,Transgender,0,0,0
BUNER DISTRICT,21,Male,7197,0,7197
BUNER DISTRICT,21,Female,7752,0,7752
BUNER DISTRICT,21,Transgender,0,0,0
BUNER DISTRICT,22,Male,6706,0,6706
BUNER DISTRICT,22,Female,7319,0,7319
BUNER DISTRICT,22,Transgender,3,0,3
BUNER DISTRICT,23,Male,6242,0,6242
BUNER DISTRICT,23,Female,6956,0,6956
BUNER DISTRICT,23,Transgender,2,0,2
BUNER DISTRICT,24,Male,5696,0,5696
BUNER DISTRICT,24,Female,6421,0,6421
BUNER DISTRICT,24,Transgender,0,0,0
BUNER DISTRICT,25,Male,6361,0,6361
BUNER DISTRICT,25,Female,8402,0,8402
BUNER DISTRICT,25,Transgender,2,0,2
BUNER DISTRICT,26,Male,6131,0,6131
BUNER DISTRICT,26,Female,7881,0,7881
BUNER DISTRICT,26,Transgender,1,0,1
BUNER DISTRICT,27,Male,6029,0,6029
BUNER DISTRICT,27,Female,7971,0,7971
BUNER DISTRICT,27,Transgender,1,0,1
BUNER DISTRICT,28,Male,5851,0,5851
BUNER DISTRICT,28,Female,6754,0,6754
BUNER DISTRICT,28,Transgender,0,0,0
BUNER DISTRICT,29,Male,5357,0,5357
BUNER DISTRICT,29,Female,6913,0,6913
BUNER DISTRICT,29,Transgender,2,0,2
BUNER DISTRICT,30,Male,5645,0,5645
BUNER DISTRICT,30,Female,6703,0,6703
BUNER DISTRICT,30,Transgender,1,0,1
BUNER DISTRICT,31,Male,4498,0,4498
BUNER DISTRICT,31,Female,6371,0,6371
BUNER DISTRICT,31,Transgender,0,0,0
BUNER DISTRICT,32,Male,3942,0,3942
BUNER DISTRICT,32,Female,5131,0,5131
BUNER DISTRICT,32,Transgender,0,0,0
BUNER DISTRICT,33,Male,4091,0,4091
BUNER DISTRICT,33,Female,5166,0,5166
BUNER DISTRICT,33,Transgender,0,0,0
BUNER DISTRICT,34,Male,3818,0,3818
BUNER DISTRICT,34,Female,4640,0,4640
BUNER DISTRICT,34,Transgender,0,0,0
BUNER DISTRICT,35,Male,4062,0,4062
BUNER DISTRICT,35,Female,5075,0,5075
BUNER DISTRICT,35,Transgender,0,0,0
BUNER DISTRICT,36,Male,3851,0,3851
BUNER DISTRICT,36,Female,4733,0,4733
BUNER DISTRICT,36,Transgender,0,0,0
BUNER DISTRICT,37,Male,3659,0,3659
BUNER DISTRICT,37,Female,4908,0,4908
BUNER DISTRICT,37,Transgender,0,0,0
BUNER DISTRICT,38,Male,3777,0,3777
BUNER DISTRICT,38,Female,4142,0,4142
BUNER DISTRICT,38,Transgender,1,0,1
BUNER DISTRICT,39,Male,3458,0,3458
BUNER DISTRICT,39,Female,3985,0,3985
BUNER DISTRICT,39,Transgender,0,0,0
BUNER DISTRICT,40,Male,3744,0,3744
BUNER DISTRICT,40,Female,4670,0,4670
BUNER DISTRICT,40,Transgender,1,0,1
BUNER DISTRICT,41,Male,3438,0,3438
BUNER DISTRICT,41,Female,3953,0,3953
BUNER DISTRICT,41,Transgender,0,0,0
BUNER DISTRICT,42,Male,3107,0,3107
BUNER DISTRICT,42,Female,3531,0,3531
BUNER DISTRICT,42,Transgender,1,0,1
BUNER DISTRICT,43,Male,3143,0,3143
BUNER DISTRICT,43,Female,3309,0,3309
BUNER DISTRICT,43,Transgender,0,0,0
BUNER DISTRICT,44,Male,2890,0,2890
BUNER DISTRICT,44,Female,3108,0,3108
BUNER DISTRICT,44,Transgender,0,0,0
BUNER DISTRICT,45,Male,2692,0,2692
BUNER DISTRICT,45,Female,3043,0,3043
BUNER DISTRICT,45,Transgender,0,0,0
BUNER DISTRICT,46,Male,2656,0,2656
BUNER DISTRICT,46,Female,3034,0,3034
BUNER DISTRICT,46,Transgender,1,0,1
BUNER DISTRICT,47,Male,2457,0,2457
BUNER DISTRICT,47,Female,2875,0,2875
BUNER DISTRICT,47,Transgender,0,0,0
BUNER DISTRICT,48,Male,2534,0,2534
BUNER DISTRICT,48,Female,2541,0,2541
BUNER DISTRICT,48,Transgender,2,0,2
BUNER DISTRICT,49,Male,2300,0,2300
BUNER DISTRICT,49,Female,2504,0,2504
BUNER DISTRICT,49,Transgender,0,0,0
BUNER DISTRICT,50,Male,2541,0,2541
BUNER DISTRICT,50,Female,2865,0,2865
BUNER DISTRICT,50,Transgender,2,0,2
BUNER DISTRICT,51,Male,2240,0,2240
BUNER DISTRICT,51,Female,2324,0,2324
BUNER DISTRICT,51,Transgender,2,0,2
BUNER DISTRICT,52,Male,2278,0,2278
BUNER DISTRICT,52,Female,1959,0,1959
BUNER DISTRICT,52,Transgender,1,0,1
BUNER DISTRICT,53,Male,2086,0,2086
BUNER DISTRICT,53,Female,1901,0,1901
BUNER DISTRICT,53,Transgender,0,0,0
BUNER DISTRICT,54,Male,2040,0,2040
BUNER DISTRICT,54,Female,1813,0,1813
BUNER DISTRICT,54,Transgender,0,0,0
BUNER DISTRICT,55,Male,1946,0,1946
BUNER DISTRICT,55,Female,1919,0,1919
BUNER DISTRICT,55,Transgender,0,0,0
BUNER DISTRICT,56,Male,1541,0,1541
BUNER DISTRICT,56,Female,1583,0,1583
BUNER DISTRICT,56,Transgender,0,0,0
BUNER DISTRICT,57,Male,1411,0,1411
BUNER DISTRICT,57,Female,1319,0,1319
BUNER DISTRICT,57,Transgender,0,0,0
BUNER DISTRICT,58,Male,1595,0,1595
BUNER DISTRICT,58,Female,1434,0,1434
BUNER DISTRICT,58,Transgender,0,0,0
BUNER DISTRICT,59,Male,1706,0,1706
BUNER DISTRICT,59,Female,1547,0,1547
BUNER DISTRICT,59,Transgender,0,0,0
BUNER DISTRICT,60,Male,1726,0,1726
BUNER DISTRICT,60,Female,1927,0,1927
BUNER DISTRICT,60,Transgender,0,0,0
BUNER DISTRICT,61,Male,1638,0,1638
BUNER DISTRICT,61,Female,1778,0,1778
BUNER DISTRICT,61,Transgender,1,0,1
BUNER DISTRICT,62,Male,1467,0,1467
BUNER DISTRICT,62,Female,1458,0,1458
BUNER DISTRICT,62,Transgender,0,0,0
BUNER DISTRICT,63,Male,1549,0,1549
BUNER DISTRICT,63,Female,1457,0,1457
BUNER DISTRICT,63,Transgender,0,0,0
BUNER DISTRICT,64,Male,1447,0,1447
BUNER DISTRICT,64,Female,1429,0,1429
BUNER DISTRICT,64,Transgender,2,0,2
BUNER DISTRICT,65,Male,1338,0,1338
BUNER DISTRICT,65,Female,1391,0,1391
BUNER DISTRICT,65,Transgender,0,0,0
BUNER DISTRICT,66,Male,1319,0,1319
BUNER DISTRICT,66,Female,1251,0,1251
BUNER DISTRICT,66,Transgender,0,0,0
BUNER DISTRICT,67,Male,1093,0,1093
BUNER DISTRICT,67,Female,971,0,971
BUNER DISTRICT,67,Transgender,0,0,0
BUNER DISTRICT,68,Male,1197,0,1197
BUNER DISTRICT,68,Female,1014,0,1014
BUNER DISTRICT,68,Transgender,1,0,1
BUNER DISTRICT,69,Male,1277,0,1277
BUNER DISTRICT,69,Female,1073,0,1073
BUNER DISTRICT,69,Transgender,0,0,0
BUNER DISTRICT,70,Male,1317,0,1317
BUNER DISTRICT,70,Female,1085,0,1085
BUNER DISTRICT,70,Transgender,1,0,1
BUNER DISTRICT,71,Male,1132,0,1132
BUNER DISTRICT,71,Female,982,0,982
BUNER DISTRICT,71,Transgender,0,0,0
BUNER DISTRICT,72,Male,886,0,886
BUNER DISTRICT,72,Female,703,0,703
BUNER DISTRICT,72,Transgender,0,0,0
BUNER DISTRICT,73,Male,901,0,901
BUNER DISTRICT,73,Female,690,0,690
BUNER DISTRICT,73,Transgender,0,0,0
BUNER DISTRICT,74,Male,821,0,821
BUNER DISTRICT,74,Female,654,0,654
BUNER DISTRICT,74,Transgender,0,0,0
BUNER DISTRICT,>=75,Male,5450,0,5450
BUNER DISTRICT,>=75,Female,5243,0,5243
BUNER DISTRICT,>=75,Transgender,0,0,0
CHAGAI DISTRICT,<1,Male,2788,196,2984
CHAGAI DISTRICT,<1,Female,2333,158,2491
CHAGAI DISTRICT,<1,Transgender,0,0,0
CHAGAI DISTRICT,1,Male,4247,302,4549
CHAGAI DISTRICT,1,Female,3784,228,4012
CHAGAI DISTRICT,1,Transgender,0,0,0
CHAGAI DISTRICT,2,Male,4558,290,4848
CHAGAI DISTRICT,2,Female,4141,270,4411
CHAGAI DISTRICT,2,Transgender,0,0,0
CHAGAI DISTRICT,3,Male,4253,283,4536
CHAGAI DISTRICT,3,Female,3878,270,4148
CHAGAI DISTRICT,3,Transgender,0,0,0
CHAGAI DISTRICT,4,Male,4116,262,4378
CHAGAI DISTRICT,4,Female,3893,258,4151
CHAGAI DISTRICT,4,Transgender,0,0,0
CHAGAI DISTRICT,5,Male,3949,277,4226
CHAGAI DISTRICT,5,Female,3747,245,3992
CHAGAI DISTRICT,5,Transgender,0,0,0
CHAGAI DISTRICT,6,Male,3849,231,4080
CHAGAI DISTRICT,6,Female,3465,228,3693
CHAGAI DISTRICT,6,Transgender,0,0,0
CHAGAI DISTRICT,7,Male,4226,297,4523
CHAGAI DISTRICT,7,Female,3789,254,4043
CHAGAI DISTRICT,7,Transgender,0,0,0
CHAGAI DISTRICT,8,Male,3902,233,4135
CHAGAI DISTRICT,8,Female,3648,221,3869
CHAGAI DISTRICT,8,Transgender,0,0,0
CHAGAI DISTRICT,9,Male,3756,271,4027
CHAGAI DISTRICT,9,Female,3184,222,3406
CHAGAI DISTRICT,9,Transgender,0,0,0
CHAGAI DISTRICT,10,Male,3662,196,3858
CHAGAI DISTRICT,10,Female,3243,204,3447
CHAGAI DISTRICT,10,Transgender,0,0,0
CHAGAI DISTRICT,11,Male,3176,253,3429
CHAGAI DISTRICT,11,Female,2860,253,3113
CHAGAI DISTRICT,11,Transgender,0,0,0
CHAGAI DISTRICT,12,Male,2868,188,3056
CHAGAI DISTRICT,12,Female,2588,183,2771
CHAGAI DISTRICT,12,Transgender,0,0,0
CHAGAI DISTRICT,13,Male,2873,200,3073
CHAGAI DISTRICT,13,Female,2527,221,2748
CHAGAI DISTRICT,13,Transgender,0,0,0
CHAGAI DISTRICT,14,Male,2505,165,2670
CHAGAI DISTRICT,14,Female,2356,191,2547
CHAGAI DISTRICT,14,Transgender,0,0,0
CHAGAI DISTRICT,15,Male,2456,189,2645
CHAGAI DISTRICT,15,Female,2170,190,2360
CHAGAI DISTRICT,15,Transgender,0,0,0
CHAGAI DISTRICT,16,Male,2196,179,2375
CHAGAI DISTRICT,16,Female,1904,169,2073
CHAGAI DISTRICT,16,Transgender,0,0,0
CHAGAI DISTRICT,17,Male,2210,181,2391
CHAGAI DISTRICT,17,Female,2004,165,2169
CHAGAI DISTRICT,17,Transgender,0,0,0
CHAGAI DISTRICT,18,Male,2293,182,2475
CHAGAI DISTRICT,18,Female,2027,168,2195
CHAGAI DISTRICT,18,Transgender,0,0,0
CHAGAI DISTRICT,19,Male,2276,190,2466
CHAGAI DISTRICT,19,Female,1929,190,2119
CHAGAI DISTRICT,19,Transgender,0,0,0
CHAGAI DISTRICT,20,Male,1937,153,2090
CHAGAI DISTRICT,20,Female,1987,152,2139
CHAGAI DISTRICT,20,Transgender,1,0,1
CHAGAI DISTRICT,21,Male,1893,163,2056
CHAGAI DISTRICT,21,Female,1866,164,2030
CHAGAI DISTRICT,21,Transgender,0,0,0
CHAGAI DISTRICT,22,Male,1583,115,1698
CHAGAI DISTRICT,22,Female,1540,158,1698
CHAGAI DISTRICT,22,Transgender,0,0,0
CHAGAI DISTRICT,23,Male,1573,151,1724
CHAGAI DISTRICT,23,Female,1518,153,1671
CHAGAI DISTRICT,23,Transgender,0,0,0
CHAGAI DISTRICT,24,Male,1370,128,1498
CHAGAI DISTRICT,24,Female,1339,130,1469
CHAGAI DISTRICT,24,Transgender,0,0,0
CHAGAI DISTRICT,25,Male,1776,134,1910
CHAGAI DISTRICT,25,Female,1723,125,1848
CHAGAI DISTRICT,25,Transgender,0,0,0
CHAGAI DISTRICT,26,Male,1358,115,1473
CHAGAI DISTRICT,26,Female,1185,136,1321
CHAGAI DISTRICT,26,Transgender,0,0,0
CHAGAI DISTRICT,27,Male,1692,140,1832
CHAGAI DISTRICT,27,Female,1714,181,1895
CHAGAI DISTRICT,27,Transgender,0,0,0
CHAGAI DISTRICT,28,Male,1416,143,1559
CHAGAI DISTRICT,28,Female,1368,121,1489
CHAGAI DISTRICT,28,Transgender,0,0,0
CHAGAI DISTRICT,29,Male,1674,125,1799
CHAGAI DISTRICT,29,Female,1780,179,1959
CHAGAI DISTRICT,29,Transgender,0,0,0
CHAGAI DISTRICT,30,Male,1293,101,1394
CHAGAI DISTRICT,30,Female,1344,86,1430
CHAGAI DISTRICT,30,Transgender,1,0,1
CHAGAI DISTRICT,31,Male,1458,112,1570
CHAGAI DISTRICT,31,Female,1433,136,1569
CHAGAI DISTRICT,31,Transgender,0,0,0
CHAGAI DISTRICT,32,Male,1333,111,1444
CHAGAI DISTRICT,32,Female,1344,106,1450
CHAGAI DISTRICT,32,Transgender,1,0,1
CHAGAI DISTRICT,33,Male,1237,96,1333
CHAGAI DISTRICT,33,Female,1101,97,1198
CHAGAI DISTRICT,33,Transgender,0,0,0
CHAGAI DISTRICT,34,Male,1291,96,1387
CHAGAI DISTRICT,34,Female,1096,95,1191
CHAGAI DISTRICT,34,Transgender,0,0,0
CHAGAI DISTRICT,35,Male,1274,107,1381
CHAGAI DISTRICT,35,Female,1098,89,1187
CHAGAI DISTRICT,35,Transgender,0,0,0
CHAGAI DISTRICT,36,Male,1029,93,1122
CHAGAI DISTRICT,36,Female,838,84,922
CHAGAI DISTRICT,36,Transgender,0,0,0
CHAGAI DISTRICT,37,Male,1599,117,1716
CHAGAI DISTRICT,37,Female,1256,132,1388
CHAGAI DISTRICT,37,Transgender,0,0,0
CHAGAI DISTRICT,38,Male,981,107,1088
CHAGAI DISTRICT,38,Female,759,68,827
CHAGAI DISTRICT,38,Transgender,1,0,1
CHAGAI DISTRICT,39,Male,1163,102,1265
CHAGAI DISTRICT,39,Female,958,72,1030
CHAGAI DISTRICT,39,Transgender,0,0,0
CHAGAI DISTRICT,40,Male,737,59,796
CHAGAI DISTRICT,40,Female,638,51,689
CHAGAI DISTRICT,40,Transgender,0,0,0
CHAGAI DISTRICT,41,Male,794,79,873
CHAGAI DISTRICT,41,Female,670,52,722
CHAGAI DISTRICT,41,Transgender,0,0,0
CHAGAI DISTRICT,42,Male,817,73,890
CHAGAI DISTRICT,42,Female,768,72,840
CHAGAI DISTRICT,42,Transgender,0,0,0
CHAGAI DISTRICT,43,Male,673,55,728
CHAGAI DISTRICT,43,Female,570,54,624
CHAGAI DISTRICT,43,Transgender,0,0,0
CHAGAI DISTRICT,44,Male,697,54,751
CHAGAI DISTRICT,44,Female,538,44,582
CHAGAI DISTRICT,44,Transgender,0,0,0
CHAGAI DISTRICT,45,Male,584,46,630
CHAGAI DISTRICT,45,Female,506,53,559
CHAGAI DISTRICT,45,Transgender,0,0,0
CHAGAI DISTRICT,46,Male,543,46,589
CHAGAI DISTRICT,46,Female,450,35,485
CHAGAI DISTRICT,46,Transgender,0,0,0
CHAGAI DISTRICT,47,Male,803,62,865
CHAGAI DISTRICT,47,Female,816,79,895
CHAGAI DISTRICT,47,Transgender,0,0,0
CHAGAI DISTRICT,48,Male,558,52,610
CHAGAI DISTRICT,48,Female,408,50,458
CHAGAI DISTRICT,48,Transgender,0,0,0
CHAGAI DISTRICT,49,Male,695,66,761
CHAGAI DISTRICT,49,Female,531,63,594
CHAGAI DISTRICT,49,Transgender,1,0,1
CHAGAI DISTRICT,50,Male,502,43,545
CHAGAI DISTRICT,50,Female,416,32,448
CHAGAI DISTRICT,50,Transgender,0,0,0
CHAGAI DISTRICT,51,Male,574,50,624
CHAGAI DISTRICT,51,Female,464,49,513
CHAGAI DISTRICT,51,Transgender,0,0,0
CHAGAI DISTRICT,52,Male,585,51,636
CHAGAI DISTRICT,52,Female,454,33,487
CHAGAI DISTRICT,52,Transgender,0,0,0
CHAGAI DISTRICT,53,Male,491,40,531
CHAGAI DISTRICT,53,Female,329,28,357
CHAGAI DISTRICT,53,Transgender,0,0,0
CHAGAI DISTRICT,54,Male,500,39,539
CHAGAI DISTRICT,54,Female,280,38,318
CHAGAI DISTRICT,54,Transgender,0,0,0
CHAGAI DISTRICT,55,Male,309,26,335
CHAGAI DISTRICT,55,Female,247,17,264
CHAGAI DISTRICT,55,Transgender,1,0,1
CHAGAI DISTRICT,56,Male,262,18,280
CHAGAI DISTRICT,56,Female,188,18,206
CHAGAI DISTRICT,56,Transgender,0,0,0
CHAGAI DISTRICT,57,Male,460,33,493
CHAGAI DISTRICT,57,Female,391,47,438
CHAGAI DISTRICT,57,Transgender,0,0,0
CHAGAI DISTRICT,58,Male,298,33,331
CHAGAI DISTRICT,58,Female,208,18,226
CHAGAI DISTRICT,58,Transgender,0,0,0
CHAGAI DISTRICT,59,Male,415,39,454
CHAGAI DISTRICT,59,Female,346,34,380
CHAGAI DISTRICT,59,Transgender,0,0,0
CHAGAI DISTRICT,60,Male,258,17,275
CHAGAI DISTRICT,60,Female,235,8,243
CHAGAI DISTRICT,60,Transgender,0,0,0
CHAGAI DISTRICT,61,Male,300,45,345
CHAGAI DISTRICT,61,Female,313,44,357
CHAGAI DISTRICT,61,Transgender,0,0,0
CHAGAI DISTRICT,62,Male,281,28,309
CHAGAI DISTRICT,62,Female,275,41,316
CHAGAI DISTRICT,62,Transgender,0,0,0
CHAGAI DISTRICT,63,Male,240,24,264
CHAGAI DISTRICT,63,Female,214,25,239
CHAGAI DISTRICT,63,Transgender,0,0,0
CHAGAI DISTRICT,64,Male,409,27,436
CHAGAI DISTRICT,64,Female,281,24,305
CHAGAI DISTRICT,64,Transgender,0,0,0
CHAGAI DISTRICT,65,Male,207,14,221
CHAGAI DISTRICT,65,Female,157,14,171
CHAGAI DISTRICT,65,Transgender,0,0,0
CHAGAI DISTRICT,66,Male,193,14,207
CHAGAI DISTRICT,66,Female,140,17,157
CHAGAI DISTRICT,66,Transgender,0,0,0
CHAGAI DISTRICT,67,Male,276,32,308
CHAGAI DISTRICT,67,Female,245,28,273
CHAGAI DISTRICT,67,Transgender,0,0,0
CHAGAI DISTRICT,68,Male,166,23,189
CHAGAI DISTRICT,68,Female,144,15,159
CHAGAI DISTRICT,68,Transgender,0,0,0
CHAGAI DISTRICT,69,Male,255,17,272
CHAGAI DISTRICT,69,Female,215,21,236
CHAGAI DISTRICT,69,Transgender,0,0,0
CHAGAI DISTRICT,70,Male,120,7,127
CHAGAI DISTRICT,70,Female,134,6,140
CHAGAI DISTRICT,70,Transgender,0,0,0
CHAGAI DISTRICT,71,Male,150,13,163
CHAGAI DISTRICT,71,Female,140,7,147
CHAGAI DISTRICT,71,Transgender,0,0,0
CHAGAI DISTRICT,72,Male,149,14,163
CHAGAI DISTRICT,72,Female,157,17,174
CHAGAI DISTRICT,72,Transgender,0,0,0
CHAGAI DISTRICT,73,Male,99,10,109
CHAGAI DISTRICT,73,Female,107,8,115
CHAGAI DISTRICT,73,Transgender,0,0,0
CHAGAI DISTRICT,74,Male,167,10,177
CHAGAI DISTRICT,74,Female,100,8,108
CHAGAI DISTRICT,74,Transgender,0,0,0
CHAGAI DISTRICT,>=75,Male,1018,66,1084
CHAGAI DISTRICT,>=75,Female,779,64,843
CHAGAI DISTRICT,>=75,Transgender,1,0,1
CHAKWAL DISTRICT,<1,Male,12971,2880,15851
CHAKWAL DISTRICT,<1,Female,12381,2822,15203
CHAKWAL DISTRICT,<1,Transgender,0,0,0
CHAKWAL DISTRICT,1,Male,13890,3207,17097
CHAKWAL DISTRICT,1,Female,13352,2982,16334
CHAKWAL DISTRICT,1,Transgender,0,0,0
CHAKWAL DISTRICT,2,Male,13900,3211,17111
CHAKWAL DISTRICT,2,Female,12915,3184,16099
CHAKWAL DISTRICT,2,Transgender,0,0,0
CHAKWAL DISTRICT,3,Male,14555,3422,17977
CHAKWAL DISTRICT,3,Female,14089,3470,17559
CHAKWAL DISTRICT,3,Transgender,0,0,0
CHAKWAL DISTRICT,4,Male,13609,3170,16779
CHAKWAL DISTRICT,4,Female,12839,3014,15853
CHAKWAL DISTRICT,4,Transgender,0,0,0
CHAKWAL DISTRICT,5,Male,13410,3266,16676
CHAKWAL DISTRICT,5,Female,13400,3157,16557
CHAKWAL DISTRICT,5,Transgender,0,0,0
CHAKWAL DISTRICT,6,Male,13249,3305,16554
CHAKWAL DISTRICT,6,Female,12719,3134,15853
CHAKWAL DISTRICT,6,Transgender,0,0,0
CHAKWAL DISTRICT,7,Male,13993,3406,17399
CHAKWAL DISTRICT,7,Female,13264,3323,16587
CHAKWAL DISTRICT,7,Transgender,0,0,0
CHAKWAL DISTRICT,8,Male,12221,2978,15199
CHAKWAL DISTRICT,8,Female,11698,2785,14483
CHAKWAL DISTRICT,8,Transgender,0,0,0
CHAKWAL DISTRICT,9,Male,14503,3502,18005
CHAKWAL DISTRICT,9,Female,13562,3345,16907
CHAKWAL DISTRICT,9,Transgender,0,0,0
CHAKWAL DISTRICT,10,Male,11258,2696,13954
CHAKWAL DISTRICT,10,Female,10730,2524,13254
CHAKWAL DISTRICT,10,Transgender,0,0,0
CHAKWAL DISTRICT,11,Male,14378,3319,17697
CHAKWAL DISTRICT,11,Female,13327,3192,16519
CHAKWAL DISTRICT,11,Transgender,0,0,0
CHAKWAL DISTRICT,12,Male,11703,2859,14562
CHAKWAL DISTRICT,12,Female,11141,2556,13697
CHAKWAL DISTRICT,12,Transgender,0,0,0
CHAKWAL DISTRICT,13,Male,13520,3258,16778
CHAKWAL DISTRICT,13,Female,12222,2917,15139
CHAKWAL DISTRICT,13,Transgender,0,0,0
CHAKWAL DISTRICT,14,Male,11858,2913,14771
CHAKWAL DISTRICT,14,Female,10876,2581,13457
CHAKWAL DISTRICT,14,Transgender,0,0,0
CHAKWAL DISTRICT,15,Male,11926,3467,15393
CHAKWAL DISTRICT,15,Female,11586,2605,14191
CHAKWAL DISTRICT,15,Transgender,1,1,2
CHAKWAL DISTRICT,16,Male,12475,3414,15889
CHAKWAL DISTRICT,16,Female,11813,2778,14591
CHAKWAL DISTRICT,16,Transgender,1,2,3
CHAKWAL DISTRICT,17,Male,12963,3634,16597
CHAKWAL DISTRICT,17,Female,12899,3142,16041
CHAKWAL DISTRICT,17,Transgender,1,1,2
CHAKWAL DISTRICT,18,Male,9702,2497,12199
CHAKWAL DISTRICT,18,Female,9687,2293,11980
CHAKWAL DISTRICT,18,Transgender,3,0,3
CHAKWAL DISTRICT,19,Male,12062,2890,14952
CHAKWAL DISTRICT,19,Female,12530,2875,15405
CHAKWAL DISTRICT,19,Transgender,1,0,1
CHAKWAL DISTRICT,20,Male,9449,2398,11847
CHAKWAL DISTRICT,20,Female,9139,2077,11216
CHAKWAL DISTRICT,20,Transgender,2,2,4
CHAKWAL DISTRICT,21,Male,11204,2704,13908
CHAKWAL DISTRICT,21,Female,12897,2944,15841
CHAKWAL DISTRICT,21,Transgender,0,0,0
CHAKWAL DISTRICT,22,Male,9170,2362,11532
CHAKWAL DISTRICT,22,Female,10584,2418,13002
CHAKWAL DISTRICT,22,Transgender,3,1,4
CHAKWAL DISTRICT,23,Male,9946,2501,12447
CHAKWAL DISTRICT,23,Female,12313,2797,15110
CHAKWAL DISTRICT,23,Transgender,1,1,2
CHAKWAL DISTRICT,24,Male,9393,2477,11870
CHAKWAL DISTRICT,24,Female,11831,2752,14583
CHAKWAL DISTRICT,24,Transgender,1,1,2
CHAKWAL DISTRICT,25,Male,7650,2011,9661
CHAKWAL DISTRICT,25,Female,9376,2076,11452
CHAKWAL DISTRICT,25,Transgender,1,3,4
CHAKWAL DISTRICT,26,Male,8540,2203,10743
CHAKWAL DISTRICT,26,Female,11791,2839,14630
CHAKWAL DISTRICT,26,Transgender,2,1,3
CHAKWAL DISTRICT,27,Male,8151,2153,10304
CHAKWAL DISTRICT,27,Female,11726,2724,14450
CHAKWAL DISTRICT,27,Transgender,0,3,3
CHAKWAL DISTRICT,28,Male,7821,1988,9809
CHAKWAL DISTRICT,28,Female,10397,2543,12940
CHAKWAL DISTRICT,28,Transgender,0,0,0
CHAKWAL DISTRICT,29,Male,8023,2176,10199
CHAKWAL DISTRICT,29,Female,11581,2648,14229
CHAKWAL DISTRICT,29,Transgender,2,0,2
CHAKWAL DISTRICT,30,Male,7112,1953,9065
CHAKWAL DISTRICT,30,Female,9148,2073,11221
CHAKWAL DISTRICT,30,Transgender,4,2,6
CHAKWAL DISTRICT,31,Male,8059,2122,10181
CHAKWAL DISTRICT,31,Female,11524,2642,14166
CHAKWAL DISTRICT,31,Transgender,1,1,2
CHAKWAL DISTRICT,32,Male,7520,2002,9522
CHAKWAL DISTRICT,32,Female,10000,2501,12501
CHAKWAL DISTRICT,32,Transgender,2,2,4
CHAKWAL DISTRICT,33,Male,7629,1977,9606
CHAKWAL DISTRICT,33,Female,10217,2288,12505
CHAKWAL DISTRICT,33,Transgender,0,1,1
CHAKWAL DISTRICT,34,Male,7258,1965,9223
CHAKWAL DISTRICT,34,Female,9876,2226,12102
CHAKWAL DISTRICT,34,Transgender,1,3,4
CHAKWAL DISTRICT,35,Male,6060,1683,7743
CHAKWAL DISTRICT,35,Female,7557,1862,9419
CHAKWAL DISTRICT,35,Transgender,3,3,6
CHAKWAL DISTRICT,36,Male,6914,1824,8738
CHAKWAL DISTRICT,36,Female,9318,2158,11476
CHAKWAL DISTRICT,36,Transgender,1,1,2
CHAKWAL DISTRICT,37,Male,6423,1626,8049
CHAKWAL DISTRICT,37,Female,8133,1937,10070
CHAKWAL DISTRICT,37,Transgender,1,1,2
CHAKWAL DISTRICT,38,Male,7278,1949,9227
CHAKWAL DISTRICT,38,Female,9114,2183,11297
CHAKWAL DISTRICT,38,Transgender,2,3,5
CHAKWAL DISTRICT,39,Male,6627,1661,8288
CHAKWAL DISTRICT,39,Female,8463,1982,10445
CHAKWAL DISTRICT,39,Transgender,1,2,3
CHAKWAL DISTRICT,40,Male,5808,1613,7421
CHAKWAL DISTRICT,40,Female,6540,1594,8134
CHAKWAL DISTRICT,40,Transgender,2,0,2
CHAKWAL DISTRICT,41,Male,6006,1553,7559
CHAKWAL DISTRICT,41,Female,7478,1665,9143
CHAKWAL DISTRICT,41,Transgender,0,1,1
CHAKWAL DISTRICT,42,Male,5415,1540,6955
CHAKWAL DISTRICT,42,Female,6805,1509,8314
CHAKWAL DISTRICT,42,Transgender,1,0,1
CHAKWAL DISTRICT,43,Male,5498,1513,7011
CHAKWAL DISTRICT,43,Female,7014,1656,8670
CHAKWAL DISTRICT,43,Transgender,1,1,2
CHAKWAL DISTRICT,44,Male,5306,1320,6626
CHAKWAL DISTRICT,44,Female,6539,1461,8000
CHAKWAL DISTRICT,44,Transgender,0,0,0
CHAKWAL DISTRICT,45,Male,4569,1267,5836
CHAKWAL DISTRICT,45,Female,5357,1335,6692
CHAKWAL DISTRICT,45,Transgender,3,1,4
CHAKWAL DISTRICT,46,Male,5325,1295,6620
CHAKWAL DISTRICT,46,Female,6157,1340,7497
CHAKWAL DISTRICT,46,Transgender,0,0,0
CHAKWAL DISTRICT,47,Male,4902,1189,6091
CHAKWAL DISTRICT,47,Female,5371,1158,6529
CHAKWAL DISTRICT,47,Transgender,1,0,1
CHAKWAL DISTRICT,48,Male,5741,1382,7123
CHAKWAL DISTRICT,48,Female,6506,1456,7962
CHAKWAL DISTRICT,48,Transgender,2,2,4
CHAKWAL DISTRICT,49,Male,5430,1229,6659
CHAKWAL DISTRICT,49,Female,6298,1304,7602
CHAKWAL DISTRICT,49,Transgender,2,1,3
CHAKWAL DISTRICT,50,Male,4943,1304,6247
CHAKWAL DISTRICT,50,Female,5473,1254,6727
CHAKWAL DISTRICT,50,Transgender,2,0,2
CHAKWAL DISTRICT,51,Male,5372,1179,6551
CHAKWAL DISTRICT,51,Female,6239,1256,7495
CHAKWAL DISTRICT,51,Transgender,1,1,2
CHAKWAL DISTRICT,52,Male,5263,1250,6513
CHAKWAL DISTRICT,52,Female,5839,1240,7079
CHAKWAL DISTRICT,52,Transgender,1,0,1
CHAKWAL DISTRICT,53,Male,5547,1181,6728
CHAKWAL DISTRICT,53,Female,6197,1221,7418
CHAKWAL DISTRICT,53,Transgender,0,0,0
CHAKWAL DISTRICT,54,Male,5046,1064,6110
CHAKWAL DISTRICT,54,Female,5429,1141,6570
CHAKWAL DISTRICT,54,Transgender,0,0,0
CHAKWAL DISTRICT,55,Male,4381,1069,5450
CHAKWAL DISTRICT,55,Female,4303,951,5254
CHAKWAL DISTRICT,55,Transgender,0,0,0
CHAKWAL DISTRICT,56,Male,4530,1003,5533
CHAKWAL DISTRICT,56,Female,4454,878,5332
CHAKWAL DISTRICT,56,Transgender,0,2,2
CHAKWAL DISTRICT,57,Male,4209,921,5130
CHAKWAL DISTRICT,57,Female,3860,837,4697
CHAKWAL DISTRICT,57,Transgender,1,0,1
CHAKWAL DISTRICT,58,Male,4271,943,5214
CHAKWAL DISTRICT,58,Female,4442,910,5352
CHAKWAL DISTRICT,58,Transgender,1,1,2
CHAKWAL DISTRICT,59,Male,3914,847,4761
CHAKWAL DISTRICT,59,Female,4369,823,5192
CHAKWAL DISTRICT,59,Transgender,0,1,1
CHAKWAL DISTRICT,60,Male,3618,847,4465
CHAKWAL DISTRICT,60,Female,3556,773,4329
CHAKWAL DISTRICT,60,Transgender,2,1,3
CHAKWAL DISTRICT,61,Male,4128,931,5059
CHAKWAL DISTRICT,61,Female,4485,883,5368
CHAKWAL DISTRICT,61,Transgender,0,0,0
CHAKWAL DISTRICT,62,Male,4291,857,5148
CHAKWAL DISTRICT,62,Female,4289,750,5039
CHAKWAL DISTRICT,62,Transgender,1,0,1
CHAKWAL DISTRICT,63,Male,4217,871,5088
CHAKWAL DISTRICT,63,Female,4190,811,5001
CHAKWAL DISTRICT,63,Transgender,0,0,0
CHAKWAL DISTRICT,64,Male,3822,753,4575
CHAKWAL DISTRICT,64,Female,3868,671,4539
CHAKWAL DISTRICT,64,Transgender,1,0,1
CHAKWAL DISTRICT,65,Male,3147,667,3814
CHAKWAL DISTRICT,65,Female,2995,552,3547
CHAKWAL DISTRICT,65,Transgender,3,1,4
CHAKWAL DISTRICT,66,Male,3074,630,3704
CHAKWAL DISTRICT,66,Female,3215,498,3713
CHAKWAL DISTRICT,66,Transgender,1,0,1
CHAKWAL DISTRICT,67,Male,2922,592,3514
CHAKWAL DISTRICT,67,Female,2890,496,3386
CHAKWAL DISTRICT,67,Transgender,0,1,1
CHAKWAL DISTRICT,68,Male,3190,494,3684
CHAKWAL DISTRICT,68,Female,3224,570,3794
CHAKWAL DISTRICT,68,Transgender,0,0,0
CHAKWAL DISTRICT,69,Male,2801,495,3296
CHAKWAL DISTRICT,69,Female,2721,515,3236
CHAKWAL DISTRICT,69,Transgender,0,0,0
CHAKWAL DISTRICT,70,Male,2313,495,2808
CHAKWAL DISTRICT,70,Female,2346,403,2749
CHAKWAL DISTRICT,70,Transgender,1,0,1
CHAKWAL DISTRICT,71,Male,2478,448,2926
CHAKWAL DISTRICT,71,Female,2461,435,2896
CHAKWAL DISTRICT,71,Transgender,0,0,0
CHAKWAL DISTRICT,72,Male,2386,392,2778
CHAKWAL DISTRICT,72,Female,2441,361,2802
CHAKWAL DISTRICT,72,Transgender,2,1,3
CHAKWAL DISTRICT,73,Male,2291,375,2666
CHAKWAL DISTRICT,73,Female,2257,384,2641
CHAKWAL DISTRICT,73,Transgender,0,0,0
CHAKWAL DISTRICT,74,Male,1779,281,2060
CHAKWAL DISTRICT,74,Female,1805,288,2093
CHAKWAL DISTRICT,74,Transgender,0,0,0
CHAKWAL DISTRICT,>=75,Male,15577,2476,18053
CHAKWAL DISTRICT,>=75,Female,16476,2534,19010
CHAKWAL DISTRICT,>=75,Transgender,4,1,5
CHARSADDA DISTRICT,<1,Male,18453,3621,22074
CHARSADDA DISTRICT,<1,Female,17342,3378,20720
CHARSADDA DISTRICT,<1,Transgender,0,0,0
CHARSADDA DISTRICT,1,Male,19078,3529,22607
CHARSADDA DISTRICT,1,Female,17833,3434,21267
CHARSADDA DISTRICT,1,Transgender,0,0,0
CHARSADDA DISTRICT,2,Male,20911,3733,24644
CHARSADDA DISTRICT,2,Female,19764,3667,23431
CHARSADDA DISTRICT,2,Transgender,0,0,0
CHARSADDA DISTRICT,3,Male,21976,4117,26093
CHARSADDA DISTRICT,3,Female,21282,3843,25125
CHARSADDA DISTRICT,3,Transgender,0,0,0
CHARSADDA DISTRICT,4,Male,22841,4170,27011
CHARSADDA DISTRICT,4,Female,21635,3835,25470
CHARSADDA DISTRICT,4,Transgender,0,0,0
CHARSADDA DISTRICT,5,Male,21947,4108,26055
CHARSADDA DISTRICT,5,Female,20604,3887,24491
CHARSADDA DISTRICT,5,Transgender,0,0,0
CHARSADDA DISTRICT,6,Male,21764,4022,25786
CHARSADDA DISTRICT,6,Female,20284,3592,23876
CHARSADDA DISTRICT,6,Transgender,0,0,0
CHARSADDA DISTRICT,7,Male,22021,4045,26066
CHARSADDA DISTRICT,7,Female,20571,3800,24371
CHARSADDA DISTRICT,7,Transgender,0,0,0
CHARSADDA DISTRICT,8,Male,21889,3876,25765
CHARSADDA DISTRICT,8,Female,20218,3552,23770
CHARSADDA DISTRICT,8,Transgender,0,0,0
CHARSADDA DISTRICT,9,Male,20982,4059,25041
CHARSADDA DISTRICT,9,Female,19153,3708,22861
CHARSADDA DISTRICT,9,Transgender,0,0,0
CHARSADDA DISTRICT,10,Male,19572,3506,23078
CHARSADDA DISTRICT,10,Female,18271,3217,21488
CHARSADDA DISTRICT,10,Transgender,0,0,0
CHARSADDA DISTRICT,11,Male,18668,3582,22250
CHARSADDA DISTRICT,11,Female,16198,3197,19395
CHARSADDA DISTRICT,11,Transgender,0,0,0
CHARSADDA DISTRICT,12,Male,17437,3253,20690
CHARSADDA DISTRICT,12,Female,15960,3064,19024
CHARSADDA DISTRICT,12,Transgender,0,0,0
CHARSADDA DISTRICT,13,Male,17910,3554,21464
CHARSADDA DISTRICT,13,Female,16166,3090,19256
CHARSADDA DISTRICT,13,Transgender,0,0,0
CHARSADDA DISTRICT,14,Male,17066,3315,20381
CHARSADDA DISTRICT,14,Female,15774,2887,18661
CHARSADDA DISTRICT,14,Transgender,0,0,0
CHARSADDA DISTRICT,15,Male,16514,3006,19520
CHARSADDA DISTRICT,15,Female,15528,2836,18364
CHARSADDA DISTRICT,15,Transgender,0,0,0
CHARSADDA DISTRICT,16,Male,14638,2914,17552
CHARSADDA DISTRICT,16,Female,14231,2748,16979
CHARSADDA DISTRICT,16,Transgender,0,0,0
CHARSADDA DISTRICT,17,Male,13807,2832,16639
CHARSADDA DISTRICT,17,Female,14891,3006,17897
CHARSADDA DISTRICT,17,Transgender,1,0,1
CHARSADDA DISTRICT,18,Male,12537,2468,15005
CHARSADDA DISTRICT,18,Female,13649,2616,16265
CHARSADDA DISTRICT,18,Transgender,0,0,0
CHARSADDA DISTRICT,19,Male,12756,2841,15597
CHARSADDA DISTRICT,19,Female,12529,2595,15124
CHARSADDA DISTRICT,19,Transgender,0,0,0
CHARSADDA DISTRICT,20,Male,12280,2652,14932
CHARSADDA DISTRICT,20,Female,14597,2644,17241
CHARSADDA DISTRICT,20,Transgender,1,0,1
CHARSADDA DISTRICT,21,Male,11718,2748,14466
CHARSADDA DISTRICT,21,Female,12156,2534,14690
CHARSADDA DISTRICT,21,Transgender,0,0,0
CHARSADDA DISTRICT,22,Male,10978,2366,13344
CHARSADDA DISTRICT,22,Female,11977,2405,14382
CHARSADDA DISTRICT,22,Transgender,0,0,0
CHARSADDA DISTRICT,23,Male,10894,2429,13323
CHARSADDA DISTRICT,23,Female,11301,2378,13679
CHARSADDA DISTRICT,23,Transgender,0,0,0
CHARSADDA DISTRICT,24,Male,10028,2260,12288
CHARSADDA DISTRICT,24,Female,11643,2301,13944
CHARSADDA DISTRICT,24,Transgender,0,0,0
CHARSADDA DISTRICT,25,Male,10185,2107,12292
CHARSADDA DISTRICT,25,Female,12740,2345,15085
CHARSADDA DISTRICT,25,Transgender,0,0,0
CHARSADDA DISTRICT,26,Male,10271,2155,12426
CHARSADDA DISTRICT,26,Female,11442,2395,13837
CHARSADDA DISTRICT,26,Transgender,0,0,0
CHARSADDA DISTRICT,27,Male,9595,2136,11731
CHARSADDA DISTRICT,27,Female,11887,2426,14313
CHARSADDA DISTRICT,27,Transgender,0,0,0
CHARSADDA DISTRICT,28,Male,9462,2010,11472
CHARSADDA DISTRICT,28,Female,9587,2084,11671
CHARSADDA DISTRICT,28,Transgender,0,0,0
CHARSADDA DISTRICT,29,Male,9360,2101,11461
CHARSADDA DISTRICT,29,Female,10840,2289,13129
CHARSADDA DISTRICT,29,Transgender,0,0,0
CHARSADDA DISTRICT,30,Male,9199,1915,11114
CHARSADDA DISTRICT,30,Female,10033,2082,12115
CHARSADDA DISTRICT,30,Transgender,1,1,2
CHARSADDA DISTRICT,31,Male,9076,1981,11057
CHARSADDA DISTRICT,31,Female,9665,2039,11704
CHARSADDA DISTRICT,31,Transgender,0,1,1
CHARSADDA DISTRICT,32,Male,7936,1775,9711
CHARSADDA DISTRICT,32,Female,8465,1811,10276
CHARSADDA DISTRICT,32,Transgender,1,0,1
CHARSADDA DISTRICT,33,Male,8104,1837,9941
CHARSADDA DISTRICT,33,Female,7714,1805,9519
CHARSADDA DISTRICT,33,Transgender,0,1,1
CHARSADDA DISTRICT,34,Male,7297,1683,8980
CHARSADDA DISTRICT,34,Female,6949,1637,8586
CHARSADDA DISTRICT,34,Transgender,0,0,0
CHARSADDA DISTRICT,35,Male,6505,1465,7970
CHARSADDA DISTRICT,35,Female,6854,1473,8327
CHARSADDA DISTRICT,35,Transgender,0,0,0
CHARSADDA DISTRICT,36,Male,6464,1417,7881
CHARSADDA DISTRICT,36,Female,6572,1421,7993
CHARSADDA DISTRICT,36,Transgender,1,0,1
CHARSADDA DISTRICT,37,Male,6371,1365,7736
CHARSADDA DISTRICT,37,Female,7557,1489,9046
CHARSADDA DISTRICT,37,Transgender,0,0,0
CHARSADDA DISTRICT,38,Male,6320,1553,7873
CHARSADDA DISTRICT,38,Female,5787,1294,7081
CHARSADDA DISTRICT,38,Transgender,0,0,0
CHARSADDA DISTRICT,39,Male,6244,1457,7701
CHARSADDA DISTRICT,39,Female,6433,1331,7764
CHARSADDA DISTRICT,39,Transgender,0,0,0
CHARSADDA DISTRICT,40,Male,5898,1385,7283
CHARSADDA DISTRICT,40,Female,6438,1336,7774
CHARSADDA DISTRICT,40,Transgender,0,0,0
CHARSADDA DISTRICT,41,Male,5963,1326,7289
CHARSADDA DISTRICT,41,Female,6193,1297,7490
CHARSADDA DISTRICT,41,Transgender,0,0,0
CHARSADDA DISTRICT,42,Male,5163,1219,6382
CHARSADDA DISTRICT,42,Female,5981,1166,7147
CHARSADDA DISTRICT,42,Transgender,0,0,0
CHARSADDA DISTRICT,43,Male,5364,1299,6663
CHARSADDA DISTRICT,43,Female,4894,1166,6060
CHARSADDA DISTRICT,43,Transgender,0,0,0
CHARSADDA DISTRICT,44,Male,5207,1212,6419
CHARSADDA DISTRICT,44,Female,4485,1027,5512
CHARSADDA DISTRICT,44,Transgender,1,0,1
CHARSADDA DISTRICT,45,Male,4239,1003,5242
CHARSADDA DISTRICT,45,Female,4349,891,5240
CHARSADDA DISTRICT,45,Transgender,0,0,0
CHARSADDA DISTRICT,46,Male,4774,1113,5887
CHARSADDA DISTRICT,46,Female,4618,1086,5704
CHARSADDA DISTRICT,46,Transgender,0,0,0
CHARSADDA DISTRICT,47,Male,4479,1054,5533
CHARSADDA DISTRICT,47,Female,5395,1039,6434
CHARSADDA DISTRICT,47,Transgender,0,0,0
CHARSADDA DISTRICT,48,Male,4393,1075,5468
CHARSADDA DISTRICT,48,Female,3586,866,4452
CHARSADDA DISTRICT,48,Transgender,0,0,0
CHARSADDA DISTRICT,49,Male,4587,1090,5677
CHARSADDA DISTRICT,49,Female,3982,909,4891
CHARSADDA DISTRICT,49,Transgender,0,0,0
CHARSADDA DISTRICT,50,Male,4118,921,5039
CHARSADDA DISTRICT,50,Female,4304,908,5212
CHARSADDA DISTRICT,50,Transgender,1,0,1
CHARSADDA DISTRICT,51,Male,4443,974,5417
CHARSADDA DISTRICT,51,Female,3959,956,4915
CHARSADDA DISTRICT,51,Transgender,0,0,0
CHARSADDA DISTRICT,52,Male,3826,918,4744
CHARSADDA DISTRICT,52,Female,3972,805,4777
CHARSADDA DISTRICT,52,Transgender,0,0,0
CHARSADDA DISTRICT,53,Male,3977,869,4846
CHARSADDA DISTRICT,53,Female,3183,755,3938
CHARSADDA DISTRICT,53,Transgender,0,0,0
CHARSADDA DISTRICT,54,Male,3551,807,4358
CHARSADDA DISTRICT,54,Female,2745,650,3395
CHARSADDA DISTRICT,54,Transgender,0,0,0
CHARSADDA DISTRICT,55,Male,3077,690,3767
CHARSADDA DISTRICT,55,Female,2705,581,3286
CHARSADDA DISTRICT,55,Transgender,0,0,0
CHARSADDA DISTRICT,56,Male,3136,737,3873
CHARSADDA DISTRICT,56,Female,2805,685,3490
CHARSADDA DISTRICT,56,Transgender,0,0,0
CHARSADDA DISTRICT,57,Male,3368,669,4037
CHARSADDA DISTRICT,57,Female,3348,635,3983
CHARSADDA DISTRICT,57,Transgender,0,0,0
CHARSADDA DISTRICT,58,Male,3401,802,4203
CHARSADDA DISTRICT,58,Female,2553,585,3138
CHARSADDA DISTRICT,58,Transgender,0,0,0
CHARSADDA DISTRICT,59,Male,3677,822,4499
CHARSADDA DISTRICT,59,Female,2880,597,3477
CHARSADDA DISTRICT,59,Transgender,0,1,1
CHARSADDA DISTRICT,60,Male,3022,689,3711
CHARSADDA DISTRICT,60,Female,2819,593,3412
CHARSADDA DISTRICT,60,Transgender,0,0,0
CHARSADDA DISTRICT,61,Male,3245,805,4050
CHARSADDA DISTRICT,61,Female,2564,589,3153
CHARSADDA DISTRICT,61,Transgender,0,0,0
CHARSADDA DISTRICT,62,Male,2754,674,3428
CHARSADDA DISTRICT,62,Female,2312,499,2811
CHARSADDA DISTRICT,62,Transgender,0,0,0
CHARSADDA DISTRICT,63,Male,2992,750,3742
CHARSADDA DISTRICT,63,Female,2379,557,2936
CHARSADDA DISTRICT,63,Transgender,0,0,0
CHARSADDA DISTRICT,64,Male,3188,630,3818
CHARSADDA DISTRICT,64,Female,2525,498,3023
CHARSADDA DISTRICT,64,Transgender,0,0,0
CHARSADDA DISTRICT,65,Male,2201,508,2709
CHARSADDA DISTRICT,65,Female,1711,384,2095
CHARSADDA DISTRICT,65,Transgender,0,0,0
CHARSADDA DISTRICT,66,Male,2111,513,2624
CHARSADDA DISTRICT,66,Female,1564,398,1962
CHARSADDA DISTRICT,66,Transgender,0,0,0
CHARSADDA DISTRICT,67,Male,2011,468,2479
CHARSADDA DISTRICT,67,Female,1705,306,2011
CHARSADDA DISTRICT,67,Transgender,0,0,0
CHARSADDA DISTRICT,68,Male,2012,435,2447
CHARSADDA DISTRICT,68,Female,1429,336,1765
CHARSADDA DISTRICT,68,Transgender,0,0,0
CHARSADDA DISTRICT,69,Male,2429,408,2837
CHARSADDA DISTRICT,69,Female,1724,356,2080
CHARSADDA DISTRICT,69,Transgender,0,0,0
CHARSADDA DISTRICT,70,Male,1541,360,1901
CHARSADDA DISTRICT,70,Female,1340,278,1618
CHARSADDA DISTRICT,70,Transgender,0,0,0
CHARSADDA DISTRICT,71,Male,1514,337,1851
CHARSADDA DISTRICT,71,Female,1114,268,1382
CHARSADDA DISTRICT,71,Transgender,0,0,0
CHARSADDA DISTRICT,72,Male,1270,292,1562
CHARSADDA DISTRICT,72,Female,989,202,1191
CHARSADDA DISTRICT,72,Transgender,0,0,0
CHARSADDA DISTRICT,73,Male,1304,302,1606
CHARSADDA DISTRICT,73,Female,1064,209,1273
CHARSADDA DISTRICT,73,Transgender,0,0,0
CHARSADDA DISTRICT,74,Male,1282,229,1511
CHARSADDA DISTRICT,74,Female,992,186,1178
CHARSADDA DISTRICT,74,Transgender,0,0,0
CHARSADDA DISTRICT,>=75,Male,8142,1590,9732
CHARSADDA DISTRICT,>=75,Female,7348,1528,8876
CHARSADDA DISTRICT,>=75,Transgender,0,0,0
CHINIOT DISTRICT,<1,Male,13051,5170,18221
CHINIOT DISTRICT,<1,Female,12340,4983,17323
CHINIOT DISTRICT,<1,Transgender,0,0,0
CHINIOT DISTRICT,1,Male,12713,5472,18185
CHINIOT DISTRICT,1,Female,11953,5246,17199
CHINIOT DISTRICT,1,Transgender,0,0,0
CHINIOT DISTRICT,2,Male,13271,5262,18533
CHINIOT DISTRICT,2,Female,12656,5074,17730
CHINIOT DISTRICT,2,Transgender,0,0,0
CHINIOT DISTRICT,3,Male,15038,5849,20887
CHINIOT DISTRICT,3,Female,13966,5463,19429
CHINIOT DISTRICT,3,Transgender,0,0,0
CHINIOT DISTRICT,4,Male,15314,5552,20866
CHINIOT DISTRICT,4,Female,14575,5304,19879
CHINIOT DISTRICT,4,Transgender,0,0,0
CHINIOT DISTRICT,5,Male,14609,5766,20375
CHINIOT DISTRICT,5,Female,13345,5410,18755
CHINIOT DISTRICT,5,Transgender,0,0,0
CHINIOT DISTRICT,6,Male,14394,5594,19988
CHINIOT DISTRICT,6,Female,13037,5176,18213
CHINIOT DISTRICT,6,Transgender,0,0,0
CHINIOT DISTRICT,7,Male,14678,6059,20737
CHINIOT DISTRICT,7,Female,13334,5649,18983
CHINIOT DISTRICT,7,Transgender,0,0,0
CHINIOT DISTRICT,8,Male,14616,5453,20069
CHINIOT DISTRICT,8,Female,13461,5088,18549
CHINIOT DISTRICT,8,Transgender,0,0,0
CHINIOT DISTRICT,9,Male,13639,5891,19530
CHINIOT DISTRICT,9,Female,12217,5414,17631
CHINIOT DISTRICT,9,Transgender,0,0,0
CHINIOT DISTRICT,10,Male,12689,4949,17638
CHINIOT DISTRICT,10,Female,11879,4501,16380
CHINIOT DISTRICT,10,Transgender,0,0,0
CHINIOT DISTRICT,11,Male,11272,5488,16760
CHINIOT DISTRICT,11,Female,9898,5122,15020
CHINIOT DISTRICT,11,Transgender,0,0,0
CHINIOT DISTRICT,12,Male,10854,4794,15648
CHINIOT DISTRICT,12,Female,9679,4241,13920
CHINIOT DISTRICT,12,Transgender,0,0,0
CHINIOT DISTRICT,13,Male,10490,5082,15572
CHINIOT DISTRICT,13,Female,8487,4463,12950
CHINIOT DISTRICT,13,Transgender,0,0,0
CHINIOT DISTRICT,14,Male,10133,4687,14820
CHINIOT DISTRICT,14,Female,8393,4013,12406
CHINIOT DISTRICT,14,Transgender,0,0,0
CHINIOT DISTRICT,15,Male,9727,4676,14403
CHINIOT DISTRICT,15,Female,8265,4072,12337
CHINIOT DISTRICT,15,Transgender,3,2,5
CHINIOT DISTRICT,16,Male,9394,4515,13909
CHINIOT DISTRICT,16,Female,8664,4199,12863
CHINIOT DISTRICT,16,Transgender,4,1,5
CHINIOT DISTRICT,17,Male,10110,4557,14667
CHINIOT DISTRICT,17,Female,9455,4225,13680
CHINIOT DISTRICT,17,Transgender,0,1,1
CHINIOT DISTRICT,18,Male,8023,4161,12184
CHINIOT DISTRICT,18,Female,8558,3825,12383
CHINIOT DISTRICT,18,Transgender,1,2,3
CHINIOT DISTRICT,19,Male,8175,4356,12531
CHINIOT DISTRICT,19,Female,7988,4253,12241
CHINIOT DISTRICT,19,Transgender,1,1,2
CHINIOT DISTRICT,20,Male,7937,3796,11733
CHINIOT DISTRICT,20,Female,8897,3629,12526
CHINIOT DISTRICT,20,Transgender,2,3,5
CHINIOT DISTRICT,21,Male,7375,4118,11493
CHINIOT DISTRICT,21,Female,7462,4163,11625
CHINIOT DISTRICT,21,Transgender,1,1,2
CHINIOT DISTRICT,22,Male,7339,3705,11044
CHINIOT DISTRICT,22,Female,7779,3774,11553
CHINIOT DISTRICT,22,Transgender,3,3,6
CHINIOT DISTRICT,23,Male,7157,3769,10926
CHINIOT DISTRICT,23,Female,7147,3908,11055
CHINIOT DISTRICT,23,Transgender,4,1,5
CHINIOT DISTRICT,24,Male,7296,3679,10975
CHINIOT DISTRICT,24,Female,7172,3746,10918
CHINIOT DISTRICT,24,Transgender,2,0,2
CHINIOT DISTRICT,25,Male,7174,3354,10528
CHINIOT DISTRICT,25,Female,8543,3505,12048
CHINIOT DISTRICT,25,Transgender,4,4,8
CHINIOT DISTRICT,26,Male,6638,3752,10390
CHINIOT DISTRICT,26,Female,7187,3713,10900
CHINIOT DISTRICT,26,Transgender,3,0,3
CHINIOT DISTRICT,27,Male,6962,3660,10622
CHINIOT DISTRICT,27,Female,7015,3680,10695
CHINIOT DISTRICT,27,Transgender,2,2,4
CHINIOT DISTRICT,28,Male,6689,3354,10043
CHINIOT DISTRICT,28,Female,6719,3405,10124
CHINIOT DISTRICT,28,Transgender,0,1,1
CHINIOT DISTRICT,29,Male,6773,3646,10419
CHINIOT DISTRICT,29,Female,7153,3652,10805
CHINIOT DISTRICT,29,Transgender,0,1,1
CHINIOT DISTRICT,30,Male,6040,3012,9052
CHINIOT DISTRICT,30,Female,7156,3029,10185
CHINIOT DISTRICT,30,Transgender,7,4,11
CHINIOT DISTRICT,31,Male,6093,3318,9411
CHINIOT DISTRICT,31,Female,6353,3367,9720
CHINIOT DISTRICT,31,Transgender,0,0,0
CHINIOT DISTRICT,32,Male,5824,2917,8741
CHINIOT DISTRICT,32,Female,6305,3106,9411
CHINIOT DISTRICT,32,Transgender,3,3,6
CHINIOT DISTRICT,33,Male,5338,3032,8370
CHINIOT DISTRICT,33,Female,5420,2933,8353
CHINIOT DISTRICT,33,Transgender,0,1,1
CHINIOT DISTRICT,34,Male,5557,2948,8505
CHINIOT DISTRICT,34,Female,5337,2860,8197
CHINIOT DISTRICT,34,Transgender,0,1,1
CHINIOT DISTRICT,35,Male,5547,2275,7822
CHINIOT DISTRICT,35,Female,5923,2327,8250
CHINIOT DISTRICT,35,Transgender,1,5,6
CHINIOT DISTRICT,36,Male,5731,2754,8485
CHINIOT DISTRICT,36,Female,5607,2660,8267
CHINIOT DISTRICT,36,Transgender,0,1,1
CHINIOT DISTRICT,37,Male,6006,2784,8790
CHINIOT DISTRICT,37,Female,6099,2782,8881
CHINIOT DISTRICT,37,Transgender,0,1,1
CHINIOT DISTRICT,38,Male,4872,2513,7385
CHINIOT DISTRICT,38,Female,4832,2372,7204
CHINIOT DISTRICT,38,Transgender,0,0,0
CHINIOT DISTRICT,39,Male,5353,2546,7899
CHINIOT DISTRICT,39,Female,5639,2591,8230
CHINIOT DISTRICT,39,Transgender,1,2,3
CHINIOT DISTRICT,40,Male,4282,2041,6323
CHINIOT DISTRICT,40,Female,4979,1934,6913
CHINIOT DISTRICT,40,Transgender,1,1,2
CHINIOT DISTRICT,41,Male,4551,2301,6852
CHINIOT DISTRICT,41,Female,4863,2254,7117
CHINIOT DISTRICT,41,Transgender,0,0,0
CHINIOT DISTRICT,42,Male,4693,2102,6795
CHINIOT DISTRICT,42,Female,4896,2033,6929
CHINIOT DISTRICT,42,Transgender,2,0,2
CHINIOT DISTRICT,43,Male,3858,2076,5934
CHINIOT DISTRICT,43,Female,3797,1907,5704
CHINIOT DISTRICT,43,Transgender,1,1,2
CHINIOT DISTRICT,44,Male,3880,2012,5892
CHINIOT DISTRICT,44,Female,3548,1831,5379
CHINIOT DISTRICT,44,Transgender,0,0,0
CHINIOT DISTRICT,45,Male,3562,1610,5172
CHINIOT DISTRICT,45,Female,3629,1417,5046
CHINIOT DISTRICT,45,Transgender,0,1,1
CHINIOT DISTRICT,46,Male,4091,1850,5941
CHINIOT DISTRICT,46,Female,3816,1928,5744
CHINIOT DISTRICT,46,Transgender,0,0,0
CHINIOT DISTRICT,47,Male,4474,1914,6388
CHINIOT DISTRICT,47,Female,4627,1964,6591
CHINIOT DISTRICT,47,Transgender,0,0,0
CHINIOT DISTRICT,48,Male,4067,1874,5941
CHINIOT DISTRICT,48,Female,3514,1629,5143
CHINIOT DISTRICT,48,Transgender,0,0,0
CHINIOT DISTRICT,49,Male,4335,1889,6224
CHINIOT DISTRICT,49,Female,3813,1763,5576
CHINIOT DISTRICT,49,Transgender,1,0,1
CHINIOT DISTRICT,50,Male,3782,1560,5342
CHINIOT DISTRICT,50,Female,3470,1355,4825
CHINIOT DISTRICT,50,Transgender,3,2,5
CHINIOT DISTRICT,51,Male,4248,1919,6167
CHINIOT DISTRICT,51,Female,3945,1941,5886
CHINIOT DISTRICT,51,Transgender,1,0,1
CHINIOT DISTRICT,52,Male,4151,1769,5920
CHINIOT DISTRICT,52,Female,4202,1792,5994
CHINIOT DISTRICT,52,Transgender,0,1,1
CHINIOT DISTRICT,53,Male,3661,1640,5301
CHINIOT DISTRICT,53,Female,3115,1431,4546
CHINIOT DISTRICT,53,Transgender,0,3,3
CHINIOT DISTRICT,54,Male,3363,1525,4888
CHINIOT DISTRICT,54,Female,2742,1328,4070
CHINIOT DISTRICT,54,Transgender,3,1,4
CHINIOT DISTRICT,55,Male,2947,1178,4125
CHINIOT DISTRICT,55,Female,2400,977,3377
CHINIOT DISTRICT,55,Transgender,1,2,3
CHINIOT DISTRICT,56,Male,2998,1357,4355
CHINIOT DISTRICT,56,Female,2888,1237,4125
CHINIOT DISTRICT,56,Transgender,0,0,0
CHINIOT DISTRICT,57,Male,3147,1251,4398
CHINIOT DISTRICT,57,Female,3323,1237,4560
CHINIOT DISTRICT,57,Transgender,0,0,0
CHINIOT DISTRICT,58,Male,2372,1037,3409
CHINIOT DISTRICT,58,Female,2075,968,3043
CHINIOT DISTRICT,58,Transgender,2,2,4
CHINIOT DISTRICT,59,Male,2549,1107,3656
CHINIOT DISTRICT,59,Female,2340,1077,3417
CHINIOT DISTRICT,59,Transgender,0,0,0
CHINIOT DISTRICT,60,Male,2252,928,3180
CHINIOT DISTRICT,60,Female,2282,798,3080
CHINIOT DISTRICT,60,Transgender,2,0,2
CHINIOT DISTRICT,61,Male,2630,1137,3767
CHINIOT DISTRICT,61,Female,2392,1122,3514
CHINIOT DISTRICT,61,Transgender,0,0,0
CHINIOT DISTRICT,62,Male,2648,1111,3759
CHINIOT DISTRICT,62,Female,2607,1075,3682
CHINIOT DISTRICT,62,Transgender,1,0,1
CHINIOT DISTRICT,63,Male,2273,1043,3316
CHINIOT DISTRICT,63,Female,2088,914,3002
CHINIOT DISTRICT,63,Transgender,1,1,2
CHINIOT DISTRICT,64,Male,2343,891,3234
CHINIOT DISTRICT,64,Female,1927,821,2748
CHINIOT DISTRICT,64,Transgender,1,0,1
CHINIOT DISTRICT,65,Male,1987,679,2666
CHINIOT DISTRICT,65,Female,1849,640,2489
CHINIOT DISTRICT,65,Transgender,3,0,3
CHINIOT DISTRICT,66,Male,2190,752,2942
CHINIOT DISTRICT,66,Female,1939,770,2709
CHINIOT DISTRICT,66,Transgender,1,0,1
CHINIOT DISTRICT,67,Male,2346,755,3101
CHINIOT DISTRICT,67,Female,2131,732,2863
CHINIOT DISTRICT,67,Transgender,0,0,0
CHINIOT DISTRICT,68,Male,1711,648,2359
CHINIOT DISTRICT,68,Female,1475,550,2025
CHINIOT DISTRICT,68,Transgender,0,0,0
CHINIOT DISTRICT,69,Male,1904,624,2528
CHINIOT DISTRICT,69,Female,1509,544,2053
CHINIOT DISTRICT,69,Transgender,0,0,0
CHINIOT DISTRICT,70,Male,1642,482,2124
CHINIOT DISTRICT,70,Female,1517,454,1971
CHINIOT DISTRICT,70,Transgender,3,1,4
CHINIOT DISTRICT,71,Male,1684,564,2248
CHINIOT DISTRICT,71,Female,1363,538,1901
CHINIOT DISTRICT,71,Transgender,0,0,0
CHINIOT DISTRICT,72,Male,1540,529,2069
CHINIOT DISTRICT,72,Female,1418,496,1914
CHINIOT DISTRICT,72,Transgender,1,0,1
CHINIOT DISTRICT,73,Male,1251,444,1695
CHINIOT DISTRICT,73,Female,1066,407,1473
CHINIOT DISTRICT,73,Transgender,0,0,0
CHINIOT DISTRICT,74,Male,1203,394,1597
CHINIOT DISTRICT,74,Female,953,326,1279
CHINIOT DISTRICT,74,Transgender,1,0,1
CHINIOT DISTRICT,>=75,Male,8945,2897,11842
CHINIOT DISTRICT,>=75,Female,8506,2902,11408
CHINIOT DISTRICT,>=75,Transgender,8,3,11
CHITRAL DISTRICT,<1,Male,5770,656,6426
CHITRAL DISTRICT,<1,Female,5481,575,6056
CHITRAL DISTRICT,<1,Transgender,0,0,0
CHITRAL DISTRICT,1,Male,5624,555,6179
CHITRAL DISTRICT,1,Female,5397,592,5989
CHITRAL DISTRICT,1,Transgender,0,0,0
CHITRAL DISTRICT,2,Male,5435,622,6057
CHITRAL DISTRICT,2,Female,5205,591,5796
CHITRAL DISTRICT,2,Transgender,0,0,0
CHITRAL DISTRICT,3,Male,5442,646,6088
CHITRAL DISTRICT,3,Female,5193,600,5793
CHITRAL DISTRICT,3,Transgender,0,0,0
CHITRAL DISTRICT,4,Male,5622,592,6214
CHITRAL DISTRICT,4,Female,5233,593,5826
CHITRAL DISTRICT,4,Transgender,0,0,0
CHITRAL DISTRICT,5,Male,5358,612,5970
CHITRAL DISTRICT,5,Female,5122,577,5699
CHITRAL DISTRICT,5,Transgender,0,0,0
CHITRAL DISTRICT,6,Male,4862,523,5385
CHITRAL DISTRICT,6,Female,4813,522,5335
CHITRAL DISTRICT,6,Transgender,0,0,0
CHITRAL DISTRICT,7,Male,5250,589,5839
CHITRAL DISTRICT,7,Female,4933,531,5464
CHITRAL DISTRICT,7,Transgender,0,0,0
CHITRAL DISTRICT,8,Male,4855,521,5376
CHITRAL DISTRICT,8,Female,4647,439,5086
CHITRAL DISTRICT,8,Transgender,0,0,0
CHITRAL DISTRICT,9,Male,5524,594,6118
CHITRAL DISTRICT,9,Female,5159,560,5719
CHITRAL DISTRICT,9,Transgender,0,0,0
CHITRAL DISTRICT,10,Male,4262,546,4808
CHITRAL DISTRICT,10,Female,4342,512,4854
CHITRAL DISTRICT,10,Transgender,0,0,0
CHITRAL DISTRICT,11,Male,5380,538,5918
CHITRAL DISTRICT,11,Female,4934,542,5476
CHITRAL DISTRICT,11,Transgender,0,0,0
CHITRAL DISTRICT,12,Male,4408,594,5002
CHITRAL DISTRICT,12,Female,4261,481,4742
CHITRAL DISTRICT,12,Transgender,0,0,0
CHITRAL DISTRICT,13,Male,5154,639,5793
CHITRAL DISTRICT,13,Female,4618,572,5190
CHITRAL DISTRICT,13,Transgender,0,0,0
CHITRAL DISTRICT,14,Male,4884,614,5498
CHITRAL DISTRICT,14,Female,4340,480,4820
CHITRAL DISTRICT,14,Transgender,0,0,0
CHITRAL DISTRICT,15,Male,5068,638,5706
CHITRAL DISTRICT,15,Female,4574,555,5129
CHITRAL DISTRICT,15,Transgender,0,0,0
CHITRAL DISTRICT,16,Male,4505,572,5077
CHITRAL DISTRICT,16,Female,4353,582,4935
CHITRAL DISTRICT,16,Transgender,2,0,2
CHITRAL DISTRICT,17,Male,4384,783,5167
CHITRAL DISTRICT,17,Female,4833,659,5492
CHITRAL DISTRICT,17,Transgender,0,0,0
CHITRAL DISTRICT,18,Male,4440,711,5151
CHITRAL DISTRICT,18,Female,4476,506,4982
CHITRAL DISTRICT,18,Transgender,1,0,1
CHITRAL DISTRICT,19,Male,4746,690,5436
CHITRAL DISTRICT,19,Female,4800,615,5415
CHITRAL DISTRICT,19,Transgender,1,0,1
CHITRAL DISTRICT,20,Male,3805,534,4339
CHITRAL DISTRICT,20,Female,3803,487,4290
CHITRAL DISTRICT,20,Transgender,0,0,0
CHITRAL DISTRICT,21,Male,4071,562,4633
CHITRAL DISTRICT,21,Female,4324,519,4843
CHITRAL DISTRICT,21,Transgender,0,0,0
CHITRAL DISTRICT,22,Male,3173,459,3632
CHITRAL DISTRICT,22,Female,3612,416,4028
CHITRAL DISTRICT,22,Transgender,0,0,0
CHITRAL DISTRICT,23,Male,3709,544,4253
CHITRAL DISTRICT,23,Female,3838,452,4290
CHITRAL DISTRICT,23,Transgender,1,0,1
CHITRAL DISTRICT,24,Male,3278,475,3753
CHITRAL DISTRICT,24,Female,3554,451,4005
CHITRAL DISTRICT,24,Transgender,0,0,0
CHITRAL DISTRICT,25,Male,3090,460,3550
CHITRAL DISTRICT,25,Female,3406,512,3918
CHITRAL DISTRICT,25,Transgender,0,1,1
CHITRAL DISTRICT,26,Male,3101,431,3532
CHITRAL DISTRICT,26,Female,3325,423,3748
CHITRAL DISTRICT,26,Transgender,0,0,0
CHITRAL DISTRICT,27,Male,3074,460,3534
CHITRAL DISTRICT,27,Female,3670,460,4130
CHITRAL DISTRICT,27,Transgender,0,0,0
CHITRAL DISTRICT,28,Male,2696,434,3130
CHITRAL DISTRICT,28,Female,2750,360,3110
CHITRAL DISTRICT,28,Transgender,0,0,0
CHITRAL DISTRICT,29,Male,2811,418,3229
CHITRAL DISTRICT,29,Female,3574,411,3985
CHITRAL DISTRICT,29,Transgender,0,0,0
CHITRAL DISTRICT,30,Male,2296,383,2679
CHITRAL DISTRICT,30,Female,2422,397,2819
CHITRAL DISTRICT,30,Transgender,0,0,0
CHITRAL DISTRICT,31,Male,2412,376,2788
CHITRAL DISTRICT,31,Female,3137,357,3494
CHITRAL DISTRICT,31,Transgender,0,0,0
CHITRAL DISTRICT,32,Male,2096,410,2506
CHITRAL DISTRICT,32,Female,2388,307,2695
CHITRAL DISTRICT,32,Transgender,0,1,1
CHITRAL DISTRICT,33,Male,2248,321,2569
CHITRAL DISTRICT,33,Female,2454,327,2781
CHITRAL DISTRICT,33,Transgender,0,0,0
CHITRAL DISTRICT,34,Male,2104,307,2411
CHITRAL DISTRICT,34,Female,2249,295,2544
CHITRAL DISTRICT,34,Transgender,0,0,0
CHITRAL DISTRICT,35,Male,1854,338,2192
CHITRAL DISTRICT,35,Female,1956,308,2264
CHITRAL DISTRICT,35,Transgender,1,0,1
CHITRAL DISTRICT,36,Male,1910,314,2224
CHITRAL DISTRICT,36,Female,2015,253,2268
CHITRAL DISTRICT,36,Transgender,0,0,0
CHITRAL DISTRICT,37,Male,1781,290,2071
CHITRAL DISTRICT,37,Female,2658,290,2948
CHITRAL DISTRICT,37,Transgender,0,0,0
CHITRAL DISTRICT,38,Male,1656,307,1963
CHITRAL DISTRICT,38,Female,1816,248,2064
CHITRAL DISTRICT,38,Transgender,0,0,0
CHITRAL DISTRICT,39,Male,1823,299,2122
CHITRAL DISTRICT,39,Female,2083,256,2339
CHITRAL DISTRICT,39,Transgender,0,0,0
CHITRAL DISTRICT,40,Male,1493,310,1803
CHITRAL DISTRICT,40,Female,1623,260,1883
CHITRAL DISTRICT,40,Transgender,4,0,4
CHITRAL DISTRICT,41,Male,1644,280,1924
CHITRAL DISTRICT,41,Female,1954,209,2163
CHITRAL DISTRICT,41,Transgender,0,0,0
CHITRAL DISTRICT,42,Male,1570,212,1782
CHITRAL DISTRICT,42,Female,1890,197,2087
CHITRAL DISTRICT,42,Transgender,0,0,0
CHITRAL DISTRICT,43,Male,1663,259,1922
CHITRAL DISTRICT,43,Female,1754,232,1986
CHITRAL DISTRICT,43,Transgender,0,0,0
CHITRAL DISTRICT,44,Male,1478,224,1702
CHITRAL DISTRICT,44,Female,1585,174,1759
CHITRAL DISTRICT,44,Transgender,0,0,0
CHITRAL DISTRICT,45,Male,1229,244,1473
CHITRAL DISTRICT,45,Female,1389,211,1600
CHITRAL DISTRICT,45,Transgender,0,0,0
CHITRAL DISTRICT,46,Male,1707,204,1911
CHITRAL DISTRICT,46,Female,1634,186,1820
CHITRAL DISTRICT,46,Transgender,0,1,1
CHITRAL DISTRICT,47,Male,1701,183,1884
CHITRAL DISTRICT,47,Female,1981,175,2156
CHITRAL DISTRICT,47,Transgender,1,1,2
CHITRAL DISTRICT,48,Male,1676,209,1885
CHITRAL DISTRICT,48,Female,1617,168,1785
CHITRAL DISTRICT,48,Transgender,0,0,0
CHITRAL DISTRICT,49,Male,1579,204,1783
CHITRAL DISTRICT,49,Female,1678,211,1889
CHITRAL DISTRICT,49,Transgender,1,0,1
CHITRAL DISTRICT,50,Male,1367,261,1628
CHITRAL DISTRICT,50,Female,1278,219,1497
CHITRAL DISTRICT,50,Transgender,0,0,0
CHITRAL DISTRICT,51,Male,1655,219,1874
CHITRAL DISTRICT,51,Female,1558,157,1715
CHITRAL DISTRICT,51,Transgender,0,0,0
CHITRAL DISTRICT,52,Male,1298,182,1480
CHITRAL DISTRICT,52,Female,1105,129,1234
CHITRAL DISTRICT,52,Transgender,0,0,0
CHITRAL DISTRICT,53,Male,1672,196,1868
CHITRAL DISTRICT,53,Female,1191,146,1337
CHITRAL DISTRICT,53,Transgender,0,0,0
CHITRAL DISTRICT,54,Male,1275,176,1451
CHITRAL DISTRICT,54,Female,944,124,1068
CHITRAL DISTRICT,54,Transgender,0,0,0
CHITRAL DISTRICT,55,Male,1090,170,1260
CHITRAL DISTRICT,55,Female,871,144,1015
CHITRAL DISTRICT,55,Transgender,0,0,0
CHITRAL DISTRICT,56,Male,1161,158,1319
CHITRAL DISTRICT,56,Female,872,93,965
CHITRAL DISTRICT,56,Transgender,0,0,0
CHITRAL DISTRICT,57,Male,989,146,1135
CHITRAL DISTRICT,57,Female,998,104,1102
CHITRAL DISTRICT,57,Transgender,0,0,0
CHITRAL DISTRICT,58,Male,1003,135,1138
CHITRAL DISTRICT,58,Female,984,97,1081
CHITRAL DISTRICT,58,Transgender,0,0,0
CHITRAL DISTRICT,59,Male,1075,155,1230
CHITRAL DISTRICT,59,Female,1269,126,1395
CHITRAL DISTRICT,59,Transgender,0,0,0
CHITRAL DISTRICT,60,Male,942,134,1076
CHITRAL DISTRICT,60,Female,979,138,1117
CHITRAL DISTRICT,60,Transgender,1,0,1
CHITRAL DISTRICT,61,Male,1369,166,1535
CHITRAL DISTRICT,61,Female,1485,135,1620
CHITRAL DISTRICT,61,Transgender,0,0,0
CHITRAL DISTRICT,62,Male,1120,156,1276
CHITRAL DISTRICT,62,Female,903,104,1007
CHITRAL DISTRICT,62,Transgender,0,0,0
CHITRAL DISTRICT,63,Male,1235,127,1362
CHITRAL DISTRICT,63,Female,925,107,1032
CHITRAL DISTRICT,63,Transgender,0,0,0
CHITRAL DISTRICT,64,Male,955,103,1058
CHITRAL DISTRICT,64,Female,841,111,952
CHITRAL DISTRICT,64,Transgender,0,0,0
CHITRAL DISTRICT,65,Male,786,100,886
CHITRAL DISTRICT,65,Female,695,72,767
CHITRAL DISTRICT,65,Transgender,1,0,1
CHITRAL DISTRICT,66,Male,1076,97,1173
CHITRAL DISTRICT,66,Female,1120,73,1193
CHITRAL DISTRICT,66,Transgender,0,0,0
CHITRAL DISTRICT,67,Male,868,114,982
CHITRAL DISTRICT,67,Female,761,93,854
CHITRAL DISTRICT,67,Transgender,0,0,0
CHITRAL DISTRICT,68,Male,854,74,928
CHITRAL DISTRICT,68,Female,525,49,574
CHITRAL DISTRICT,68,Transgender,0,0,0
CHITRAL DISTRICT,69,Male,801,78,879
CHITRAL DISTRICT,69,Female,589,55,644
CHITRAL DISTRICT,69,Transgender,0,0,0
CHITRAL DISTRICT,70,Male,620,68,688
CHITRAL DISTRICT,70,Female,542,52,594
CHITRAL DISTRICT,70,Transgender,1,0,1
CHITRAL DISTRICT,71,Male,1054,79,1133
CHITRAL DISTRICT,71,Female,939,65,1004
CHITRAL DISTRICT,71,Transgender,0,0,0
CHITRAL DISTRICT,72,Male,635,90,725
CHITRAL DISTRICT,72,Female,453,57,510
CHITRAL DISTRICT,72,Transgender,0,0,0
CHITRAL DISTRICT,73,Male,553,47,600
CHITRAL DISTRICT,73,Female,395,37,432
CHITRAL DISTRICT,73,Transgender,0,0,0
CHITRAL DISTRICT,74,Male,423,50,473
CHITRAL DISTRICT,74,Female,331,38,369
CHITRAL DISTRICT,74,Transgender,0,0,0
CHITRAL DISTRICT,>=75,Male,3772,353,4125
CHITRAL DISTRICT,>=75,Female,3072,295,3367
CHITRAL DISTRICT,>=75,Transgender,3,0,3
DADU DISTRICT,<1,Male,12585,4172,16757
DADU DISTRICT,<1,Female,11735,3878,15613
DADU DISTRICT,<1,Transgender,0,0,0
DADU DISTRICT,1,Male,15020,4629,19649
DADU DISTRICT,1,Female,15445,4527,19972
DADU DISTRICT,1,Transgender,0,0,0
DADU DISTRICT,2,Male,18430,5509,23939
DADU DISTRICT,2,Female,19224,5340,24564
DADU DISTRICT,2,Transgender,0,0,0
DADU DISTRICT,3,Male,21288,6403,27691
DADU DISTRICT,3,Female,21285,6163,27448
DADU DISTRICT,3,Transgender,0,0,0
DADU DISTRICT,4,Male,22131,6325,28456
DADU DISTRICT,4,Female,22768,6037,28805
DADU DISTRICT,4,Transgender,0,0,0
DADU DISTRICT,5,Male,22836,6821,29657
DADU DISTRICT,5,Female,21524,6452,27976
DADU DISTRICT,5,Transgender,0,0,0
DADU DISTRICT,6,Male,22826,6108,28934
DADU DISTRICT,6,Female,21283,5766,27049
DADU DISTRICT,6,Transgender,0,0,0
DADU DISTRICT,7,Male,19350,6202,25552
DADU DISTRICT,7,Female,16963,5627,22590
DADU DISTRICT,7,Transgender,0,0,0
DADU DISTRICT,8,Male,23807,6197,30004
DADU DISTRICT,8,Female,21404,5551,26955
DADU DISTRICT,8,Transgender,0,0,0
DADU DISTRICT,9,Male,17871,5789,23660
DADU DISTRICT,9,Female,15819,5085,20904
DADU DISTRICT,9,Transgender,0,0,0
DADU DISTRICT,10,Male,21425,5696,27121
DADU DISTRICT,10,Female,18602,4967,23569
DADU DISTRICT,10,Transgender,0,0,0
DADU DISTRICT,11,Male,14461,4881,19342
DADU DISTRICT,11,Female,12481,4285,16766
DADU DISTRICT,11,Transgender,0,0,0
DADU DISTRICT,12,Male,17248,5060,22308
DADU DISTRICT,12,Female,14661,4474,19135
DADU DISTRICT,12,Transgender,0,0,0
DADU DISTRICT,13,Male,13450,4696,18146
DADU DISTRICT,13,Female,11371,4108,15479
DADU DISTRICT,13,Transgender,0,0,0
DADU DISTRICT,14,Male,14061,4560,18621
DADU DISTRICT,14,Female,12159,4114,16273
DADU DISTRICT,14,Transgender,0,0,0
DADU DISTRICT,15,Male,14679,5049,19728
DADU DISTRICT,15,Female,11750,4387,16137
DADU DISTRICT,15,Transgender,3,1,4
DADU DISTRICT,16,Male,13751,4709,18460
DADU DISTRICT,16,Female,11571,4112,15683
DADU DISTRICT,16,Transgender,3,4,7
DADU DISTRICT,17,Male,12069,4819,16888
DADU DISTRICT,17,Female,10115,4102,14217
DADU DISTRICT,17,Transgender,2,0,2
DADU DISTRICT,18,Male,13694,4512,18206
DADU DISTRICT,18,Female,12808,4405,17213
DADU DISTRICT,18,Transgender,8,2,10
DADU DISTRICT,19,Male,10260,3970,14230
DADU DISTRICT,19,Female,9623,3944,13567
DADU DISTRICT,19,Transgender,2,1,3
DADU DISTRICT,20,Male,12127,3921,16048
DADU DISTRICT,20,Female,11964,4152,16116
DADU DISTRICT,20,Transgender,6,4,10
DADU DISTRICT,21,Male,8241,3377,11618
DADU DISTRICT,21,Female,8136,3524,11660
DADU DISTRICT,21,Transgender,1,0,1
DADU DISTRICT,22,Male,9535,3447,12982
DADU DISTRICT,22,Female,8686,3377,12063
DADU DISTRICT,22,Transgender,8,1,9
DADU DISTRICT,23,Male,7551,3185,10736
DADU DISTRICT,23,Female,7311,3044,10355
DADU DISTRICT,23,Transgender,5,1,6
DADU DISTRICT,24,Male,7517,2891,10408
DADU DISTRICT,24,Female,7363,2833,10196
DADU DISTRICT,24,Transgender,4,0,4
DADU DISTRICT,25,Male,9648,3342,12990
DADU DISTRICT,25,Female,9553,3383,12936
DADU DISTRICT,25,Transgender,7,2,9
DADU DISTRICT,26,Male,7527,2758,10285
DADU DISTRICT,26,Female,7216,2881,10097
DADU DISTRICT,26,Transgender,3,1,4
DADU DISTRICT,27,Male,8144,3030,11174
DADU DISTRICT,27,Female,7778,2985,10763
DADU DISTRICT,27,Transgender,5,2,7
DADU DISTRICT,28,Male,8326,2921,11247
DADU DISTRICT,28,Female,8818,3150,11968
DADU DISTRICT,28,Transgender,1,1,2
DADU DISTRICT,29,Male,8248,2833,11081
DADU DISTRICT,29,Female,8394,3156,11550
DADU DISTRICT,29,Transgender,3,0,3
DADU DISTRICT,30,Male,8139,2774,10913
DADU DISTRICT,30,Female,8962,2994,11956
DADU DISTRICT,30,Transgender,11,1,12
DADU DISTRICT,31,Male,7094,2631,9725
DADU DISTRICT,31,Female,7319,2485,9804
DADU DISTRICT,31,Transgender,3,1,4
DADU DISTRICT,32,Male,7382,2621,10003
DADU DISTRICT,32,Female,7334,2587,9921
DADU DISTRICT,32,Transgender,1,3,4
DADU DISTRICT,33,Male,6546,2532,9078
DADU DISTRICT,33,Female,6603,2473,9076
DADU DISTRICT,33,Transgender,2,1,3
DADU DISTRICT,34,Male,5523,2015,7538
DADU DISTRICT,34,Female,5717,2000,7717
DADU DISTRICT,34,Transgender,2,2,4
DADU DISTRICT,35,Male,6895,2234,9129
DADU DISTRICT,35,Female,6816,2350,9166
DADU DISTRICT,35,Transgender,5,3,8
DADU DISTRICT,36,Male,5916,1870,7786
DADU DISTRICT,36,Female,5271,1671,6942
DADU DISTRICT,36,Transgender,6,0,6
DADU DISTRICT,37,Male,7886,2192,10078
DADU DISTRICT,37,Female,6826,2085,8911
DADU DISTRICT,37,Transgender,3,0,3
DADU DISTRICT,38,Male,5676,2078,7754
DADU DISTRICT,38,Female,5837,2077,7914
DADU DISTRICT,38,Transgender,4,0,4
DADU DISTRICT,39,Male,6143,2021,8164
DADU DISTRICT,39,Female,5702,2008,7710
DADU DISTRICT,39,Transgender,2,0,2
DADU DISTRICT,40,Male,5675,2069,7744
DADU DISTRICT,40,Female,6489,2112,8601
DADU DISTRICT,40,Transgender,4,2,6
DADU DISTRICT,41,Male,5029,1806,6835
DADU DISTRICT,41,Female,4941,1683,6624
DADU DISTRICT,41,Transgender,0,1,1
DADU DISTRICT,42,Male,5206,1721,6927
DADU DISTRICT,42,Female,5256,1729,6985
DADU DISTRICT,42,Transgender,3,1,4
DADU DISTRICT,43,Male,4347,1684,6031
DADU DISTRICT,43,Female,4648,1643,6291
DADU DISTRICT,43,Transgender,2,0,2
DADU DISTRICT,44,Male,4201,1635,5836
DADU DISTRICT,44,Female,4174,1491,5665
DADU DISTRICT,44,Transgender,2,2,4
DADU DISTRICT,45,Male,4634,1623,6257
DADU DISTRICT,45,Female,4306,1577,5883
DADU DISTRICT,45,Transgender,12,2,14
DADU DISTRICT,46,Male,4025,1402,5427
DADU DISTRICT,46,Female,3511,1232,4743
DADU DISTRICT,46,Transgender,4,1,5
DADU DISTRICT,47,Male,4833,1594,6427
DADU DISTRICT,47,Female,4850,1427,6277
DADU DISTRICT,47,Transgender,5,0,5
DADU DISTRICT,48,Male,3948,1483,5431
DADU DISTRICT,48,Female,3898,1448,5346
DADU DISTRICT,48,Transgender,2,0,2
DADU DISTRICT,49,Male,3981,1553,5534
DADU DISTRICT,49,Female,3831,1511,5342
DADU DISTRICT,49,Transgender,0,0,0
DADU DISTRICT,50,Male,4068,1480,5548
DADU DISTRICT,50,Female,3988,1373,5361
DADU DISTRICT,50,Transgender,2,3,5
DADU DISTRICT,51,Male,3593,1293,4886
DADU DISTRICT,51,Female,3175,1124,4299
DADU DISTRICT,51,Transgender,2,0,2
DADU DISTRICT,52,Male,3342,1303,4645
DADU DISTRICT,52,Female,3477,1061,4538
DADU DISTRICT,52,Transgender,1,1,2
DADU DISTRICT,53,Male,2873,1149,4022
DADU DISTRICT,53,Female,2562,883,3445
DADU DISTRICT,53,Transgender,1,0,1
DADU DISTRICT,54,Male,2603,1031,3634
DADU DISTRICT,54,Female,2341,887,3228
DADU DISTRICT,54,Transgender,1,0,1
DADU DISTRICT,55,Male,3135,1104,4239
DADU DISTRICT,55,Female,2713,934,3647
DADU DISTRICT,55,Transgender,1,2,3
DADU DISTRICT,56,Male,2402,790,3192
DADU DISTRICT,56,Female,2147,610,2757
DADU DISTRICT,56,Transgender,0,1,1
DADU DISTRICT,57,Male,2832,855,3687
DADU DISTRICT,57,Female,3007,838,3845
DADU DISTRICT,57,Transgender,1,0,1
DADU DISTRICT,58,Male,2355,823,3178
DADU DISTRICT,58,Female,2045,698,2743
DADU DISTRICT,58,Transgender,0,0,0
DADU DISTRICT,59,Male,2150,743,2893
DADU DISTRICT,59,Female,2251,772,3023
DADU DISTRICT,59,Transgender,0,0,0
DADU DISTRICT,60,Male,2358,683,3041
DADU DISTRICT,60,Female,2455,790,3245
DADU DISTRICT,60,Transgender,2,1,3
DADU DISTRICT,61,Male,2024,639,2663
DADU DISTRICT,61,Female,2163,710,2873
DADU DISTRICT,61,Transgender,1,0,1
DADU DISTRICT,62,Male,2223,666,2889
DADU DISTRICT,62,Female,2651,820,3471
DADU DISTRICT,62,Transgender,0,0,0
DADU DISTRICT,63,Male,1949,686,2635
DADU DISTRICT,63,Female,2061,739,2800
DADU DISTRICT,63,Transgender,0,0,0
DADU DISTRICT,64,Male,1781,573,2354
DADU DISTRICT,64,Female,1757,526,2283
DADU DISTRICT,64,Transgender,1,0,1
DADU DISTRICT,65,Male,1799,613,2412
DADU DISTRICT,65,Female,1796,581,2377
DADU DISTRICT,65,Transgender,1,1,2
DADU DISTRICT,66,Male,1486,470,1956
DADU DISTRICT,66,Female,1381,429,1810
DADU DISTRICT,66,Transgender,1,1,2
DADU DISTRICT,67,Male,1590,459,2049
DADU DISTRICT,67,Female,1703,448,2151
DADU DISTRICT,67,Transgender,1,0,1
DADU DISTRICT,68,Male,1392,475,1867
DADU DISTRICT,68,Female,1338,420,1758
DADU DISTRICT,68,Transgender,0,0,0
DADU DISTRICT,69,Male,1313,337,1650
DADU DISTRICT,69,Female,1228,406,1634
DADU DISTRICT,69,Transgender,0,0,0
DADU DISTRICT,70,Male,1213,311,1524
DADU DISTRICT,70,Female,1235,344,1579
DADU DISTRICT,70,Transgender,1,0,1
DADU DISTRICT,71,Male,1014,309,1323
DADU DISTRICT,71,Female,1015,328,1343
DADU DISTRICT,71,Transgender,0,0,0
DADU DISTRICT,72,Male,959,245,1204
DADU DISTRICT,72,Female,1193,309,1502
DADU DISTRICT,72,Transgender,0,1,1
DADU DISTRICT,73,Male,904,276,1180
DADU DISTRICT,73,Female,941,303,1244
DADU DISTRICT,73,Transgender,0,0,0
DADU DISTRICT,74,Male,728,229,957
DADU DISTRICT,74,Female,694,199,893
DADU DISTRICT,74,Transgender,0,0,0
DADU DISTRICT,>=75,Male,5849,1688,7537
DADU DISTRICT,>=75,Female,6287,1851,8138
DADU DISTRICT,>=75,Transgender,8,0,8
DERA BUGTI DISTRICT,<1,Male,5185,2021,7206
DERA BUGTI DISTRICT,<1,Female,5954,2115,8069
DERA BUGTI DISTRICT,<1,Transgender,0,0,0
DERA BUGTI DISTRICT,1,Male,4218,2048,6266
DERA BUGTI DISTRICT,1,Female,4474,2167,6641
DERA BUGTI DISTRICT,1,Transgender,0,0,0
DERA BUGTI DISTRICT,2,Male,5600,2451,8051
DERA BUGTI DISTRICT,2,Female,5846,2595,8441
DERA BUGTI DISTRICT,2,Transgender,0,0,0
DERA BUGTI DISTRICT,3,Male,4358,2517,6875
DERA BUGTI DISTRICT,3,Female,4540,2450,6990
DERA BUGTI DISTRICT,3,Transgender,0,0,0
DERA BUGTI DISTRICT,4,Male,5774,2419,8193
DERA BUGTI DISTRICT,4,Female,5773,2363,8136
DERA BUGTI DISTRICT,4,Transgender,0,0,0
DERA BUGTI DISTRICT,5,Male,3966,2329,6295
DERA BUGTI DISTRICT,5,Female,3800,2084,5884
DERA BUGTI DISTRICT,5,Transgender,0,0,0
DERA BUGTI DISTRICT,6,Male,6136,2235,8371
DERA BUGTI DISTRICT,6,Female,5129,1989,7118
DERA BUGTI DISTRICT,6,Transgender,0,0,0
DERA BUGTI DISTRICT,7,Male,4199,2340,6539
DERA BUGTI DISTRICT,7,Female,3260,1793,5053
DERA BUGTI DISTRICT,7,Transgender,0,0,0
DERA BUGTI DISTRICT,8,Male,5738,2090,7828
DERA BUGTI DISTRICT,8,Female,4205,1703,5908
DERA BUGTI DISTRICT,8,Transgender,0,0,0
DERA BUGTI DISTRICT,9,Male,4344,1976,6320
DERA BUGTI DISTRICT,9,Female,3222,1518,4740
DERA BUGTI DISTRICT,9,Transgender,0,0,0
DERA BUGTI DISTRICT,10,Male,5194,1778,6972
DERA BUGTI DISTRICT,10,Female,3383,1365,4748
DERA BUGTI DISTRICT,10,Transgender,0,0,0
DERA BUGTI DISTRICT,11,Male,3338,1307,4645
DERA BUGTI DISTRICT,11,Female,2221,1069,3290
DERA BUGTI DISTRICT,11,Transgender,0,0,0
DERA BUGTI DISTRICT,12,Male,3457,1376,4833
DERA BUGTI DISTRICT,12,Female,2048,1005,3053
DERA BUGTI DISTRICT,12,Transgender,0,0,0
DERA BUGTI DISTRICT,13,Male,2481,1123,3604
DERA BUGTI DISTRICT,13,Female,1347,829,2176
DERA BUGTI DISTRICT,13,Transgender,0,0,0
DERA BUGTI DISTRICT,14,Male,2928,1111,4039
DERA BUGTI DISTRICT,14,Female,1281,825,2106
DERA BUGTI DISTRICT,14,Transgender,0,0,0
DERA BUGTI DISTRICT,15,Male,1964,952,2916
DERA BUGTI DISTRICT,15,Female,924,610,1534
DERA BUGTI DISTRICT,15,Transgender,0,0,0
DERA BUGTI DISTRICT,16,Male,2056,914,2970
DERA BUGTI DISTRICT,16,Female,971,660,1631
DERA BUGTI DISTRICT,16,Transgender,0,0,0
DERA BUGTI DISTRICT,17,Male,1535,882,2417
DERA BUGTI DISTRICT,17,Female,956,721,1677
DERA BUGTI DISTRICT,17,Transgender,0,0,0
DERA BUGTI DISTRICT,18,Male,1337,942,2279
DERA BUGTI DISTRICT,18,Female,1528,927,2455
DERA BUGTI DISTRICT,18,Transgender,0,0,0
DERA BUGTI DISTRICT,19,Male,1454,1003,2457
DERA BUGTI DISTRICT,19,Female,1558,927,2485
DERA BUGTI DISTRICT,19,Transgender,0,0,0
DERA BUGTI DISTRICT,20,Male,1515,820,2335
DERA BUGTI DISTRICT,20,Female,1605,926,2531
DERA BUGTI DISTRICT,20,Transgender,0,0,0
DERA BUGTI DISTRICT,21,Male,1363,804,2167
DERA BUGTI DISTRICT,21,Female,1365,877,2242
DERA BUGTI DISTRICT,21,Transgender,0,0,0
DERA BUGTI DISTRICT,22,Male,1261,643,1904
DERA BUGTI DISTRICT,22,Female,1169,611,1780
DERA BUGTI DISTRICT,22,Transgender,0,0,0
DERA BUGTI DISTRICT,23,Male,1176,742,1918
DERA BUGTI DISTRICT,23,Female,1202,766,1968
DERA BUGTI DISTRICT,23,Transgender,0,0,0
DERA BUGTI DISTRICT,24,Male,1233,712,1945
DERA BUGTI DISTRICT,24,Female,1251,739,1990
DERA BUGTI DISTRICT,24,Transgender,0,0,0
DERA BUGTI DISTRICT,25,Male,1483,750,2233
DERA BUGTI DISTRICT,25,Female,1484,664,2148
DERA BUGTI DISTRICT,25,Transgender,0,0,0
DERA BUGTI DISTRICT,26,Male,1163,631,1794
DERA BUGTI DISTRICT,26,Female,1268,640,1908
DERA BUGTI DISTRICT,26,Transgender,0,0,0
DERA BUGTI DISTRICT,27,Male,1308,743,2051
DERA BUGTI DISTRICT,27,Female,1418,740,2158
DERA BUGTI DISTRICT,27,Transgender,0,0,0
DERA BUGTI DISTRICT,28,Male,1349,665,2014
DERA BUGTI DISTRICT,28,Female,1500,713,2213
DERA BUGTI DISTRICT,28,Transgender,0,0,0
DERA BUGTI DISTRICT,29,Male,1517,765,2282
DERA BUGTI DISTRICT,29,Female,1312,710,2022
DERA BUGTI DISTRICT,29,Transgender,0,0,0
DERA BUGTI DISTRICT,30,Male,1504,674,2178
DERA BUGTI DISTRICT,30,Female,1703,706,2409
DERA BUGTI DISTRICT,30,Transgender,0,0,0
DERA BUGTI DISTRICT,31,Male,1151,599,1750
DERA BUGTI DISTRICT,31,Female,1303,574,1877
DERA BUGTI DISTRICT,31,Transgender,0,0,0
DERA BUGTI DISTRICT,32,Male,1124,526,1650
DERA BUGTI DISTRICT,32,Female,1069,576,1645
DERA BUGTI DISTRICT,32,Transgender,0,0,0
DERA BUGTI DISTRICT,33,Male,996,486,1482
DERA BUGTI DISTRICT,33,Female,1254,511,1765
DERA BUGTI DISTRICT,33,Transgender,0,0,0
DERA BUGTI DISTRICT,34,Male,850,408,1258
DERA BUGTI DISTRICT,34,Female,956,520,1476
DERA BUGTI DISTRICT,34,Transgender,0,0,0
DERA BUGTI DISTRICT,35,Male,1094,514,1608
DERA BUGTI DISTRICT,35,Female,1053,438,1491
DERA BUGTI DISTRICT,35,Transgender,1,0,1
DERA BUGTI DISTRICT,36,Male,912,434,1346
DERA BUGTI DISTRICT,36,Female,949,360,1309
DERA BUGTI DISTRICT,36,Transgender,0,0,0
DERA BUGTI DISTRICT,37,Male,1085,458,1543
DERA BUGTI DISTRICT,37,Female,864,384,1248
DERA BUGTI DISTRICT,37,Transgender,0,0,0
DERA BUGTI DISTRICT,38,Male,1035,391,1426
DERA BUGTI DISTRICT,38,Female,1132,477,1609
DERA BUGTI DISTRICT,38,Transgender,0,0,0
DERA BUGTI DISTRICT,39,Male,1040,423,1463
DERA BUGTI DISTRICT,39,Female,811,337,1148
DERA BUGTI DISTRICT,39,Transgender,0,0,0
DERA BUGTI DISTRICT,40,Male,1210,407,1617
DERA BUGTI DISTRICT,40,Female,1180,464,1644
DERA BUGTI DISTRICT,40,Transgender,0,0,0
DERA BUGTI DISTRICT,41,Male,787,296,1083
DERA BUGTI DISTRICT,41,Female,734,285,1019
DERA BUGTI DISTRICT,41,Transgender,0,0,0
DERA BUGTI DISTRICT,42,Male,695,279,974
DERA BUGTI DISTRICT,42,Female,583,268,851
DERA BUGTI DISTRICT,42,Transgender,0,0,0
DERA BUGTI DISTRICT,43,Male,592,261,853
DERA BUGTI DISTRICT,43,Female,736,344,1080
DERA BUGTI DISTRICT,43,Transgender,0,0,0
DERA BUGTI DISTRICT,44,Male,530,216,746
DERA BUGTI DISTRICT,44,Female,584,282,866
DERA BUGTI DISTRICT,44,Transgender,0,0,0
DERA BUGTI DISTRICT,45,Male,613,232,845
DERA BUGTI DISTRICT,45,Female,649,304,953
DERA BUGTI DISTRICT,45,Transgender,0,0,0
DERA BUGTI DISTRICT,46,Male,433,212,645
DERA BUGTI DISTRICT,46,Female,429,218,647
DERA BUGTI DISTRICT,46,Transgender,0,0,0
DERA BUGTI DISTRICT,47,Male,590,243,833
DERA BUGTI DISTRICT,47,Female,444,255,699
DERA BUGTI DISTRICT,47,Transgender,0,0,0
DERA BUGTI DISTRICT,48,Male,539,276,815
DERA BUGTI DISTRICT,48,Female,608,327,935
DERA BUGTI DISTRICT,48,Transgender,0,0,0
DERA BUGTI DISTRICT,49,Male,525,301,826
DERA BUGTI DISTRICT,49,Female,450,266,716
DERA BUGTI DISTRICT,49,Transgender,0,0,0
DERA BUGTI DISTRICT,50,Male,623,256,879
DERA BUGTI DISTRICT,50,Female,674,352,1026
DERA BUGTI DISTRICT,50,Transgender,0,0,0
DERA BUGTI DISTRICT,51,Male,395,236,631
DERA BUGTI DISTRICT,51,Female,379,201,580
DERA BUGTI DISTRICT,51,Transgender,0,0,0
DERA BUGTI DISTRICT,52,Male,340,211,551
DERA BUGTI DISTRICT,52,Female,306,199,505
DERA BUGTI DISTRICT,52,Transgender,0,0,0
DERA BUGTI DISTRICT,53,Male,364,206,570
DERA BUGTI DISTRICT,53,Female,439,228,667
DERA BUGTI DISTRICT,53,Transgender,0,0,0
DERA BUGTI DISTRICT,54,Male,392,189,581
DERA BUGTI DISTRICT,54,Female,362,186,548
DERA BUGTI DISTRICT,54,Transgender,0,0,0
DERA BUGTI DISTRICT,55,Male,404,183,587
DERA BUGTI DISTRICT,55,Female,370,191,561
DERA BUGTI DISTRICT,55,Transgender,0,0,0
DERA BUGTI DISTRICT,56,Male,347,151,498
DERA BUGTI DISTRICT,56,Female,286,135,421
DERA BUGTI DISTRICT,56,Transgender,0,0,0
DERA BUGTI DISTRICT,57,Male,414,189,603
DERA BUGTI DISTRICT,57,Female,243,144,387
DERA BUGTI DISTRICT,57,Transgender,0,0,0
DERA BUGTI DISTRICT,58,Male,259,153,412
DERA BUGTI DISTRICT,58,Female,245,149,394
DERA BUGTI DISTRICT,58,Transgender,0,0,0
DERA BUGTI DISTRICT,59,Male,330,145,475
DERA BUGTI DISTRICT,59,Female,242,130,372
DERA BUGTI DISTRICT,59,Transgender,0,0,0
DERA BUGTI DISTRICT,60,Male,332,148,480
DERA BUGTI DISTRICT,60,Female,273,146,419
DERA BUGTI DISTRICT,60,Transgender,0,0,0
DERA BUGTI DISTRICT,61,Male,223,108,331
DERA BUGTI DISTRICT,61,Female,165,99,264
DERA BUGTI DISTRICT,61,Transgender,0,0,0
DERA BUGTI DISTRICT,62,Male,223,88,311
DERA BUGTI DISTRICT,62,Female,188,90,278
DERA BUGTI DISTRICT,62,Transgender,0,0,0
DERA BUGTI DISTRICT,63,Male,201,100,301
DERA BUGTI DISTRICT,63,Female,198,100,298
DERA BUGTI DISTRICT,63,Transgender,0,0,0
DERA BUGTI DISTRICT,64,Male,210,74,284
DERA BUGTI DISTRICT,64,Female,188,91,279
DERA BUGTI DISTRICT,64,Transgender,0,0,0
DERA BUGTI DISTRICT,65,Male,185,89,274
DERA BUGTI DISTRICT,65,Female,168,95,263
DERA BUGTI DISTRICT,65,Transgender,0,0,0
DERA BUGTI DISTRICT,66,Male,160,73,233
DERA BUGTI DISTRICT,66,Female,120,61,181
DERA BUGTI DISTRICT,66,Transgender,0,0,0
DERA BUGTI DISTRICT,67,Male,208,88,296
DERA BUGTI DISTRICT,67,Female,125,53,178
DERA BUGTI DISTRICT,67,Transgender,0,0,0
DERA BUGTI DISTRICT,68,Male,139,57,196
DERA BUGTI DISTRICT,68,Female,118,67,185
DERA BUGTI DISTRICT,68,Transgender,0,0,0
DERA BUGTI DISTRICT,69,Male,147,61,208
DERA BUGTI DISTRICT,69,Female,93,47,140
DERA BUGTI DISTRICT,69,Transgender,0,0,0
DERA BUGTI DISTRICT,70,Male,167,59,226
DERA BUGTI DISTRICT,70,Female,132,68,200
DERA BUGTI DISTRICT,70,Transgender,0,0,0
DERA BUGTI DISTRICT,71,Male,72,36,108
DERA BUGTI DISTRICT,71,Female,90,51,141
DERA BUGTI DISTRICT,71,Transgender,0,0,0
DERA BUGTI DISTRICT,72,Male,100,33,133
DERA BUGTI DISTRICT,72,Female,70,45,115
DERA BUGTI DISTRICT,72,Transgender,0,0,0
DERA BUGTI DISTRICT,73,Male,101,33,134
DERA BUGTI DISTRICT,73,Female,89,42,131
DERA BUGTI DISTRICT,73,Transgender,0,0,0
DERA BUGTI DISTRICT,74,Male,92,29,121
DERA BUGTI DISTRICT,74,Female,74,38,112
DERA BUGTI DISTRICT,74,Transgender,0,0,0
DERA BUGTI DISTRICT,>=75,Male,669,304,973
DERA BUGTI DISTRICT,>=75,Female,590,336,926
DERA BUGTI DISTRICT,>=75,Transgender,0,0,0
DERA GHAZI KHAN DISTRICT,<1,Male,34698,7163,41861
DERA GHAZI KHAN DISTRICT,<1,Female,32652,6677,39329
DERA GHAZI KHAN DISTRICT,<1,Transgender,0,0,0
DERA GHAZI KHAN DISTRICT,1,Male,35686,7534,43220
DERA GHAZI KHAN DISTRICT,1,Female,34784,7072,41856
DERA GHAZI KHAN DISTRICT,1,Transgender,0,0,0
DERA GHAZI KHAN DISTRICT,2,Male,42188,7736,49924
DERA GHAZI KHAN DISTRICT,2,Female,42010,7394,49404
DERA GHAZI KHAN DISTRICT,2,Transgender,0,0,0
DERA GHAZI KHAN DISTRICT,3,Male,43750,8476,52226
DERA GHAZI KHAN DISTRICT,3,Female,42523,8146,50669
DERA GHAZI KHAN DISTRICT,3,Transgender,0,0,0
DERA GHAZI KHAN DISTRICT,4,Male,48305,8224,56529
DERA GHAZI KHAN DISTRICT,4,Female,46408,7633,54041
DERA GHAZI KHAN DISTRICT,4,Transgender,0,0,0
DERA GHAZI KHAN DISTRICT,5,Male,43354,8519,51873
DERA GHAZI KHAN DISTRICT,5,Female,40355,7798,48153
DERA GHAZI KHAN DISTRICT,5,Transgender,0,0,0
DERA GHAZI KHAN DISTRICT,6,Male,44138,7913,52051
DERA GHAZI KHAN DISTRICT,6,Female,40582,7224,47806
DERA GHAZI KHAN DISTRICT,6,Transgender,0,0,0
DERA GHAZI KHAN DISTRICT,7,Male,44486,8786,53272
DERA GHAZI KHAN DISTRICT,7,Female,40212,8037,48249
DERA GHAZI KHAN DISTRICT,7,Transgender,0,0,0
DERA GHAZI KHAN DISTRICT,8,Male,48552,8304,56856
DERA GHAZI KHAN DISTRICT,8,Female,42086,7401,49487
DERA GHAZI KHAN DISTRICT,8,Transgender,0,0,0
DERA GHAZI KHAN DISTRICT,9,Male,41022,8438,49460
DERA GHAZI KHAN DISTRICT,9,Female,35914,7494,43408
DERA GHAZI KHAN DISTRICT,9,Transgender,0,0,0
DERA GHAZI KHAN DISTRICT,10,Male,42055,7594,49649
DERA GHAZI KHAN DISTRICT,10,Female,36885,6479,43364
DERA GHAZI KHAN DISTRICT,10,Transgender,0,0,0
DERA GHAZI KHAN DISTRICT,11,Male,31920,7527,39447
DERA GHAZI KHAN DISTRICT,11,Female,27633,6698,34331
DERA GHAZI KHAN DISTRICT,11,Transgender,0,0,0
DERA GHAZI KHAN DISTRICT,12,Male,34156,6754,40910
DERA GHAZI KHAN DISTRICT,12,Female,30339,6039,36378
DERA GHAZI KHAN DISTRICT,12,Transgender,0,0,0
DERA GHAZI KHAN DISTRICT,13,Male,28608,6853,35461
DERA GHAZI KHAN DISTRICT,13,Female,24441,5974,30415
DERA GHAZI KHAN DISTRICT,13,Transgender,0,0,0
DERA GHAZI KHAN DISTRICT,14,Male,28112,6357,34469
DERA GHAZI KHAN DISTRICT,14,Female,25396,5796,31192
DERA GHAZI KHAN DISTRICT,14,Transgender,0,0,0
DERA GHAZI KHAN DISTRICT,15,Male,25622,6379,32001
DERA GHAZI KHAN DISTRICT,15,Female,21421,5679,27100
DERA GHAZI KHAN DISTRICT,15,Transgender,4,0,4
DERA GHAZI KHAN DISTRICT,16,Male,23923,6227,30150
DERA GHAZI KHAN DISTRICT,16,Female,21813,5462,27275
DERA GHAZI KHAN DISTRICT,16,Transgender,14,0,14
DERA GHAZI KHAN DISTRICT,17,Male,21289,6416,27705
DERA GHAZI KHAN DISTRICT,17,Female,18945,5533,24478
DERA GHAZI KHAN DISTRICT,17,Transgender,4,1,5
DERA GHAZI KHAN DISTRICT,18,Male,24739,5901,30640
DERA GHAZI KHAN DISTRICT,18,Female,24364,5744,30108
DERA GHAZI KHAN DISTRICT,18,Transgender,5,2,7
DERA GHAZI KHAN DISTRICT,19,Male,20809,6087,26896
DERA GHAZI KHAN DISTRICT,19,Female,20441,6175,26616
DERA GHAZI KHAN DISTRICT,19,Transgender,3,0,3
DERA GHAZI KHAN DISTRICT,20,Male,21398,5392,26790
DERA GHAZI KHAN DISTRICT,20,Female,24356,5349,29705
DERA GHAZI KHAN DISTRICT,20,Transgender,4,0,4
DERA GHAZI KHAN DISTRICT,21,Male,17820,5491,23311
DERA GHAZI KHAN DISTRICT,21,Female,19075,5637,24712
DERA GHAZI KHAN DISTRICT,21,Transgender,4,1,5
DERA GHAZI KHAN DISTRICT,22,Male,18859,4920,23779
DERA GHAZI KHAN DISTRICT,22,Female,19368,5151,24519
DERA GHAZI KHAN DISTRICT,22,Transgender,3,3,6
DERA GHAZI KHAN DISTRICT,23,Male,15779,4609,20388
DERA GHAZI KHAN DISTRICT,23,Female,16915,4945,21860
DERA GHAZI KHAN DISTRICT,23,Transgender,1,5,6
DERA GHAZI KHAN DISTRICT,24,Male,15170,4277,19447
DERA GHAZI KHAN DISTRICT,24,Female,16423,4745,21168
DERA GHAZI KHAN DISTRICT,24,Transgender,2,2,4
DERA GHAZI KHAN DISTRICT,25,Male,16596,4139,20735
DERA GHAZI KHAN DISTRICT,25,Female,19173,4653,23826
DERA GHAZI KHAN DISTRICT,25,Transgender,2,1,3
DERA GHAZI KHAN DISTRICT,26,Male,13784,4134,17918
DERA GHAZI KHAN DISTRICT,26,Female,15420,4506,19926
DERA GHAZI KHAN DISTRICT,26,Transgender,4,3,7
DERA GHAZI KHAN DISTRICT,27,Male,13572,4108,17680
DERA GHAZI KHAN DISTRICT,27,Female,15736,4570,20306
DERA GHAZI KHAN DISTRICT,27,Transgender,3,3,6
DERA GHAZI KHAN DISTRICT,28,Male,13754,3823,17577
DERA GHAZI KHAN DISTRICT,28,Female,16667,4403,21070
DERA GHAZI KHAN DISTRICT,28,Transgender,4,0,4
DERA GHAZI KHAN DISTRICT,29,Male,12602,3814,16416
DERA GHAZI KHAN DISTRICT,29,Female,15529,4280,19809
DERA GHAZI KHAN DISTRICT,29,Transgender,2,1,3
DERA GHAZI KHAN DISTRICT,30,Male,14037,3815,17852
DERA GHAZI KHAN DISTRICT,30,Female,17240,4111,21351
DERA GHAZI KHAN DISTRICT,30,Transgender,3,1,4
DERA GHAZI KHAN DISTRICT,31,Male,11812,3640,15452
DERA GHAZI KHAN DISTRICT,31,Female,14678,3965,18643
DERA GHAZI KHAN DISTRICT,31,Transgender,2,0,2
DERA GHAZI KHAN DISTRICT,32,Male,11177,3379,14556
DERA GHAZI KHAN DISTRICT,32,Female,14206,3911,18117
DERA GHAZI KHAN DISTRICT,32,Transgender,3,0,3
DERA GHAZI KHAN DISTRICT,33,Male,10517,3359,13876
DERA GHAZI KHAN DISTRICT,33,Female,13137,3649,16786
DERA GHAZI KHAN DISTRICT,33,Transgender,2,0,2
DERA GHAZI KHAN DISTRICT,34,Male,10900,3198,14098
DERA GHAZI KHAN DISTRICT,34,Female,12539,3498,16037
DERA GHAZI KHAN DISTRICT,34,Transgender,1,1,2
DERA GHAZI KHAN DISTRICT,35,Male,12547,3020,15567
DERA GHAZI KHAN DISTRICT,35,Female,13263,3335,16598
DERA GHAZI KHAN DISTRICT,35,Transgender,5,3,8
DERA GHAZI KHAN DISTRICT,36,Male,11474,3114,14588
DERA GHAZI KHAN DISTRICT,36,Female,11537,3182,14719
DERA GHAZI KHAN DISTRICT,36,Transgender,4,0,4
DERA GHAZI KHAN DISTRICT,37,Male,11517,3005,14522
DERA GHAZI KHAN DISTRICT,37,Female,11518,3031,14549
DERA GHAZI KHAN DISTRICT,37,Transgender,2,0,2
DERA GHAZI KHAN DISTRICT,38,Male,9993,3010,13003
DERA GHAZI KHAN DISTRICT,38,Female,11376,3113,14489
DERA GHAZI KHAN DISTRICT,38,Transgender,0,2,2
DERA GHAZI KHAN DISTRICT,39,Male,9833,2831,12664
DERA GHAZI KHAN DISTRICT,39,Female,10727,2946,13673
DERA GHAZI KHAN DISTRICT,39,Transgender,2,1,3
DERA GHAZI KHAN DISTRICT,40,Male,9874,2765,12639
DERA GHAZI KHAN DISTRICT,40,Female,11777,2879,14656
DERA GHAZI KHAN DISTRICT,40,Transgender,2,3,5
DERA GHAZI KHAN DISTRICT,41,Male,8800,2601,11401
DERA GHAZI KHAN DISTRICT,41,Female,9858,2638,12496
DERA GHAZI KHAN DISTRICT,41,Transgender,0,0,0
DERA GHAZI KHAN DISTRICT,42,Male,8054,2443,10497
DERA GHAZI KHAN DISTRICT,42,Female,8884,2383,11267
DERA GHAZI KHAN DISTRICT,42,Transgender,4,0,4
DERA GHAZI KHAN DISTRICT,43,Male,7002,2300,9302
DERA GHAZI KHAN DISTRICT,43,Female,8065,2355,10420
DERA GHAZI KHAN DISTRICT,43,Transgender,0,0,0
DERA GHAZI KHAN DISTRICT,44,Male,6628,2196,8824
DERA GHAZI KHAN DISTRICT,44,Female,7487,2216,9703
DERA GHAZI KHAN DISTRICT,44,Transgender,1,0,1
DERA GHAZI KHAN DISTRICT,45,Male,7492,2116,9608
DERA GHAZI KHAN DISTRICT,45,Female,7986,2099,10085
DERA GHAZI KHAN DISTRICT,45,Transgender,8,2,10
DERA GHAZI KHAN DISTRICT,46,Male,6679,2006,8685
DERA GHAZI KHAN DISTRICT,46,Female,6835,1947,8782
DERA GHAZI KHAN DISTRICT,46,Transgender,1,1,2
DERA GHAZI KHAN DISTRICT,47,Male,7009,2093,9102
DERA GHAZI KHAN DISTRICT,47,Female,7151,2013,9164
DERA GHAZI KHAN DISTRICT,47,Transgender,2,0,2
DERA GHAZI KHAN DISTRICT,48,Male,6969,2062,9031
DERA GHAZI KHAN DISTRICT,48,Female,7569,2032,9601
DERA GHAZI KHAN DISTRICT,48,Transgender,1,0,1
DERA GHAZI KHAN DISTRICT,49,Male,7023,2102,9125
DERA GHAZI KHAN DISTRICT,49,Female,6900,2019,8919
DERA GHAZI KHAN DISTRICT,49,Transgender,0,1,1
DERA GHAZI KHAN DISTRICT,50,Male,7603,2026,9629
DERA GHAZI KHAN DISTRICT,50,Female,7575,1999,9574
DERA GHAZI KHAN DISTRICT,50,Transgender,3,0,3
DERA GHAZI KHAN DISTRICT,51,Male,6566,1969,8535
DERA GHAZI KHAN DISTRICT,51,Female,6203,1738,7941
DERA GHAZI KHAN DISTRICT,51,Transgender,0,0,0
DERA GHAZI KHAN DISTRICT,52,Male,6289,1844,8133
DERA GHAZI KHAN DISTRICT,52,Female,5606,1709,7315
DERA GHAZI KHAN DISTRICT,52,Transgender,0,0,0
DERA GHAZI KHAN DISTRICT,53,Male,6024,1824,7848
DERA GHAZI KHAN DISTRICT,53,Female,5343,1599,6942
DERA GHAZI KHAN DISTRICT,53,Transgender,1,1,2
DERA GHAZI KHAN DISTRICT,54,Male,5625,1732,7357
DERA GHAZI KHAN DISTRICT,54,Female,4744,1457,6201
DERA GHAZI KHAN DISTRICT,54,Transgender,0,0,0
DERA GHAZI KHAN DISTRICT,55,Male,5459,1565,7024
DERA GHAZI KHAN DISTRICT,55,Female,5029,1350,6379
DERA GHAZI KHAN DISTRICT,55,Transgender,3,2,5
DERA GHAZI KHAN DISTRICT,56,Male,4552,1475,6027
DERA GHAZI KHAN DISTRICT,56,Female,3957,1146,5103
DERA GHAZI KHAN DISTRICT,56,Transgender,0,0,0
DERA GHAZI KHAN DISTRICT,57,Male,4514,1300,5814
DERA GHAZI KHAN DISTRICT,57,Female,3930,976,4906
DERA GHAZI KHAN DISTRICT,57,Transgender,0,0,0
DERA GHAZI KHAN DISTRICT,58,Male,3776,1243,5019
DERA GHAZI KHAN DISTRICT,58,Female,3796,1067,4863
DERA GHAZI KHAN DISTRICT,58,Transgender,1,0,1
DERA GHAZI KHAN DISTRICT,59,Male,3945,1179,5124
DERA GHAZI KHAN DISTRICT,59,Female,3614,1062,4676
DERA GHAZI KHAN DISTRICT,59,Transgender,0,1,1
DERA GHAZI KHAN DISTRICT,60,Male,4581,1173,5754
DERA GHAZI KHAN DISTRICT,60,Female,5046,1141,6187
DERA GHAZI KHAN DISTRICT,60,Transgender,3,1,4
DERA GHAZI KHAN DISTRICT,61,Male,3900,1181,5081
DERA GHAZI KHAN DISTRICT,61,Female,4238,1167,5405
DERA GHAZI KHAN DISTRICT,61,Transgender,2,0,2
DERA GHAZI KHAN DISTRICT,62,Male,3880,1153,5033
DERA GHAZI KHAN DISTRICT,62,Female,4166,1058,5224
DERA GHAZI KHAN DISTRICT,62,Transgender,2,0,2
DERA GHAZI KHAN DISTRICT,63,Male,3760,1083,4843
DERA GHAZI KHAN DISTRICT,63,Female,3864,1110,4974
DERA GHAZI KHAN DISTRICT,63,Transgender,0,0,0
DERA GHAZI KHAN DISTRICT,64,Male,3432,980,4412
DERA GHAZI KHAN DISTRICT,64,Female,3433,882,4315
DERA GHAZI KHAN DISTRICT,64,Transgender,1,0,1
DERA GHAZI KHAN DISTRICT,65,Male,3791,833,4624
DERA GHAZI KHAN DISTRICT,65,Female,3710,863,4573
DERA GHAZI KHAN DISTRICT,65,Transgender,4,0,4
DERA GHAZI KHAN DISTRICT,66,Male,3166,759,3925
DERA GHAZI KHAN DISTRICT,66,Female,3023,711,3734
DERA GHAZI KHAN DISTRICT,66,Transgender,0,0,0
DERA GHAZI KHAN DISTRICT,67,Male,3445,737,4182
DERA GHAZI KHAN DISTRICT,67,Female,3103,622,3725
DERA GHAZI KHAN DISTRICT,67,Transgender,1,1,2
DERA GHAZI KHAN DISTRICT,68,Male,2940,706,3646
DERA GHAZI KHAN DISTRICT,68,Female,2793,670,3463
DERA GHAZI KHAN DISTRICT,68,Transgender,2,1,3
DERA GHAZI KHAN DISTRICT,69,Male,2598,620,3218
DERA GHAZI KHAN DISTRICT,69,Female,2502,570,3072
DERA GHAZI KHAN DISTRICT,69,Transgender,1,0,1
DERA GHAZI KHAN DISTRICT,70,Male,3144,558,3702
DERA GHAZI KHAN DISTRICT,70,Female,2923,571,3494
DERA GHAZI KHAN DISTRICT,70,Transgender,0,0,0
DERA GHAZI KHAN DISTRICT,71,Male,2468,544,3012
DERA GHAZI KHAN DISTRICT,71,Female,2384,556,2940
DERA GHAZI KHAN DISTRICT,71,Transgender,0,0,0
DERA GHAZI KHAN DISTRICT,72,Male,2378,585,2963
DERA GHAZI KHAN DISTRICT,72,Female,2275,476,2751
DERA GHAZI KHAN DISTRICT,72,Transgender,0,0,0
DERA GHAZI KHAN DISTRICT,73,Male,2180,487,2667
DERA GHAZI KHAN DISTRICT,73,Female,1989,456,2445
DERA GHAZI KHAN DISTRICT,73,Transgender,0,0,0
DERA GHAZI KHAN DISTRICT,74,Male,1795,387,2182
DERA GHAZI KHAN DISTRICT,74,Female,1613,357,1970
DERA GHAZI KHAN DISTRICT,74,Transgender,0,0,0
DERA GHAZI KHAN DISTRICT,>=75,Male,15679,2861,18540
DERA GHAZI KHAN DISTRICT,>=75,Female,15246,3094,18340
DERA GHAZI KHAN DISTRICT,>=75,Transgender,7,0,7
DERA ISMAIL KHAN DISTRICT,<1,Male,18653,4953,23606
DERA ISMAIL KHAN DISTRICT,<1,Female,17663,4387,22050
DERA ISMAIL KHAN DISTRICT,<1,Transgender,0,0,0
DERA ISMAIL KHAN DISTRICT,1,Male,19760,4723,24483
DERA ISMAIL KHAN DISTRICT,1,Female,18952,4311,23263
DERA ISMAIL KHAN DISTRICT,1,Transgender,0,0,0
DERA ISMAIL KHAN DISTRICT,2,Male,21895,4916,26811
DERA ISMAIL KHAN DISTRICT,2,Female,21173,4583,25756
DERA ISMAIL KHAN DISTRICT,2,Transgender,0,0,0
DERA ISMAIL KHAN DISTRICT,3,Male,23425,5242,28667
DERA ISMAIL KHAN DISTRICT,3,Female,22466,5012,27478
DERA ISMAIL KHAN DISTRICT,3,Transgender,0,0,0
DERA ISMAIL KHAN DISTRICT,4,Male,23904,5075,28979
DERA ISMAIL KHAN DISTRICT,4,Female,22295,4716,27011
DERA ISMAIL KHAN DISTRICT,4,Transgender,0,0,0
DERA ISMAIL KHAN DISTRICT,5,Male,23332,5094,28426
DERA ISMAIL KHAN DISTRICT,5,Female,21781,4757,26538
DERA ISMAIL KHAN DISTRICT,5,Transgender,0,0,0
DERA ISMAIL KHAN DISTRICT,6,Male,21621,4772,26393
DERA ISMAIL KHAN DISTRICT,6,Female,19921,4316,24237
DERA ISMAIL KHAN DISTRICT,6,Transgender,0,0,0
DERA ISMAIL KHAN DISTRICT,7,Male,24226,5262,29488
DERA ISMAIL KHAN DISTRICT,7,Female,21861,4812,26673
DERA ISMAIL KHAN DISTRICT,7,Transgender,0,0,0
DERA ISMAIL KHAN DISTRICT,8,Male,22236,4917,27153
DERA ISMAIL KHAN DISTRICT,8,Female,20180,4190,24370
DERA ISMAIL KHAN DISTRICT,8,Transgender,0,0,0
DERA ISMAIL KHAN DISTRICT,9,Male,21892,5039,26931
DERA ISMAIL KHAN DISTRICT,9,Female,19015,4517,23532
DERA ISMAIL KHAN DISTRICT,9,Transgender,0,0,0
DERA ISMAIL KHAN DISTRICT,10,Male,19392,4329,23721
DERA ISMAIL KHAN DISTRICT,10,Female,17338,3901,21239
DERA ISMAIL KHAN DISTRICT,10,Transgender,0,0,0
DERA ISMAIL KHAN DISTRICT,11,Male,17853,4781,22634
DERA ISMAIL KHAN DISTRICT,11,Female,15487,4104,19591
DERA ISMAIL KHAN DISTRICT,11,Transgender,0,0,0
DERA ISMAIL KHAN DISTRICT,12,Male,16235,4067,20302
DERA ISMAIL KHAN DISTRICT,12,Female,15156,3632,18788
DERA ISMAIL KHAN DISTRICT,12,Transgender,0,0,0
DERA ISMAIL KHAN DISTRICT,13,Male,15904,4341,20245
DERA ISMAIL KHAN DISTRICT,13,Female,13893,3878,17771
DERA ISMAIL KHAN DISTRICT,13,Transgender,0,0,0
DERA ISMAIL KHAN DISTRICT,14,Male,15146,4335,19481
DERA ISMAIL KHAN DISTRICT,14,Female,13355,3549,16904
DERA ISMAIL KHAN DISTRICT,14,Transgender,0,0,0
DERA ISMAIL KHAN DISTRICT,15,Male,14306,4089,18395
DERA ISMAIL KHAN DISTRICT,15,Female,13077,3581,16658
DERA ISMAIL KHAN DISTRICT,15,Transgender,1,0,1
DERA ISMAIL KHAN DISTRICT,16,Male,13408,4045,17453
DERA ISMAIL KHAN DISTRICT,16,Female,12388,3554,15942
DERA ISMAIL KHAN DISTRICT,16,Transgender,2,1,3
DERA ISMAIL KHAN DISTRICT,17,Male,13081,4176,17257
DERA ISMAIL KHAN DISTRICT,17,Female,12411,3834,16245
DERA ISMAIL KHAN DISTRICT,17,Transgender,2,0,2
DERA ISMAIL KHAN DISTRICT,18,Male,12493,3622,16115
DERA ISMAIL KHAN DISTRICT,18,Female,11224,3193,14417
DERA ISMAIL KHAN DISTRICT,18,Transgender,0,1,1
DERA ISMAIL KHAN DISTRICT,19,Male,12496,4079,16575
DERA ISMAIL KHAN DISTRICT,19,Female,10753,3521,14274
DERA ISMAIL KHAN DISTRICT,19,Transgender,0,1,1
DERA ISMAIL KHAN DISTRICT,20,Male,11187,3384,14571
DERA ISMAIL KHAN DISTRICT,20,Female,11234,3046,14280
DERA ISMAIL KHAN DISTRICT,20,Transgender,4,1,5
DERA ISMAIL KHAN DISTRICT,21,Male,10974,3803,14777
DERA ISMAIL KHAN DISTRICT,21,Female,10398,3545,13943
DERA ISMAIL KHAN DISTRICT,21,Transgender,1,1,2
DERA ISMAIL KHAN DISTRICT,22,Male,9521,3260,12781
DERA ISMAIL KHAN DISTRICT,22,Female,9621,3107,12728
DERA ISMAIL KHAN DISTRICT,22,Transgender,4,2,6
DERA ISMAIL KHAN DISTRICT,23,Male,9850,3565,13415
DERA ISMAIL KHAN DISTRICT,23,Female,10076,3479,13555
DERA ISMAIL KHAN DISTRICT,23,Transgender,1,0,1
DERA ISMAIL KHAN DISTRICT,24,Male,9297,3230,12527
DERA ISMAIL KHAN DISTRICT,24,Female,9774,3275,13049
DERA ISMAIL KHAN DISTRICT,24,Transgender,1,8,9
DERA ISMAIL KHAN DISTRICT,25,Male,9700,2899,12599
DERA ISMAIL KHAN DISTRICT,25,Female,10562,2917,13479
DERA ISMAIL KHAN DISTRICT,25,Transgender,3,2,5
DERA ISMAIL KHAN DISTRICT,26,Male,9517,3176,12693
DERA ISMAIL KHAN DISTRICT,26,Female,10399,3278,13677
DERA ISMAIL KHAN DISTRICT,26,Transgender,1,2,3
DERA ISMAIL KHAN DISTRICT,27,Male,9841,3158,12999
DERA ISMAIL KHAN DISTRICT,27,Female,10963,3356,14319
DERA ISMAIL KHAN DISTRICT,27,Transgender,0,1,1
DERA ISMAIL KHAN DISTRICT,28,Male,8818,2943,11761
DERA ISMAIL KHAN DISTRICT,28,Female,9147,3058,12205
DERA ISMAIL KHAN DISTRICT,28,Transgender,1,2,3
DERA ISMAIL KHAN DISTRICT,29,Male,9307,2989,12296
DERA ISMAIL KHAN DISTRICT,29,Female,9998,3109,13107
DERA ISMAIL KHAN DISTRICT,29,Transgender,1,2,3
DERA ISMAIL KHAN DISTRICT,30,Male,7973,2654,10627
DERA ISMAIL KHAN DISTRICT,30,Female,8391,2547,10938
DERA ISMAIL KHAN DISTRICT,30,Transgender,0,1,1
DERA ISMAIL KHAN DISTRICT,31,Male,8189,2780,10969
DERA ISMAIL KHAN DISTRICT,31,Female,8738,2819,11557
DERA ISMAIL KHAN DISTRICT,31,Transgender,2,2,4
DERA ISMAIL KHAN DISTRICT,32,Male,7316,2585,9901
DERA ISMAIL KHAN DISTRICT,32,Female,7796,2633,10429
DERA ISMAIL KHAN DISTRICT,32,Transgender,1,1,2
DERA ISMAIL KHAN DISTRICT,33,Male,6890,2579,9469
DERA ISMAIL KHAN DISTRICT,33,Female,6577,2296,8873
DERA ISMAIL KHAN DISTRICT,33,Transgender,1,1,2
DERA ISMAIL KHAN DISTRICT,34,Male,6301,2371,8672
DERA ISMAIL KHAN DISTRICT,34,Female,6270,2297,8567
DERA ISMAIL KHAN DISTRICT,34,Transgender,0,0,0
DERA ISMAIL KHAN DISTRICT,35,Male,6343,2077,8420
DERA ISMAIL KHAN DISTRICT,35,Female,5864,1934,7798
DERA ISMAIL KHAN DISTRICT,35,Transgender,3,0,3
DERA ISMAIL KHAN DISTRICT,36,Male,6338,2253,8591
DERA ISMAIL KHAN DISTRICT,36,Female,5903,1985,7888
DERA ISMAIL KHAN DISTRICT,36,Transgender,0,1,1
DERA ISMAIL KHAN DISTRICT,37,Male,6325,1915,8240
DERA ISMAIL KHAN DISTRICT,37,Female,6409,1976,8385
DERA ISMAIL KHAN DISTRICT,37,Transgender,3,0,3
DERA ISMAIL KHAN DISTRICT,38,Male,5481,2223,7704
DERA ISMAIL KHAN DISTRICT,38,Female,5193,1905,7098
DERA ISMAIL KHAN DISTRICT,38,Transgender,1,0,1
DERA ISMAIL KHAN DISTRICT,39,Male,5700,2066,7766
DERA ISMAIL KHAN DISTRICT,39,Female,5496,1937,7433
DERA ISMAIL KHAN DISTRICT,39,Transgender,1,1,2
DERA ISMAIL KHAN DISTRICT,40,Male,4706,1825,6531
DERA ISMAIL KHAN DISTRICT,40,Female,5369,1691,7060
DERA ISMAIL KHAN DISTRICT,40,Transgender,3,0,3
DERA ISMAIL KHAN DISTRICT,41,Male,4954,1839,6793
DERA ISMAIL KHAN DISTRICT,41,Female,5413,1716,7129
DERA ISMAIL KHAN DISTRICT,41,Transgender,1,0,1
DERA ISMAIL KHAN DISTRICT,42,Male,4532,1693,6225
DERA ISMAIL KHAN DISTRICT,42,Female,5256,1553,6809
DERA ISMAIL KHAN DISTRICT,42,Transgender,3,0,3
DERA ISMAIL KHAN DISTRICT,43,Male,4595,1632,6227
DERA ISMAIL KHAN DISTRICT,43,Female,4290,1547,5837
DERA ISMAIL KHAN DISTRICT,43,Transgender,1,2,3
DERA ISMAIL KHAN DISTRICT,44,Male,4563,1594,6157
DERA ISMAIL KHAN DISTRICT,44,Female,4426,1425,5851
DERA ISMAIL KHAN DISTRICT,44,Transgender,0,0,0
DERA ISMAIL KHAN DISTRICT,45,Male,3835,1354,5189
DERA ISMAIL KHAN DISTRICT,45,Female,4042,1377,5419
DERA ISMAIL KHAN DISTRICT,45,Transgender,0,0,0
DERA ISMAIL KHAN DISTRICT,46,Male,4297,1568,5865
DERA ISMAIL KHAN DISTRICT,46,Female,4295,1381,5676
DERA ISMAIL KHAN DISTRICT,46,Transgender,1,0,1
DERA ISMAIL KHAN DISTRICT,47,Male,4569,1410,5979
DERA ISMAIL KHAN DISTRICT,47,Female,4628,1349,5977
DERA ISMAIL KHAN DISTRICT,47,Transgender,0,1,1
DERA ISMAIL KHAN DISTRICT,48,Male,4610,1642,6252
DERA ISMAIL KHAN DISTRICT,48,Female,4285,1496,5781
DERA ISMAIL KHAN DISTRICT,48,Transgender,1,0,1
DERA ISMAIL KHAN DISTRICT,49,Male,4517,1575,6092
DERA ISMAIL KHAN DISTRICT,49,Female,4388,1457,5845
DERA ISMAIL KHAN DISTRICT,49,Transgender,2,2,4
DERA ISMAIL KHAN DISTRICT,50,Male,4113,1371,5484
DERA ISMAIL KHAN DISTRICT,50,Female,3734,1293,5027
DERA ISMAIL KHAN DISTRICT,50,Transgender,3,1,4
DERA ISMAIL KHAN DISTRICT,51,Male,4297,1588,5885
DERA ISMAIL KHAN DISTRICT,51,Female,3982,1350,5332
DERA ISMAIL KHAN DISTRICT,51,Transgender,0,0,0
DERA ISMAIL KHAN DISTRICT,52,Male,4117,1409,5526
DERA ISMAIL KHAN DISTRICT,52,Female,3701,1250,4951
DERA ISMAIL KHAN DISTRICT,52,Transgender,0,0,0
DERA ISMAIL KHAN DISTRICT,53,Male,3898,1376,5274
DERA ISMAIL KHAN DISTRICT,53,Female,3026,1210,4236
DERA ISMAIL KHAN DISTRICT,53,Transgender,0,1,1
DERA ISMAIL KHAN DISTRICT,54,Male,3779,1358,5137
DERA ISMAIL KHAN DISTRICT,54,Female,2874,1110,3984
DERA ISMAIL KHAN DISTRICT,54,Transgender,0,0,0
DERA ISMAIL KHAN DISTRICT,55,Male,3081,1131,4212
DERA ISMAIL KHAN DISTRICT,55,Female,2602,939,3541
DERA ISMAIL KHAN DISTRICT,55,Transgender,2,1,3
DERA ISMAIL KHAN DISTRICT,56,Male,3172,1209,4381
DERA ISMAIL KHAN DISTRICT,56,Female,2493,990,3483
DERA ISMAIL KHAN DISTRICT,56,Transgender,1,0,1
DERA ISMAIL KHAN DISTRICT,57,Male,2818,1110,3928
DERA ISMAIL KHAN DISTRICT,57,Female,2660,826,3486
DERA ISMAIL KHAN DISTRICT,57,Transgender,0,0,0
DERA ISMAIL KHAN DISTRICT,58,Male,2587,1048,3635
DERA ISMAIL KHAN DISTRICT,58,Female,2231,828,3059
DERA ISMAIL KHAN DISTRICT,58,Transgender,0,2,2
DERA ISMAIL KHAN DISTRICT,59,Male,2607,986,3593
DERA ISMAIL KHAN DISTRICT,59,Female,2311,822,3133
DERA ISMAIL KHAN DISTRICT,59,Transgender,0,1,1
DERA ISMAIL KHAN DISTRICT,60,Male,2438,836,3274
DERA ISMAIL KHAN DISTRICT,60,Female,2246,764,3010
DERA ISMAIL KHAN DISTRICT,60,Transgender,0,0,0
DERA ISMAIL KHAN DISTRICT,61,Male,2801,928,3729
DERA ISMAIL KHAN DISTRICT,61,Female,2441,846,3287
DERA ISMAIL KHAN DISTRICT,61,Transgender,0,0,0
DERA ISMAIL KHAN DISTRICT,62,Male,2702,933,3635
DERA ISMAIL KHAN DISTRICT,62,Female,2501,840,3341
DERA ISMAIL KHAN DISTRICT,62,Transgender,0,0,0
DERA ISMAIL KHAN DISTRICT,63,Male,2304,928,3232
DERA ISMAIL KHAN DISTRICT,63,Female,2048,828,2876
DERA ISMAIL KHAN DISTRICT,63,Transgender,0,0,0
DERA ISMAIL KHAN DISTRICT,64,Male,2361,811,3172
DERA ISMAIL KHAN DISTRICT,64,Female,1909,661,2570
DERA ISMAIL KHAN DISTRICT,64,Transgender,1,0,1
DERA ISMAIL KHAN DISTRICT,65,Male,1817,678,2495
DERA ISMAIL KHAN DISTRICT,65,Female,1591,529,2120
DERA ISMAIL KHAN DISTRICT,65,Transgender,1,0,1
DERA ISMAIL KHAN DISTRICT,66,Male,2162,698,2860
DERA ISMAIL KHAN DISTRICT,66,Female,1663,551,2214
DERA ISMAIL KHAN DISTRICT,66,Transgender,0,0,0
DERA ISMAIL KHAN DISTRICT,67,Male,2282,638,2920
DERA ISMAIL KHAN DISTRICT,67,Female,1829,515,2344
DERA ISMAIL KHAN DISTRICT,67,Transgender,0,0,0
DERA ISMAIL KHAN DISTRICT,68,Male,1682,563,2245
DERA ISMAIL KHAN DISTRICT,68,Female,1297,424,1721
DERA ISMAIL KHAN DISTRICT,68,Transgender,1,0,1
DERA ISMAIL KHAN DISTRICT,69,Male,1535,500,2035
DERA ISMAIL KHAN DISTRICT,69,Female,1206,357,1563
DERA ISMAIL KHAN DISTRICT,69,Transgender,0,0,0
DERA ISMAIL KHAN DISTRICT,70,Male,1320,410,1730
DERA ISMAIL KHAN DISTRICT,70,Female,1031,315,1346
DERA ISMAIL KHAN DISTRICT,70,Transgender,1,0,1
DERA ISMAIL KHAN DISTRICT,71,Male,1519,451,1970
DERA ISMAIL KHAN DISTRICT,71,Female,1223,391,1614
DERA ISMAIL KHAN DISTRICT,71,Transgender,0,0,0
DERA ISMAIL KHAN DISTRICT,72,Male,1386,410,1796
DERA ISMAIL KHAN DISTRICT,72,Female,1167,389,1556
DERA ISMAIL KHAN DISTRICT,72,Transgender,1,1,2
DERA ISMAIL KHAN DISTRICT,73,Male,971,374,1345
DERA ISMAIL KHAN DISTRICT,73,Female,821,325,1146
DERA ISMAIL KHAN DISTRICT,73,Transgender,0,0,0
DERA ISMAIL KHAN DISTRICT,74,Male,792,263,1055
DERA ISMAIL KHAN DISTRICT,74,Female,708,237,945
DERA ISMAIL KHAN DISTRICT,74,Transgender,0,0,0
DERA ISMAIL KHAN DISTRICT,>=75,Male,6047,1887,7934
DERA ISMAIL KHAN DISTRICT,>=75,Female,6034,1953,7987
DERA ISMAIL KHAN DISTRICT,>=75,Transgender,2,0,2
FAISALABAD DISTRICT,<1,Male,51369,43723,95092
FAISALABAD DISTRICT,<1,Female,49463,41703,91166
FAISALABAD DISTRICT,<1,Transgender,0,0,0
FAISALABAD DISTRICT,1,Male,52951,45990,98941
FAISALABAD DISTRICT,1,Female,50407,43938,94345
FAISALABAD DISTRICT,1,Transgender,0,0,0
FAISALABAD DISTRICT,2,Male,52059,43734,95793
FAISALABAD DISTRICT,2,Female,49821,42202,92023
FAISALABAD DISTRICT,2,Transgender,0,0,0
FAISALABAD DISTRICT,3,Male,57070,46760,103830
FAISALABAD DISTRICT,3,Female,54698,45279,99977
FAISALABAD DISTRICT,3,Transgender,0,0,0
FAISALABAD DISTRICT,4,Male,57551,44580,102131
FAISALABAD DISTRICT,4,Female,54477,42278,96755
FAISALABAD DISTRICT,4,Transgender,0,0,0
FAISALABAD DISTRICT,5,Male,55519,44638,100157
FAISALABAD DISTRICT,5,Female,52212,42625,94837
FAISALABAD DISTRICT,5,Transgender,0,0,0
FAISALABAD DISTRICT,6,Male,54728,43931,98659
FAISALABAD DISTRICT,6,Female,51204,41373,92577
FAISALABAD DISTRICT,6,Transgender,0,0,0
FAISALABAD DISTRICT,7,Male,58281,47141,105422
FAISALABAD DISTRICT,7,Female,54996,45151,100147
FAISALABAD DISTRICT,7,Transgender,0,0,0
FAISALABAD DISTRICT,8,Male,55020,41375,96395
FAISALABAD DISTRICT,8,Female,51432,40015,91447
FAISALABAD DISTRICT,8,Transgender,0,0,0
FAISALABAD DISTRICT,9,Male,55664,47269,102933
FAISALABAD DISTRICT,9,Female,51408,44792,96200
FAISALABAD DISTRICT,9,Transgender,0,0,0
FAISALABAD DISTRICT,10,Male,50531,39435,89966
FAISALABAD DISTRICT,10,Female,47412,37545,84957
FAISALABAD DISTRICT,10,Transgender,0,0,0
FAISALABAD DISTRICT,11,Male,50724,47058,97782
FAISALABAD DISTRICT,11,Female,47267,44119,91386
FAISALABAD DISTRICT,11,Transgender,0,0,0
FAISALABAD DISTRICT,12,Male,46632,38815,85447
FAISALABAD DISTRICT,12,Female,42813,36327,79140
FAISALABAD DISTRICT,12,Transgender,0,0,0
FAISALABAD DISTRICT,13,Male,46464,42488,88952
FAISALABAD DISTRICT,13,Female,42598,39960,82558
FAISALABAD DISTRICT,13,Transgender,0,0,0
FAISALABAD DISTRICT,14,Male,44912,39479,84391
FAISALABAD DISTRICT,14,Female,41042,35958,77000
FAISALABAD DISTRICT,14,Transgender,0,0,0
FAISALABAD DISTRICT,15,Male,44377,38975,83352
FAISALABAD DISTRICT,15,Female,41717,37464,79181
FAISALABAD DISTRICT,15,Transgender,7,2,9
FAISALABAD DISTRICT,16,Male,43913,40613,84526
FAISALABAD DISTRICT,16,Female,41535,37604,79139
FAISALABAD DISTRICT,16,Transgender,4,5,9
FAISALABAD DISTRICT,17,Male,45616,42137,87753
FAISALABAD DISTRICT,17,Female,42908,39018,81926
FAISALABAD DISTRICT,17,Transgender,5,7,12
FAISALABAD DISTRICT,18,Male,39933,37629,77562
FAISALABAD DISTRICT,18,Female,37288,33049,70337
FAISALABAD DISTRICT,18,Transgender,10,3,13
FAISALABAD DISTRICT,19,Male,41886,42610,84496
FAISALABAD DISTRICT,19,Female,40624,40354,80978
FAISALABAD DISTRICT,19,Transgender,9,5,14
FAISALABAD DISTRICT,20,Male,38844,38112,76956
FAISALABAD DISTRICT,20,Female,38475,33491,71966
FAISALABAD DISTRICT,20,Transgender,5,15,20
FAISALABAD DISTRICT,21,Male,40666,44047,84713
FAISALABAD DISTRICT,21,Female,40664,42331,82995
FAISALABAD DISTRICT,21,Transgender,4,5,9
FAISALABAD DISTRICT,22,Male,37912,39100,77012
FAISALABAD DISTRICT,22,Female,38743,38244,76987
FAISALABAD DISTRICT,22,Transgender,10,9,19
FAISALABAD DISTRICT,23,Male,36048,39201,75249
FAISALABAD DISTRICT,23,Female,36770,39943,76713
FAISALABAD DISTRICT,23,Transgender,5,6,11
FAISALABAD DISTRICT,24,Male,34620,37747,72367
FAISALABAD DISTRICT,24,Female,35606,39698,75304
FAISALABAD DISTRICT,24,Transgender,8,7,15
FAISALABAD DISTRICT,25,Male,31242,30364,61606
FAISALABAD DISTRICT,25,Female,34457,29645,64102
FAISALABAD DISTRICT,25,Transgender,12,18,30
FAISALABAD DISTRICT,26,Male,32394,35439,67833
FAISALABAD DISTRICT,26,Female,34590,37272,71862
FAISALABAD DISTRICT,26,Transgender,6,11,17
FAISALABAD DISTRICT,27,Male,31930,33299,65229
FAISALABAD DISTRICT,27,Female,33421,35164,68585
FAISALABAD DISTRICT,27,Transgender,3,21,24
FAISALABAD DISTRICT,28,Male,30999,31958,62957
FAISALABAD DISTRICT,28,Female,32150,33685,65835
FAISALABAD DISTRICT,28,Transgender,11,19,30
FAISALABAD DISTRICT,29,Male,31759,32908,64667
FAISALABAD DISTRICT,29,Female,32618,33161,65779
FAISALABAD DISTRICT,29,Transgender,3,7,10
FAISALABAD DISTRICT,30,Male,28295,28871,57166
FAISALABAD DISTRICT,30,Female,31768,28752,60520
FAISALABAD DISTRICT,30,Transgender,21,23,44
FAISALABAD DISTRICT,31,Male,29732,31630,61362
FAISALABAD DISTRICT,31,Female,31597,31896,63493
FAISALABAD DISTRICT,31,Transgender,7,9,16
FAISALABAD DISTRICT,32,Male,26552,29861,56413
FAISALABAD DISTRICT,32,Female,28901,29955,58856
FAISALABAD DISTRICT,32,Transgender,8,13,21
FAISALABAD DISTRICT,33,Male,26713,29984,56697
FAISALABAD DISTRICT,33,Female,27204,29345,56549
FAISALABAD DISTRICT,33,Transgender,5,12,17
FAISALABAD DISTRICT,34,Male,28113,28969,57082
FAISALABAD DISTRICT,34,Female,26310,27433,53743
FAISALABAD DISTRICT,34,Transgender,6,3,9
FAISALABAD DISTRICT,35,Male,26020,24031,50051
FAISALABAD DISTRICT,35,Female,24753,22512,47265
FAISALABAD DISTRICT,35,Transgender,15,23,38
FAISALABAD DISTRICT,36,Male,27775,26339,54114
FAISALABAD DISTRICT,36,Female,25321,25272,50593
FAISALABAD DISTRICT,36,Transgender,7,8,15
FAISALABAD DISTRICT,37,Male,25366,24256,49622
FAISALABAD DISTRICT,37,Female,25409,23010,48419
FAISALABAD DISTRICT,37,Transgender,6,10,16
FAISALABAD DISTRICT,38,Male,24508,26260,50768
FAISALABAD DISTRICT,38,Female,22633,24748,47381
FAISALABAD DISTRICT,38,Transgender,4,9,13
FAISALABAD DISTRICT,39,Male,24337,24593,48930
FAISALABAD DISTRICT,39,Female,24290,23229,47519
FAISALABAD DISTRICT,39,Transgender,1,8,9
FAISALABAD DISTRICT,40,Male,20385,22582,42967
FAISALABAD DISTRICT,40,Female,20290,19688,39978
FAISALABAD DISTRICT,40,Transgender,19,28,47
FAISALABAD DISTRICT,41,Male,21799,22747,44546
FAISALABAD DISTRICT,41,Female,22544,21405,43949
FAISALABAD DISTRICT,41,Transgender,1,5,6
FAISALABAD DISTRICT,42,Male,19275,20307,39582
FAISALABAD DISTRICT,42,Female,20288,19221,39509
FAISALABAD DISTRICT,42,Transgender,8,7,15
FAISALABAD DISTRICT,43,Male,18373,20002,38375
FAISALABAD DISTRICT,43,Female,17642,19089,36731
FAISALABAD DISTRICT,43,Transgender,2,5,7
FAISALABAD DISTRICT,44,Male,18153,18848,37001
FAISALABAD DISTRICT,44,Female,17032,17940,34972
FAISALABAD DISTRICT,44,Transgender,4,6,10
FAISALABAD DISTRICT,45,Male,15777,16502,32279
FAISALABAD DISTRICT,45,Female,15081,14457,29538
FAISALABAD DISTRICT,45,Transgender,9,15,24
FAISALABAD DISTRICT,46,Male,17611,17230,34841
FAISALABAD DISTRICT,46,Female,17307,16084,33391
FAISALABAD DISTRICT,46,Transgender,3,6,9
FAISALABAD DISTRICT,47,Male,17752,16195,33947
FAISALABAD DISTRICT,47,Female,17728,14715,32443
FAISALABAD DISTRICT,47,Transgender,5,11,16
FAISALABAD DISTRICT,48,Male,17848,17688,35536
FAISALABAD DISTRICT,48,Female,15388,16536,31924
FAISALABAD DISTRICT,48,Transgender,1,8,9
FAISALABAD DISTRICT,49,Male,18554,17629,36183
FAISALABAD DISTRICT,49,Female,16865,16205,33070
FAISALABAD DISTRICT,49,Transgender,5,9,14
FAISALABAD DISTRICT,50,Male,16508,15645,32153
FAISALABAD DISTRICT,50,Female,14377,13831,28208
FAISALABAD DISTRICT,50,Transgender,15,13,28
FAISALABAD DISTRICT,51,Male,18309,17063,35372
FAISALABAD DISTRICT,51,Female,17668,15721,33389
FAISALABAD DISTRICT,51,Transgender,4,2,6
FAISALABAD DISTRICT,52,Male,17411,16137,33548
FAISALABAD DISTRICT,52,Female,16178,14514,30692
FAISALABAD DISTRICT,52,Transgender,8,6,14
FAISALABAD DISTRICT,53,Male,16778,15835,32613
FAISALABAD DISTRICT,53,Female,13885,14115,28000
FAISALABAD DISTRICT,53,Transgender,2,6,8
FAISALABAD DISTRICT,54,Male,15752,15109,30861
FAISALABAD DISTRICT,54,Female,12691,13162,25853
FAISALABAD DISTRICT,54,Transgender,1,3,4
FAISALABAD DISTRICT,55,Male,13148,12613,25761
FAISALABAD DISTRICT,55,Female,10043,9807,19850
FAISALABAD DISTRICT,55,Transgender,9,4,13
FAISALABAD DISTRICT,56,Male,13655,12626,26281
FAISALABAD DISTRICT,56,Female,11643,10772,22415
FAISALABAD DISTRICT,56,Transgender,1,5,6
FAISALABAD DISTRICT,57,Male,12044,10691,22735
FAISALABAD DISTRICT,57,Female,11260,8689,19949
FAISALABAD DISTRICT,57,Transgender,9,3,12
FAISALABAD DISTRICT,58,Male,11256,10688,21944
FAISALABAD DISTRICT,58,Female,9644,9511,19155
FAISALABAD DISTRICT,58,Transgender,4,3,7
FAISALABAD DISTRICT,59,Male,11737,10322,22059
FAISALABAD DISTRICT,59,Female,10166,9168,19334
FAISALABAD DISTRICT,59,Transgender,1,1,2
FAISALABAD DISTRICT,60,Male,10415,9086,19501
FAISALABAD DISTRICT,60,Female,8825,7451,16276
FAISALABAD DISTRICT,60,Transgender,11,13,24
FAISALABAD DISTRICT,61,Male,11910,10145,22055
FAISALABAD DISTRICT,61,Female,10302,8349,18651
FAISALABAD DISTRICT,61,Transgender,5,2,7
FAISALABAD DISTRICT,62,Male,10991,9571,20562
FAISALABAD DISTRICT,62,Female,9623,7487,17110
FAISALABAD DISTRICT,62,Transgender,1,1,2
FAISALABAD DISTRICT,63,Male,9936,8951,18887
FAISALABAD DISTRICT,63,Female,8341,7340,15681
FAISALABAD DISTRICT,63,Transgender,6,2,8
FAISALABAD DISTRICT,64,Male,9090,7624,16714
FAISALABAD DISTRICT,64,Female,7750,6459,14209
FAISALABAD DISTRICT,64,Transgender,1,0,1
FAISALABAD DISTRICT,65,Male,7637,5959,13596
FAISALABAD DISTRICT,65,Female,6740,4955,11695
FAISALABAD DISTRICT,65,Transgender,5,6,11
FAISALABAD DISTRICT,66,Male,7893,5525,13418
FAISALABAD DISTRICT,66,Female,6867,4686,11553
FAISALABAD DISTRICT,66,Transgender,4,1,5
FAISALABAD DISTRICT,67,Male,7114,4819,11933
FAISALABAD DISTRICT,67,Female,6518,4086,10604
FAISALABAD DISTRICT,67,Transgender,3,3,6
FAISALABAD DISTRICT,68,Male,6249,4855,11104
FAISALABAD DISTRICT,68,Female,5532,4182,9714
FAISALABAD DISTRICT,68,Transgender,2,0,2
FAISALABAD DISTRICT,69,Male,6333,4407,10740
FAISALABAD DISTRICT,69,Female,5543,4086,9629
FAISALABAD DISTRICT,69,Transgender,2,0,2
FAISALABAD DISTRICT,70,Male,6346,4103,10449
FAISALABAD DISTRICT,70,Female,5645,3689,9334
FAISALABAD DISTRICT,70,Transgender,5,4,9
FAISALABAD DISTRICT,71,Male,7122,4461,11583
FAISALABAD DISTRICT,71,Female,6030,4132,10162
FAISALABAD DISTRICT,71,Transgender,4,0,4
FAISALABAD DISTRICT,72,Male,6414,4256,10670
FAISALABAD DISTRICT,72,Female,5193,3607,8800
FAISALABAD DISTRICT,72,Transgender,4,1,5
FAISALABAD DISTRICT,73,Male,5062,3801,8863
FAISALABAD DISTRICT,73,Female,4353,3373,7726
FAISALABAD DISTRICT,73,Transgender,2,2,4
FAISALABAD DISTRICT,74,Male,4516,3106,7622
FAISALABAD DISTRICT,74,Female,3758,2702,6460
FAISALABAD DISTRICT,74,Transgender,0,1,1
FAISALABAD DISTRICT,>=75,Male,35739,22538,58277
FAISALABAD DISTRICT,>=75,Female,31552,20636,52188
FAISALABAD DISTRICT,>=75,Transgender,19,21,40
FR BANNU,<1,Male,607,0,607
FR BANNU,<1,Female,565,0,565
FR BANNU,<1,Transgender,0,0,0
FR BANNU,1,Male,666,0,666
FR BANNU,1,Female,616,0,616
FR BANNU,1,Transgender,0,0,0
FR BANNU,2,Male,849,0,849
FR BANNU,2,Female,842,0,842
FR BANNU,2,Transgender,0,0,0
FR BANNU,3,Male,863,0,863
FR BANNU,3,Female,831,0,831
FR BANNU,3,Transgender,0,0,0
FR BANNU,4,Male,895,0,895
FR BANNU,4,Female,917,0,917
FR BANNU,4,Transgender,0,0,0
FR BANNU,5,Male,904,0,904
FR BANNU,5,Female,794,0,794
FR BANNU,5,Transgender,0,0,0
FR BANNU,6,Male,927,0,927
FR BANNU,6,Female,851,0,851
FR BANNU,6,Transgender,0,0,0
FR BANNU,7,Male,928,0,928
FR BANNU,7,Female,732,0,732
FR BANNU,7,Transgender,0,0,0
FR BANNU,8,Male,1011,0,1011
FR BANNU,8,Female,792,0,792
FR BANNU,8,Transgender,0,0,0
FR BANNU,9,Male,779,0,779
FR BANNU,9,Female,644,0,644
FR BANNU,9,Transgender,0,0,0
FR BANNU,10,Male,830,0,830
FR BANNU,10,Female,630,0,630
FR BANNU,10,Transgender,0,0,0
FR BANNU,11,Male,555,0,555
FR BANNU,11,Female,487,0,487
FR BANNU,11,Transgender,0,0,0
FR BANNU,12,Male,561,0,561
FR BANNU,12,Female,513,0,513
FR BANNU,12,Transgender,0,0,0
FR BANNU,13,Male,483,0,483
FR BANNU,13,Female,374,0,374
FR BANNU,13,Transgender,0,0,0
FR BANNU,14,Male,424,0,424
FR BANNU,14,Female,409,0,409
FR BANNU,14,Transgender,0,0,0
FR BANNU,15,Male,439,0,439
FR BANNU,15,Female,351,0,351
FR BANNU,15,Transgender,0,0,0
FR BANNU,16,Male,390,0,390
FR BANNU,16,Female,387,0,387
FR BANNU,16,Transgender,0,0,0
FR BANNU,17,Male,264,0,264
FR BANNU,17,Female,256,0,256
FR BANNU,17,Transgender,0,0,0
FR BANNU,18,Male,446,0,446
FR BANNU,18,Female,409,0,409
FR BANNU,18,Transgender,0,0,0
FR BANNU,19,Male,384,0,384
FR BANNU,19,Female,336,0,336
FR BANNU,19,Transgender,0,0,0
FR BANNU,20,Male,389,0,389
FR BANNU,20,Female,491,0,491
FR BANNU,20,Transgender,0,0,0
FR BANNU,21,Male,379,0,379
FR BANNU,21,Female,388,0,388
FR BANNU,21,Transgender,0,0,0
FR BANNU,22,Male,370,0,370
FR BANNU,22,Female,388,0,388
FR BANNU,22,Transgender,0,0,0
FR BANNU,23,Male,417,0,417
FR BANNU,23,Female,357,0,357
FR BANNU,23,Transgender,0,0,0
FR BANNU,24,Male,338,0,338
FR BANNU,24,Female,338,0,338
FR BANNU,24,Transgender,0,0,0
FR BANNU,25,Male,419,0,419
FR BANNU,25,Female,503,0,503
FR BANNU,25,Transgender,0,0,0
FR BANNU,26,Male,343,0,343
FR BANNU,26,Female,307,0,307
FR BANNU,26,Transgender,0,0,0
FR BANNU,27,Male,413,0,413
FR BANNU,27,Female,316,0,316
FR BANNU,27,Transgender,0,0,0
FR BANNU,28,Male,316,0,316
FR BANNU,28,Female,312,0,312
FR BANNU,28,Transgender,0,0,0
FR BANNU,29,Male,343,0,343
FR BANNU,29,Female,297,0,297
FR BANNU,29,Transgender,0,0,0
FR BANNU,30,Male,337,0,337
FR BANNU,30,Female,380,0,380
FR BANNU,30,Transgender,0,0,0
FR BANNU,31,Male,285,0,285
FR BANNU,31,Female,226,0,226
FR BANNU,31,Transgender,0,0,0
FR BANNU,32,Male,282,0,282
FR BANNU,32,Female,183,0,183
FR BANNU,32,Transgender,0,0,0
FR BANNU,33,Male,279,0,279
FR BANNU,33,Female,204,0,204
FR BANNU,33,Transgender,0,0,0
FR BANNU,34,Male,206,0,206
FR BANNU,34,Female,134,0,134
FR BANNU,34,Transgender,0,0,0
FR BANNU,35,Male,183,0,183
FR BANNU,35,Female,282,0,282
FR BANNU,35,Transgender,0,0,0
FR BANNU,36,Male,134,0,134
FR BANNU,36,Female,144,0,144
FR BANNU,36,Transgender,0,0,0
FR BANNU,37,Male,167,0,167
FR BANNU,37,Female,163,0,163
FR BANNU,37,Transgender,0,0,0
FR BANNU,38,Male,162,0,162
FR BANNU,38,Female,173,0,173
FR BANNU,38,Transgender,0,0,0
FR BANNU,39,Male,183,0,183
FR BANNU,39,Female,160,0,160
FR BANNU,39,Transgender,0,0,0
FR BANNU,40,Male,191,0,191
FR BANNU,40,Female,283,0,283
FR BANNU,40,Transgender,0,0,0
FR BANNU,41,Male,169,0,169
FR BANNU,41,Female,145,0,145
FR BANNU,41,Transgender,0,0,0
FR BANNU,42,Male,127,0,127
FR BANNU,42,Female,149,0,149
FR BANNU,42,Transgender,0,0,0
FR BANNU,43,Male,133,0,133
FR BANNU,43,Female,153,0,153
FR BANNU,43,Transgender,0,0,0
FR BANNU,44,Male,115,0,115
FR BANNU,44,Female,139,0,139
FR BANNU,44,Transgender,0,0,0
FR BANNU,45,Male,135,0,135
FR BANNU,45,Female,172,0,172
FR BANNU,45,Transgender,0,0,0
FR BANNU,46,Male,95,0,95
FR BANNU,46,Female,99,0,99
FR BANNU,46,Transgender,0,0,0
FR BANNU,47,Male,111,0,111
FR BANNU,47,Female,102,0,102
FR BANNU,47,Transgender,0,0,0
FR BANNU,48,Male,81,0,81
FR BANNU,48,Female,110,0,110
FR BANNU,48,Transgender,0,0,0
FR BANNU,49,Male,97,0,97
FR BANNU,49,Female,112,0,112
FR BANNU,49,Transgender,0,0,0
FR BANNU,50,Male,123,0,123
FR BANNU,50,Female,210,0,210
FR BANNU,50,Transgender,0,0,0
FR BANNU,51,Male,98,0,98
FR BANNU,51,Female,90,0,90
FR BANNU,51,Transgender,0,0,0
FR BANNU,52,Male,87,0,87
FR BANNU,52,Female,82,0,82
FR BANNU,52,Transgender,0,0,0
FR BANNU,53,Male,80,0,80
FR BANNU,53,Female,92,0,92
FR BANNU,53,Transgender,0,0,0
FR BANNU,54,Male,80,0,80
FR BANNU,54,Female,86,0,86
FR BANNU,54,Transgender,0,0,0
FR BANNU,55,Male,93,0,93
FR BANNU,55,Female,123,0,123
FR BANNU,55,Transgender,0,0,0
FR BANNU,56,Male,56,0,56
FR BANNU,56,Female,61,0,61
FR BANNU,56,Transgender,0,0,0
FR BANNU,57,Male,90,0,90
FR BANNU,57,Female,61,0,61
FR BANNU,57,Transgender,0,0,0
FR BANNU,58,Male,71,0,71
FR BANNU,58,Female,73,0,73
FR BANNU,58,Transgender,0,0,0
FR BANNU,59,Male,70,0,70
FR BANNU,59,Female,67,0,67
FR BANNU,59,Transgender,0,0,0
FR BANNU,60,Male,94,0,94
FR BANNU,60,Female,111,0,111
FR BANNU,60,Transgender,0,0,0
FR BANNU,61,Male,84,0,84
FR BANNU,61,Female,55,0,55
FR BANNU,61,Transgender,0,0,0
FR BANNU,62,Male,68,0,68
FR BANNU,62,Female,47,0,47
FR BANNU,62,Transgender,0,0,0
FR BANNU,63,Male,77,0,77
FR BANNU,63,Female,71,0,71
FR BANNU,63,Transgender,0,0,0
FR BANNU,64,Male,70,0,70
FR BANNU,64,Female,54,0,54
FR BANNU,64,Transgender,0,0,0
FR BANNU,65,Male,61,0,61
FR BANNU,65,Female,71,0,71
FR BANNU,65,Transgender,0,0,0
FR BANNU,66,Male,53,0,53
FR BANNU,66,Female,38,0,38
FR BANNU,66,Transgender,0,0,0
FR BANNU,67,Male,65,0,65
FR BANNU,67,Female,38,0,38
FR BANNU,67,Transgender,0,0,0
FR BANNU,68,Male,33,0,33
FR BANNU,68,Female,31,0,31
FR BANNU,68,Transgender,0,0,0
FR BANNU,69,Male,45,0,45
FR BANNU,69,Female,32,0,32
FR BANNU,69,Transgender,0,0,0
FR BANNU,70,Male,53,0,53
FR BANNU,70,Female,46,0,46
FR BANNU,70,Transgender,0,0,0
FR BANNU,71,Male,53,0,53
FR BANNU,71,Female,21,0,21
FR BANNU,71,Transgender,0,0,0
FR BANNU,72,Male,23,0,23
FR BANNU,72,Female,30,0,30
FR BANNU,72,Transgender,0,0,0
FR BANNU,73,Male,37,0,37
FR BANNU,73,Female,24,0,24
FR BANNU,73,Transgender,0,0,0
FR BANNU,74,Male,24,0,24
FR BANNU,74,Female,39,0,39
FR BANNU,74,Transgender,0,0,0
FR BANNU,>=75,Male,194,0,194
FR BANNU,>=75,Female,227,0,227
FR BANNU,>=75,Transgender,0,0,0
FR D.I.KHAN,<1,Male,1162,0,1162
FR D.I.KHAN,<1,Female,1140,0,1140
FR D.I.KHAN,<1,Transgender,0,0,0
FR D.I.KHAN,1,Male,1423,0,1423
FR D.I.KHAN,1,Female,1294,0,1294
FR D.I.KHAN,1,Transgender,0,0,0
FR D.I.KHAN,2,Male,1487,0,1487
FR D.I.KHAN,2,Female,1483,0,1483
FR D.I.KHAN,2,Transgender,0,0,0
FR D.I.KHAN,3,Male,1467,0,1467
FR D.I.KHAN,3,Female,1408,0,1408
FR D.I.KHAN,3,Transgender,0,0,0
FR D.I.KHAN,4,Male,1487,0,1487
FR D.I.KHAN,4,Female,1488,0,1488
FR D.I.KHAN,4,Transgender,0,0,0
FR D.I.KHAN,5,Male,1428,0,1428
FR D.I.KHAN,5,Female,1264,0,1264
FR D.I.KHAN,5,Transgender,0,0,0
FR D.I.KHAN,6,Male,1427,0,1427
FR D.I.KHAN,6,Female,1323,0,1323
FR D.I.KHAN,6,Transgender,0,0,0
FR D.I.KHAN,7,Male,1454,0,1454
FR D.I.KHAN,7,Female,1247,0,1247
FR D.I.KHAN,7,Transgender,0,0,0
FR D.I.KHAN,8,Male,1506,0,1506
FR D.I.KHAN,8,Female,1257,0,1257
FR D.I.KHAN,8,Transgender,0,0,0
FR D.I.KHAN,9,Male,1254,0,1254
FR D.I.KHAN,9,Female,1111,0,1111
FR D.I.KHAN,9,Transgender,0,0,0
FR D.I.KHAN,10,Male,1233,0,1233
FR D.I.KHAN,10,Female,1037,0,1037
FR D.I.KHAN,10,Transgender,0,0,0
FR D.I.KHAN,11,Male,942,0,942
FR D.I.KHAN,11,Female,837,0,837
FR D.I.KHAN,11,Transgender,0,0,0
FR D.I.KHAN,12,Male,963,0,963
FR D.I.KHAN,12,Female,816,0,816
FR D.I.KHAN,12,Transgender,0,0,0
FR D.I.KHAN,13,Male,806,0,806
FR D.I.KHAN,13,Female,620,0,620
FR D.I.KHAN,13,Transgender,0,0,0
FR D.I.KHAN,14,Male,811,0,811
FR D.I.KHAN,14,Female,583,0,583
FR D.I.KHAN,14,Transgender,0,0,0
FR D.I.KHAN,15,Male,724,0,724
FR D.I.KHAN,15,Female,438,0,438
FR D.I.KHAN,15,Transgender,0,0,0
FR D.I.KHAN,16,Male,670,0,670
FR D.I.KHAN,16,Female,521,0,521
FR D.I.KHAN,16,Transgender,0,0,0
FR D.I.KHAN,17,Male,531,0,531
FR D.I.KHAN,17,Female,460,0,460
FR D.I.KHAN,17,Transgender,0,0,0
FR D.I.KHAN,18,Male,732,0,732
FR D.I.KHAN,18,Female,659,0,659
FR D.I.KHAN,18,Transgender,0,0,0
FR D.I.KHAN,19,Male,664,0,664
FR D.I.KHAN,19,Female,526,0,526
FR D.I.KHAN,19,Transgender,0,0,0
FR D.I.KHAN,20,Male,634,0,634
FR D.I.KHAN,20,Female,686,0,686
FR D.I.KHAN,20,Transgender,0,0,0
FR D.I.KHAN,21,Male,555,0,555
FR D.I.KHAN,21,Female,483,0,483
FR D.I.KHAN,21,Transgender,0,0,0
FR D.I.KHAN,22,Male,453,0,453
FR D.I.KHAN,22,Female,418,0,418
FR D.I.KHAN,22,Transgender,1,0,1
FR D.I.KHAN,23,Male,465,0,465
FR D.I.KHAN,23,Female,540,0,540
FR D.I.KHAN,23,Transgender,0,0,0
FR D.I.KHAN,24,Male,426,0,426
FR D.I.KHAN,24,Female,456,0,456
FR D.I.KHAN,24,Transgender,0,0,0
FR D.I.KHAN,25,Male,561,0,561
FR D.I.KHAN,25,Female,626,0,626
FR D.I.KHAN,25,Transgender,0,0,0
FR D.I.KHAN,26,Male,425,0,425
FR D.I.KHAN,26,Female,471,0,471
FR D.I.KHAN,26,Transgender,0,0,0
FR D.I.KHAN,27,Male,456,0,456
FR D.I.KHAN,27,Female,486,0,486
FR D.I.KHAN,27,Transgender,0,0,0
FR D.I.KHAN,28,Male,470,0,470
FR D.I.KHAN,28,Female,443,0,443
FR D.I.KHAN,28,Transgender,1,0,1
FR D.I.KHAN,29,Male,377,0,377
FR D.I.KHAN,29,Female,496,0,496
FR D.I.KHAN,29,Transgender,0,0,0
FR D.I.KHAN,30,Male,511,0,511
FR D.I.KHAN,30,Female,565,0,565
FR D.I.KHAN,30,Transgender,0,0,0
FR D.I.KHAN,31,Male,416,0,416
FR D.I.KHAN,31,Female,428,0,428
FR D.I.KHAN,31,Transgender,0,0,0
FR D.I.KHAN,32,Male,335,0,335
FR D.I.KHAN,32,Female,290,0,290
FR D.I.KHAN,32,Transgender,0,0,0
FR D.I.KHAN,33,Male,315,0,315
FR D.I.KHAN,33,Female,323,0,323
FR D.I.KHAN,33,Transgender,0,0,0
FR D.I.KHAN,34,Male,264,0,264
FR D.I.KHAN,34,Female,220,0,220
FR D.I.KHAN,34,Transgender,0,0,0
FR D.I.KHAN,35,Male,277,0,277
FR D.I.KHAN,35,Female,334,0,334
FR D.I.KHAN,35,Transgender,0,0,0
FR D.I.KHAN,36,Male,218,0,218
FR D.I.KHAN,36,Female,287,0,287
FR D.I.KHAN,36,Transgender,1,0,1
FR D.I.KHAN,37,Male,266,0,266
FR D.I.KHAN,37,Female,214,0,214
FR D.I.KHAN,37,Transgender,0,0,0
FR D.I.KHAN,38,Male,268,0,268
FR D.I.KHAN,38,Female,264,0,264
FR D.I.KHAN,38,Transgender,0,0,0
FR D.I.KHAN,39,Male,248,0,248
FR D.I.KHAN,39,Female,231,0,231
FR D.I.KHAN,39,Transgender,0,0,0
FR D.I.KHAN,40,Male,270,0,270
FR D.I.KHAN,40,Female,388,0,388
FR D.I.KHAN,40,Transgender,0,0,0
FR D.I.KHAN,41,Male,231,0,231
FR D.I.KHAN,41,Female,269,0,269
FR D.I.KHAN,41,Transgender,0,0,0
FR D.I.KHAN,42,Male,179,0,179
FR D.I.KHAN,42,Female,174,0,174
FR D.I.KHAN,42,Transgender,0,0,0
FR D.I.KHAN,43,Male,191,0,191
FR D.I.KHAN,43,Female,229,0,229
FR D.I.KHAN,43,Transgender,0,0,0
FR D.I.KHAN,44,Male,197,0,197
FR D.I.KHAN,44,Female,172,0,172
FR D.I.KHAN,44,Transgender,0,0,0
FR D.I.KHAN,45,Male,210,0,210
FR D.I.KHAN,45,Female,246,0,246
FR D.I.KHAN,45,Transgender,0,0,0
FR D.I.KHAN,46,Male,188,0,188
FR D.I.KHAN,46,Female,180,0,180
FR D.I.KHAN,46,Transgender,0,0,0
FR D.I.KHAN,47,Male,175,0,175
FR D.I.KHAN,47,Female,141,0,141
FR D.I.KHAN,47,Transgender,0,0,0
FR D.I.KHAN,48,Male,187,0,187
FR D.I.KHAN,48,Female,173,0,173
FR D.I.KHAN,48,Transgender,0,0,0
FR D.I.KHAN,49,Male,190,0,190
FR D.I.KHAN,49,Female,171,0,171
FR D.I.KHAN,49,Transgender,0,0,0
FR D.I.KHAN,50,Male,215,0,215
FR D.I.KHAN,50,Female,284,0,284
FR D.I.KHAN,50,Transgender,0,0,0
FR D.I.KHAN,51,Male,174,0,174
FR D.I.KHAN,51,Female,173,0,173
FR D.I.KHAN,51,Transgender,0,0,0
FR D.I.KHAN,52,Male,132,0,132
FR D.I.KHAN,52,Female,131,0,131
FR D.I.KHAN,52,Transgender,0,0,0
FR D.I.KHAN,53,Male,171,0,171
FR D.I.KHAN,53,Female,147,0,147
FR D.I.KHAN,53,Transgender,0,0,0
FR D.I.KHAN,54,Male,167,0,167
FR D.I.KHAN,54,Female,161,0,161
FR D.I.KHAN,54,Transgender,0,0,0
FR D.I.KHAN,55,Male,159,0,159
FR D.I.KHAN,55,Female,140,0,140
FR D.I.KHAN,55,Transgender,0,0,0
FR D.I.KHAN,56,Male,129,0,129
FR D.I.KHAN,56,Female,129,0,129
FR D.I.KHAN,56,Transgender,0,0,0
FR D.I.KHAN,57,Male,127,0,127
FR D.I.KHAN,57,Female,109,0,109
FR D.I.KHAN,57,Transgender,0,0,0
FR D.I.KHAN,58,Male,133,0,133
FR D.I.KHAN,58,Female,121,0,121
FR D.I.KHAN,58,Transgender,0,0,0
FR D.I.KHAN,59,Male,150,0,150
FR D.I.KHAN,59,Female,115,0,115
FR D.I.KHAN,59,Transgender,0,0,0
FR D.I.KHAN,60,Male,160,0,160
FR D.I.KHAN,60,Female,172,0,172
FR D.I.KHAN,60,Transgender,0,0,0
FR D.I.KHAN,61,Male,133,0,133
FR D.I.KHAN,61,Female,121,0,121
FR D.I.KHAN,61,Transgender,0,0,0
FR D.I.KHAN,62,Male,110,0,110
FR D.I.KHAN,62,Female,100,0,100
FR D.I.KHAN,62,Transgender,0,0,0
FR D.I.KHAN,63,Male,123,0,123
FR D.I.KHAN,63,Female,116,0,116
FR D.I.KHAN,63,Transgender,0,0,0
FR D.I.KHAN,64,Male,113,0,113
FR D.I.KHAN,64,Female,88,0,88
FR D.I.KHAN,64,Transgender,0,0,0
FR D.I.KHAN,65,Male,100,0,100
FR D.I.KHAN,65,Female,80,0,80
FR D.I.KHAN,65,Transgender,0,0,0
FR D.I.KHAN,66,Male,87,0,87
FR D.I.KHAN,66,Female,106,0,106
FR D.I.KHAN,66,Transgender,0,0,0
FR D.I.KHAN,67,Male,77,0,77
FR D.I.KHAN,67,Female,76,0,76
FR D.I.KHAN,67,Transgender,0,0,0
FR D.I.KHAN,68,Male,78,0,78
FR D.I.KHAN,68,Female,60,0,60
FR D.I.KHAN,68,Transgender,0,0,0
FR D.I.KHAN,69,Male,81,0,81
FR D.I.KHAN,69,Female,68,0,68
FR D.I.KHAN,69,Transgender,0,0,0
FR D.I.KHAN,70,Male,81,0,81
FR D.I.KHAN,70,Female,78,0,78
FR D.I.KHAN,70,Transgender,0,0,0
FR D.I.KHAN,71,Male,55,0,55
FR D.I.KHAN,71,Female,63,0,63
FR D.I.KHAN,71,Transgender,0,0,0
FR D.I.KHAN,72,Male,58,0,58
FR D.I.KHAN,72,Female,50,0,50
FR D.I.KHAN,72,Transgender,0,0,0
FR D.I.KHAN,73,Male,53,0,53
FR D.I.KHAN,73,Female,55,0,55
FR D.I.KHAN,73,Transgender,0,0,0
FR D.I.KHAN,74,Male,52,0,52
FR D.I.KHAN,74,Female,50,0,50
FR D.I.KHAN,74,Transgender,0,0,0
FR D.I.KHAN,>=75,Male,309,0,309
FR D.I.KHAN,>=75,Female,437,0,437
FR D.I.KHAN,>=75,Transgender,1,0,1
FR LAKKI MARWAT,<1,Male,438,0,438
FR LAKKI MARWAT,<1,Female,393,0,393
FR LAKKI MARWAT,<1,Transgender,0,0,0
FR LAKKI MARWAT,1,Male,380,0,380
FR LAKKI MARWAT,1,Female,396,0,396
FR LAKKI MARWAT,1,Transgender,0,0,0
FR LAKKI MARWAT,2,Male,562,0,562
FR LAKKI MARWAT,2,Female,541,0,541
FR LAKKI MARWAT,2,Transgender,0,0,0
FR LAKKI MARWAT,3,Male,479,0,479
FR LAKKI MARWAT,3,Female,492,0,492
FR LAKKI MARWAT,3,Transgender,0,0,0
FR LAKKI MARWAT,4,Male,603,0,603
FR LAKKI MARWAT,4,Female,519,0,519
FR LAKKI MARWAT,4,Transgender,0,0,0
FR LAKKI MARWAT,5,Male,489,0,489
FR LAKKI MARWAT,5,Female,432,0,432
FR LAKKI MARWAT,5,Transgender,0,0,0
FR LAKKI MARWAT,6,Male,585,0,585
FR LAKKI MARWAT,6,Female,502,0,502
FR LAKKI MARWAT,6,Transgender,0,0,0
FR LAKKI MARWAT,7,Male,467,0,467
FR LAKKI MARWAT,7,Female,372,0,372
FR LAKKI MARWAT,7,Transgender,0,0,0
FR LAKKI MARWAT,8,Male,568,0,568
FR LAKKI MARWAT,8,Female,502,0,502
FR LAKKI MARWAT,8,Transgender,0,0,0
FR LAKKI MARWAT,9,Male,458,0,458
FR LAKKI MARWAT,9,Female,359,0,359
FR LAKKI MARWAT,9,Transgender,0,0,0
FR LAKKI MARWAT,10,Male,546,0,546
FR LAKKI MARWAT,10,Female,435,0,435
FR LAKKI MARWAT,10,Transgender,0,0,0
FR LAKKI MARWAT,11,Male,394,0,394
FR LAKKI MARWAT,11,Female,308,0,308
FR LAKKI MARWAT,11,Transgender,0,0,0
FR LAKKI MARWAT,12,Male,397,0,397
FR LAKKI MARWAT,12,Female,297,0,297
FR LAKKI MARWAT,12,Transgender,0,0,0
FR LAKKI MARWAT,13,Male,376,0,376
FR LAKKI MARWAT,13,Female,264,0,264
FR LAKKI MARWAT,13,Transgender,0,0,0
FR LAKKI MARWAT,14,Male,381,0,381
FR LAKKI MARWAT,14,Female,253,0,253
FR LAKKI MARWAT,14,Transgender,0,0,0
FR LAKKI MARWAT,15,Male,342,0,342
FR LAKKI MARWAT,15,Female,230,0,230
FR LAKKI MARWAT,15,Transgender,0,0,0
FR LAKKI MARWAT,16,Male,302,0,302
FR LAKKI MARWAT,16,Female,249,0,249
FR LAKKI MARWAT,16,Transgender,0,0,0
FR LAKKI MARWAT,17,Male,309,0,309
FR LAKKI MARWAT,17,Female,275,0,275
FR LAKKI MARWAT,17,Transgender,0,0,0
FR LAKKI MARWAT,18,Male,286,0,286
FR LAKKI MARWAT,18,Female,243,0,243
FR LAKKI MARWAT,18,Transgender,0,0,0
FR LAKKI MARWAT,19,Male,245,0,245
FR LAKKI MARWAT,19,Female,224,0,224
FR LAKKI MARWAT,19,Transgender,0,0,0
FR LAKKI MARWAT,20,Male,285,0,285
FR LAKKI MARWAT,20,Female,275,0,275
FR LAKKI MARWAT,20,Transgender,0,0,0
FR LAKKI MARWAT,21,Male,191,0,191
FR LAKKI MARWAT,21,Female,210,0,210
FR LAKKI MARWAT,21,Transgender,0,0,0
FR LAKKI MARWAT,22,Male,191,0,191
FR LAKKI MARWAT,22,Female,201,0,201
FR LAKKI MARWAT,22,Transgender,0,0,0
FR LAKKI MARWAT,23,Male,193,0,193
FR LAKKI MARWAT,23,Female,194,0,194
FR LAKKI MARWAT,23,Transgender,0,0,0
FR LAKKI MARWAT,24,Male,140,0,140
FR LAKKI MARWAT,24,Female,179,0,179
FR LAKKI MARWAT,24,Transgender,0,0,0
FR LAKKI MARWAT,25,Male,231,0,231
FR LAKKI MARWAT,25,Female,244,0,244
FR LAKKI MARWAT,25,Transgender,0,0,0
FR LAKKI MARWAT,26,Male,185,0,185
FR LAKKI MARWAT,26,Female,186,0,186
FR LAKKI MARWAT,26,Transgender,0,0,0
FR LAKKI MARWAT,27,Male,186,0,186
FR LAKKI MARWAT,27,Female,181,0,181
FR LAKKI MARWAT,27,Transgender,0,0,0
FR LAKKI MARWAT,28,Male,158,0,158
FR LAKKI MARWAT,28,Female,224,0,224
FR LAKKI MARWAT,28,Transgender,0,0,0
FR LAKKI MARWAT,29,Male,161,0,161
FR LAKKI MARWAT,29,Female,169,0,169
FR LAKKI MARWAT,29,Transgender,0,0,0
FR LAKKI MARWAT,30,Male,187,0,187
FR LAKKI MARWAT,30,Female,204,0,204
FR LAKKI MARWAT,30,Transgender,0,0,0
FR LAKKI MARWAT,31,Male,137,0,137
FR LAKKI MARWAT,31,Female,142,0,142
FR LAKKI MARWAT,31,Transgender,0,0,0
FR LAKKI MARWAT,32,Male,118,0,118
FR LAKKI MARWAT,32,Female,119,0,119
FR LAKKI MARWAT,32,Transgender,0,0,0
FR LAKKI MARWAT,33,Male,98,0,98
FR LAKKI MARWAT,33,Female,135,0,135
FR LAKKI MARWAT,33,Transgender,0,0,0
FR LAKKI MARWAT,34,Male,101,0,101
FR LAKKI MARWAT,34,Female,105,0,105
FR LAKKI MARWAT,34,Transgender,0,0,0
FR LAKKI MARWAT,35,Male,154,0,154
FR LAKKI MARWAT,35,Female,139,0,139
FR LAKKI MARWAT,35,Transgender,0,0,0
FR LAKKI MARWAT,36,Male,82,0,82
FR LAKKI MARWAT,36,Female,120,0,120
FR LAKKI MARWAT,36,Transgender,0,0,0
FR LAKKI MARWAT,37,Male,77,0,77
FR LAKKI MARWAT,37,Female,104,0,104
FR LAKKI MARWAT,37,Transgender,0,0,0
FR LAKKI MARWAT,38,Male,97,0,97
FR LAKKI MARWAT,38,Female,148,0,148
FR LAKKI MARWAT,38,Transgender,0,0,0
FR LAKKI MARWAT,39,Male,107,0,107
FR LAKKI MARWAT,39,Female,100,0,100
FR LAKKI MARWAT,39,Transgender,0,0,0
FR LAKKI MARWAT,40,Male,172,0,172
FR LAKKI MARWAT,40,Female,138,0,138
FR LAKKI MARWAT,40,Transgender,0,0,0
FR LAKKI MARWAT,41,Male,98,0,98
FR LAKKI MARWAT,41,Female,98,0,98
FR LAKKI MARWAT,41,Transgender,0,0,0
FR LAKKI MARWAT,42,Male,70,0,70
FR LAKKI MARWAT,42,Female,74,0,74
FR LAKKI MARWAT,42,Transgender,0,0,0
FR LAKKI MARWAT,43,Male,77,0,77
FR LAKKI MARWAT,43,Female,91,0,91
FR LAKKI MARWAT,43,Transgender,0,0,0
FR LAKKI MARWAT,44,Male,69,0,69
FR LAKKI MARWAT,44,Female,79,0,79
FR LAKKI MARWAT,44,Transgender,0,0,0
FR LAKKI MARWAT,45,Male,94,0,94
FR LAKKI MARWAT,45,Female,106,0,106
FR LAKKI MARWAT,45,Transgender,0,0,0
FR LAKKI MARWAT,46,Male,50,0,50
FR LAKKI MARWAT,46,Female,88,0,88
FR LAKKI MARWAT,46,Transgender,0,0,0
FR LAKKI MARWAT,47,Male,48,0,48
FR LAKKI MARWAT,47,Female,67,0,67
FR LAKKI MARWAT,47,Transgender,0,0,0
FR LAKKI MARWAT,48,Male,61,0,61
FR LAKKI MARWAT,48,Female,81,0,81
FR LAKKI MARWAT,48,Transgender,0,0,0
FR LAKKI MARWAT,49,Male,66,0,66
FR LAKKI MARWAT,49,Female,65,0,65
FR LAKKI MARWAT,49,Transgender,0,0,0
FR LAKKI MARWAT,50,Male,95,0,95
FR LAKKI MARWAT,50,Female,106,0,106
FR LAKKI MARWAT,50,Transgender,0,0,0
FR LAKKI MARWAT,51,Male,57,0,57
FR LAKKI MARWAT,51,Female,72,0,72
FR LAKKI MARWAT,51,Transgender,0,0,0
FR LAKKI MARWAT,52,Male,53,0,53
FR LAKKI MARWAT,52,Female,55,0,55
FR LAKKI MARWAT,52,Transgender,0,0,0
FR LAKKI MARWAT,53,Male,76,0,76
FR LAKKI MARWAT,53,Female,56,0,56
FR LAKKI MARWAT,53,Transgender,0,0,0
FR LAKKI MARWAT,54,Male,55,0,55
FR LAKKI MARWAT,54,Female,67,0,67
FR LAKKI MARWAT,54,Transgender,0,0,0
FR LAKKI MARWAT,55,Male,66,0,66
FR LAKKI MARWAT,55,Female,78,0,78
FR LAKKI MARWAT,55,Transgender,0,0,0
FR LAKKI MARWAT,56,Male,61,0,61
FR LAKKI MARWAT,56,Female,49,0,49
FR LAKKI MARWAT,56,Transgender,0,0,0
FR LAKKI MARWAT,57,Male,45,0,45
FR LAKKI MARWAT,57,Female,45,0,45
FR LAKKI MARWAT,57,Transgender,0,0,0
FR LAKKI MARWAT,58,Male,65,0,65
FR LAKKI MARWAT,58,Female,49,0,49
FR LAKKI MARWAT,58,Transgender,0,0,0
FR LAKKI MARWAT,59,Male,52,0,52
FR LAKKI MARWAT,59,Female,30,0,30
FR LAKKI MARWAT,59,Transgender,0,0,0
FR LAKKI MARWAT,60,Male,65,0,65
FR LAKKI MARWAT,60,Female,65,0,65
FR LAKKI MARWAT,60,Transgender,0,0,0
FR LAKKI MARWAT,61,Male,41,0,41
FR LAKKI MARWAT,61,Female,39,0,39
FR LAKKI MARWAT,61,Transgender,0,0,0
FR LAKKI MARWAT,62,Male,43,0,43
FR LAKKI MARWAT,62,Female,38,0,38
FR LAKKI MARWAT,62,Transgender,0,0,0
FR LAKKI MARWAT,63,Male,32,0,32
FR LAKKI MARWAT,63,Female,47,0,47
FR LAKKI MARWAT,63,Transgender,0,0,0
FR LAKKI MARWAT,64,Male,45,0,45
FR LAKKI MARWAT,64,Female,44,0,44
FR LAKKI MARWAT,64,Transgender,0,0,0
FR LAKKI MARWAT,65,Male,36,0,36
FR LAKKI MARWAT,65,Female,33,0,33
FR LAKKI MARWAT,65,Transgender,0,0,0
FR LAKKI MARWAT,66,Male,18,0,18
FR LAKKI MARWAT,66,Female,22,0,22
FR LAKKI MARWAT,66,Transgender,0,0,0
FR LAKKI MARWAT,67,Male,26,0,26
FR LAKKI MARWAT,67,Female,26,0,26
FR LAKKI MARWAT,67,Transgender,0,0,0
FR LAKKI MARWAT,68,Male,28,0,28
FR LAKKI MARWAT,68,Female,24,0,24
FR LAKKI MARWAT,68,Transgender,0,0,0
FR LAKKI MARWAT,69,Male,18,0,18
FR LAKKI MARWAT,69,Female,13,0,13
FR LAKKI MARWAT,69,Transgender,0,0,0
FR LAKKI MARWAT,70,Male,21,0,21
FR LAKKI MARWAT,70,Female,32,0,32
FR LAKKI MARWAT,70,Transgender,0,0,0
FR LAKKI MARWAT,71,Male,20,0,20
FR LAKKI MARWAT,71,Female,17,0,17
FR LAKKI MARWAT,71,Transgender,0,0,0
FR LAKKI MARWAT,72,Male,9,0,9
FR LAKKI MARWAT,72,Female,13,0,13
FR LAKKI MARWAT,72,Transgender,0,0,0
FR LAKKI MARWAT,73,Male,19,0,19
FR LAKKI MARWAT,73,Female,10,0,10
FR LAKKI MARWAT,73,Transgender,0,0,0
FR LAKKI MARWAT,74,Male,24,0,24
FR LAKKI MARWAT,74,Female,16,0,16
FR LAKKI MARWAT,74,Transgender,0,0,0
FR LAKKI MARWAT,>=75,Male,124,0,124
FR LAKKI MARWAT,>=75,Female,111,0,111
FR LAKKI MARWAT,>=75,Transgender,0,0,0
FR PESHAWAR,<1,Male,935,0,935
FR PESHAWAR,<1,Female,816,0,816
FR PESHAWAR,<1,Transgender,0,0,0
FR PESHAWAR,1,Male,1009,0,1009
FR PESHAWAR,1,Female,946,0,946
FR PESHAWAR,1,Transgender,0,0,0
FR PESHAWAR,2,Male,981,0,981
FR PESHAWAR,2,Female,896,0,896
FR PESHAWAR,2,Transgender,0,0,0
FR PESHAWAR,3,Male,1025,0,1025
FR PESHAWAR,3,Female,939,0,939
FR PESHAWAR,3,Transgender,0,0,0
FR PESHAWAR,4,Male,951,0,951
FR PESHAWAR,4,Female,859,0,859
FR PESHAWAR,4,Transgender,0,0,0
FR PESHAWAR,5,Male,1023,0,1023
FR PESHAWAR,5,Female,968,0,968
FR PESHAWAR,5,Transgender,0,0,0
FR PESHAWAR,6,Male,959,0,959
FR PESHAWAR,6,Female,934,0,934
FR PESHAWAR,6,Transgender,0,0,0
FR PESHAWAR,7,Male,1054,0,1054
FR PESHAWAR,7,Female,944,0,944
FR PESHAWAR,7,Transgender,0,0,0
FR PESHAWAR,8,Male,876,0,876
FR PESHAWAR,8,Female,892,0,892
FR PESHAWAR,8,Transgender,0,0,0
FR PESHAWAR,9,Male,1033,0,1033
FR PESHAWAR,9,Female,1018,0,1018
FR PESHAWAR,9,Transgender,0,0,0
FR PESHAWAR,10,Male,817,0,817
FR PESHAWAR,10,Female,806,0,806
FR PESHAWAR,10,Transgender,0,0,0
FR PESHAWAR,11,Male,1012,0,1012
FR PESHAWAR,11,Female,857,0,857
FR PESHAWAR,11,Transgender,0,0,0
FR PESHAWAR,12,Male,767,0,767
FR PESHAWAR,12,Female,748,0,748
FR PESHAWAR,12,Transgender,0,0,0
FR PESHAWAR,13,Male,944,0,944
FR PESHAWAR,13,Female,810,0,810
FR PESHAWAR,13,Transgender,0,0,0
FR PESHAWAR,14,Male,835,0,835
FR PESHAWAR,14,Female,740,0,740
FR PESHAWAR,14,Transgender,0,0,0
FR PESHAWAR,15,Male,777,0,777
FR PESHAWAR,15,Female,779,0,779
FR PESHAWAR,15,Transgender,1,0,1
FR PESHAWAR,16,Male,783,0,783
FR PESHAWAR,16,Female,708,0,708
FR PESHAWAR,16,Transgender,0,0,0
FR PESHAWAR,17,Male,760,0,760
FR PESHAWAR,17,Female,786,0,786
FR PESHAWAR,17,Transgender,0,0,0
FR PESHAWAR,18,Male,675,0,675
FR PESHAWAR,18,Female,669,0,669
FR PESHAWAR,18,Transgender,0,0,0
FR PESHAWAR,19,Male,726,0,726
FR PESHAWAR,19,Female,816,0,816
FR PESHAWAR,19,Transgender,0,0,0
FR PESHAWAR,20,Male,572,0,572
FR PESHAWAR,20,Female,579,0,579
FR PESHAWAR,20,Transgender,0,0,0
FR PESHAWAR,21,Male,711,0,711
FR PESHAWAR,21,Female,828,0,828
FR PESHAWAR,21,Transgender,0,0,0
FR PESHAWAR,22,Male,514,0,514
FR PESHAWAR,22,Female,559,0,559
FR PESHAWAR,22,Transgender,0,0,0
FR PESHAWAR,23,Male,580,0,580
FR PESHAWAR,23,Female,683,0,683
FR PESHAWAR,23,Transgender,0,0,0
FR PESHAWAR,24,Male,515,0,515
FR PESHAWAR,24,Female,639,0,639
FR PESHAWAR,24,Transgender,0,0,0
FR PESHAWAR,25,Male,384,0,384
FR PESHAWAR,25,Female,412,0,412
FR PESHAWAR,25,Transgender,0,0,0
FR PESHAWAR,26,Male,477,0,477
FR PESHAWAR,26,Female,606,0,606
FR PESHAWAR,26,Transgender,0,0,0
FR PESHAWAR,27,Male,478,0,478
FR PESHAWAR,27,Female,679,0,679
FR PESHAWAR,27,Transgender,0,0,0
FR PESHAWAR,28,Male,415,0,415
FR PESHAWAR,28,Female,466,0,466
FR PESHAWAR,28,Transgender,0,0,0
FR PESHAWAR,29,Male,461,0,461
FR PESHAWAR,29,Female,563,0,563
FR PESHAWAR,29,Transgender,0,0,0
FR PESHAWAR,30,Male,328,0,328
FR PESHAWAR,30,Female,350,0,350
FR PESHAWAR,30,Transgender,0,0,0
FR PESHAWAR,31,Male,457,0,457
FR PESHAWAR,31,Female,581,0,581
FR PESHAWAR,31,Transgender,1,0,1
FR PESHAWAR,32,Male,354,0,354
FR PESHAWAR,32,Female,430,0,430
FR PESHAWAR,32,Transgender,0,0,0
FR PESHAWAR,33,Male,439,0,439
FR PESHAWAR,33,Female,422,0,422
FR PESHAWAR,33,Transgender,0,0,0
FR PESHAWAR,34,Male,357,0,357
FR PESHAWAR,34,Female,443,0,443
FR PESHAWAR,34,Transgender,0,0,0
FR PESHAWAR,35,Male,237,0,237
FR PESHAWAR,35,Female,227,0,227
FR PESHAWAR,35,Transgender,0,0,0
FR PESHAWAR,36,Male,319,0,319
FR PESHAWAR,36,Female,333,0,333
FR PESHAWAR,36,Transgender,0,0,0
FR PESHAWAR,37,Male,284,0,284
FR PESHAWAR,37,Female,371,0,371
FR PESHAWAR,37,Transgender,0,0,0
FR PESHAWAR,38,Male,277,0,277
FR PESHAWAR,38,Female,326,0,326
FR PESHAWAR,38,Transgender,1,0,1
FR PESHAWAR,39,Male,295,0,295
FR PESHAWAR,39,Female,366,0,366
FR PESHAWAR,39,Transgender,0,0,0
FR PESHAWAR,40,Male,217,0,217
FR PESHAWAR,40,Female,244,0,244
FR PESHAWAR,40,Transgender,0,0,0
FR PESHAWAR,41,Male,295,0,295
FR PESHAWAR,41,Female,392,0,392
FR PESHAWAR,41,Transgender,0,0,0
FR PESHAWAR,42,Male,196,0,196
FR PESHAWAR,42,Female,260,0,260
FR PESHAWAR,42,Transgender,0,0,0
FR PESHAWAR,43,Male,241,0,241
FR PESHAWAR,43,Female,281,0,281
FR PESHAWAR,43,Transgender,0,0,0
FR PESHAWAR,44,Male,210,0,210
FR PESHAWAR,44,Female,271,0,271
FR PESHAWAR,44,Transgender,0,0,0
FR PESHAWAR,45,Male,130,0,130
FR PESHAWAR,45,Female,183,0,183
FR PESHAWAR,45,Transgender,0,0,0
FR PESHAWAR,46,Male,215,0,215
FR PESHAWAR,46,Female,288,0,288
FR PESHAWAR,46,Transgender,0,0,0
FR PESHAWAR,47,Male,187,0,187
FR PESHAWAR,47,Female,270,0,270
FR PESHAWAR,47,Transgender,0,0,0
FR PESHAWAR,48,Male,176,0,176
FR PESHAWAR,48,Female,215,0,215
FR PESHAWAR,48,Transgender,0,0,0
FR PESHAWAR,49,Male,169,0,169
FR PESHAWAR,49,Female,223,0,223
FR PESHAWAR,49,Transgender,0,0,0
FR PESHAWAR,50,Male,131,0,131
FR PESHAWAR,50,Female,142,0,142
FR PESHAWAR,50,Transgender,0,0,0
FR PESHAWAR,51,Male,164,0,164
FR PESHAWAR,51,Female,232,0,232
FR PESHAWAR,51,Transgender,0,0,0
FR PESHAWAR,52,Male,128,0,128
FR PESHAWAR,52,Female,188,0,188
FR PESHAWAR,52,Transgender,0,0,0
FR PESHAWAR,53,Male,171,0,171
FR PESHAWAR,53,Female,169,0,169
FR PESHAWAR,53,Transgender,0,0,0
FR PESHAWAR,54,Male,133,0,133
FR PESHAWAR,54,Female,171,0,171
FR PESHAWAR,54,Transgender,0,0,0
FR PESHAWAR,55,Male,121,0,121
FR PESHAWAR,55,Female,112,0,112
FR PESHAWAR,55,Transgender,1,0,1
FR PESHAWAR,56,Male,125,0,125
FR PESHAWAR,56,Female,185,0,185
FR PESHAWAR,56,Transgender,0,0,0
FR PESHAWAR,57,Male,140,0,140
FR PESHAWAR,57,Female,244,0,244
FR PESHAWAR,57,Transgender,0,0,0
FR PESHAWAR,58,Male,167,0,167
FR PESHAWAR,58,Female,167,0,167
FR PESHAWAR,58,Transgender,0,0,0
FR PESHAWAR,59,Male,137,0,137
FR PESHAWAR,59,Female,160,0,160
FR PESHAWAR,59,Transgender,0,0,0
FR PESHAWAR,60,Male,93,0,93
FR PESHAWAR,60,Female,104,0,104
FR PESHAWAR,60,Transgender,0,0,0
FR PESHAWAR,61,Male,160,0,160
FR PESHAWAR,61,Female,141,0,141
FR PESHAWAR,61,Transgender,0,0,0
FR PESHAWAR,62,Male,115,0,115
FR PESHAWAR,62,Female,149,0,149
FR PESHAWAR,62,Transgender,0,0,0
FR PESHAWAR,63,Male,139,0,139
FR PESHAWAR,63,Female,113,0,113
FR PESHAWAR,63,Transgender,0,0,0
FR PESHAWAR,64,Male,127,0,127
FR PESHAWAR,64,Female,139,0,139
FR PESHAWAR,64,Transgender,0,0,0
FR PESHAWAR,65,Male,88,0,88
FR PESHAWAR,65,Female,86,0,86
FR PESHAWAR,65,Transgender,0,0,0
FR PESHAWAR,66,Male,90,0,90
FR PESHAWAR,66,Female,116,0,116
FR PESHAWAR,66,Transgender,0,0,0
FR PESHAWAR,67,Male,106,0,106
FR PESHAWAR,67,Female,120,0,120
FR PESHAWAR,67,Transgender,0,0,0
FR PESHAWAR,68,Male,109,0,109
FR PESHAWAR,68,Female,97,0,97
FR PESHAWAR,68,Transgender,0,0,0
FR PESHAWAR,69,Male,93,0,93
FR PESHAWAR,69,Female,95,0,95
FR PESHAWAR,69,Transgender,0,0,0
FR PESHAWAR,70,Male,48,0,48
FR PESHAWAR,70,Female,53,0,53
FR PESHAWAR,70,Transgender,0,0,0
FR PESHAWAR,71,Male,70,0,70
FR PESHAWAR,71,Female,62,0,62
FR PESHAWAR,71,Transgender,0,0,0
FR PESHAWAR,72,Male,48,0,48
FR PESHAWAR,72,Female,83,0,83
FR PESHAWAR,72,Transgender,0,0,0
FR PESHAWAR,73,Male,64,0,64
FR PESHAWAR,73,Female,52,0,52
FR PESHAWAR,73,Transgender,0,0,0
FR PESHAWAR,74,Male,55,0,55
FR PESHAWAR,74,Female,50,0,50
FR PESHAWAR,74,Transgender,0,0,0
FR PESHAWAR,>=75,Male,422,0,422
FR PESHAWAR,>=75,Female,430,0,430
FR PESHAWAR,>=75,Transgender,0,0,0
FR TANK,<1,Male,460,0,460
FR TANK,<1,Female,423,0,423
FR TANK,<1,Transgender,0,0,0
FR TANK,1,Male,598,0,598
FR TANK,1,Female,650,0,650
FR TANK,1,Transgender,0,0,0
FR TANK,2,Male,714,0,714
FR TANK,2,Female,685,0,685
FR TANK,2,Transgender,0,0,0
FR TANK,3,Male,756,0,756
FR TANK,3,Female,661,0,661
FR TANK,3,Transgender,0,0,0
FR TANK,4,Male,707,0,707
FR TANK,4,Female,709,0,709
FR TANK,4,Transgender,0,0,0
FR TANK,5,Male,664,0,664
FR TANK,5,Female,622,0,622
FR TANK,5,Transgender,0,0,0
FR TANK,6,Male,708,0,708
FR TANK,6,Female,684,0,684
FR TANK,6,Transgender,0,0,0
FR TANK,7,Male,665,0,665
FR TANK,7,Female,512,0,512
FR TANK,7,Transgender,0,0,0
FR TANK,8,Male,742,0,742
FR TANK,8,Female,651,0,651
FR TANK,8,Transgender,0,0,0
FR TANK,9,Male,592,0,592
FR TANK,9,Female,518,0,518
FR TANK,9,Transgender,0,0,0
FR TANK,10,Male,608,0,608
FR TANK,10,Female,535,0,535
FR TANK,10,Transgender,0,0,0
FR TANK,11,Male,464,0,464
FR TANK,11,Female,428,0,428
FR TANK,11,Transgender,0,0,0
FR TANK,12,Male,505,0,505
FR TANK,12,Female,398,0,398
FR TANK,12,Transgender,0,0,0
FR TANK,13,Male,490,0,490
FR TANK,13,Female,387,0,387
FR TANK,13,Transgender,0,0,0
FR TANK,14,Male,431,0,431
FR TANK,14,Female,362,0,362
FR TANK,14,Transgender,0,0,0
FR TANK,15,Male,398,0,398
FR TANK,15,Female,347,0,347
FR TANK,15,Transgender,0,0,0
FR TANK,16,Male,341,0,341
FR TANK,16,Female,341,0,341
FR TANK,16,Transgender,0,0,0
FR TANK,17,Male,315,0,315
FR TANK,17,Female,335,0,335
FR TANK,17,Transgender,0,0,0
FR TANK,18,Male,320,0,320
FR TANK,18,Female,317,0,317
FR TANK,18,Transgender,0,0,0
FR TANK,19,Male,299,0,299
FR TANK,19,Female,305,0,305
FR TANK,19,Transgender,0,0,0
FR TANK,20,Male,300,0,300
FR TANK,20,Female,342,0,342
FR TANK,20,Transgender,0,0,0
FR TANK,21,Male,287,0,287
FR TANK,21,Female,303,0,303
FR TANK,21,Transgender,0,0,0
FR TANK,22,Male,297,0,297
FR TANK,22,Female,237,0,237
FR TANK,22,Transgender,1,0,1
FR TANK,23,Male,322,0,322
FR TANK,23,Female,263,0,263
FR TANK,23,Transgender,0,0,0
FR TANK,24,Male,312,0,312
FR TANK,24,Female,273,0,273
FR TANK,24,Transgender,0,0,0
FR TANK,25,Male,313,0,313
FR TANK,25,Female,316,0,316
FR TANK,25,Transgender,0,0,0
FR TANK,26,Male,331,0,331
FR TANK,26,Female,365,0,365
FR TANK,26,Transgender,0,0,0
FR TANK,27,Male,298,0,298
FR TANK,27,Female,320,0,320
FR TANK,27,Transgender,0,0,0
FR TANK,28,Male,309,0,309
FR TANK,28,Female,244,0,244
FR TANK,28,Transgender,0,0,0
FR TANK,29,Male,249,0,249
FR TANK,29,Female,302,0,302
FR TANK,29,Transgender,0,0,0
FR TANK,30,Male,232,0,232
FR TANK,30,Female,233,0,233
FR TANK,30,Transgender,0,0,0
FR TANK,31,Male,315,0,315
FR TANK,31,Female,252,0,252
FR TANK,31,Transgender,0,0,0
FR TANK,32,Male,223,0,223
FR TANK,32,Female,183,0,183
FR TANK,32,Transgender,0,0,0
FR TANK,33,Male,224,0,224
FR TANK,33,Female,168,0,168
FR TANK,33,Transgender,0,0,0
FR TANK,34,Male,188,0,188
FR TANK,34,Female,156,0,156
FR TANK,34,Transgender,0,0,0
FR TANK,35,Male,168,0,168
FR TANK,35,Female,179,0,179
FR TANK,35,Transgender,0,0,0
FR TANK,36,Male,196,0,196
FR TANK,36,Female,175,0,175
FR TANK,36,Transgender,0,0,0
FR TANK,37,Male,155,0,155
FR TANK,37,Female,149,0,149
FR TANK,37,Transgender,0,0,0
FR TANK,38,Male,167,0,167
FR TANK,38,Female,131,0,131
FR TANK,38,Transgender,0,0,0
FR TANK,39,Male,141,0,141
FR TANK,39,Female,153,0,153
FR TANK,39,Transgender,0,0,0
FR TANK,40,Male,147,0,147
FR TANK,40,Female,151,0,151
FR TANK,40,Transgender,0,0,0
FR TANK,41,Male,156,0,156
FR TANK,41,Female,153,0,153
FR TANK,41,Transgender,0,0,0
FR TANK,42,Male,118,0,118
FR TANK,42,Female,104,0,104
FR TANK,42,Transgender,1,0,1
FR TANK,43,Male,151,0,151
FR TANK,43,Female,119,0,119
FR TANK,43,Transgender,0,0,0
FR TANK,44,Male,119,0,119
FR TANK,44,Female,110,0,110
FR TANK,44,Transgender,0,0,0
FR TANK,45,Male,77,0,77
FR TANK,45,Female,104,0,104
FR TANK,45,Transgender,0,0,0
FR TANK,46,Male,98,0,98
FR TANK,46,Female,119,0,119
FR TANK,46,Transgender,0,0,0
FR TANK,47,Male,91,0,91
FR TANK,47,Female,110,0,110
FR TANK,47,Transgender,0,0,0
FR TANK,48,Male,105,0,105
FR TANK,48,Female,101,0,101
FR TANK,48,Transgender,0,0,0
FR TANK,49,Male,100,0,100
FR TANK,49,Female,119,0,119
FR TANK,49,Transgender,0,0,0
FR TANK,50,Male,92,0,92
FR TANK,50,Female,123,0,123
FR TANK,50,Transgender,0,0,0
FR TANK,51,Male,108,0,108
FR TANK,51,Female,134,0,134
FR TANK,51,Transgender,0,0,0
FR TANK,52,Male,84,0,84
FR TANK,52,Female,105,0,105
FR TANK,52,Transgender,0,0,0
FR TANK,53,Male,115,0,115
FR TANK,53,Female,104,0,104
FR TANK,53,Transgender,0,0,0
FR TANK,54,Male,114,0,114
FR TANK,54,Female,89,0,89
FR TANK,54,Transgender,0,0,0
FR TANK,55,Male,90,0,90
FR TANK,55,Female,74,0,74
FR TANK,55,Transgender,0,0,0
FR TANK,56,Male,88,0,88
FR TANK,56,Female,83,0,83
FR TANK,56,Transgender,0,0,0
FR TANK,57,Male,98,0,98
FR TANK,57,Female,96,0,96
FR TANK,57,Transgender,0,0,0
FR TANK,58,Male,99,0,99
FR TANK,58,Female,76,0,76
FR TANK,58,Transgender,0,0,0
FR TANK,59,Male,72,0,72
FR TANK,59,Female,64,0,64
FR TANK,59,Transgender,0,0,0
FR TANK,60,Male,83,0,83
FR TANK,60,Female,72,0,72
FR TANK,60,Transgender,0,0,0
FR TANK,61,Male,59,0,59
FR TANK,61,Female,65,0,65
FR TANK,61,Transgender,0,0,0
FR TANK,62,Male,63,0,63
FR TANK,62,Female,45,0,45
FR TANK,62,Transgender,0,0,0
FR TANK,63,Male,60,0,60
FR TANK,63,Female,59,0,59
FR TANK,63,Transgender,0,0,0
FR TANK,64,Male,57,0,57
FR TANK,64,Female,61,0,61
FR TANK,64,Transgender,0,0,0
FR TANK,65,Male,48,0,48
FR TANK,65,Female,55,0,55
FR TANK,65,Transgender,0,0,0
FR TANK,66,Male,60,0,60
FR TANK,66,Female,54,0,54
FR TANK,66,Transgender,0,0,0
FR TANK,67,Male,52,0,52
FR TANK,67,Female,39,0,39
FR TANK,67,Transgender,0,0,0
FR TANK,68,Male,31,0,31
FR TANK,68,Female,32,0,32
FR TANK,68,Transgender,0,0,0
FR TANK,69,Male,26,0,26
FR TANK,69,Female,35,0,35
FR TANK,69,Transgender,0,0,0
FR TANK,70,Male,37,0,37
FR TANK,70,Female,52,0,52
FR TANK,70,Transgender,0,0,0
FR TANK,71,Male,22,0,22
FR TANK,71,Female,44,0,44
FR TANK,71,Transgender,0,0,0
FR TANK,72,Male,30,0,30
FR TANK,72,Female,28,0,28
FR TANK,72,Transgender,1,0,1
FR TANK,73,Male,31,0,31
FR TANK,73,Female,33,0,33
FR TANK,73,Transgender,0,0,0
FR TANK,74,Male,22,0,22
FR TANK,74,Female,23,0,23
FR TANK,74,Transgender,0,0,0
FR TANK,>=75,Male,176,0,176
FR TANK,>=75,Female,183,0,183
FR TANK,>=75,Transgender,0,0,0
GHOTKI DISTRICT,<1,Male,19386,4715,24101
GHOTKI DISTRICT,<1,Female,18108,4221,22329
GHOTKI DISTRICT,<1,Transgender,0,0,0
GHOTKI DISTRICT,1,Male,19150,5085,24235
GHOTKI DISTRICT,1,Female,18580,4825,23405
GHOTKI DISTRICT,1,Transgender,0,0,0
GHOTKI DISTRICT,2,Male,22828,5303,28131
GHOTKI DISTRICT,2,Female,22997,4842,27839
GHOTKI DISTRICT,2,Transgender,0,0,0
GHOTKI DISTRICT,3,Male,24098,5836,29934
GHOTKI DISTRICT,3,Female,22969,5518,28487
GHOTKI DISTRICT,3,Transgender,0,0,0
GHOTKI DISTRICT,4,Male,25895,5802,31697
GHOTKI DISTRICT,4,Female,24503,5535,30038
GHOTKI DISTRICT,4,Transgender,0,0,0
GHOTKI DISTRICT,5,Male,24595,6003,30598
GHOTKI DISTRICT,5,Female,22276,5477,27753
GHOTKI DISTRICT,5,Transgender,0,0,0
GHOTKI DISTRICT,6,Male,25059,5560,30619
GHOTKI DISTRICT,6,Female,23518,5154,28672
GHOTKI DISTRICT,6,Transgender,0,0,0
GHOTKI DISTRICT,7,Male,23394,5989,29383
GHOTKI DISTRICT,7,Female,20813,5458,26271
GHOTKI DISTRICT,7,Transgender,0,0,0
GHOTKI DISTRICT,8,Male,27194,6093,33287
GHOTKI DISTRICT,8,Female,24361,5321,29682
GHOTKI DISTRICT,8,Transgender,0,0,0
GHOTKI DISTRICT,9,Male,21120,5552,26672
GHOTKI DISTRICT,9,Female,18062,4932,22994
GHOTKI DISTRICT,9,Transgender,0,0,0
GHOTKI DISTRICT,10,Male,24127,5506,29633
GHOTKI DISTRICT,10,Female,20962,4813,25775
GHOTKI DISTRICT,10,Transgender,0,0,0
GHOTKI DISTRICT,11,Male,16573,4870,21443
GHOTKI DISTRICT,11,Female,14137,4285,18422
GHOTKI DISTRICT,11,Transgender,0,0,0
GHOTKI DISTRICT,12,Male,19362,4852,24214
GHOTKI DISTRICT,12,Female,16264,4198,20462
GHOTKI DISTRICT,12,Transgender,0,0,0
GHOTKI DISTRICT,13,Male,15285,4606,19891
GHOTKI DISTRICT,13,Female,12581,3928,16509
GHOTKI DISTRICT,13,Transgender,0,0,0
GHOTKI DISTRICT,14,Male,15862,4392,20254
GHOTKI DISTRICT,14,Female,13448,3933,17381
GHOTKI DISTRICT,14,Transgender,0,0,0
GHOTKI DISTRICT,15,Male,15110,4622,19732
GHOTKI DISTRICT,15,Female,11929,4050,15979
GHOTKI DISTRICT,15,Transgender,4,0,4
GHOTKI DISTRICT,16,Male,14719,4357,19076
GHOTKI DISTRICT,16,Female,12205,3924,16129
GHOTKI DISTRICT,16,Transgender,3,1,4
GHOTKI DISTRICT,17,Male,13120,4326,17446
GHOTKI DISTRICT,17,Female,10453,3776,14229
GHOTKI DISTRICT,17,Transgender,1,1,2
GHOTKI DISTRICT,18,Male,15046,4382,19428
GHOTKI DISTRICT,18,Female,14860,4358,19218
GHOTKI DISTRICT,18,Transgender,7,3,10
GHOTKI DISTRICT,19,Male,12708,4024,16732
GHOTKI DISTRICT,19,Female,11973,3833,15806
GHOTKI DISTRICT,19,Transgender,3,0,3
GHOTKI DISTRICT,20,Male,13273,3842,17115
GHOTKI DISTRICT,20,Female,12717,3627,16344
GHOTKI DISTRICT,20,Transgender,6,3,9
GHOTKI DISTRICT,21,Male,9667,3283,12950
GHOTKI DISTRICT,21,Female,9590,3279,12869
GHOTKI DISTRICT,21,Transgender,2,2,4
GHOTKI DISTRICT,22,Male,10079,3186,13265
GHOTKI DISTRICT,22,Female,9379,3164,12543
GHOTKI DISTRICT,22,Transgender,4,2,6
GHOTKI DISTRICT,23,Male,8265,2984,11249
GHOTKI DISTRICT,23,Female,8493,3042,11535
GHOTKI DISTRICT,23,Transgender,1,2,3
GHOTKI DISTRICT,24,Male,7929,2764,10693
GHOTKI DISTRICT,24,Female,8032,2809,10841
GHOTKI DISTRICT,24,Transgender,2,1,3
GHOTKI DISTRICT,25,Male,9383,2786,12169
GHOTKI DISTRICT,25,Female,9886,2874,12760
GHOTKI DISTRICT,25,Transgender,4,3,7
GHOTKI DISTRICT,26,Male,8214,2828,11042
GHOTKI DISTRICT,26,Female,8256,2844,11100
GHOTKI DISTRICT,26,Transgender,2,0,2
GHOTKI DISTRICT,27,Male,7841,2733,10574
GHOTKI DISTRICT,27,Female,8072,2819,10891
GHOTKI DISTRICT,27,Transgender,2,1,3
GHOTKI DISTRICT,28,Male,8584,2920,11504
GHOTKI DISTRICT,28,Female,9554,2999,12553
GHOTKI DISTRICT,28,Transgender,7,0,7
GHOTKI DISTRICT,29,Male,8033,2686,10719
GHOTKI DISTRICT,29,Female,8604,2607,11211
GHOTKI DISTRICT,29,Transgender,4,2,6
GHOTKI DISTRICT,30,Male,8667,2585,11252
GHOTKI DISTRICT,30,Female,9290,2670,11960
GHOTKI DISTRICT,30,Transgender,8,5,13
GHOTKI DISTRICT,31,Male,8139,2513,10652
GHOTKI DISTRICT,31,Female,8449,2493,10942
GHOTKI DISTRICT,31,Transgender,0,2,2
GHOTKI DISTRICT,32,Male,7465,2368,9833
GHOTKI DISTRICT,32,Female,7670,2387,10057
GHOTKI DISTRICT,32,Transgender,1,1,2
GHOTKI DISTRICT,33,Male,7169,2306,9475
GHOTKI DISTRICT,33,Female,7844,2353,10197
GHOTKI DISTRICT,33,Transgender,1,0,1
GHOTKI DISTRICT,34,Male,7212,2242,9454
GHOTKI DISTRICT,34,Female,7400,2182,9582
GHOTKI DISTRICT,34,Transgender,1,0,1
GHOTKI DISTRICT,35,Male,7713,2233,9946
GHOTKI DISTRICT,35,Female,7242,2128,9370
GHOTKI DISTRICT,35,Transgender,5,4,9
GHOTKI DISTRICT,36,Male,7689,2141,9830
GHOTKI DISTRICT,36,Female,7201,2063,9264
GHOTKI DISTRICT,36,Transgender,2,1,3
GHOTKI DISTRICT,37,Male,7487,1986,9473
GHOTKI DISTRICT,37,Female,7131,1968,9099
GHOTKI DISTRICT,37,Transgender,0,0,0
GHOTKI DISTRICT,38,Male,6543,2264,8807
GHOTKI DISTRICT,38,Female,6483,2128,8611
GHOTKI DISTRICT,38,Transgender,1,1,2
GHOTKI DISTRICT,39,Male,6360,2082,8442
GHOTKI DISTRICT,39,Female,6346,1902,8248
GHOTKI DISTRICT,39,Transgender,2,0,2
GHOTKI DISTRICT,40,Male,5578,1987,7565
GHOTKI DISTRICT,40,Female,6084,1785,7869
GHOTKI DISTRICT,40,Transgender,3,1,4
GHOTKI DISTRICT,41,Male,5459,1727,7186
GHOTKI DISTRICT,41,Female,5577,1759,7336
GHOTKI DISTRICT,41,Transgender,0,1,1
GHOTKI DISTRICT,42,Male,5145,1625,6770
GHOTKI DISTRICT,42,Female,5385,1587,6972
GHOTKI DISTRICT,42,Transgender,1,2,3
GHOTKI DISTRICT,43,Male,4409,1702,6111
GHOTKI DISTRICT,43,Female,4725,1475,6200
GHOTKI DISTRICT,43,Transgender,2,0,2
GHOTKI DISTRICT,44,Male,4404,1609,6013
GHOTKI DISTRICT,44,Female,4467,1397,5864
GHOTKI DISTRICT,44,Transgender,0,2,2
GHOTKI DISTRICT,45,Male,4458,1417,5875
GHOTKI DISTRICT,45,Female,4389,1267,5656
GHOTKI DISTRICT,45,Transgender,4,0,4
GHOTKI DISTRICT,46,Male,4456,1541,5997
GHOTKI DISTRICT,46,Female,4173,1269,5442
GHOTKI DISTRICT,46,Transgender,1,2,3
GHOTKI DISTRICT,47,Male,4499,1384,5883
GHOTKI DISTRICT,47,Female,4215,1133,5348
GHOTKI DISTRICT,47,Transgender,0,0,0
GHOTKI DISTRICT,48,Male,4360,1366,5726
GHOTKI DISTRICT,48,Female,3999,1261,5260
GHOTKI DISTRICT,48,Transgender,0,0,0
GHOTKI DISTRICT,49,Male,4046,1264,5310
GHOTKI DISTRICT,49,Female,3611,1100,4711
GHOTKI DISTRICT,49,Transgender,1,3,4
GHOTKI DISTRICT,50,Male,3950,1277,5227
GHOTKI DISTRICT,50,Female,3779,1100,4879
GHOTKI DISTRICT,50,Transgender,0,1,1
GHOTKI DISTRICT,51,Male,3794,1135,4929
GHOTKI DISTRICT,51,Female,3112,947,4059
GHOTKI DISTRICT,51,Transgender,0,0,0
GHOTKI DISTRICT,52,Male,3164,1103,4267
GHOTKI DISTRICT,52,Female,2822,820,3642
GHOTKI DISTRICT,52,Transgender,4,1,5
GHOTKI DISTRICT,53,Male,3125,963,4088
GHOTKI DISTRICT,53,Female,2462,787,3249
GHOTKI DISTRICT,53,Transgender,1,0,1
GHOTKI DISTRICT,54,Male,2853,899,3752
GHOTKI DISTRICT,54,Female,2385,749,3134
GHOTKI DISTRICT,54,Transgender,0,0,0
GHOTKI DISTRICT,55,Male,2710,847,3557
GHOTKI DISTRICT,55,Female,2442,747,3189
GHOTKI DISTRICT,55,Transgender,0,2,2
GHOTKI DISTRICT,56,Male,2395,795,3190
GHOTKI DISTRICT,56,Female,2097,603,2700
GHOTKI DISTRICT,56,Transgender,0,0,0
GHOTKI DISTRICT,57,Male,2279,690,2969
GHOTKI DISTRICT,57,Female,2173,557,2730
GHOTKI DISTRICT,57,Transgender,0,1,1
GHOTKI DISTRICT,58,Male,2110,645,2755
GHOTKI DISTRICT,58,Female,2131,668,2799
GHOTKI DISTRICT,58,Transgender,0,1,1
GHOTKI DISTRICT,59,Male,2065,627,2692
GHOTKI DISTRICT,59,Female,2111,623,2734
GHOTKI DISTRICT,59,Transgender,1,0,1
GHOTKI DISTRICT,60,Male,2325,638,2963
GHOTKI DISTRICT,60,Female,2470,723,3193
GHOTKI DISTRICT,60,Transgender,1,0,1
GHOTKI DISTRICT,61,Male,1959,604,2563
GHOTKI DISTRICT,61,Female,2289,693,2982
GHOTKI DISTRICT,61,Transgender,0,0,0
GHOTKI DISTRICT,62,Male,1972,586,2558
GHOTKI DISTRICT,62,Female,2176,622,2798
GHOTKI DISTRICT,62,Transgender,1,0,1
GHOTKI DISTRICT,63,Male,1871,573,2444
GHOTKI DISTRICT,63,Female,2075,560,2635
GHOTKI DISTRICT,63,Transgender,1,0,1
GHOTKI DISTRICT,64,Male,1793,519,2312
GHOTKI DISTRICT,64,Female,1839,497,2336
GHOTKI DISTRICT,64,Transgender,1,0,1
GHOTKI DISTRICT,65,Male,1733,457,2190
GHOTKI DISTRICT,65,Female,1742,440,2182
GHOTKI DISTRICT,65,Transgender,1,0,1
GHOTKI DISTRICT,66,Male,1682,449,2131
GHOTKI DISTRICT,66,Female,1576,408,1984
GHOTKI DISTRICT,66,Transgender,1,0,1
GHOTKI DISTRICT,67,Male,1420,361,1781
GHOTKI DISTRICT,67,Female,1386,352,1738
GHOTKI DISTRICT,67,Transgender,1,0,1
GHOTKI DISTRICT,68,Male,1281,322,1603
GHOTKI DISTRICT,68,Female,1276,379,1655
GHOTKI DISTRICT,68,Transgender,0,0,0
GHOTKI DISTRICT,69,Male,1207,296,1503
GHOTKI DISTRICT,69,Female,1154,329,1483
GHOTKI DISTRICT,69,Transgender,0,0,0
GHOTKI DISTRICT,70,Male,1187,297,1484
GHOTKI DISTRICT,70,Female,1309,293,1602
GHOTKI DISTRICT,70,Transgender,5,2,7
GHOTKI DISTRICT,71,Male,1168,258,1426
GHOTKI DISTRICT,71,Female,1127,315,1442
GHOTKI DISTRICT,71,Transgender,0,0,0
GHOTKI DISTRICT,72,Male,858,229,1087
GHOTKI DISTRICT,72,Female,1048,272,1320
GHOTKI DISTRICT,72,Transgender,2,0,2
GHOTKI DISTRICT,73,Male,888,218,1106
GHOTKI DISTRICT,73,Female,802,237,1039
GHOTKI DISTRICT,73,Transgender,0,0,0
GHOTKI DISTRICT,74,Male,765,207,972
GHOTKI DISTRICT,74,Female,800,193,993
GHOTKI DISTRICT,74,Transgender,1,0,1
GHOTKI DISTRICT,>=75,Male,6005,1332,7337
GHOTKI DISTRICT,>=75,Female,6216,1543,7759
GHOTKI DISTRICT,>=75,Transgender,3,2,5
GUJRANWALA DISTRICT,<1,Male,24121,34180,58301
GUJRANWALA DISTRICT,<1,Female,22970,32941,55911
GUJRANWALA DISTRICT,<1,Transgender,0,0,0
GUJRANWALA DISTRICT,1,Male,26243,36659,62902
GUJRANWALA DISTRICT,1,Female,25004,35255,60259
GUJRANWALA DISTRICT,1,Transgender,0,0,0
GUJRANWALA DISTRICT,2,Male,26694,36627,63321
GUJRANWALA DISTRICT,2,Female,25414,34924,60338
GUJRANWALA DISTRICT,2,Transgender,0,0,0
GUJRANWALA DISTRICT,3,Male,28131,39205,67336
GUJRANWALA DISTRICT,3,Female,27186,37756,64942
GUJRANWALA DISTRICT,3,Transgender,0,0,0
GUJRANWALA DISTRICT,4,Male,27269,37053,64322
GUJRANWALA DISTRICT,4,Female,26443,35421,61864
GUJRANWALA DISTRICT,4,Transgender,0,0,0
GUJRANWALA DISTRICT,5,Male,27592,37318,64910
GUJRANWALA DISTRICT,5,Female,26539,36084,62623
GUJRANWALA DISTRICT,5,Transgender,0,0,0
GUJRANWALA DISTRICT,6,Male,27464,36996,64460
GUJRANWALA DISTRICT,6,Female,26216,35087,61303
GUJRANWALA DISTRICT,6,Transgender,0,0,0
GUJRANWALA DISTRICT,7,Male,28583,39409,67992
GUJRANWALA DISTRICT,7,Female,26973,36948,63921
GUJRANWALA DISTRICT,7,Transgender,0,0,0
GUJRANWALA DISTRICT,8,Male,26429,34966,61395
GUJRANWALA DISTRICT,8,Female,24807,33442,58249
GUJRANWALA DISTRICT,8,Transgender,0,0,0
GUJRANWALA DISTRICT,9,Male,27914,37908,65822
GUJRANWALA DISTRICT,9,Female,25836,35617,61453
GUJRANWALA DISTRICT,9,Transgender,0,0,0
GUJRANWALA DISTRICT,10,Male,25169,33433,58602
GUJRANWALA DISTRICT,10,Female,24003,31634,55637
GUJRANWALA DISTRICT,10,Transgender,0,0,0
GUJRANWALA DISTRICT,11,Male,27389,37763,65152
GUJRANWALA DISTRICT,11,Female,26184,35579,61763
GUJRANWALA DISTRICT,11,Transgender,0,0,0
GUJRANWALA DISTRICT,12,Male,24825,33191,58016
GUJRANWALA DISTRICT,12,Female,23002,30909,53911
GUJRANWALA DISTRICT,12,Transgender,0,0,0
GUJRANWALA DISTRICT,13,Male,25716,35014,60730
GUJRANWALA DISTRICT,13,Female,24197,32982,57179
GUJRANWALA DISTRICT,13,Transgender,0,0,0
GUJRANWALA DISTRICT,14,Male,24557,32353,56910
GUJRANWALA DISTRICT,14,Female,22870,30396,53266
GUJRANWALA DISTRICT,14,Transgender,0,0,0
GUJRANWALA DISTRICT,15,Male,23852,32641,56493
GUJRANWALA DISTRICT,15,Female,23482,31223,54705
GUJRANWALA DISTRICT,15,Transgender,4,4,8
GUJRANWALA DISTRICT,16,Male,24247,32711,56958
GUJRANWALA DISTRICT,16,Female,23866,31393,55259
GUJRANWALA DISTRICT,16,Transgender,3,8,11
GUJRANWALA DISTRICT,17,Male,23223,33499,56722
GUJRANWALA DISTRICT,17,Female,23100,31888,54988
GUJRANWALA DISTRICT,17,Transgender,3,9,12
GUJRANWALA DISTRICT,18,Male,22045,30744,52789
GUJRANWALA DISTRICT,18,Female,20920,27556,48476
GUJRANWALA DISTRICT,18,Transgender,8,11,19
GUJRANWALA DISTRICT,19,Male,21757,31669,53426
GUJRANWALA DISTRICT,19,Female,22529,31270,53799
GUJRANWALA DISTRICT,19,Transgender,7,9,16
GUJRANWALA DISTRICT,20,Male,19869,28764,48633
GUJRANWALA DISTRICT,20,Female,20110,26910,47020
GUJRANWALA DISTRICT,20,Transgender,4,20,24
GUJRANWALA DISTRICT,21,Male,20336,31284,51620
GUJRANWALA DISTRICT,21,Female,22754,32694,55448
GUJRANWALA DISTRICT,21,Transgender,7,8,15
GUJRANWALA DISTRICT,22,Male,18962,29109,48071
GUJRANWALA DISTRICT,22,Female,21667,30769,52436
GUJRANWALA DISTRICT,22,Transgender,8,19,27
GUJRANWALA DISTRICT,23,Male,17789,28003,45792
GUJRANWALA DISTRICT,23,Female,20867,30583,51450
GUJRANWALA DISTRICT,23,Transgender,6,5,11
GUJRANWALA DISTRICT,24,Male,17002,27989,44991
GUJRANWALA DISTRICT,24,Female,20044,30278,50322
GUJRANWALA DISTRICT,24,Transgender,7,11,18
GUJRANWALA DISTRICT,25,Male,15174,24298,39472
GUJRANWALA DISTRICT,25,Female,17719,25150,42869
GUJRANWALA DISTRICT,25,Transgender,10,22,32
GUJRANWALA DISTRICT,26,Male,15566,26787,42353
GUJRANWALA DISTRICT,26,Female,18739,28685,47424
GUJRANWALA DISTRICT,26,Transgender,3,11,14
GUJRANWALA DISTRICT,27,Male,14227,24545,38772
GUJRANWALA DISTRICT,27,Female,17129,27004,44133
GUJRANWALA DISTRICT,27,Transgender,3,13,16
GUJRANWALA DISTRICT,28,Male,14480,24657,39137
GUJRANWALA DISTRICT,28,Female,17151,27271,44422
GUJRANWALA DISTRICT,28,Transgender,8,18,26
GUJRANWALA DISTRICT,29,Male,13630,22211,35841
GUJRANWALA DISTRICT,29,Female,15623,23780,39403
GUJRANWALA DISTRICT,29,Transgender,2,7,9
GUJRANWALA DISTRICT,30,Male,13894,22985,36879
GUJRANWALA DISTRICT,30,Female,16343,24819,41162
GUJRANWALA DISTRICT,30,Transgender,8,19,27
GUJRANWALA DISTRICT,31,Male,12721,21378,34099
GUJRANWALA DISTRICT,31,Female,14412,22239,36651
GUJRANWALA DISTRICT,31,Transgender,2,10,12
GUJRANWALA DISTRICT,32,Male,12729,23013,35742
GUJRANWALA DISTRICT,32,Female,15010,23466,38476
GUJRANWALA DISTRICT,32,Transgender,9,15,24
GUJRANWALA DISTRICT,33,Male,11514,20860,32374
GUJRANWALA DISTRICT,33,Female,13828,21526,35354
GUJRANWALA DISTRICT,33,Transgender,5,6,11
GUJRANWALA DISTRICT,34,Male,11429,19154,30583
GUJRANWALA DISTRICT,34,Female,12857,19486,32343
GUJRANWALA DISTRICT,34,Transgender,0,3,3
GUJRANWALA DISTRICT,35,Male,12361,19290,31651
GUJRANWALA DISTRICT,35,Female,13151,19272,32423
GUJRANWALA DISTRICT,35,Transgender,10,15,25
GUJRANWALA DISTRICT,36,Male,12205,18645,30850
GUJRANWALA DISTRICT,36,Female,12292,18363,30655
GUJRANWALA DISTRICT,36,Transgender,3,6,9
GUJRANWALA DISTRICT,37,Male,10986,16450,27436
GUJRANWALA DISTRICT,37,Female,11872,16147,28019
GUJRANWALA DISTRICT,37,Transgender,4,10,14
GUJRANWALA DISTRICT,38,Male,11675,19824,31499
GUJRANWALA DISTRICT,38,Female,12135,20065,32200
GUJRANWALA DISTRICT,38,Transgender,3,4,7
GUJRANWALA DISTRICT,39,Male,11048,16944,27992
GUJRANWALA DISTRICT,39,Female,11820,16669,28489
GUJRANWALA DISTRICT,39,Transgender,1,7,8
GUJRANWALA DISTRICT,40,Male,10998,19332,30330
GUJRANWALA DISTRICT,40,Female,11438,18076,29514
GUJRANWALA DISTRICT,40,Transgender,13,27,40
GUJRANWALA DISTRICT,41,Male,9869,15346,25215
GUJRANWALA DISTRICT,41,Female,10511,14838,25349
GUJRANWALA DISTRICT,41,Transgender,3,3,6
GUJRANWALA DISTRICT,42,Male,9615,15722,25337
GUJRANWALA DISTRICT,42,Female,10265,14762,25027
GUJRANWALA DISTRICT,42,Transgender,2,7,9
GUJRANWALA DISTRICT,43,Male,8970,14551,23521
GUJRANWALA DISTRICT,43,Female,9443,14681,24124
GUJRANWALA DISTRICT,43,Transgender,3,4,7
GUJRANWALA DISTRICT,44,Male,8746,13222,21968
GUJRANWALA DISTRICT,44,Female,8796,13160,21956
GUJRANWALA DISTRICT,44,Transgender,0,1,1
GUJRANWALA DISTRICT,45,Male,8727,14530,23257
GUJRANWALA DISTRICT,45,Female,8493,13535,22028
GUJRANWALA DISTRICT,45,Transgender,6,17,23
GUJRANWALA DISTRICT,46,Male,7834,11512,19346
GUJRANWALA DISTRICT,46,Female,7686,10996,18682
GUJRANWALA DISTRICT,46,Transgender,1,3,4
GUJRANWALA DISTRICT,47,Male,7921,11095,19016
GUJRANWALA DISTRICT,47,Female,7889,9854,17743
GUJRANWALA DISTRICT,47,Transgender,1,7,8
GUJRANWALA DISTRICT,48,Male,8609,12480,21089
GUJRANWALA DISTRICT,48,Female,8038,12739,20777
GUJRANWALA DISTRICT,48,Transgender,2,3,5
GUJRANWALA DISTRICT,49,Male,8439,11785,20224
GUJRANWALA DISTRICT,49,Female,8061,11696,19757
GUJRANWALA DISTRICT,49,Transgender,0,0,0
GUJRANWALA DISTRICT,50,Male,8679,14296,22975
GUJRANWALA DISTRICT,50,Female,8048,13204,21252
GUJRANWALA DISTRICT,50,Transgender,6,11,17
GUJRANWALA DISTRICT,51,Male,7977,10914,18891
GUJRANWALA DISTRICT,51,Female,7409,10362,17771
GUJRANWALA DISTRICT,51,Transgender,1,1,2
GUJRANWALA DISTRICT,52,Male,8383,11590,19973
GUJRANWALA DISTRICT,52,Female,7311,10015,17326
GUJRANWALA DISTRICT,52,Transgender,3,3,6
GUJRANWALA DISTRICT,53,Male,7675,11089,18764
GUJRANWALA DISTRICT,53,Female,6641,10576,17217
GUJRANWALA DISTRICT,53,Transgender,1,0,1
GUJRANWALA DISTRICT,54,Male,7257,10158,17415
GUJRANWALA DISTRICT,54,Female,6092,9400,15492
GUJRANWALA DISTRICT,54,Transgender,1,2,3
GUJRANWALA DISTRICT,55,Male,6971,11054,18025
GUJRANWALA DISTRICT,55,Female,5456,9135,14591
GUJRANWALA DISTRICT,55,Transgender,3,8,11
GUJRANWALA DISTRICT,56,Male,5823,8318,14141
GUJRANWALA DISTRICT,56,Female,4722,6909,11631
GUJRANWALA DISTRICT,56,Transgender,1,1,2
GUJRANWALA DISTRICT,57,Male,5272,7073,12345
GUJRANWALA DISTRICT,57,Female,4519,5294,9813
GUJRANWALA DISTRICT,57,Transgender,1,2,3
GUJRANWALA DISTRICT,58,Male,5503,7362,12865
GUJRANWALA DISTRICT,58,Female,4832,6784,11616
GUJRANWALA DISTRICT,58,Transgender,1,5,6
GUJRANWALA DISTRICT,59,Male,5342,7078,12420
GUJRANWALA DISTRICT,59,Female,4555,6367,10922
GUJRANWALA DISTRICT,59,Transgender,0,0,0
GUJRANWALA DISTRICT,60,Male,5474,8325,13799
GUJRANWALA DISTRICT,60,Female,4640,6822,11462
GUJRANWALA DISTRICT,60,Transgender,6,9,15
GUJRANWALA DISTRICT,61,Male,4777,6620,11397
GUJRANWALA DISTRICT,61,Female,4096,5363,9459
GUJRANWALA DISTRICT,61,Transgender,1,0,1
GUJRANWALA DISTRICT,62,Male,4704,6733,11437
GUJRANWALA DISTRICT,62,Female,3915,5173,9088
GUJRANWALA DISTRICT,62,Transgender,1,2,3
GUJRANWALA DISTRICT,63,Male,4313,6520,10833
GUJRANWALA DISTRICT,63,Female,3745,5525,9270
GUJRANWALA DISTRICT,63,Transgender,2,1,3
GUJRANWALA DISTRICT,64,Male,4007,5422,9429
GUJRANWALA DISTRICT,64,Female,3607,4740,8347
GUJRANWALA DISTRICT,64,Transgender,0,1,1
GUJRANWALA DISTRICT,65,Male,4067,5869,9936
GUJRANWALA DISTRICT,65,Female,3540,4919,8459
GUJRANWALA DISTRICT,65,Transgender,4,4,8
GUJRANWALA DISTRICT,66,Male,2840,3673,6513
GUJRANWALA DISTRICT,66,Female,2571,3209,5780
GUJRANWALA DISTRICT,66,Transgender,0,1,1
GUJRANWALA DISTRICT,67,Male,2651,3222,5873
GUJRANWALA DISTRICT,67,Female,2469,2596,5065
GUJRANWALA DISTRICT,67,Transgender,0,2,2
GUJRANWALA DISTRICT,68,Male,2708,3561,6269
GUJRANWALA DISTRICT,68,Female,2637,3262,5899
GUJRANWALA DISTRICT,68,Transgender,0,2,2
GUJRANWALA DISTRICT,69,Male,2772,3332,6104
GUJRANWALA DISTRICT,69,Female,2725,3161,5886
GUJRANWALA DISTRICT,69,Transgender,0,0,0
GUJRANWALA DISTRICT,70,Male,3759,4364,8123
GUJRANWALA DISTRICT,70,Female,3091,3598,6689
GUJRANWALA DISTRICT,70,Transgender,3,6,9
GUJRANWALA DISTRICT,71,Male,2615,3076,5691
GUJRANWALA DISTRICT,71,Female,2423,2634,5057
GUJRANWALA DISTRICT,71,Transgender,0,2,2
GUJRANWALA DISTRICT,72,Male,2816,3082,5898
GUJRANWALA DISTRICT,72,Female,2287,2498,4785
GUJRANWALA DISTRICT,72,Transgender,0,0,0
GUJRANWALA DISTRICT,73,Male,2471,2956,5427
GUJRANWALA DISTRICT,73,Female,2103,2460,4563
GUJRANWALA DISTRICT,73,Transgender,1,0,1
GUJRANWALA DISTRICT,74,Male,2330,2428,4758
GUJRANWALA DISTRICT,74,Female,1905,2122,4027
GUJRANWALA DISTRICT,74,Transgender,3,0,3
GUJRANWALA DISTRICT,>=75,Male,20293,19747,40040
GUJRANWALA DISTRICT,>=75,Female,16692,17796,34488
GUJRANWALA DISTRICT,>=75,Transgender,11,5,16
GUJRAT DISTRICT,<1,Male,21698,8836,30534
GUJRAT DISTRICT,<1,Female,20827,8582,29409
GUJRAT DISTRICT,<1,Transgender,0,0,0
GUJRAT DISTRICT,1,Male,23431,9596,33027
GUJRAT DISTRICT,1,Female,22499,9103,31602
GUJRAT DISTRICT,1,Transgender,0,0,0
GUJRAT DISTRICT,2,Male,23587,9659,33246
GUJRAT DISTRICT,2,Female,22652,9291,31943
GUJRAT DISTRICT,2,Transgender,0,0,0
GUJRAT DISTRICT,3,Male,24851,10222,35073
GUJRAT DISTRICT,3,Female,23986,10159,34145
GUJRAT DISTRICT,3,Transgender,0,0,0
GUJRAT DISTRICT,4,Male,23792,9587,33379
GUJRAT DISTRICT,4,Female,22351,9186,31537
GUJRAT DISTRICT,4,Transgender,0,0,0
GUJRAT DISTRICT,5,Male,23925,9878,33803
GUJRAT DISTRICT,5,Female,23189,9630,32819
GUJRAT DISTRICT,5,Transgender,0,0,0
GUJRAT DISTRICT,6,Male,23891,9763,33654
GUJRAT DISTRICT,6,Female,22471,9176,31647
GUJRAT DISTRICT,6,Transgender,0,0,0
GUJRAT DISTRICT,7,Male,25683,10535,36218
GUJRAT DISTRICT,7,Female,24097,9855,33952
GUJRAT DISTRICT,7,Transgender,0,0,0
GUJRAT DISTRICT,8,Male,22519,9122,31641
GUJRAT DISTRICT,8,Female,21208,8609,29817
GUJRAT DISTRICT,8,Transgender,0,0,0
GUJRAT DISTRICT,9,Male,25298,10478,35776
GUJRAT DISTRICT,9,Female,23769,9996,33765
GUJRAT DISTRICT,9,Transgender,0,0,0
GUJRAT DISTRICT,10,Male,21021,8567,29588
GUJRAT DISTRICT,10,Female,19987,8109,28096
GUJRAT DISTRICT,10,Transgender,0,0,0
GUJRAT DISTRICT,11,Male,24812,10068,34880
GUJRAT DISTRICT,11,Female,23508,9408,32916
GUJRAT DISTRICT,11,Transgender,0,0,0
GUJRAT DISTRICT,12,Male,21020,8574,29594
GUJRAT DISTRICT,12,Female,19799,7927,27726
GUJRAT DISTRICT,12,Transgender,0,0,0
GUJRAT DISTRICT,13,Male,23475,9405,32880
GUJRAT DISTRICT,13,Female,22150,8961,31111
GUJRAT DISTRICT,13,Transgender,0,0,0
GUJRAT DISTRICT,14,Male,21216,8762,29978
GUJRAT DISTRICT,14,Female,19913,7809,27722
GUJRAT DISTRICT,14,Transgender,0,0,0
GUJRAT DISTRICT,15,Male,20969,8621,29590
GUJRAT DISTRICT,15,Female,20883,8202,29085
GUJRAT DISTRICT,15,Transgender,4,0,4
GUJRAT DISTRICT,16,Male,21797,8442,30239
GUJRAT DISTRICT,16,Female,20898,8178,29076
GUJRAT DISTRICT,16,Transgender,3,0,3
GUJRAT DISTRICT,17,Male,21689,9126,30815
GUJRAT DISTRICT,17,Female,21600,8724,30324
GUJRAT DISTRICT,17,Transgender,3,1,4
GUJRAT DISTRICT,18,Male,18174,7543,25717
GUJRAT DISTRICT,18,Female,17843,6856,24699
GUJRAT DISTRICT,18,Transgender,5,3,8
GUJRAT DISTRICT,19,Male,19938,8375,28313
GUJRAT DISTRICT,19,Female,21142,8537,29679
GUJRAT DISTRICT,19,Transgender,3,1,4
GUJRAT DISTRICT,20,Male,16276,7306,23582
GUJRAT DISTRICT,20,Female,16878,6676,23554
GUJRAT DISTRICT,20,Transgender,2,3,5
GUJRAT DISTRICT,21,Male,18017,8405,26422
GUJRAT DISTRICT,21,Female,21807,9126,30933
GUJRAT DISTRICT,21,Transgender,1,2,3
GUJRAT DISTRICT,22,Male,15362,7419,22781
GUJRAT DISTRICT,22,Female,19511,7802,27313
GUJRAT DISTRICT,22,Transgender,3,0,3
GUJRAT DISTRICT,23,Male,14634,7967,22601
GUJRAT DISTRICT,23,Female,20713,8462,29175
GUJRAT DISTRICT,23,Transgender,7,2,9
GUJRAT DISTRICT,24,Male,13861,7706,21567
GUJRAT DISTRICT,24,Female,19756,8348,28104
GUJRAT DISTRICT,24,Transgender,1,1,2
GUJRAT DISTRICT,25,Male,11854,6698,18552
GUJRAT DISTRICT,25,Female,15856,6699,22555
GUJRAT DISTRICT,25,Transgender,3,3,6
GUJRAT DISTRICT,26,Male,12469,7641,20110
GUJRAT DISTRICT,26,Female,18780,8240,27020
GUJRAT DISTRICT,26,Transgender,3,1,4
GUJRAT DISTRICT,27,Male,11891,7489,19380
GUJRAT DISTRICT,27,Female,18735,8213,26948
GUJRAT DISTRICT,27,Transgender,3,2,5
GUJRAT DISTRICT,28,Male,11616,7129,18745
GUJRAT DISTRICT,28,Female,17368,7471,24839
GUJRAT DISTRICT,28,Transgender,2,4,6
GUJRAT DISTRICT,29,Male,11504,7359,18863
GUJRAT DISTRICT,29,Female,17498,7588,25086
GUJRAT DISTRICT,29,Transgender,1,1,2
GUJRAT DISTRICT,30,Male,11257,6793,18050
GUJRAT DISTRICT,30,Female,15750,6869,22619
GUJRAT DISTRICT,30,Transgender,4,5,9
GUJRAT DISTRICT,31,Male,11127,6957,18084
GUJRAT DISTRICT,31,Female,16351,7238,23589
GUJRAT DISTRICT,31,Transgender,1,1,2
GUJRAT DISTRICT,32,Male,10713,6675,17388
GUJRAT DISTRICT,32,Female,15251,6947,22198
GUJRAT DISTRICT,32,Transgender,5,2,7
GUJRAT DISTRICT,33,Male,10537,6558,17095
GUJRAT DISTRICT,33,Female,15123,6679,21802
GUJRAT DISTRICT,33,Transgender,1,0,1
GUJRAT DISTRICT,34,Male,9625,5991,15616
GUJRAT DISTRICT,34,Female,14004,6128,20132
GUJRAT DISTRICT,34,Transgender,3,1,4
GUJRAT DISTRICT,35,Male,9290,5509,14799
GUJRAT DISTRICT,35,Female,12847,5542,18389
GUJRAT DISTRICT,35,Transgender,6,6,12
GUJRAT DISTRICT,36,Male,8941,5373,14314
GUJRAT DISTRICT,36,Female,12806,5535,18341
GUJRAT DISTRICT,36,Transgender,0,1,1
GUJRAT DISTRICT,37,Male,8288,5047,13335
GUJRAT DISTRICT,37,Female,11565,5041,16606
GUJRAT DISTRICT,37,Transgender,1,1,2
GUJRAT DISTRICT,38,Male,9380,5556,14936
GUJRAT DISTRICT,38,Female,12628,5792,18420
GUJRAT DISTRICT,38,Transgender,5,0,5
GUJRAT DISTRICT,39,Male,8526,4984,13510
GUJRAT DISTRICT,39,Female,12080,5264,17344
GUJRAT DISTRICT,39,Transgender,1,3,4
GUJRAT DISTRICT,40,Male,9081,5339,14420
GUJRAT DISTRICT,40,Female,11528,5153,16681
GUJRAT DISTRICT,40,Transgender,2,8,10
GUJRAT DISTRICT,41,Male,7933,4282,12215
GUJRAT DISTRICT,41,Female,10498,4445,14943
GUJRAT DISTRICT,41,Transgender,1,0,1
GUJRAT DISTRICT,42,Male,7524,4165,11689
GUJRAT DISTRICT,42,Female,9571,4346,13917
GUJRAT DISTRICT,42,Transgender,2,0,2
GUJRAT DISTRICT,43,Male,7439,3949,11388
GUJRAT DISTRICT,43,Female,10073,4475,14548
GUJRAT DISTRICT,43,Transgender,0,2,2
GUJRAT DISTRICT,44,Male,7068,3630,10698
GUJRAT DISTRICT,44,Female,9312,3948,13260
GUJRAT DISTRICT,44,Transgender,0,1,1
GUJRAT DISTRICT,45,Male,7502,3943,11445
GUJRAT DISTRICT,45,Female,8639,3912,12551
GUJRAT DISTRICT,45,Transgender,6,1,7
GUJRAT DISTRICT,46,Male,6847,3247,10094
GUJRAT DISTRICT,46,Female,8395,3247,11642
GUJRAT DISTRICT,46,Transgender,1,3,4
GUJRAT DISTRICT,47,Male,6639,3230,9869
GUJRAT DISTRICT,47,Female,7363,2961,10324
GUJRAT DISTRICT,47,Transgender,0,1,1
GUJRAT DISTRICT,48,Male,7808,3487,11295
GUJRAT DISTRICT,48,Female,8958,3800,12758
GUJRAT DISTRICT,48,Transgender,2,1,3
GUJRAT DISTRICT,49,Male,7329,3233,10562
GUJRAT DISTRICT,49,Female,9008,3689,12697
GUJRAT DISTRICT,49,Transgender,1,2,3
GUJRAT DISTRICT,50,Male,7966,3842,11808
GUJRAT DISTRICT,50,Female,9073,3884,12957
GUJRAT DISTRICT,50,Transgender,8,4,12
GUJRAT DISTRICT,51,Male,6862,3031,9893
GUJRAT DISTRICT,51,Female,8141,3179,11320
GUJRAT DISTRICT,51,Transgender,1,0,1
GUJRAT DISTRICT,52,Male,7192,3141,10333
GUJRAT DISTRICT,52,Female,7783,3256,11039
GUJRAT DISTRICT,52,Transgender,1,1,2
GUJRAT DISTRICT,53,Male,6911,3106,10017
GUJRAT DISTRICT,53,Female,8288,3531,11819
GUJRAT DISTRICT,53,Transgender,2,0,2
GUJRAT DISTRICT,54,Male,6741,2856,9597
GUJRAT DISTRICT,54,Female,7825,3077,10902
GUJRAT DISTRICT,54,Transgender,0,1,1
GUJRAT DISTRICT,55,Male,6851,3103,9954
GUJRAT DISTRICT,55,Female,6967,2897,9864
GUJRAT DISTRICT,55,Transgender,2,0,2
GUJRAT DISTRICT,56,Male,5578,2419,7997
GUJRAT DISTRICT,56,Female,5937,2290,8227
GUJRAT DISTRICT,56,Transgender,0,0,0
GUJRAT DISTRICT,57,Male,4937,2168,7105
GUJRAT DISTRICT,57,Female,4975,1788,6763
GUJRAT DISTRICT,57,Transgender,3,0,3
GUJRAT DISTRICT,58,Male,5785,2240,8025
GUJRAT DISTRICT,58,Female,6253,2239,8492
GUJRAT DISTRICT,58,Transgender,2,2,4
GUJRAT DISTRICT,59,Male,5744,2226,7970
GUJRAT DISTRICT,59,Female,6025,2184,8209
GUJRAT DISTRICT,59,Transgender,0,0,0
GUJRAT DISTRICT,60,Male,6501,2674,9175
GUJRAT DISTRICT,60,Female,6248,2284,8532
GUJRAT DISTRICT,60,Transgender,7,1,8
GUJRAT DISTRICT,61,Male,5825,2328,8153
GUJRAT DISTRICT,61,Female,5745,2086,7831
GUJRAT DISTRICT,61,Transgender,0,0,0
GUJRAT DISTRICT,62,Male,5979,2239,8218
GUJRAT DISTRICT,62,Female,5389,1894,7283
GUJRAT DISTRICT,62,Transgender,3,0,3
GUJRAT DISTRICT,63,Male,5833,2213,8046
GUJRAT DISTRICT,63,Female,5458,2042,7500
GUJRAT DISTRICT,63,Transgender,0,0,0
GUJRAT DISTRICT,64,Male,5098,1810,6908
GUJRAT DISTRICT,64,Female,4981,1576,6557
GUJRAT DISTRICT,64,Transgender,0,1,1
GUJRAT DISTRICT,65,Male,5329,1912,7241
GUJRAT DISTRICT,65,Female,4869,1669,6538
GUJRAT DISTRICT,65,Transgender,5,0,5
GUJRAT DISTRICT,66,Male,4036,1342,5378
GUJRAT DISTRICT,66,Female,3653,1091,4744
GUJRAT DISTRICT,66,Transgender,1,0,1
GUJRAT DISTRICT,67,Male,3759,1216,4975
GUJRAT DISTRICT,67,Female,3260,1015,4275
GUJRAT DISTRICT,67,Transgender,3,0,3
GUJRAT DISTRICT,68,Male,4057,1318,5375
GUJRAT DISTRICT,68,Female,3777,1174,4951
GUJRAT DISTRICT,68,Transgender,0,0,0
GUJRAT DISTRICT,69,Male,3763,1173,4936
GUJRAT DISTRICT,69,Female,3574,1080,4654
GUJRAT DISTRICT,69,Transgender,0,0,0
GUJRAT DISTRICT,70,Male,4319,1378,5697
GUJRAT DISTRICT,70,Female,4019,1227,5246
GUJRAT DISTRICT,70,Transgender,2,0,2
GUJRAT DISTRICT,71,Male,3285,1004,4289
GUJRAT DISTRICT,71,Female,3143,957,4100
GUJRAT DISTRICT,71,Transgender,2,0,2
GUJRAT DISTRICT,72,Male,3509,1085,4594
GUJRAT DISTRICT,72,Female,3112,859,3971
GUJRAT DISTRICT,72,Transgender,2,0,2
GUJRAT DISTRICT,73,Male,3152,1050,4202
GUJRAT DISTRICT,73,Female,2954,861,3815
GUJRAT DISTRICT,73,Transgender,0,0,0
GUJRAT DISTRICT,74,Male,2807,819,3626
GUJRAT DISTRICT,74,Female,2571,705,3276
GUJRAT DISTRICT,74,Transgender,1,0,1
GUJRAT DISTRICT,>=75,Male,23403,6510,29913
GUJRAT DISTRICT,>=75,Female,22853,6219,29072
GUJRAT DISTRICT,>=75,Transgender,15,0,15
GWADAR DISTRICT,<1,Male,1189,1960,3149
GWADAR DISTRICT,<1,Female,1166,1723,2889
GWADAR DISTRICT,<1,Transgender,0,0,0
GWADAR DISTRICT,1,Male,1367,2203,3570
GWADAR DISTRICT,1,Female,1253,1766,3019
GWADAR DISTRICT,1,Transgender,0,0,0
GWADAR DISTRICT,2,Male,1472,2208,3680
GWADAR DISTRICT,2,Female,1373,2055,3428
GWADAR DISTRICT,2,Transgender,0,0,0
GWADAR DISTRICT,3,Male,1610,2367,3977
GWADAR DISTRICT,3,Female,1582,2129,3711
GWADAR DISTRICT,3,Transgender,0,0,0
GWADAR DISTRICT,4,Male,1510,2281,3791
GWADAR DISTRICT,4,Female,1448,2036,3484
GWADAR DISTRICT,4,Transgender,0,0,0
GWADAR DISTRICT,5,Male,1677,2237,3914
GWADAR DISTRICT,5,Female,1663,2183,3846
GWADAR DISTRICT,5,Transgender,0,0,0
GWADAR DISTRICT,6,Male,1542,2135,3677
GWADAR DISTRICT,6,Female,1467,1996,3463
GWADAR DISTRICT,6,Transgender,0,0,0
GWADAR DISTRICT,7,Male,1759,2397,4156
GWADAR DISTRICT,7,Female,1535,2142,3677
GWADAR DISTRICT,7,Transgender,0,0,0
GWADAR DISTRICT,8,Male,1751,2416,4167
GWADAR DISTRICT,8,Female,1565,2163,3728
GWADAR DISTRICT,8,Transgender,0,0,0
GWADAR DISTRICT,9,Male,1450,2267,3717
GWADAR DISTRICT,9,Female,1405,2036,3441
GWADAR DISTRICT,9,Transgender,0,0,0
GWADAR DISTRICT,10,Male,1607,2321,3928
GWADAR DISTRICT,10,Female,1457,2050,3507
GWADAR DISTRICT,10,Transgender,0,0,0
GWADAR DISTRICT,11,Male,1443,2059,3502
GWADAR DISTRICT,11,Female,1211,1836,3047
GWADAR DISTRICT,11,Transgender,0,0,0
GWADAR DISTRICT,12,Male,1262,1986,3248
GWADAR DISTRICT,12,Female,1234,1738,2972
GWADAR DISTRICT,12,Transgender,0,0,0
GWADAR DISTRICT,13,Male,1235,1817,3052
GWADAR DISTRICT,13,Female,1120,1621,2741
GWADAR DISTRICT,13,Transgender,0,0,0
GWADAR DISTRICT,14,Male,1139,1932,3071
GWADAR DISTRICT,14,Female,1115,1579,2694
GWADAR DISTRICT,14,Transgender,0,0,0
GWADAR DISTRICT,15,Male,1210,1927,3137
GWADAR DISTRICT,15,Female,1124,1627,2751
GWADAR DISTRICT,15,Transgender,0,0,0
GWADAR DISTRICT,16,Male,1166,1869,3035
GWADAR DISTRICT,16,Female,971,1543,2514
GWADAR DISTRICT,16,Transgender,0,0,0
GWADAR DISTRICT,17,Male,1148,1900,3048
GWADAR DISTRICT,17,Female,1172,1823,2995
GWADAR DISTRICT,17,Transgender,0,0,0
GWADAR DISTRICT,18,Male,1222,2089,3311
GWADAR DISTRICT,18,Female,982,1719,2701
GWADAR DISTRICT,18,Transgender,0,1,1
GWADAR DISTRICT,19,Male,1180,2047,3227
GWADAR DISTRICT,19,Female,889,1709,2598
GWADAR DISTRICT,19,Transgender,0,1,1
GWADAR DISTRICT,20,Male,1161,1971,3132
GWADAR DISTRICT,20,Female,981,1582,2563
GWADAR DISTRICT,20,Transgender,1,0,1
GWADAR DISTRICT,21,Male,979,1745,2724
GWADAR DISTRICT,21,Female,749,1541,2290
GWADAR DISTRICT,21,Transgender,0,0,0
GWADAR DISTRICT,22,Male,767,1692,2459
GWADAR DISTRICT,22,Female,550,1282,1832
GWADAR DISTRICT,22,Transgender,0,1,1
GWADAR DISTRICT,23,Male,835,1620,2455
GWADAR DISTRICT,23,Female,622,1196,1818
GWADAR DISTRICT,23,Transgender,0,0,0
GWADAR DISTRICT,24,Male,745,1460,2205
GWADAR DISTRICT,24,Female,639,1127,1766
GWADAR DISTRICT,24,Transgender,0,0,0
GWADAR DISTRICT,25,Male,854,1790,2644
GWADAR DISTRICT,25,Female,772,1461,2233
GWADAR DISTRICT,25,Transgender,0,1,1
GWADAR DISTRICT,26,Male,685,1392,2077
GWADAR DISTRICT,26,Female,575,1218,1793
GWADAR DISTRICT,26,Transgender,0,0,0
GWADAR DISTRICT,27,Male,812,1636,2448
GWADAR DISTRICT,27,Female,933,1475,2408
GWADAR DISTRICT,27,Transgender,0,0,0
GWADAR DISTRICT,28,Male,669,1497,2166
GWADAR DISTRICT,28,Female,783,1285,2068
GWADAR DISTRICT,28,Transgender,1,0,1
GWADAR DISTRICT,29,Male,802,1533,2335
GWADAR DISTRICT,29,Female,795,1403,2198
GWADAR DISTRICT,29,Transgender,0,1,1
GWADAR DISTRICT,30,Male,788,1625,2413
GWADAR DISTRICT,30,Female,780,1235,2015
GWADAR DISTRICT,30,Transgender,0,0,0
GWADAR DISTRICT,31,Male,850,1597,2447
GWADAR DISTRICT,31,Female,768,1333,2101
GWADAR DISTRICT,31,Transgender,0,0,0
GWADAR DISTRICT,32,Male,764,1452,2216
GWADAR DISTRICT,32,Female,614,1036,1650
GWADAR DISTRICT,32,Transgender,0,0,0
GWADAR DISTRICT,33,Male,685,1374,2059
GWADAR DISTRICT,33,Female,597,1026,1623
GWADAR DISTRICT,33,Transgender,0,0,0
GWADAR DISTRICT,34,Male,529,1126,1655
GWADAR DISTRICT,34,Female,457,781,1238
GWADAR DISTRICT,34,Transgender,0,1,1
GWADAR DISTRICT,35,Male,707,1377,2084
GWADAR DISTRICT,35,Female,691,933,1624
GWADAR DISTRICT,35,Transgender,0,2,2
GWADAR DISTRICT,36,Male,613,984,1597
GWADAR DISTRICT,36,Female,502,671,1173
GWADAR DISTRICT,36,Transgender,0,0,0
GWADAR DISTRICT,37,Male,868,1141,2009
GWADAR DISTRICT,37,Female,916,989,1905
GWADAR DISTRICT,37,Transgender,0,1,1
GWADAR DISTRICT,38,Male,587,1090,1677
GWADAR DISTRICT,38,Female,465,763,1228
GWADAR DISTRICT,38,Transgender,0,0,0
GWADAR DISTRICT,39,Male,640,1087,1727
GWADAR DISTRICT,39,Female,612,798,1410
GWADAR DISTRICT,39,Transgender,0,0,0
GWADAR DISTRICT,40,Male,469,1171,1640
GWADAR DISTRICT,40,Female,420,731,1151
GWADAR DISTRICT,40,Transgender,0,1,1
GWADAR DISTRICT,41,Male,499,1141,1640
GWADAR DISTRICT,41,Female,425,634,1059
GWADAR DISTRICT,41,Transgender,0,0,0
GWADAR DISTRICT,42,Male,551,888,1439
GWADAR DISTRICT,42,Female,435,641,1076
GWADAR DISTRICT,42,Transgender,0,0,0
GWADAR DISTRICT,43,Male,444,867,1311
GWADAR DISTRICT,43,Female,357,589,946
GWADAR DISTRICT,43,Transgender,0,0,0
GWADAR DISTRICT,44,Male,392,588,980
GWADAR DISTRICT,44,Female,312,474,786
GWADAR DISTRICT,44,Transgender,0,0,0
GWADAR DISTRICT,45,Male,351,785,1136
GWADAR DISTRICT,45,Female,271,492,763
GWADAR DISTRICT,45,Transgender,0,0,0
GWADAR DISTRICT,46,Male,335,544,879
GWADAR DISTRICT,46,Female,248,393,641
GWADAR DISTRICT,46,Transgender,0,0,0
GWADAR DISTRICT,47,Male,404,653,1057
GWADAR DISTRICT,47,Female,407,561,968
GWADAR DISTRICT,47,Transgender,0,0,0
GWADAR DISTRICT,48,Male,287,612,899
GWADAR DISTRICT,48,Female,233,404,637
GWADAR DISTRICT,48,Transgender,0,1,1
GWADAR DISTRICT,49,Male,357,664,1021
GWADAR DISTRICT,49,Female,277,465,742
GWADAR DISTRICT,49,Transgender,0,0,0
GWADAR DISTRICT,50,Male,303,595,898
GWADAR DISTRICT,50,Female,284,455,739
GWADAR DISTRICT,50,Transgender,0,0,0
GWADAR DISTRICT,51,Male,348,564,912
GWADAR DISTRICT,51,Female,250,403,653
GWADAR DISTRICT,51,Transgender,0,0,0
GWADAR DISTRICT,52,Male,312,476,788
GWADAR DISTRICT,52,Female,259,357,616
GWADAR DISTRICT,52,Transgender,0,0,0
GWADAR DISTRICT,53,Male,257,488,745
GWADAR DISTRICT,53,Female,220,390,610
GWADAR DISTRICT,53,Transgender,0,0,0
GWADAR DISTRICT,54,Male,278,441,719
GWADAR DISTRICT,54,Female,237,333,570
GWADAR DISTRICT,54,Transgender,0,0,0
GWADAR DISTRICT,55,Male,209,439,648
GWADAR DISTRICT,55,Female,200,303,503
GWADAR DISTRICT,55,Transgender,0,1,1
GWADAR DISTRICT,56,Male,209,334,543
GWADAR DISTRICT,56,Female,177,281,458
GWADAR DISTRICT,56,Transgender,0,1,1
GWADAR DISTRICT,57,Male,275,421,696
GWADAR DISTRICT,57,Female,261,308,569
GWADAR DISTRICT,57,Transgender,0,0,0
GWADAR DISTRICT,58,Male,214,358,572
GWADAR DISTRICT,58,Female,173,312,485
GWADAR DISTRICT,58,Transgender,0,0,0
GWADAR DISTRICT,59,Male,269,367,636
GWADAR DISTRICT,59,Female,242,422,664
GWADAR DISTRICT,59,Transgender,0,0,0
GWADAR DISTRICT,60,Male,183,341,524
GWADAR DISTRICT,60,Female,197,296,493
GWADAR DISTRICT,60,Transgender,0,0,0
GWADAR DISTRICT,61,Male,185,279,464
GWADAR DISTRICT,61,Female,188,253,441
GWADAR DISTRICT,61,Transgender,0,0,0
GWADAR DISTRICT,62,Male,184,280,464
GWADAR DISTRICT,62,Female,222,237,459
GWADAR DISTRICT,62,Transgender,0,1,1
GWADAR DISTRICT,63,Male,211,306,517
GWADAR DISTRICT,63,Female,207,242,449
GWADAR DISTRICT,63,Transgender,0,0,0
GWADAR DISTRICT,64,Male,305,318,623
GWADAR DISTRICT,64,Female,263,267,530
GWADAR DISTRICT,64,Transgender,0,0,0
GWADAR DISTRICT,65,Male,150,290,440
GWADAR DISTRICT,65,Female,159,226,385
GWADAR DISTRICT,65,Transgender,0,1,1
GWADAR DISTRICT,66,Male,124,152,276
GWADAR DISTRICT,66,Female,100,125,225
GWADAR DISTRICT,66,Transgender,0,0,0
GWADAR DISTRICT,67,Male,148,159,307
GWADAR DISTRICT,67,Female,167,152,319
GWADAR DISTRICT,67,Transgender,0,0,0
GWADAR DISTRICT,68,Male,158,176,334
GWADAR DISTRICT,68,Female,118,170,288
GWADAR DISTRICT,68,Transgender,0,0,0
GWADAR DISTRICT,69,Male,317,196,513
GWADAR DISTRICT,69,Female,213,203,416
GWADAR DISTRICT,69,Transgender,0,0,0
GWADAR DISTRICT,70,Male,116,167,283
GWADAR DISTRICT,70,Female,103,131,234
GWADAR DISTRICT,70,Transgender,0,0,0
GWADAR DISTRICT,71,Male,88,113,201
GWADAR DISTRICT,71,Female,87,95,182
GWADAR DISTRICT,71,Transgender,0,0,0
GWADAR DISTRICT,72,Male,83,93,176
GWADAR DISTRICT,72,Female,76,71,147
GWADAR DISTRICT,72,Transgender,0,0,0
GWADAR DISTRICT,73,Male,99,95,194
GWADAR DISTRICT,73,Female,82,99,181
GWADAR DISTRICT,73,Transgender,0,0,0
GWADAR DISTRICT,74,Male,156,129,285
GWADAR DISTRICT,74,Female,117,127,244
GWADAR DISTRICT,74,Transgender,0,0,0
GWADAR DISTRICT,>=75,Male,750,720,1470
GWADAR DISTRICT,>=75,Female,653,696,1349
GWADAR DISTRICT,>=75,Transgender,0,0,0
HAFIZABAD DISTRICT,<1,Male,9429,4887,14316
HAFIZABAD DISTRICT,<1,Female,8816,4583,13399
HAFIZABAD DISTRICT,<1,Transgender,0,0,0
HAFIZABAD DISTRICT,1,Male,9535,5140,14675
HAFIZABAD DISTRICT,1,Female,9249,4782,14031
HAFIZABAD DISTRICT,1,Transgender,0,0,0
HAFIZABAD DISTRICT,2,Male,9764,5028,14792
HAFIZABAD DISTRICT,2,Female,9395,4608,14003
HAFIZABAD DISTRICT,2,Transgender,0,0,0
HAFIZABAD DISTRICT,3,Male,10436,5334,15770
HAFIZABAD DISTRICT,3,Female,10237,5201,15438
HAFIZABAD DISTRICT,3,Transgender,0,0,0
HAFIZABAD DISTRICT,4,Male,10782,5264,16046
HAFIZABAD DISTRICT,4,Female,10427,5108,15535
HAFIZABAD DISTRICT,4,Transgender,0,0,0
HAFIZABAD DISTRICT,5,Male,10492,5049,15541
HAFIZABAD DISTRICT,5,Female,9905,4926,14831
HAFIZABAD DISTRICT,5,Transgender,0,0,0
HAFIZABAD DISTRICT,6,Male,10628,5311,15939
HAFIZABAD DISTRICT,6,Female,9938,4823,14761
HAFIZABAD DISTRICT,6,Transgender,0,0,0
HAFIZABAD DISTRICT,7,Male,11004,5511,16515
HAFIZABAD DISTRICT,7,Female,10284,5327,15611
HAFIZABAD DISTRICT,7,Transgender,0,0,0
HAFIZABAD DISTRICT,8,Male,10760,5101,15861
HAFIZABAD DISTRICT,8,Female,10040,4883,14923
HAFIZABAD DISTRICT,8,Transgender,0,0,0
HAFIZABAD DISTRICT,9,Male,10352,5508,15860
HAFIZABAD DISTRICT,9,Female,9545,4973,14518
HAFIZABAD DISTRICT,9,Transgender,0,0,0
HAFIZABAD DISTRICT,10,Male,9736,4706,14442
HAFIZABAD DISTRICT,10,Female,9281,4624,13905
HAFIZABAD DISTRICT,10,Transgender,0,0,0
HAFIZABAD DISTRICT,11,Male,9504,5216,14720
HAFIZABAD DISTRICT,11,Female,8806,4992,13798
HAFIZABAD DISTRICT,11,Transgender,0,0,0
HAFIZABAD DISTRICT,12,Male,9070,4773,13843
HAFIZABAD DISTRICT,12,Female,8472,4346,12818
HAFIZABAD DISTRICT,12,Transgender,0,0,0
HAFIZABAD DISTRICT,13,Male,8719,4857,13576
HAFIZABAD DISTRICT,13,Female,7928,4608,12536
HAFIZABAD DISTRICT,13,Transgender,0,0,0
HAFIZABAD DISTRICT,14,Male,8463,4536,12999
HAFIZABAD DISTRICT,14,Female,7651,4317,11968
HAFIZABAD DISTRICT,14,Transgender,0,0,0
HAFIZABAD DISTRICT,15,Male,8029,4255,12284
HAFIZABAD DISTRICT,15,Female,7908,4328,12236
HAFIZABAD DISTRICT,15,Transgender,2,1,3
HAFIZABAD DISTRICT,16,Male,8061,4521,12582
HAFIZABAD DISTRICT,16,Female,7877,4581,12458
HAFIZABAD DISTRICT,16,Transgender,0,1,1
HAFIZABAD DISTRICT,17,Male,7678,4471,12149
HAFIZABAD DISTRICT,17,Female,7593,4407,12000
HAFIZABAD DISTRICT,17,Transgender,1,3,4
HAFIZABAD DISTRICT,18,Male,7750,4154,11904
HAFIZABAD DISTRICT,18,Female,7435,4106,11541
HAFIZABAD DISTRICT,18,Transgender,1,3,4
HAFIZABAD DISTRICT,19,Male,7241,4393,11634
HAFIZABAD DISTRICT,19,Female,7326,4242,11568
HAFIZABAD DISTRICT,19,Transgender,0,1,1
HAFIZABAD DISTRICT,20,Male,6865,3894,10759
HAFIZABAD DISTRICT,20,Female,7302,3800,11102
HAFIZABAD DISTRICT,20,Transgender,1,3,4
HAFIZABAD DISTRICT,21,Male,6626,4071,10697
HAFIZABAD DISTRICT,21,Female,7033,4235,11268
HAFIZABAD DISTRICT,21,Transgender,0,0,0
HAFIZABAD DISTRICT,22,Male,6342,3704,10046
HAFIZABAD DISTRICT,22,Female,7159,4104,11263
HAFIZABAD DISTRICT,22,Transgender,2,2,4
HAFIZABAD DISTRICT,23,Male,5810,3433,9243
HAFIZABAD DISTRICT,23,Female,6292,3878,10170
HAFIZABAD DISTRICT,23,Transgender,1,1,2
HAFIZABAD DISTRICT,24,Male,5514,3475,8989
HAFIZABAD DISTRICT,24,Female,6157,3687,9844
HAFIZABAD DISTRICT,24,Transgender,2,0,2
HAFIZABAD DISTRICT,25,Male,5648,3079,8727
HAFIZABAD DISTRICT,25,Female,6638,3576,10214
HAFIZABAD DISTRICT,25,Transgender,0,2,2
HAFIZABAD DISTRICT,26,Male,5387,3461,8848
HAFIZABAD DISTRICT,26,Female,6108,3731,9839
HAFIZABAD DISTRICT,26,Transgender,0,0,0
HAFIZABAD DISTRICT,27,Male,5069,2971,8040
HAFIZABAD DISTRICT,27,Female,5605,3517,9122
HAFIZABAD DISTRICT,27,Transgender,1,2,3
HAFIZABAD DISTRICT,28,Male,5130,3056,8186
HAFIZABAD DISTRICT,28,Female,5802,3459,9261
HAFIZABAD DISTRICT,28,Transgender,0,1,1
HAFIZABAD DISTRICT,29,Male,4733,2868,7601
HAFIZABAD DISTRICT,29,Female,5557,3179,8736
HAFIZABAD DISTRICT,29,Transgender,1,4,5
HAFIZABAD DISTRICT,30,Male,5209,3104,8313
HAFIZABAD DISTRICT,30,Female,6263,3449,9712
HAFIZABAD DISTRICT,30,Transgender,0,5,5
HAFIZABAD DISTRICT,31,Male,4555,2799,7354
HAFIZABAD DISTRICT,31,Female,5241,3065,8306
HAFIZABAD DISTRICT,31,Transgender,1,1,2
HAFIZABAD DISTRICT,32,Male,4423,2791,7214
HAFIZABAD DISTRICT,32,Female,5205,3163,8368
HAFIZABAD DISTRICT,32,Transgender,0,0,0
HAFIZABAD DISTRICT,33,Male,4240,2633,6873
HAFIZABAD DISTRICT,33,Female,4750,2840,7590
HAFIZABAD DISTRICT,33,Transgender,1,1,2
HAFIZABAD DISTRICT,34,Male,4420,2513,6933
HAFIZABAD DISTRICT,34,Female,4541,2684,7225
HAFIZABAD DISTRICT,34,Transgender,2,1,3
HAFIZABAD DISTRICT,35,Male,4681,2596,7277
HAFIZABAD DISTRICT,35,Female,5052,2730,7782
HAFIZABAD DISTRICT,35,Transgender,1,1,2
HAFIZABAD DISTRICT,36,Male,4906,2496,7402
HAFIZABAD DISTRICT,36,Female,4879,2545,7424
HAFIZABAD DISTRICT,36,Transgender,2,1,3
HAFIZABAD DISTRICT,37,Male,4322,2201,6523
HAFIZABAD DISTRICT,37,Female,4464,2199,6663
HAFIZABAD DISTRICT,37,Transgender,0,1,1
HAFIZABAD DISTRICT,38,Male,4477,2491,6968
HAFIZABAD DISTRICT,38,Female,4230,2584,6814
HAFIZABAD DISTRICT,38,Transgender,2,3,5
HAFIZABAD DISTRICT,39,Male,4159,2219,6378
HAFIZABAD DISTRICT,39,Female,4599,2339,6938
HAFIZABAD DISTRICT,39,Transgender,0,0,0
HAFIZABAD DISTRICT,40,Male,4112,2583,6695
HAFIZABAD DISTRICT,40,Female,4375,2371,6746
HAFIZABAD DISTRICT,40,Transgender,1,5,6
HAFIZABAD DISTRICT,41,Male,4130,2180,6310
HAFIZABAD DISTRICT,41,Female,4184,2178,6362
HAFIZABAD DISTRICT,41,Transgender,0,1,1
HAFIZABAD DISTRICT,42,Male,3898,2049,5947
HAFIZABAD DISTRICT,42,Female,3602,1934,5536
HAFIZABAD DISTRICT,42,Transgender,0,0,0
HAFIZABAD DISTRICT,43,Male,3388,1866,5254
HAFIZABAD DISTRICT,43,Female,3254,1871,5125
HAFIZABAD DISTRICT,43,Transgender,0,0,0
HAFIZABAD DISTRICT,44,Male,3299,1799,5098
HAFIZABAD DISTRICT,44,Female,3148,1757,4905
HAFIZABAD DISTRICT,44,Transgender,1,0,1
HAFIZABAD DISTRICT,45,Male,3250,1827,5077
HAFIZABAD DISTRICT,45,Female,3139,1848,4987
HAFIZABAD DISTRICT,45,Transgender,1,1,2
HAFIZABAD DISTRICT,46,Male,3342,1659,5001
HAFIZABAD DISTRICT,46,Female,3182,1659,4841
HAFIZABAD DISTRICT,46,Transgender,0,0,0
HAFIZABAD DISTRICT,47,Male,3205,1561,4766
HAFIZABAD DISTRICT,47,Female,2931,1464,4395
HAFIZABAD DISTRICT,47,Transgender,1,1,2
HAFIZABAD DISTRICT,48,Male,3219,1814,5033
HAFIZABAD DISTRICT,48,Female,2920,1672,4592
HAFIZABAD DISTRICT,48,Transgender,0,1,1
HAFIZABAD DISTRICT,49,Male,3185,1600,4785
HAFIZABAD DISTRICT,49,Female,2852,1656,4508
HAFIZABAD DISTRICT,49,Transgender,1,0,1
HAFIZABAD DISTRICT,50,Male,3185,1870,5055
HAFIZABAD DISTRICT,50,Female,2839,1633,4472
HAFIZABAD DISTRICT,50,Transgender,2,1,3
HAFIZABAD DISTRICT,51,Male,3345,1785,5130
HAFIZABAD DISTRICT,51,Female,2732,1449,4181
HAFIZABAD DISTRICT,51,Transgender,1,0,1
HAFIZABAD DISTRICT,52,Male,3034,1634,4668
HAFIZABAD DISTRICT,52,Female,2471,1316,3787
HAFIZABAD DISTRICT,52,Transgender,0,3,3
HAFIZABAD DISTRICT,53,Male,2931,1564,4495
HAFIZABAD DISTRICT,53,Female,2222,1353,3575
HAFIZABAD DISTRICT,53,Transgender,0,0,0
HAFIZABAD DISTRICT,54,Male,2570,1516,4086
HAFIZABAD DISTRICT,54,Female,1977,1211,3188
HAFIZABAD DISTRICT,54,Transgender,0,0,0
HAFIZABAD DISTRICT,55,Male,2300,1394,3694
HAFIZABAD DISTRICT,55,Female,1964,1145,3109
HAFIZABAD DISTRICT,55,Transgender,1,1,2
HAFIZABAD DISTRICT,56,Male,2269,1122,3391
HAFIZABAD DISTRICT,56,Female,1994,938,2932
HAFIZABAD DISTRICT,56,Transgender,0,0,0
HAFIZABAD DISTRICT,57,Male,1889,924,2813
HAFIZABAD DISTRICT,57,Female,1767,726,2493
HAFIZABAD DISTRICT,57,Transgender,0,0,0
HAFIZABAD DISTRICT,58,Male,2070,1034,3104
HAFIZABAD DISTRICT,58,Female,1717,873,2590
HAFIZABAD DISTRICT,58,Transgender,1,1,2
HAFIZABAD DISTRICT,59,Male,2072,985,3057
HAFIZABAD DISTRICT,59,Female,1763,919,2682
HAFIZABAD DISTRICT,59,Transgender,0,0,0
HAFIZABAD DISTRICT,60,Male,2205,1192,3397
HAFIZABAD DISTRICT,60,Female,1961,920,2881
HAFIZABAD DISTRICT,60,Transgender,2,0,2
HAFIZABAD DISTRICT,61,Male,2036,908,2944
HAFIZABAD DISTRICT,61,Female,1742,793,2535
HAFIZABAD DISTRICT,61,Transgender,0,0,0
HAFIZABAD DISTRICT,62,Male,1758,910,2668
HAFIZABAD DISTRICT,62,Female,1532,694,2226
HAFIZABAD DISTRICT,62,Transgender,0,0,0
HAFIZABAD DISTRICT,63,Male,1800,873,2673
HAFIZABAD DISTRICT,63,Female,1610,779,2389
HAFIZABAD DISTRICT,63,Transgender,1,0,1
HAFIZABAD DISTRICT,64,Male,1697,776,2473
HAFIZABAD DISTRICT,64,Female,1507,629,2136
HAFIZABAD DISTRICT,64,Transgender,0,0,0
HAFIZABAD DISTRICT,65,Male,1701,745,2446
HAFIZABAD DISTRICT,65,Female,1501,690,2191
HAFIZABAD DISTRICT,65,Transgender,0,0,0
HAFIZABAD DISTRICT,66,Male,1464,542,2006
HAFIZABAD DISTRICT,66,Female,1258,536,1794
HAFIZABAD DISTRICT,66,Transgender,0,0,0
HAFIZABAD DISTRICT,67,Male,1268,459,1727
HAFIZABAD DISTRICT,67,Female,1032,357,1389
HAFIZABAD DISTRICT,67,Transgender,0,0,0
HAFIZABAD DISTRICT,68,Male,1216,508,1724
HAFIZABAD DISTRICT,68,Female,1141,440,1581
HAFIZABAD DISTRICT,68,Transgender,0,0,0
HAFIZABAD DISTRICT,69,Male,1383,529,1912
HAFIZABAD DISTRICT,69,Female,1160,437,1597
HAFIZABAD DISTRICT,69,Transgender,0,2,2
HAFIZABAD DISTRICT,70,Male,1506,609,2115
HAFIZABAD DISTRICT,70,Female,1313,522,1835
HAFIZABAD DISTRICT,70,Transgender,2,1,3
HAFIZABAD DISTRICT,71,Male,1169,456,1625
HAFIZABAD DISTRICT,71,Female,1009,431,1440
HAFIZABAD DISTRICT,71,Transgender,1,0,1
HAFIZABAD DISTRICT,72,Male,1040,398,1438
HAFIZABAD DISTRICT,72,Female,866,346,1212
HAFIZABAD DISTRICT,72,Transgender,0,0,0
HAFIZABAD DISTRICT,73,Male,953,411,1364
HAFIZABAD DISTRICT,73,Female,876,348,1224
HAFIZABAD DISTRICT,73,Transgender,0,0,0
HAFIZABAD DISTRICT,74,Male,997,355,1352
HAFIZABAD DISTRICT,74,Female,875,284,1159
HAFIZABAD DISTRICT,74,Transgender,0,0,0
HAFIZABAD DISTRICT,>=75,Male,8472,3054,11526
HAFIZABAD DISTRICT,>=75,Female,7471,2603,10074
HAFIZABAD DISTRICT,>=75,Transgender,4,1,5
HANGU DISTRICT,<1,Male,5879,1442,7321
HANGU DISTRICT,<1,Female,5460,1359,6819
HANGU DISTRICT,<1,Transgender,0,0,0
HANGU DISTRICT,1,Male,6522,1410,7932
HANGU DISTRICT,1,Female,6108,1438,7546
HANGU DISTRICT,1,Transgender,0,0,0
HANGU DISTRICT,2,Male,7087,1634,8721
HANGU DISTRICT,2,Female,6808,1547,8355
HANGU DISTRICT,2,Transgender,0,0,0
HANGU DISTRICT,3,Male,7846,1751,9597
HANGU DISTRICT,3,Female,7239,1652,8891
HANGU DISTRICT,3,Transgender,0,0,0
HANGU DISTRICT,4,Male,7371,1701,9072
HANGU DISTRICT,4,Female,6872,1591,8463
HANGU DISTRICT,4,Transgender,0,0,0
HANGU DISTRICT,5,Male,7455,1741,9196
HANGU DISTRICT,5,Female,7026,1469,8495
HANGU DISTRICT,5,Transgender,0,0,0
HANGU DISTRICT,6,Male,6882,1589,8471
HANGU DISTRICT,6,Female,6460,1508,7968
HANGU DISTRICT,6,Transgender,0,0,0
HANGU DISTRICT,7,Male,7163,1728,8891
HANGU DISTRICT,7,Female,6749,1555,8304
HANGU DISTRICT,7,Transgender,0,0,0
HANGU DISTRICT,8,Male,7073,1583,8656
HANGU DISTRICT,8,Female,6435,1432,7867
HANGU DISTRICT,8,Transgender,0,0,0
HANGU DISTRICT,9,Male,7059,1571,8630
HANGU DISTRICT,9,Female,6154,1439,7593
HANGU DISTRICT,9,Transgender,0,0,0
HANGU DISTRICT,10,Male,6335,1461,7796
HANGU DISTRICT,10,Female,5925,1290,7215
HANGU DISTRICT,10,Transgender,0,0,0
HANGU DISTRICT,11,Male,6362,1530,7892
HANGU DISTRICT,11,Female,5574,1295,6869
HANGU DISTRICT,11,Transgender,0,0,0
HANGU DISTRICT,12,Male,5785,1352,7137
HANGU DISTRICT,12,Female,5309,1227,6536
HANGU DISTRICT,12,Transgender,0,0,0
HANGU DISTRICT,13,Male,5843,1445,7288
HANGU DISTRICT,13,Female,5384,1391,6775
HANGU DISTRICT,13,Transgender,0,0,0
HANGU DISTRICT,14,Male,5364,1279,6643
HANGU DISTRICT,14,Female,5203,1296,6499
HANGU DISTRICT,14,Transgender,0,0,0
HANGU DISTRICT,15,Male,5249,1282,6531
HANGU DISTRICT,15,Female,5435,1308,6743
HANGU DISTRICT,15,Transgender,2,0,2
HANGU DISTRICT,16,Male,5166,1240,6406
HANGU DISTRICT,16,Female,4988,1200,6188
HANGU DISTRICT,16,Transgender,0,0,0
HANGU DISTRICT,17,Male,4692,1106,5798
HANGU DISTRICT,17,Female,4808,1179,5987
HANGU DISTRICT,17,Transgender,2,0,2
HANGU DISTRICT,18,Male,4760,1020,5780
HANGU DISTRICT,18,Female,4633,1089,5722
HANGU DISTRICT,18,Transgender,1,0,1
HANGU DISTRICT,19,Male,4411,1034,5445
HANGU DISTRICT,19,Female,4398,1064,5462
HANGU DISTRICT,19,Transgender,2,1,3
HANGU DISTRICT,20,Male,3758,881,4639
HANGU DISTRICT,20,Female,4409,1015,5424
HANGU DISTRICT,20,Transgender,1,1,2
HANGU DISTRICT,21,Male,3452,904,4356
HANGU DISTRICT,21,Female,4219,977,5196
HANGU DISTRICT,21,Transgender,2,0,2
HANGU DISTRICT,22,Male,2957,775,3732
HANGU DISTRICT,22,Female,3783,908,4691
HANGU DISTRICT,22,Transgender,0,0,0
HANGU DISTRICT,23,Male,3212,790,4002
HANGU DISTRICT,23,Female,4053,975,5028
HANGU DISTRICT,23,Transgender,1,0,1
HANGU DISTRICT,24,Male,2777,754,3531
HANGU DISTRICT,24,Female,3653,870,4523
HANGU DISTRICT,24,Transgender,1,0,1
HANGU DISTRICT,25,Male,2938,724,3662
HANGU DISTRICT,25,Female,4184,957,5141
HANGU DISTRICT,25,Transgender,1,0,1
HANGU DISTRICT,26,Male,2769,783,3552
HANGU DISTRICT,26,Female,3863,908,4771
HANGU DISTRICT,26,Transgender,1,0,1
HANGU DISTRICT,27,Male,2647,758,3405
HANGU DISTRICT,27,Female,3810,986,4796
HANGU DISTRICT,27,Transgender,3,1,4
HANGU DISTRICT,28,Male,2428,749,3177
HANGU DISTRICT,28,Female,3574,848,4422
HANGU DISTRICT,28,Transgender,1,0,1
HANGU DISTRICT,29,Male,2297,713,3010
HANGU DISTRICT,29,Female,3631,888,4519
HANGU DISTRICT,29,Transgender,1,0,1
HANGU DISTRICT,30,Male,2444,684,3128
HANGU DISTRICT,30,Female,3537,866,4403
HANGU DISTRICT,30,Transgender,0,0,0
HANGU DISTRICT,31,Male,2155,648,2803
HANGU DISTRICT,31,Female,3241,813,4054
HANGU DISTRICT,31,Transgender,0,0,0
HANGU DISTRICT,32,Male,1787,618,2405
HANGU DISTRICT,32,Female,2543,676,3219
HANGU DISTRICT,32,Transgender,0,0,0
HANGU DISTRICT,33,Male,1834,601,2435
HANGU DISTRICT,33,Female,2716,717,3433
HANGU DISTRICT,33,Transgender,0,0,0
HANGU DISTRICT,34,Male,1609,470,2079
HANGU DISTRICT,34,Female,2253,551,2804
HANGU DISTRICT,34,Transgender,1,0,1
HANGU DISTRICT,35,Male,1720,525,2245
HANGU DISTRICT,35,Female,2454,617,3071
HANGU DISTRICT,35,Transgender,0,0,0
HANGU DISTRICT,36,Male,1404,406,1810
HANGU DISTRICT,36,Female,2073,502,2575
HANGU DISTRICT,36,Transgender,0,0,0
HANGU DISTRICT,37,Male,1351,475,1826
HANGU DISTRICT,37,Female,1964,544,2508
HANGU DISTRICT,37,Transgender,1,0,1
HANGU DISTRICT,38,Male,1525,491,2016
HANGU DISTRICT,38,Female,2070,480,2550
HANGU DISTRICT,38,Transgender,0,1,1
HANGU DISTRICT,39,Male,1370,424,1794
HANGU DISTRICT,39,Female,1849,515,2364
HANGU DISTRICT,39,Transgender,0,0,0
HANGU DISTRICT,40,Male,1445,468,1913
HANGU DISTRICT,40,Female,2267,589,2856
HANGU DISTRICT,40,Transgender,1,0,1
HANGU DISTRICT,41,Male,1094,370,1464
HANGU DISTRICT,41,Female,1796,451,2247
HANGU DISTRICT,41,Transgender,1,0,1
HANGU DISTRICT,42,Male,974,350,1324
HANGU DISTRICT,42,Female,1397,377,1774
HANGU DISTRICT,42,Transgender,0,0,0
HANGU DISTRICT,43,Male,1132,372,1504
HANGU DISTRICT,43,Female,1588,408,1996
HANGU DISTRICT,43,Transgender,0,0,0
HANGU DISTRICT,44,Male,872,305,1177
HANGU DISTRICT,44,Female,1305,358,1663
HANGU DISTRICT,44,Transgender,0,1,1
HANGU DISTRICT,45,Male,986,323,1309
HANGU DISTRICT,45,Female,1580,383,1963
HANGU DISTRICT,45,Transgender,1,0,1
HANGU DISTRICT,46,Male,883,256,1139
HANGU DISTRICT,46,Female,1280,307,1587
HANGU DISTRICT,46,Transgender,0,0,0
HANGU DISTRICT,47,Male,796,273,1069
HANGU DISTRICT,47,Female,1180,361,1541
HANGU DISTRICT,47,Transgender,0,0,0
HANGU DISTRICT,48,Male,824,288,1112
HANGU DISTRICT,48,Female,1273,286,1559
HANGU DISTRICT,48,Transgender,0,0,0
HANGU DISTRICT,49,Male,783,237,1020
HANGU DISTRICT,49,Female,1230,309,1539
HANGU DISTRICT,49,Transgender,0,0,0
HANGU DISTRICT,50,Male,1071,319,1390
HANGU DISTRICT,50,Female,1642,390,2032
HANGU DISTRICT,50,Transgender,0,0,0
HANGU DISTRICT,51,Male,742,271,1013
HANGU DISTRICT,51,Female,1183,315,1498
HANGU DISTRICT,51,Transgender,0,0,0
HANGU DISTRICT,52,Male,718,265,983
HANGU DISTRICT,52,Female,1002,294,1296
HANGU DISTRICT,52,Transgender,0,0,0
HANGU DISTRICT,53,Male,831,268,1099
HANGU DISTRICT,53,Female,1102,278,1380
HANGU DISTRICT,53,Transgender,0,0,0
HANGU DISTRICT,54,Male,718,233,951
HANGU DISTRICT,54,Female,904,247,1151
HANGU DISTRICT,54,Transgender,0,0,0
HANGU DISTRICT,55,Male,831,240,1071
HANGU DISTRICT,55,Female,1208,262,1470
HANGU DISTRICT,55,Transgender,2,0,2
HANGU DISTRICT,56,Male,623,174,797
HANGU DISTRICT,56,Female,920,216,1136
HANGU DISTRICT,56,Transgender,0,0,0
HANGU DISTRICT,57,Male,561,192,753
HANGU DISTRICT,57,Female,810,230,1040
HANGU DISTRICT,57,Transgender,0,0,0
HANGU DISTRICT,58,Male,656,183,839
HANGU DISTRICT,58,Female,874,212,1086
HANGU DISTRICT,58,Transgender,0,0,0
HANGU DISTRICT,59,Male,584,191,775
HANGU DISTRICT,59,Female,823,210,1033
HANGU DISTRICT,59,Transgender,0,0,0
HANGU DISTRICT,60,Male,852,204,1056
HANGU DISTRICT,60,Female,1062,211,1273
HANGU DISTRICT,60,Transgender,1,0,1
HANGU DISTRICT,61,Male,718,241,959
HANGU DISTRICT,61,Female,901,214,1115
HANGU DISTRICT,61,Transgender,0,0,0
HANGU DISTRICT,62,Male,680,200,880
HANGU DISTRICT,62,Female,802,219,1021
HANGU DISTRICT,62,Transgender,0,0,0
HANGU DISTRICT,63,Male,756,195,951
HANGU DISTRICT,63,Female,837,195,1032
HANGU DISTRICT,63,Transgender,0,0,0
HANGU DISTRICT,64,Male,679,179,858
HANGU DISTRICT,64,Female,737,188,925
HANGU DISTRICT,64,Transgender,0,0,0
HANGU DISTRICT,65,Male,657,158,815
HANGU DISTRICT,65,Female,703,133,836
HANGU DISTRICT,65,Transgender,0,0,0
HANGU DISTRICT,66,Male,559,133,692
HANGU DISTRICT,66,Female,594,120,714
HANGU DISTRICT,66,Transgender,0,0,0
HANGU DISTRICT,67,Male,547,189,736
HANGU DISTRICT,67,Female,575,155,730
HANGU DISTRICT,67,Transgender,0,0,0
HANGU DISTRICT,68,Male,581,124,705
HANGU DISTRICT,68,Female,485,118,603
HANGU DISTRICT,68,Transgender,0,0,0
HANGU DISTRICT,69,Male,495,126,621
HANGU DISTRICT,69,Female,431,79,510
HANGU DISTRICT,69,Transgender,0,0,0
HANGU DISTRICT,70,Male,491,94,585
HANGU DISTRICT,70,Female,482,96,578
HANGU DISTRICT,70,Transgender,1,0,1
HANGU DISTRICT,71,Male,410,93,503
HANGU DISTRICT,71,Female,395,96,491
HANGU DISTRICT,71,Transgender,0,0,0
HANGU DISTRICT,72,Male,417,99,516
HANGU DISTRICT,72,Female,344,102,446
HANGU DISTRICT,72,Transgender,1,0,1
HANGU DISTRICT,73,Male,383,101,484
HANGU DISTRICT,73,Female,324,71,395
HANGU DISTRICT,73,Transgender,0,0,0
HANGU DISTRICT,74,Male,325,94,419
HANGU DISTRICT,74,Female,249,61,310
HANGU DISTRICT,74,Transgender,0,0,0
HANGU DISTRICT,>=75,Male,2204,548,2752
HANGU DISTRICT,>=75,Female,2532,585,3117
HANGU DISTRICT,>=75,Transgender,0,1,1
HARIPUR DISTRICT,<1,Male,11600,1474,13074
HARIPUR DISTRICT,<1,Female,11190,1441,12631
HARIPUR DISTRICT,<1,Transgender,0,0,0
HARIPUR DISTRICT,1,Male,11736,1563,13299
HARIPUR DISTRICT,1,Female,11096,1493,12589
HARIPUR DISTRICT,1,Transgender,0,0,0
HARIPUR DISTRICT,2,Male,11433,1525,12958
HARIPUR DISTRICT,2,Female,10810,1425,12235
HARIPUR DISTRICT,2,Transgender,0,0,0
HARIPUR DISTRICT,3,Male,11907,1611,13518
HARIPUR DISTRICT,3,Female,11348,1539,12887
HARIPUR DISTRICT,3,Transgender,0,0,0
HARIPUR DISTRICT,4,Male,11044,1504,12548
HARIPUR DISTRICT,4,Female,10395,1460,11855
HARIPUR DISTRICT,4,Transgender,0,0,0
HARIPUR DISTRICT,5,Male,10905,1452,12357
HARIPUR DISTRICT,5,Female,10475,1456,11931
HARIPUR DISTRICT,5,Transgender,0,0,0
HARIPUR DISTRICT,6,Male,10972,1522,12494
HARIPUR DISTRICT,6,Female,10247,1435,11682
HARIPUR DISTRICT,6,Transgender,0,0,0
HARIPUR DISTRICT,7,Male,11474,1573,13047
HARIPUR DISTRICT,7,Female,10972,1548,12520
HARIPUR DISTRICT,7,Transgender,0,0,0
HARIPUR DISTRICT,8,Male,9961,1395,11356
HARIPUR DISTRICT,8,Female,9229,1229,10458
HARIPUR DISTRICT,8,Transgender,0,0,0
HARIPUR DISTRICT,9,Male,11855,1644,13499
HARIPUR DISTRICT,9,Female,10963,1584,12547
HARIPUR DISTRICT,9,Transgender,0,0,0
HARIPUR DISTRICT,10,Male,8701,1240,9941
HARIPUR DISTRICT,10,Female,8393,1181,9574
HARIPUR DISTRICT,10,Transgender,0,0,0
HARIPUR DISTRICT,11,Male,11206,1595,12801
HARIPUR DISTRICT,11,Female,10406,1519,11925
HARIPUR DISTRICT,11,Transgender,0,0,0
HARIPUR DISTRICT,12,Male,8690,1278,9968
HARIPUR DISTRICT,12,Female,7956,1158,9114
HARIPUR DISTRICT,12,Transgender,0,0,0
HARIPUR DISTRICT,13,Male,10064,1496,11560
HARIPUR DISTRICT,13,Female,9219,1349,10568
HARIPUR DISTRICT,13,Transgender,0,0,0
HARIPUR DISTRICT,14,Male,8820,1315,10135
HARIPUR DISTRICT,14,Female,8137,1292,9429
HARIPUR DISTRICT,14,Transgender,0,0,0
HARIPUR DISTRICT,15,Male,8901,1361,10262
HARIPUR DISTRICT,15,Female,8510,1181,9691
HARIPUR DISTRICT,15,Transgender,0,0,0
HARIPUR DISTRICT,16,Male,9079,1491,10570
HARIPUR DISTRICT,16,Female,8611,1250,9861
HARIPUR DISTRICT,16,Transgender,0,0,0
HARIPUR DISTRICT,17,Male,9249,1472,10721
HARIPUR DISTRICT,17,Female,8786,1326,10112
HARIPUR DISTRICT,17,Transgender,0,0,0
HARIPUR DISTRICT,18,Male,7691,1216,8907
HARIPUR DISTRICT,18,Female,7341,1025,8366
HARIPUR DISTRICT,18,Transgender,1,1,2
HARIPUR DISTRICT,19,Male,9085,1465,10550
HARIPUR DISTRICT,19,Female,9107,1349,10456
HARIPUR DISTRICT,19,Transgender,0,1,1
HARIPUR DISTRICT,20,Male,7297,1104,8401
HARIPUR DISTRICT,20,Female,6756,992,7748
HARIPUR DISTRICT,20,Transgender,1,0,1
HARIPUR DISTRICT,21,Male,8837,1441,10278
HARIPUR DISTRICT,21,Female,9104,1377,10481
HARIPUR DISTRICT,21,Transgender,2,0,2
HARIPUR DISTRICT,22,Male,7066,1250,8316
HARIPUR DISTRICT,22,Female,7643,1210,8853
HARIPUR DISTRICT,22,Transgender,1,3,4
HARIPUR DISTRICT,23,Male,7833,1318,9151
HARIPUR DISTRICT,23,Female,8778,1297,10075
HARIPUR DISTRICT,23,Transgender,1,2,3
HARIPUR DISTRICT,24,Male,7199,1179,8378
HARIPUR DISTRICT,24,Female,8638,1246,9884
HARIPUR DISTRICT,24,Transgender,0,2,2
HARIPUR DISTRICT,25,Male,5825,1000,6825
HARIPUR DISTRICT,25,Female,6582,1047,7629
HARIPUR DISTRICT,25,Transgender,0,4,4
HARIPUR DISTRICT,26,Male,6742,1137,7879
HARIPUR DISTRICT,26,Female,8364,1253,9617
HARIPUR DISTRICT,26,Transgender,0,1,1
HARIPUR DISTRICT,27,Male,6300,1120,7420
HARIPUR DISTRICT,27,Female,8405,1247,9652
HARIPUR DISTRICT,27,Transgender,1,0,1
HARIPUR DISTRICT,28,Male,5949,1032,6981
HARIPUR DISTRICT,28,Female,7347,1196,8543
HARIPUR DISTRICT,28,Transgender,0,4,4
HARIPUR DISTRICT,29,Male,6219,1072,7291
HARIPUR DISTRICT,29,Female,8007,1191,9198
HARIPUR DISTRICT,29,Transgender,1,1,2
HARIPUR DISTRICT,30,Male,5234,930,6164
HARIPUR DISTRICT,30,Female,6110,1108,7218
HARIPUR DISTRICT,30,Transgender,0,0,0
HARIPUR DISTRICT,31,Male,6407,1117,7524
HARIPUR DISTRICT,31,Female,8081,1177,9258
HARIPUR DISTRICT,31,Transgender,0,0,0
HARIPUR DISTRICT,32,Male,5843,967,6810
HARIPUR DISTRICT,32,Female,6777,1094,7871
HARIPUR DISTRICT,32,Transgender,0,2,2
HARIPUR DISTRICT,33,Male,5879,942,6821
HARIPUR DISTRICT,33,Female,6796,1074,7870
HARIPUR DISTRICT,33,Transgender,0,1,1
HARIPUR DISTRICT,34,Male,5827,942,6769
HARIPUR DISTRICT,34,Female,6816,981,7797
HARIPUR DISTRICT,34,Transgender,0,0,0
HARIPUR DISTRICT,35,Male,4394,829,5223
HARIPUR DISTRICT,35,Female,4899,890,5789
HARIPUR DISTRICT,35,Transgender,2,3,5
HARIPUR DISTRICT,36,Male,5397,913,6310
HARIPUR DISTRICT,36,Female,6408,941,7349
HARIPUR DISTRICT,36,Transgender,0,0,0
HARIPUR DISTRICT,37,Male,4837,861,5698
HARIPUR DISTRICT,37,Female,5748,816,6564
HARIPUR DISTRICT,37,Transgender,0,1,1
HARIPUR DISTRICT,38,Male,5348,984,6332
HARIPUR DISTRICT,38,Female,5416,963,6379
HARIPUR DISTRICT,38,Transgender,0,0,0
HARIPUR DISTRICT,39,Male,5217,804,6021
HARIPUR DISTRICT,39,Female,5437,829,6266
HARIPUR DISTRICT,39,Transgender,0,0,0
HARIPUR DISTRICT,40,Male,4002,833,4835
HARIPUR DISTRICT,40,Female,4084,814,4898
HARIPUR DISTRICT,40,Transgender,0,1,1
HARIPUR DISTRICT,41,Male,4576,822,5398
HARIPUR DISTRICT,41,Female,4939,838,5777
HARIPUR DISTRICT,41,Transgender,0,0,0
HARIPUR DISTRICT,42,Male,4207,886,5093
HARIPUR DISTRICT,42,Female,4218,707,4925
HARIPUR DISTRICT,42,Transgender,0,0,0
HARIPUR DISTRICT,43,Male,4200,823,5023
HARIPUR DISTRICT,43,Female,4478,757,5235
HARIPUR DISTRICT,43,Transgender,0,0,0
HARIPUR DISTRICT,44,Male,4076,732,4808
HARIPUR DISTRICT,44,Female,4307,708,5015
HARIPUR DISTRICT,44,Transgender,0,0,0
HARIPUR DISTRICT,45,Male,2885,601,3486
HARIPUR DISTRICT,45,Female,3172,640,3812
HARIPUR DISTRICT,45,Transgender,0,0,0
HARIPUR DISTRICT,46,Male,3791,664,4455
HARIPUR DISTRICT,46,Female,4266,613,4879
HARIPUR DISTRICT,46,Transgender,0,0,0
HARIPUR DISTRICT,47,Male,3399,619,4018
HARIPUR DISTRICT,47,Female,3655,485,4140
HARIPUR DISTRICT,47,Transgender,1,1,2
HARIPUR DISTRICT,48,Male,3729,603,4332
HARIPUR DISTRICT,48,Female,3957,609,4566
HARIPUR DISTRICT,48,Transgender,0,0,0
HARIPUR DISTRICT,49,Male,3572,557,4129
HARIPUR DISTRICT,49,Female,3960,615,4575
HARIPUR DISTRICT,49,Transgender,0,0,0
HARIPUR DISTRICT,50,Male,3025,572,3597
HARIPUR DISTRICT,50,Female,3164,625,3789
HARIPUR DISTRICT,50,Transgender,1,0,1
HARIPUR DISTRICT,51,Male,3535,588,4123
HARIPUR DISTRICT,51,Female,4007,558,4565
HARIPUR DISTRICT,51,Transgender,1,0,1
HARIPUR DISTRICT,52,Male,3272,565,3837
HARIPUR DISTRICT,52,Female,3459,535,3994
HARIPUR DISTRICT,52,Transgender,1,0,1
HARIPUR DISTRICT,53,Male,3471,576,4047
HARIPUR DISTRICT,53,Female,3488,557,4045
HARIPUR DISTRICT,53,Transgender,0,0,0
HARIPUR DISTRICT,54,Male,3353,628,3981
HARIPUR DISTRICT,54,Female,3210,466,3676
HARIPUR DISTRICT,54,Transgender,0,0,0
HARIPUR DISTRICT,55,Male,2470,476,2946
HARIPUR DISTRICT,55,Female,2199,383,2582
HARIPUR DISTRICT,55,Transgender,0,0,0
HARIPUR DISTRICT,56,Male,2970,477,3447
HARIPUR DISTRICT,56,Female,2525,402,2927
HARIPUR DISTRICT,56,Transgender,0,0,0
HARIPUR DISTRICT,57,Male,2545,436,2981
HARIPUR DISTRICT,57,Female,2087,328,2415
HARIPUR DISTRICT,57,Transgender,0,0,0
HARIPUR DISTRICT,58,Male,2548,432,2980
HARIPUR DISTRICT,58,Female,2194,342,2536
HARIPUR DISTRICT,58,Transgender,0,0,0
HARIPUR DISTRICT,59,Male,2560,408,2968
HARIPUR DISTRICT,59,Female,2458,328,2786
HARIPUR DISTRICT,59,Transgender,0,0,0
HARIPUR DISTRICT,60,Male,2011,452,2463
HARIPUR DISTRICT,60,Female,1970,389,2359
HARIPUR DISTRICT,60,Transgender,1,1,2
HARIPUR DISTRICT,61,Male,2718,432,3150
HARIPUR DISTRICT,61,Female,2620,368,2988
HARIPUR DISTRICT,61,Transgender,0,0,0
HARIPUR DISTRICT,62,Male,2551,363,2914
HARIPUR DISTRICT,62,Female,2396,329,2725
HARIPUR DISTRICT,62,Transgender,0,0,0
HARIPUR DISTRICT,63,Male,2409,397,2806
HARIPUR DISTRICT,63,Female,2339,399,2738
HARIPUR DISTRICT,63,Transgender,0,0,0
HARIPUR DISTRICT,64,Male,2260,321,2581
HARIPUR DISTRICT,64,Female,2115,321,2436
HARIPUR DISTRICT,64,Transgender,0,0,0
HARIPUR DISTRICT,65,Male,1626,288,1914
HARIPUR DISTRICT,65,Female,1450,250,1700
HARIPUR DISTRICT,65,Transgender,0,0,0
HARIPUR DISTRICT,66,Male,2040,291,2331
HARIPUR DISTRICT,66,Female,1985,244,2229
HARIPUR DISTRICT,66,Transgender,0,0,0
HARIPUR DISTRICT,67,Male,1818,256,2074
HARIPUR DISTRICT,67,Female,1806,212,2018
HARIPUR DISTRICT,67,Transgender,0,1,1
HARIPUR DISTRICT,68,Male,1766,260,2026
HARIPUR DISTRICT,68,Female,1483,206,1689
HARIPUR DISTRICT,68,Transgender,0,0,0
HARIPUR DISTRICT,69,Male,1693,243,1936
HARIPUR DISTRICT,69,Female,1440,210,1650
HARIPUR DISTRICT,69,Transgender,0,0,0
HARIPUR DISTRICT,70,Male,1166,236,1402
HARIPUR DISTRICT,70,Female,1130,201,1331
HARIPUR DISTRICT,70,Transgender,1,0,1
HARIPUR DISTRICT,71,Male,1505,207,1712
HARIPUR DISTRICT,71,Female,1500,165,1665
HARIPUR DISTRICT,71,Transgender,0,0,0
HARIPUR DISTRICT,72,Male,1456,219,1675
HARIPUR DISTRICT,72,Female,1396,155,1551
HARIPUR DISTRICT,72,Transgender,0,0,0
HARIPUR DISTRICT,73,Male,1174,186,1360
HARIPUR DISTRICT,73,Female,1102,173,1275
HARIPUR DISTRICT,73,Transgender,1,0,1
HARIPUR DISTRICT,74,Male,1022,165,1187
HARIPUR DISTRICT,74,Female,948,133,1081
HARIPUR DISTRICT,74,Transgender,0,0,0
HARIPUR DISTRICT,>=75,Male,6983,1047,8030
HARIPUR DISTRICT,>=75,Female,7181,1041,8222
HARIPUR DISTRICT,>=75,Transgender,0,0,0
HARNAI DISTRICT,<1,Male,1021,385,1406
HARNAI DISTRICT,<1,Female,883,316,1199
HARNAI DISTRICT,<1,Transgender,0,0,0
HARNAI DISTRICT,1,Male,1236,324,1560
HARNAI DISTRICT,1,Female,1135,306,1441
HARNAI DISTRICT,1,Transgender,0,0,0
HARNAI DISTRICT,2,Male,1328,425,1753
HARNAI DISTRICT,2,Female,1360,390,1750
HARNAI DISTRICT,2,Transgender,0,0,0
HARNAI DISTRICT,3,Male,1355,411,1766
HARNAI DISTRICT,3,Female,1272,395,1667
HARNAI DISTRICT,3,Transgender,0,0,0
HARNAI DISTRICT,4,Male,1496,444,1940
HARNAI DISTRICT,4,Female,1401,338,1739
HARNAI DISTRICT,4,Transgender,0,0,0
HARNAI DISTRICT,5,Male,1324,430,1754
HARNAI DISTRICT,5,Female,1263,353,1616
HARNAI DISTRICT,5,Transgender,0,0,0
HARNAI DISTRICT,6,Male,1478,355,1833
HARNAI DISTRICT,6,Female,1361,369,1730
HARNAI DISTRICT,6,Transgender,0,0,0
HARNAI DISTRICT,7,Male,1332,374,1706
HARNAI DISTRICT,7,Female,1201,338,1539
HARNAI DISTRICT,7,Transgender,0,0,0
HARNAI DISTRICT,8,Male,1535,374,1909
HARNAI DISTRICT,8,Female,1214,357,1571
HARNAI DISTRICT,8,Transgender,0,0,0
HARNAI DISTRICT,9,Male,1240,358,1598
HARNAI DISTRICT,9,Female,936,292,1228
HARNAI DISTRICT,9,Transgender,0,0,0
HARNAI DISTRICT,10,Male,1251,348,1599
HARNAI DISTRICT,10,Female,1034,263,1297
HARNAI DISTRICT,10,Transgender,0,0,0
HARNAI DISTRICT,11,Male,932,296,1228
HARNAI DISTRICT,11,Female,759,264,1023
HARNAI DISTRICT,11,Transgender,0,0,0
HARNAI DISTRICT,12,Male,987,263,1250
HARNAI DISTRICT,12,Female,734,219,953
HARNAI DISTRICT,12,Transgender,0,0,0
HARNAI DISTRICT,13,Male,737,277,1014
HARNAI DISTRICT,13,Female,636,195,831
HARNAI DISTRICT,13,Transgender,0,0,0
HARNAI DISTRICT,14,Male,744,271,1015
HARNAI DISTRICT,14,Female,601,204,805
HARNAI DISTRICT,14,Transgender,0,0,0
HARNAI DISTRICT,15,Male,811,256,1067
HARNAI DISTRICT,15,Female,565,166,731
HARNAI DISTRICT,15,Transgender,0,0,0
HARNAI DISTRICT,16,Male,596,254,850
HARNAI DISTRICT,16,Female,537,211,748
HARNAI DISTRICT,16,Transgender,0,0,0
HARNAI DISTRICT,17,Male,564,215,779
HARNAI DISTRICT,17,Female,503,226,729
HARNAI DISTRICT,17,Transgender,0,0,0
HARNAI DISTRICT,18,Male,722,254,976
HARNAI DISTRICT,18,Female,653,208,861
HARNAI DISTRICT,18,Transgender,0,0,0
HARNAI DISTRICT,19,Male,648,260,908
HARNAI DISTRICT,19,Female,516,164,680
HARNAI DISTRICT,19,Transgender,0,1,1
HARNAI DISTRICT,20,Male,722,296,1018
HARNAI DISTRICT,20,Female,575,196,771
HARNAI DISTRICT,20,Transgender,0,0,0
HARNAI DISTRICT,21,Male,562,365,927
HARNAI DISTRICT,21,Female,498,208,706
HARNAI DISTRICT,21,Transgender,0,0,0
HARNAI DISTRICT,22,Male,484,268,752
HARNAI DISTRICT,22,Female,398,180,578
HARNAI DISTRICT,22,Transgender,0,1,1
HARNAI DISTRICT,23,Male,545,292,837
HARNAI DISTRICT,23,Female,497,188,685
HARNAI DISTRICT,23,Transgender,0,0,0
HARNAI DISTRICT,24,Male,479,273,752
HARNAI DISTRICT,24,Female,434,192,626
HARNAI DISTRICT,24,Transgender,0,0,0
HARNAI DISTRICT,25,Male,707,348,1055
HARNAI DISTRICT,25,Female,652,214,866
HARNAI DISTRICT,25,Transgender,2,0,2
HARNAI DISTRICT,26,Male,567,253,820
HARNAI DISTRICT,26,Female,695,241,936
HARNAI DISTRICT,26,Transgender,0,0,0
HARNAI DISTRICT,27,Male,590,251,841
HARNAI DISTRICT,27,Female,689,216,905
HARNAI DISTRICT,27,Transgender,0,0,0
HARNAI DISTRICT,28,Male,448,288,736
HARNAI DISTRICT,28,Female,589,219,808
HARNAI DISTRICT,28,Transgender,0,0,0
HARNAI DISTRICT,29,Male,562,275,837
HARNAI DISTRICT,29,Female,738,195,933
HARNAI DISTRICT,29,Transgender,0,0,0
HARNAI DISTRICT,30,Male,580,286,866
HARNAI DISTRICT,30,Female,577,159,736
HARNAI DISTRICT,30,Transgender,2,1,3
HARNAI DISTRICT,31,Male,562,273,835
HARNAI DISTRICT,31,Female,556,191,747
HARNAI DISTRICT,31,Transgender,0,1,1
HARNAI DISTRICT,32,Male,527,227,754
HARNAI DISTRICT,32,Female,500,146,646
HARNAI DISTRICT,32,Transgender,0,0,0
HARNAI DISTRICT,33,Male,527,227,754
HARNAI DISTRICT,33,Female,475,149,624
HARNAI DISTRICT,33,Transgender,0,0,0
HARNAI DISTRICT,34,Male,418,208,626
HARNAI DISTRICT,34,Female,320,122,442
HARNAI DISTRICT,34,Transgender,1,0,1
HARNAI DISTRICT,35,Male,472,199,671
HARNAI DISTRICT,35,Female,361,112,473
HARNAI DISTRICT,35,Transgender,1,1,2
HARNAI DISTRICT,36,Male,326,163,489
HARNAI DISTRICT,36,Female,281,128,409
HARNAI DISTRICT,36,Transgender,0,0,0
HARNAI DISTRICT,37,Male,593,170,763
HARNAI DISTRICT,37,Female,441,153,594
HARNAI DISTRICT,37,Transgender,1,0,1
HARNAI DISTRICT,38,Male,351,161,512
HARNAI DISTRICT,38,Female,285,117,402
HARNAI DISTRICT,38,Transgender,2,0,2
HARNAI DISTRICT,39,Male,429,178,607
HARNAI DISTRICT,39,Female,388,94,482
HARNAI DISTRICT,39,Transgender,0,0,0
HARNAI DISTRICT,40,Male,321,180,501
HARNAI DISTRICT,40,Female,340,109,449
HARNAI DISTRICT,40,Transgender,1,0,1
HARNAI DISTRICT,41,Male,307,163,470
HARNAI DISTRICT,41,Female,308,86,394
HARNAI DISTRICT,41,Transgender,0,0,0
HARNAI DISTRICT,42,Male,251,126,377
HARNAI DISTRICT,42,Female,303,87,390
HARNAI DISTRICT,42,Transgender,0,0,0
HARNAI DISTRICT,43,Male,272,111,383
HARNAI DISTRICT,43,Female,246,62,308
HARNAI DISTRICT,43,Transgender,0,0,0
HARNAI DISTRICT,44,Male,196,88,284
HARNAI DISTRICT,44,Female,203,62,265
HARNAI DISTRICT,44,Transgender,0,0,0
HARNAI DISTRICT,45,Male,237,107,344
HARNAI DISTRICT,45,Female,213,71,284
HARNAI DISTRICT,45,Transgender,0,0,0
HARNAI DISTRICT,46,Male,266,88,354
HARNAI DISTRICT,46,Female,225,74,299
HARNAI DISTRICT,46,Transgender,0,0,0
HARNAI DISTRICT,47,Male,291,87,378
HARNAI DISTRICT,47,Female,343,80,423
HARNAI DISTRICT,47,Transgender,0,0,0
HARNAI DISTRICT,48,Male,203,68,271
HARNAI DISTRICT,48,Female,188,70,258
HARNAI DISTRICT,48,Transgender,0,0,0
HARNAI DISTRICT,49,Male,254,73,327
HARNAI DISTRICT,49,Female,221,61,282
HARNAI DISTRICT,49,Transgender,1,0,1
HARNAI DISTRICT,50,Male,266,92,358
HARNAI DISTRICT,50,Female,221,48,269
HARNAI DISTRICT,50,Transgender,2,0,2
HARNAI DISTRICT,51,Male,232,83,315
HARNAI DISTRICT,51,Female,191,64,255
HARNAI DISTRICT,51,Transgender,0,0,0
HARNAI DISTRICT,52,Male,229,58,287
HARNAI DISTRICT,52,Female,186,62,248
HARNAI DISTRICT,52,Transgender,0,0,0
HARNAI DISTRICT,53,Male,230,72,302
HARNAI DISTRICT,53,Female,131,33,164
HARNAI DISTRICT,53,Transgender,0,0,0
HARNAI DISTRICT,54,Male,198,60,258
HARNAI DISTRICT,54,Female,131,45,176
HARNAI DISTRICT,54,Transgender,0,0,0
HARNAI DISTRICT,55,Male,143,55,198
HARNAI DISTRICT,55,Female,140,51,191
HARNAI DISTRICT,55,Transgender,0,0,0
HARNAI DISTRICT,56,Male,118,45,163
HARNAI DISTRICT,56,Female,109,48,157
HARNAI DISTRICT,56,Transgender,0,0,0
HARNAI DISTRICT,57,Male,168,47,215
HARNAI DISTRICT,57,Female,193,52,245
HARNAI DISTRICT,57,Transgender,0,0,0
HARNAI DISTRICT,58,Male,140,53,193
HARNAI DISTRICT,58,Female,97,37,134
HARNAI DISTRICT,58,Transgender,0,0,0
HARNAI DISTRICT,59,Male,184,80,264
HARNAI DISTRICT,59,Female,140,41,181
HARNAI DISTRICT,59,Transgender,0,0,0
HARNAI DISTRICT,60,Male,161,71,232
HARNAI DISTRICT,60,Female,131,54,185
HARNAI DISTRICT,60,Transgender,0,0,0
HARNAI DISTRICT,61,Male,139,47,186
HARNAI DISTRICT,61,Female,159,46,205
HARNAI DISTRICT,61,Transgender,0,0,0
HARNAI DISTRICT,62,Male,125,32,157
HARNAI DISTRICT,62,Female,141,23,164
HARNAI DISTRICT,62,Transgender,0,0,0
HARNAI DISTRICT,63,Male,134,40,174
HARNAI DISTRICT,63,Female,118,45,163
HARNAI DISTRICT,63,Transgender,0,0,0
HARNAI DISTRICT,64,Male,130,34,164
HARNAI DISTRICT,64,Female,114,30,144
HARNAI DISTRICT,64,Transgender,0,0,0
HARNAI DISTRICT,65,Male,101,36,137
HARNAI DISTRICT,65,Female,75,19,94
HARNAI DISTRICT,65,Transgender,0,0,0
HARNAI DISTRICT,66,Male,105,31,136
HARNAI DISTRICT,66,Female,89,31,120
HARNAI DISTRICT,66,Transgender,0,0,0
HARNAI DISTRICT,67,Male,111,24,135
HARNAI DISTRICT,67,Female,99,22,121
HARNAI DISTRICT,67,Transgender,0,0,0
HARNAI DISTRICT,68,Male,69,21,90
HARNAI DISTRICT,68,Female,54,15,69
HARNAI DISTRICT,68,Transgender,0,0,0
HARNAI DISTRICT,69,Male,89,23,112
HARNAI DISTRICT,69,Female,87,18,105
HARNAI DISTRICT,69,Transgender,0,0,0
HARNAI DISTRICT,70,Male,77,18,95
HARNAI DISTRICT,70,Female,58,13,71
HARNAI DISTRICT,70,Transgender,0,0,0
HARNAI DISTRICT,71,Male,84,14,98
HARNAI DISTRICT,71,Female,79,19,98
HARNAI DISTRICT,71,Transgender,0,0,0
HARNAI DISTRICT,72,Male,71,13,84
HARNAI DISTRICT,72,Female,85,16,101
HARNAI DISTRICT,72,Transgender,0,0,0
HARNAI DISTRICT,73,Male,60,18,78
HARNAI DISTRICT,73,Female,59,9,68
HARNAI DISTRICT,73,Transgender,0,0,0
HARNAI DISTRICT,74,Male,54,11,65
HARNAI DISTRICT,74,Female,35,5,40
HARNAI DISTRICT,74,Transgender,0,0,0
HARNAI DISTRICT,>=75,Male,319,97,416
HARNAI DISTRICT,>=75,Female,329,113,442
HARNAI DISTRICT,>=75,Transgender,0,1,1
HYDERABAD DISTRICT,<1,Male,4342,19279,23621
HYDERABAD DISTRICT,<1,Female,4240,18278,22518
HYDERABAD DISTRICT,<1,Transgender,0,0,0
HYDERABAD DISTRICT,1,Male,4847,20519,25366
HYDERABAD DISTRICT,1,Female,4752,19662,24414
HYDERABAD DISTRICT,1,Transgender,0,0,0
HYDERABAD DISTRICT,2,Male,5704,22165,27869
HYDERABAD DISTRICT,2,Female,5511,20914,26425
HYDERABAD DISTRICT,2,Transgender,0,0,0
HYDERABAD DISTRICT,3,Male,6349,23887,30236
HYDERABAD DISTRICT,3,Female,6213,23323,29536
HYDERABAD DISTRICT,3,Transgender,0,0,0
HYDERABAD DISTRICT,4,Male,6379,22987,29366
HYDERABAD DISTRICT,4,Female,6175,21692,27867
HYDERABAD DISTRICT,4,Transgender,0,0,0
HYDERABAD DISTRICT,5,Male,6557,23636,30193
HYDERABAD DISTRICT,5,Female,6278,22051,28329
HYDERABAD DISTRICT,5,Transgender,0,0,0
HYDERABAD DISTRICT,6,Male,6376,21907,28283
HYDERABAD DISTRICT,6,Female,5818,20513,26331
HYDERABAD DISTRICT,6,Transgender,0,0,0
HYDERABAD DISTRICT,7,Male,5868,22837,28705
HYDERABAD DISTRICT,7,Female,5330,21611,26941
HYDERABAD DISTRICT,7,Transgender,0,0,0
HYDERABAD DISTRICT,8,Male,6766,21165,27931
HYDERABAD DISTRICT,8,Female,5894,19785,25679
HYDERABAD DISTRICT,8,Transgender,0,0,0
HYDERABAD DISTRICT,9,Male,5115,21491,26606
HYDERABAD DISTRICT,9,Female,4606,20205,24811
HYDERABAD DISTRICT,9,Transgender,0,0,0
HYDERABAD DISTRICT,10,Male,6194,19919,26113
HYDERABAD DISTRICT,10,Female,5231,18161,23392
HYDERABAD DISTRICT,10,Transgender,0,0,0
HYDERABAD DISTRICT,11,Male,4241,20938,25179
HYDERABAD DISTRICT,11,Female,3678,19305,22983
HYDERABAD DISTRICT,11,Transgender,0,0,0
HYDERABAD DISTRICT,12,Male,5136,19386,24522
HYDERABAD DISTRICT,12,Female,4185,17362,21547
HYDERABAD DISTRICT,12,Transgender,0,0,0
HYDERABAD DISTRICT,13,Male,3979,19288,23267
HYDERABAD DISTRICT,13,Female,3372,17970,21342
HYDERABAD DISTRICT,13,Transgender,0,0,0
HYDERABAD DISTRICT,14,Male,4010,18058,22068
HYDERABAD DISTRICT,14,Female,3497,16695,20192
HYDERABAD DISTRICT,14,Transgender,0,0,0
HYDERABAD DISTRICT,15,Male,4551,19613,24164
HYDERABAD DISTRICT,15,Female,3571,18223,21794
HYDERABAD DISTRICT,15,Transgender,1,3,4
HYDERABAD DISTRICT,16,Male,4128,19584,23712
HYDERABAD DISTRICT,16,Female,3559,18699,22258
HYDERABAD DISTRICT,16,Transgender,1,3,4
HYDERABAD DISTRICT,17,Male,3664,21102,24766
HYDERABAD DISTRICT,17,Female,2965,18870,21835
HYDERABAD DISTRICT,17,Transgender,1,6,7
HYDERABAD DISTRICT,18,Male,4546,20101,24647
HYDERABAD DISTRICT,18,Female,4093,17942,22035
HYDERABAD DISTRICT,18,Transgender,4,5,9
HYDERABAD DISTRICT,19,Male,3334,19745,23079
HYDERABAD DISTRICT,19,Female,3589,18308,21897
HYDERABAD DISTRICT,19,Transgender,1,1,2
HYDERABAD DISTRICT,20,Male,4232,19790,24022
HYDERABAD DISTRICT,20,Female,4006,17149,21155
HYDERABAD DISTRICT,20,Transgender,1,11,12
HYDERABAD DISTRICT,21,Male,2972,20030,23002
HYDERABAD DISTRICT,21,Female,3085,18003,21088
HYDERABAD DISTRICT,21,Transgender,1,2,3
HYDERABAD DISTRICT,22,Male,3318,19269,22587
HYDERABAD DISTRICT,22,Female,3070,17807,20877
HYDERABAD DISTRICT,22,Transgender,1,14,15
HYDERABAD DISTRICT,23,Male,2798,17432,20230
HYDERABAD DISTRICT,23,Female,2617,16839,19456
HYDERABAD DISTRICT,23,Transgender,0,6,6
HYDERABAD DISTRICT,24,Male,2576,17420,19996
HYDERABAD DISTRICT,24,Female,2665,16449,19114
HYDERABAD DISTRICT,24,Transgender,2,4,6
HYDERABAD DISTRICT,25,Male,3409,15967,19376
HYDERABAD DISTRICT,25,Female,3160,16263,19423
HYDERABAD DISTRICT,25,Transgender,2,10,12
HYDERABAD DISTRICT,26,Male,2920,17043,19963
HYDERABAD DISTRICT,26,Female,2802,16744,19546
HYDERABAD DISTRICT,26,Transgender,0,4,4
HYDERABAD DISTRICT,27,Male,2788,16082,18870
HYDERABAD DISTRICT,27,Female,2898,15645,18543
HYDERABAD DISTRICT,27,Transgender,0,5,5
HYDERABAD DISTRICT,28,Male,2969,16658,19627
HYDERABAD DISTRICT,28,Female,3053,17251,20304
HYDERABAD DISTRICT,28,Transgender,2,6,8
HYDERABAD DISTRICT,29,Male,2741,15861,18602
HYDERABAD DISTRICT,29,Female,3046,14939,17985
HYDERABAD DISTRICT,29,Transgender,0,2,2
HYDERABAD DISTRICT,30,Male,3025,16132,19157
HYDERABAD DISTRICT,30,Female,2850,16362,19212
HYDERABAD DISTRICT,30,Transgender,2,13,15
HYDERABAD DISTRICT,31,Male,2808,16750,19558
HYDERABAD DISTRICT,31,Female,2874,14990,17864
HYDERABAD DISTRICT,31,Transgender,0,3,3
HYDERABAD DISTRICT,32,Male,2532,15970,18502
HYDERABAD DISTRICT,32,Female,2525,14507,17032
HYDERABAD DISTRICT,32,Transgender,1,4,5
HYDERABAD DISTRICT,33,Male,2557,15342,17899
HYDERABAD DISTRICT,33,Female,2464,13713,16177
HYDERABAD DISTRICT,33,Transgender,1,4,5
HYDERABAD DISTRICT,34,Male,2342,14388,16730
HYDERABAD DISTRICT,34,Female,2245,12509,14754
HYDERABAD DISTRICT,34,Transgender,2,6,8
HYDERABAD DISTRICT,35,Male,2626,12750,15376
HYDERABAD DISTRICT,35,Female,2278,12315,14593
HYDERABAD DISTRICT,35,Transgender,0,17,17
HYDERABAD DISTRICT,36,Male,2512,13380,15892
HYDERABAD DISTRICT,36,Female,2152,11611,13763
HYDERABAD DISTRICT,36,Transgender,0,6,6
HYDERABAD DISTRICT,37,Male,2661,12391,15052
HYDERABAD DISTRICT,37,Female,2418,10282,12700
HYDERABAD DISTRICT,37,Transgender,1,4,5
HYDERABAD DISTRICT,38,Male,2235,13661,15896
HYDERABAD DISTRICT,38,Female,2164,12244,14408
HYDERABAD DISTRICT,38,Transgender,1,2,3
HYDERABAD DISTRICT,39,Male,2363,12651,15014
HYDERABAD DISTRICT,39,Female,2281,11055,13336
HYDERABAD DISTRICT,39,Transgender,0,2,2
HYDERABAD DISTRICT,40,Male,2062,12014,14076
HYDERABAD DISTRICT,40,Female,1958,10961,12919
HYDERABAD DISTRICT,40,Transgender,2,17,19
HYDERABAD DISTRICT,41,Male,1897,11912,13809
HYDERABAD DISTRICT,41,Female,1816,10255,12071
HYDERABAD DISTRICT,41,Transgender,0,3,3
HYDERABAD DISTRICT,42,Male,1610,10919,12529
HYDERABAD DISTRICT,42,Female,1733,9181,10914
HYDERABAD DISTRICT,42,Transgender,0,8,8
HYDERABAD DISTRICT,43,Male,1578,10819,12397
HYDERABAD DISTRICT,43,Female,1535,9379,10914
HYDERABAD DISTRICT,43,Transgender,1,2,3
HYDERABAD DISTRICT,44,Male,1601,10056,11657
HYDERABAD DISTRICT,44,Female,1468,8508,9976
HYDERABAD DISTRICT,44,Transgender,0,5,5
HYDERABAD DISTRICT,45,Male,1587,8988,10575
HYDERABAD DISTRICT,45,Female,1392,7879,9271
HYDERABAD DISTRICT,45,Transgender,1,16,17
HYDERABAD DISTRICT,46,Male,1536,9431,10967
HYDERABAD DISTRICT,46,Female,1347,7417,8764
HYDERABAD DISTRICT,46,Transgender,0,8,8
HYDERABAD DISTRICT,47,Male,1511,8450,9961
HYDERABAD DISTRICT,47,Female,1544,6672,8216
HYDERABAD DISTRICT,47,Transgender,0,3,3
HYDERABAD DISTRICT,48,Male,1485,9206,10691
HYDERABAD DISTRICT,48,Female,1289,8018,9307
HYDERABAD DISTRICT,48,Transgender,2,5,7
HYDERABAD DISTRICT,49,Male,1485,8819,10304
HYDERABAD DISTRICT,49,Female,1378,7597,8975
HYDERABAD DISTRICT,49,Transgender,0,3,3
HYDERABAD DISTRICT,50,Male,1418,8047,9465
HYDERABAD DISTRICT,50,Female,1063,6938,8001
HYDERABAD DISTRICT,50,Transgender,0,6,6
HYDERABAD DISTRICT,51,Male,1265,8263,9528
HYDERABAD DISTRICT,51,Female,1030,6807,7837
HYDERABAD DISTRICT,51,Transgender,0,5,5
HYDERABAD DISTRICT,52,Male,1113,7737,8850
HYDERABAD DISTRICT,52,Female,1020,6236,7256
HYDERABAD DISTRICT,52,Transgender,0,0,0
HYDERABAD DISTRICT,53,Male,908,7316,8224
HYDERABAD DISTRICT,53,Female,751,6167,6918
HYDERABAD DISTRICT,53,Transgender,0,1,1
HYDERABAD DISTRICT,54,Male,915,6582,7497
HYDERABAD DISTRICT,54,Female,717,5354,6071
HYDERABAD DISTRICT,54,Transgender,0,4,4
HYDERABAD DISTRICT,55,Male,866,6187,7053
HYDERABAD DISTRICT,55,Female,726,4906,5632
HYDERABAD DISTRICT,55,Transgender,0,6,6
HYDERABAD DISTRICT,56,Male,759,5665,6424
HYDERABAD DISTRICT,56,Female,700,4558,5258
HYDERABAD DISTRICT,56,Transgender,0,5,5
HYDERABAD DISTRICT,57,Male,791,5022,5813
HYDERABAD DISTRICT,57,Female,866,4134,5000
HYDERABAD DISTRICT,57,Transgender,1,2,3
HYDERABAD DISTRICT,58,Male,725,4983,5708
HYDERABAD DISTRICT,58,Female,757,4342,5099
HYDERABAD DISTRICT,58,Transgender,0,0,0
HYDERABAD DISTRICT,59,Male,722,4528,5250
HYDERABAD DISTRICT,59,Female,792,4158,4950
HYDERABAD DISTRICT,59,Transgender,0,1,1
HYDERABAD DISTRICT,60,Male,856,3946,4802
HYDERABAD DISTRICT,60,Female,781,3717,4498
HYDERABAD DISTRICT,60,Transgender,0,5,5
HYDERABAD DISTRICT,61,Male,669,4485,5154
HYDERABAD DISTRICT,61,Female,715,4384,5099
HYDERABAD DISTRICT,61,Transgender,1,1,2
HYDERABAD DISTRICT,62,Male,694,4448,5142
HYDERABAD DISTRICT,62,Female,709,4049,4758
HYDERABAD DISTRICT,62,Transgender,0,0,0
HYDERABAD DISTRICT,63,Male,669,4175,4844
HYDERABAD DISTRICT,63,Female,674,4175,4849
HYDERABAD DISTRICT,63,Transgender,0,2,2
HYDERABAD DISTRICT,64,Male,704,3675,4379
HYDERABAD DISTRICT,64,Female,636,3199,3835
HYDERABAD DISTRICT,64,Transgender,1,1,2
HYDERABAD DISTRICT,65,Male,610,3135,3745
HYDERABAD DISTRICT,65,Female,499,2791,3290
HYDERABAD DISTRICT,65,Transgender,0,2,2
HYDERABAD DISTRICT,66,Male,464,2737,3201
HYDERABAD DISTRICT,66,Female,437,2236,2673
HYDERABAD DISTRICT,66,Transgender,0,1,1
HYDERABAD DISTRICT,67,Male,471,2414,2885
HYDERABAD DISTRICT,67,Female,497,2063,2560
HYDERABAD DISTRICT,67,Transgender,0,2,2
HYDERABAD DISTRICT,68,Male,400,2734,3134
HYDERABAD DISTRICT,68,Female,423,2517,2940
HYDERABAD DISTRICT,68,Transgender,0,3,3
HYDERABAD DISTRICT,69,Male,420,2263,2683
HYDERABAD DISTRICT,69,Female,447,2002,2449
HYDERABAD DISTRICT,69,Transgender,1,0,1
HYDERABAD DISTRICT,70,Male,379,1771,2150
HYDERABAD DISTRICT,70,Female,348,1848,2196
HYDERABAD DISTRICT,70,Transgender,0,3,3
HYDERABAD DISTRICT,71,Male,298,1785,2083
HYDERABAD DISTRICT,71,Female,287,1767,2054
HYDERABAD DISTRICT,71,Transgender,0,1,1
HYDERABAD DISTRICT,72,Male,272,1725,1997
HYDERABAD DISTRICT,72,Female,255,1669,1924
HYDERABAD DISTRICT,72,Transgender,0,0,0
HYDERABAD DISTRICT,73,Male,248,1754,2002
HYDERABAD DISTRICT,73,Female,249,1764,2013
HYDERABAD DISTRICT,73,Transgender,0,0,0
HYDERABAD DISTRICT,74,Male,256,1232,1488
HYDERABAD DISTRICT,74,Female,222,1205,1427
HYDERABAD DISTRICT,74,Transgender,0,0,0
HYDERABAD DISTRICT,>=75,Male,1572,8133,9705
HYDERABAD DISTRICT,>=75,Female,1815,9222,11037
HYDERABAD DISTRICT,>=75,Transgender,3,3,6
JACOBABAD DISTRICT,<1,Male,9702,3698,13400
JACOBABAD DISTRICT,<1,Female,9467,3395,12862
JACOBABAD DISTRICT,<1,Transgender,0,0,0
JACOBABAD DISTRICT,1,Male,10857,4152,15009
JACOBABAD DISTRICT,1,Female,11228,3866,15094
JACOBABAD DISTRICT,1,Transgender,0,0,0
JACOBABAD DISTRICT,2,Male,13727,4789,18516
JACOBABAD DISTRICT,2,Female,14038,4524,18562
JACOBABAD DISTRICT,2,Transgender,0,0,0
JACOBABAD DISTRICT,3,Male,14605,5235,19840
JACOBABAD DISTRICT,3,Female,14556,5024,19580
JACOBABAD DISTRICT,3,Transgender,0,0,0
JACOBABAD DISTRICT,4,Male,15259,5179,20438
JACOBABAD DISTRICT,4,Female,15046,5057,20103
JACOBABAD DISTRICT,4,Transgender,0,0,0
JACOBABAD DISTRICT,5,Male,14432,5154,19586
JACOBABAD DISTRICT,5,Female,13826,4851,18677
JACOBABAD DISTRICT,5,Transgender,0,0,0
JACOBABAD DISTRICT,6,Male,15039,4672,19711
JACOBABAD DISTRICT,6,Female,13553,4417,17970
JACOBABAD DISTRICT,6,Transgender,0,0,0
JACOBABAD DISTRICT,7,Male,14443,5489,19932
JACOBABAD DISTRICT,7,Female,12831,4977,17808
JACOBABAD DISTRICT,7,Transgender,0,0,0
JACOBABAD DISTRICT,8,Male,16691,5111,21802
JACOBABAD DISTRICT,8,Female,14707,4829,19536
JACOBABAD DISTRICT,8,Transgender,0,0,0
JACOBABAD DISTRICT,9,Male,12171,4795,16966
JACOBABAD DISTRICT,9,Female,10560,4346,14906
JACOBABAD DISTRICT,9,Transgender,0,0,0
JACOBABAD DISTRICT,10,Male,14531,4535,19066
JACOBABAD DISTRICT,10,Female,12104,4165,16269
JACOBABAD DISTRICT,10,Transgender,0,0,0
JACOBABAD DISTRICT,11,Male,8929,3860,12789
JACOBABAD DISTRICT,11,Female,7447,3383,10830
JACOBABAD DISTRICT,11,Transgender,0,0,0
JACOBABAD DISTRICT,12,Male,10916,4057,14973
JACOBABAD DISTRICT,12,Female,8765,3683,12448
JACOBABAD DISTRICT,12,Transgender,0,0,0
JACOBABAD DISTRICT,13,Male,7671,3488,11159
JACOBABAD DISTRICT,13,Female,6036,3257,9293
JACOBABAD DISTRICT,13,Transgender,0,0,0
JACOBABAD DISTRICT,14,Male,8171,3479,11650
JACOBABAD DISTRICT,14,Female,6654,3212,9866
JACOBABAD DISTRICT,14,Transgender,0,0,0
JACOBABAD DISTRICT,15,Male,7794,3633,11427
JACOBABAD DISTRICT,15,Female,5676,3209,8885
JACOBABAD DISTRICT,15,Transgender,0,1,1
JACOBABAD DISTRICT,16,Male,7662,3452,11114
JACOBABAD DISTRICT,16,Female,5910,3153,9063
JACOBABAD DISTRICT,16,Transgender,6,1,7
JACOBABAD DISTRICT,17,Male,6444,3670,10114
JACOBABAD DISTRICT,17,Female,4985,3203,8188
JACOBABAD DISTRICT,17,Transgender,2,3,5
JACOBABAD DISTRICT,18,Male,7589,3341,10930
JACOBABAD DISTRICT,18,Female,7443,3441,10884
JACOBABAD DISTRICT,18,Transgender,2,4,6
JACOBABAD DISTRICT,19,Male,5763,3002,8765
JACOBABAD DISTRICT,19,Female,5448,2957,8405
JACOBABAD DISTRICT,19,Transgender,2,1,3
JACOBABAD DISTRICT,20,Male,5952,2836,8788
JACOBABAD DISTRICT,20,Female,6152,2838,8990
JACOBABAD DISTRICT,20,Transgender,6,4,10
JACOBABAD DISTRICT,21,Male,4316,2475,6791
JACOBABAD DISTRICT,21,Female,4514,2425,6939
JACOBABAD DISTRICT,21,Transgender,1,1,2
JACOBABAD DISTRICT,22,Male,4385,2443,6828
JACOBABAD DISTRICT,22,Female,4221,2275,6496
JACOBABAD DISTRICT,22,Transgender,4,3,7
JACOBABAD DISTRICT,23,Male,3666,2289,5955
JACOBABAD DISTRICT,23,Female,3802,2181,5983
JACOBABAD DISTRICT,23,Transgender,2,0,2
JACOBABAD DISTRICT,24,Male,3668,2037,5705
JACOBABAD DISTRICT,24,Female,3765,2090,5855
JACOBABAD DISTRICT,24,Transgender,4,1,5
JACOBABAD DISTRICT,25,Male,4714,2215,6929
JACOBABAD DISTRICT,25,Female,5016,2255,7271
JACOBABAD DISTRICT,25,Transgender,0,5,5
JACOBABAD DISTRICT,26,Male,3945,1961,5906
JACOBABAD DISTRICT,26,Female,4195,2063,6258
JACOBABAD DISTRICT,26,Transgender,2,2,4
JACOBABAD DISTRICT,27,Male,4657,2360,7017
JACOBABAD DISTRICT,27,Female,5028,2479,7507
JACOBABAD DISTRICT,27,Transgender,2,4,6
JACOBABAD DISTRICT,28,Male,4061,2111,6172
JACOBABAD DISTRICT,28,Female,4821,2312,7133
JACOBABAD DISTRICT,28,Transgender,2,2,4
JACOBABAD DISTRICT,29,Male,5234,2317,7551
JACOBABAD DISTRICT,29,Female,5408,2426,7834
JACOBABAD DISTRICT,29,Transgender,1,1,2
JACOBABAD DISTRICT,30,Male,4285,2143,6428
JACOBABAD DISTRICT,30,Female,4619,2118,6737
JACOBABAD DISTRICT,30,Transgender,2,5,7
JACOBABAD DISTRICT,31,Male,4486,2232,6718
JACOBABAD DISTRICT,31,Female,4793,2130,6923
JACOBABAD DISTRICT,31,Transgender,0,2,2
JACOBABAD DISTRICT,32,Male,4170,2052,6222
JACOBABAD DISTRICT,32,Female,4583,1970,6553
JACOBABAD DISTRICT,32,Transgender,0,5,5
JACOBABAD DISTRICT,33,Male,3900,2040,5940
JACOBABAD DISTRICT,33,Female,4324,1907,6231
JACOBABAD DISTRICT,33,Transgender,1,1,2
JACOBABAD DISTRICT,34,Male,3606,1776,5382
JACOBABAD DISTRICT,34,Female,3765,1714,5479
JACOBABAD DISTRICT,34,Transgender,2,0,2
JACOBABAD DISTRICT,35,Male,3765,1783,5548
JACOBABAD DISTRICT,35,Female,3698,1676,5374
JACOBABAD DISTRICT,35,Transgender,4,5,9
JACOBABAD DISTRICT,36,Male,4104,1631,5735
JACOBABAD DISTRICT,36,Female,3857,1436,5293
JACOBABAD DISTRICT,36,Transgender,3,1,4
JACOBABAD DISTRICT,37,Male,5557,2005,7562
JACOBABAD DISTRICT,37,Female,4876,1937,6813
JACOBABAD DISTRICT,37,Transgender,3,1,4
JACOBABAD DISTRICT,38,Male,3575,1573,5148
JACOBABAD DISTRICT,38,Female,3562,1638,5200
JACOBABAD DISTRICT,38,Transgender,1,2,3
JACOBABAD DISTRICT,39,Male,4105,1781,5886
JACOBABAD DISTRICT,39,Female,3814,1686,5500
JACOBABAD DISTRICT,39,Transgender,2,1,3
JACOBABAD DISTRICT,40,Male,2820,1435,4255
JACOBABAD DISTRICT,40,Female,2917,1352,4269
JACOBABAD DISTRICT,40,Transgender,4,4,8
JACOBABAD DISTRICT,41,Male,2908,1313,4221
JACOBABAD DISTRICT,41,Female,2959,1235,4194
JACOBABAD DISTRICT,41,Transgender,1,0,1
JACOBABAD DISTRICT,42,Male,2997,1232,4229
JACOBABAD DISTRICT,42,Female,2968,1291,4259
JACOBABAD DISTRICT,42,Transgender,0,1,1
JACOBABAD DISTRICT,43,Male,2138,1195,3333
JACOBABAD DISTRICT,43,Female,2479,1152,3631
JACOBABAD DISTRICT,43,Transgender,0,2,2
JACOBABAD DISTRICT,44,Male,2061,1081,3142
JACOBABAD DISTRICT,44,Female,2301,1081,3382
JACOBABAD DISTRICT,44,Transgender,0,0,0
JACOBABAD DISTRICT,45,Male,2021,1118,3139
JACOBABAD DISTRICT,45,Female,2226,1071,3297
JACOBABAD DISTRICT,45,Transgender,0,2,2
JACOBABAD DISTRICT,46,Male,2212,1020,3232
JACOBABAD DISTRICT,46,Female,2272,856,3128
JACOBABAD DISTRICT,46,Transgender,1,0,1
JACOBABAD DISTRICT,47,Male,2805,1181,3986
JACOBABAD DISTRICT,47,Female,3095,1239,4334
JACOBABAD DISTRICT,47,Transgender,2,1,3
JACOBABAD DISTRICT,48,Male,2065,1097,3162
JACOBABAD DISTRICT,48,Female,2209,999,3208
JACOBABAD DISTRICT,48,Transgender,1,1,2
JACOBABAD DISTRICT,49,Male,2383,1155,3538
JACOBABAD DISTRICT,49,Female,2313,1032,3345
JACOBABAD DISTRICT,49,Transgender,0,1,1
JACOBABAD DISTRICT,50,Male,1777,930,2707
JACOBABAD DISTRICT,50,Female,1873,904,2777
JACOBABAD DISTRICT,50,Transgender,2,3,5
JACOBABAD DISTRICT,51,Male,2008,934,2942
JACOBABAD DISTRICT,51,Female,1940,896,2836
JACOBABAD DISTRICT,51,Transgender,2,0,2
JACOBABAD DISTRICT,52,Male,2046,911,2957
JACOBABAD DISTRICT,52,Female,1900,797,2697
JACOBABAD DISTRICT,52,Transgender,0,0,0
JACOBABAD DISTRICT,53,Male,1541,831,2372
JACOBABAD DISTRICT,53,Female,1398,709,2107
JACOBABAD DISTRICT,53,Transgender,0,1,1
JACOBABAD DISTRICT,54,Male,1342,729,2071
JACOBABAD DISTRICT,54,Female,1195,557,1752
JACOBABAD DISTRICT,54,Transgender,0,0,0
JACOBABAD DISTRICT,55,Male,1256,619,1875
JACOBABAD DISTRICT,55,Female,1375,626,2001
JACOBABAD DISTRICT,55,Transgender,2,0,2
JACOBABAD DISTRICT,56,Male,1363,584,1947
JACOBABAD DISTRICT,56,Female,1309,470,1779
JACOBABAD DISTRICT,56,Transgender,0,1,1
JACOBABAD DISTRICT,57,Male,1852,739,2591
JACOBABAD DISTRICT,57,Female,1980,706,2686
JACOBABAD DISTRICT,57,Transgender,0,1,1
JACOBABAD DISTRICT,58,Male,1086,514,1600
JACOBABAD DISTRICT,58,Female,1014,499,1513
JACOBABAD DISTRICT,58,Transgender,1,0,1
JACOBABAD DISTRICT,59,Male,1196,528,1724
JACOBABAD DISTRICT,59,Female,1271,587,1858
JACOBABAD DISTRICT,59,Transgender,1,0,1
JACOBABAD DISTRICT,60,Male,1050,491,1541
JACOBABAD DISTRICT,60,Female,1178,508,1686
JACOBABAD DISTRICT,60,Transgender,2,0,2
JACOBABAD DISTRICT,61,Male,1008,457,1465
JACOBABAD DISTRICT,61,Female,1207,546,1753
JACOBABAD DISTRICT,61,Transgender,0,0,0
JACOBABAD DISTRICT,62,Male,1126,466,1592
JACOBABAD DISTRICT,62,Female,1439,637,2076
JACOBABAD DISTRICT,62,Transgender,0,0,0
JACOBABAD DISTRICT,63,Male,926,443,1369
JACOBABAD DISTRICT,63,Female,987,521,1508
JACOBABAD DISTRICT,63,Transgender,0,0,0
JACOBABAD DISTRICT,64,Male,917,392,1309
JACOBABAD DISTRICT,64,Female,875,413,1288
JACOBABAD DISTRICT,64,Transgender,0,1,1
JACOBABAD DISTRICT,65,Male,783,376,1159
JACOBABAD DISTRICT,65,Female,872,378,1250
JACOBABAD DISTRICT,65,Transgender,0,1,1
JACOBABAD DISTRICT,66,Male,948,341,1289
JACOBABAD DISTRICT,66,Female,957,330,1287
JACOBABAD DISTRICT,66,Transgender,0,1,1
JACOBABAD DISTRICT,67,Male,1092,365,1457
JACOBABAD DISTRICT,67,Female,1261,485,1746
JACOBABAD DISTRICT,67,Transgender,0,0,0
JACOBABAD DISTRICT,68,Male,653,296,949
JACOBABAD DISTRICT,68,Female,653,296,949
JACOBABAD DISTRICT,68,Transgender,1,0,1
JACOBABAD DISTRICT,69,Male,781,247,1028
JACOBABAD DISTRICT,69,Female,678,287,965
JACOBABAD DISTRICT,69,Transgender,0,0,0
JACOBABAD DISTRICT,70,Male,502,192,694
JACOBABAD DISTRICT,70,Female,541,218,759
JACOBABAD DISTRICT,70,Transgender,1,0,1
JACOBABAD DISTRICT,71,Male,614,233,847
JACOBABAD DISTRICT,71,Female,622,225,847
JACOBABAD DISTRICT,71,Transgender,0,1,1
JACOBABAD DISTRICT,72,Male,555,182,737
JACOBABAD DISTRICT,72,Female,660,244,904
JACOBABAD DISTRICT,72,Transgender,0,0,0
JACOBABAD DISTRICT,73,Male,425,170,595
JACOBABAD DISTRICT,73,Female,407,196,603
JACOBABAD DISTRICT,73,Transgender,0,0,0
JACOBABAD DISTRICT,74,Male,357,119,476
JACOBABAD DISTRICT,74,Female,348,139,487
JACOBABAD DISTRICT,74,Transgender,0,0,0
JACOBABAD DISTRICT,>=75,Male,2860,998,3858
JACOBABAD DISTRICT,>=75,Female,3920,1382,5302
JACOBABAD DISTRICT,>=75,Transgender,3,6,9
JAFFARABAD DISTRICT,<1,Male,4975,1907,6882
JAFFARABAD DISTRICT,<1,Female,4821,1834,6655
JAFFARABAD DISTRICT,<1,Transgender,0,0,0
JAFFARABAD DISTRICT,1,Male,5982,2551,8533
JAFFARABAD DISTRICT,1,Female,6146,2474,8620
JAFFARABAD DISTRICT,1,Transgender,0,0,0
JAFFARABAD DISTRICT,2,Male,7302,2815,10117
JAFFARABAD DISTRICT,2,Female,7453,2869,10322
JAFFARABAD DISTRICT,2,Transgender,0,0,0
JAFFARABAD DISTRICT,3,Male,7439,3309,10748
JAFFARABAD DISTRICT,3,Female,7433,3233,10666
JAFFARABAD DISTRICT,3,Transgender,0,0,0
JAFFARABAD DISTRICT,4,Male,7890,3038,10928
JAFFARABAD DISTRICT,4,Female,7587,2940,10527
JAFFARABAD DISTRICT,4,Transgender,0,0,0
JAFFARABAD DISTRICT,5,Male,7512,3151,10663
JAFFARABAD DISTRICT,5,Female,7288,2825,10113
JAFFARABAD DISTRICT,5,Transgender,0,0,0
JAFFARABAD DISTRICT,6,Male,7891,2810,10701
JAFFARABAD DISTRICT,6,Female,7058,2456,9514
JAFFARABAD DISTRICT,6,Transgender,0,0,0
JAFFARABAD DISTRICT,7,Male,7394,3250,10644
JAFFARABAD DISTRICT,7,Female,6368,2991,9359
JAFFARABAD DISTRICT,7,Transgender,0,0,0
JAFFARABAD DISTRICT,8,Male,8336,2800,11136
JAFFARABAD DISTRICT,8,Female,6809,2589,9398
JAFFARABAD DISTRICT,8,Transgender,0,0,0
JAFFARABAD DISTRICT,9,Male,6044,2750,8794
JAFFARABAD DISTRICT,9,Female,5074,2311,7385
JAFFARABAD DISTRICT,9,Transgender,0,0,0
JAFFARABAD DISTRICT,10,Male,6871,2347,9218
JAFFARABAD DISTRICT,10,Female,5681,2121,7802
JAFFARABAD DISTRICT,10,Transgender,0,0,0
JAFFARABAD DISTRICT,11,Male,4470,2200,6670
JAFFARABAD DISTRICT,11,Female,3598,1851,5449
JAFFARABAD DISTRICT,11,Transgender,0,0,0
JAFFARABAD DISTRICT,12,Male,5188,2126,7314
JAFFARABAD DISTRICT,12,Female,4439,1867,6306
JAFFARABAD DISTRICT,12,Transgender,0,0,0
JAFFARABAD DISTRICT,13,Male,3623,1884,5507
JAFFARABAD DISTRICT,13,Female,2988,1590,4578
JAFFARABAD DISTRICT,13,Transgender,0,0,0
JAFFARABAD DISTRICT,14,Male,4188,1755,5943
JAFFARABAD DISTRICT,14,Female,3408,1524,4932
JAFFARABAD DISTRICT,14,Transgender,0,0,0
JAFFARABAD DISTRICT,15,Male,3524,1825,5349
JAFFARABAD DISTRICT,15,Female,2829,1612,4441
JAFFARABAD DISTRICT,15,Transgender,1,0,1
JAFFARABAD DISTRICT,16,Male,3897,1752,5649
JAFFARABAD DISTRICT,16,Female,3124,1433,4557
JAFFARABAD DISTRICT,16,Transgender,1,0,1
JAFFARABAD DISTRICT,17,Male,2929,1854,4783
JAFFARABAD DISTRICT,17,Female,2587,1512,4099
JAFFARABAD DISTRICT,17,Transgender,1,0,1
JAFFARABAD DISTRICT,18,Male,4280,1672,5952
JAFFARABAD DISTRICT,18,Female,3883,1666,5549
JAFFARABAD DISTRICT,18,Transgender,1,0,1
JAFFARABAD DISTRICT,19,Male,2964,1553,4517
JAFFARABAD DISTRICT,19,Female,2781,1525,4306
JAFFARABAD DISTRICT,19,Transgender,0,0,0
JAFFARABAD DISTRICT,20,Male,3054,1326,4380
JAFFARABAD DISTRICT,20,Female,2945,1236,4181
JAFFARABAD DISTRICT,20,Transgender,1,0,1
JAFFARABAD DISTRICT,21,Male,2219,1259,3478
JAFFARABAD DISTRICT,21,Female,2293,1242,3535
JAFFARABAD DISTRICT,21,Transgender,0,0,0
JAFFARABAD DISTRICT,22,Male,2138,1137,3275
JAFFARABAD DISTRICT,22,Female,2047,1074,3121
JAFFARABAD DISTRICT,22,Transgender,0,0,0
JAFFARABAD DISTRICT,23,Male,1937,1186,3123
JAFFARABAD DISTRICT,23,Female,1811,1029,2840
JAFFARABAD DISTRICT,23,Transgender,2,0,2
JAFFARABAD DISTRICT,24,Male,1943,1111,3054
JAFFARABAD DISTRICT,24,Female,1925,1029,2954
JAFFARABAD DISTRICT,24,Transgender,2,0,2
JAFFARABAD DISTRICT,25,Male,2203,1101,3304
JAFFARABAD DISTRICT,25,Female,2467,1073,3540
JAFFARABAD DISTRICT,25,Transgender,4,2,6
JAFFARABAD DISTRICT,26,Male,1905,966,2871
JAFFARABAD DISTRICT,26,Female,2083,1008,3091
JAFFARABAD DISTRICT,26,Transgender,1,0,1
JAFFARABAD DISTRICT,27,Male,2557,1295,3852
JAFFARABAD DISTRICT,27,Female,2566,1488,4054
JAFFARABAD DISTRICT,27,Transgender,2,0,2
JAFFARABAD DISTRICT,28,Male,2043,962,3005
JAFFARABAD DISTRICT,28,Female,2340,1068,3408
JAFFARABAD DISTRICT,28,Transgender,2,0,2
JAFFARABAD DISTRICT,29,Male,2414,1198,3612
JAFFARABAD DISTRICT,29,Female,2600,1411,4011
JAFFARABAD DISTRICT,29,Transgender,1,0,1
JAFFARABAD DISTRICT,30,Male,1944,848,2792
JAFFARABAD DISTRICT,30,Female,2469,923,3392
JAFFARABAD DISTRICT,30,Transgender,4,0,4
JAFFARABAD DISTRICT,31,Male,2081,1126,3207
JAFFARABAD DISTRICT,31,Female,2461,1267,3728
JAFFARABAD DISTRICT,31,Transgender,0,0,0
JAFFARABAD DISTRICT,32,Male,2092,1121,3213
JAFFARABAD DISTRICT,32,Female,2504,1188,3692
JAFFARABAD DISTRICT,32,Transgender,1,0,1
JAFFARABAD DISTRICT,33,Male,1805,934,2739
JAFFARABAD DISTRICT,33,Female,2044,926,2970
JAFFARABAD DISTRICT,33,Transgender,2,0,2
JAFFARABAD DISTRICT,34,Male,1790,922,2712
JAFFARABAD DISTRICT,34,Female,1911,891,2802
JAFFARABAD DISTRICT,34,Transgender,1,1,2
JAFFARABAD DISTRICT,35,Male,1821,854,2675
JAFFARABAD DISTRICT,35,Female,1916,802,2718
JAFFARABAD DISTRICT,35,Transgender,2,0,2
JAFFARABAD DISTRICT,36,Male,2077,889,2966
JAFFARABAD DISTRICT,36,Female,1900,907,2807
JAFFARABAD DISTRICT,36,Transgender,1,0,1
JAFFARABAD DISTRICT,37,Male,2866,1209,4075
JAFFARABAD DISTRICT,37,Female,2492,1344,3836
JAFFARABAD DISTRICT,37,Transgender,1,1,2
JAFFARABAD DISTRICT,38,Male,1768,832,2600
JAFFARABAD DISTRICT,38,Female,1654,680,2334
JAFFARABAD DISTRICT,38,Transgender,0,0,0
JAFFARABAD DISTRICT,39,Male,2169,881,3050
JAFFARABAD DISTRICT,39,Female,1850,832,2682
JAFFARABAD DISTRICT,39,Transgender,1,0,1
JAFFARABAD DISTRICT,40,Male,1426,605,2031
JAFFARABAD DISTRICT,40,Female,1554,568,2122
JAFFARABAD DISTRICT,40,Transgender,0,0,0
JAFFARABAD DISTRICT,41,Male,1493,672,2165
JAFFARABAD DISTRICT,41,Female,1451,681,2132
JAFFARABAD DISTRICT,41,Transgender,0,0,0
JAFFARABAD DISTRICT,42,Male,1480,662,2142
JAFFARABAD DISTRICT,42,Female,1503,676,2179
JAFFARABAD DISTRICT,42,Transgender,1,1,2
JAFFARABAD DISTRICT,43,Male,1083,596,1679
JAFFARABAD DISTRICT,43,Female,1059,491,1550
JAFFARABAD DISTRICT,43,Transgender,0,0,0
JAFFARABAD DISTRICT,44,Male,988,483,1471
JAFFARABAD DISTRICT,44,Female,1016,453,1469
JAFFARABAD DISTRICT,44,Transgender,0,0,0
JAFFARABAD DISTRICT,45,Male,953,410,1363
JAFFARABAD DISTRICT,45,Female,1027,379,1406
JAFFARABAD DISTRICT,45,Transgender,2,0,2
JAFFARABAD DISTRICT,46,Male,1106,456,1562
JAFFARABAD DISTRICT,46,Female,1131,463,1594
JAFFARABAD DISTRICT,46,Transgender,0,0,0
JAFFARABAD DISTRICT,47,Male,1479,605,2084
JAFFARABAD DISTRICT,47,Female,1517,774,2291
JAFFARABAD DISTRICT,47,Transgender,0,0,0
JAFFARABAD DISTRICT,48,Male,920,506,1426
JAFFARABAD DISTRICT,48,Female,1004,412,1416
JAFFARABAD DISTRICT,48,Transgender,1,0,1
JAFFARABAD DISTRICT,49,Male,1063,569,1632
JAFFARABAD DISTRICT,49,Female,988,522,1510
JAFFARABAD DISTRICT,49,Transgender,0,0,0
JAFFARABAD DISTRICT,50,Male,819,380,1199
JAFFARABAD DISTRICT,50,Female,970,368,1338
JAFFARABAD DISTRICT,50,Transgender,0,0,0
JAFFARABAD DISTRICT,51,Male,991,497,1488
JAFFARABAD DISTRICT,51,Female,1004,485,1489
JAFFARABAD DISTRICT,51,Transgender,0,0,0
JAFFARABAD DISTRICT,52,Male,931,484,1415
JAFFARABAD DISTRICT,52,Female,954,455,1409
JAFFARABAD DISTRICT,52,Transgender,0,0,0
JAFFARABAD DISTRICT,53,Male,782,332,1114
JAFFARABAD DISTRICT,53,Female,717,321,1038
JAFFARABAD DISTRICT,53,Transgender,0,0,0
JAFFARABAD DISTRICT,54,Male,752,352,1104
JAFFARABAD DISTRICT,54,Female,623,274,897
JAFFARABAD DISTRICT,54,Transgender,0,0,0
JAFFARABAD DISTRICT,55,Male,564,268,832
JAFFARABAD DISTRICT,55,Female,627,263,890
JAFFARABAD DISTRICT,55,Transgender,0,0,0
JAFFARABAD DISTRICT,56,Male,657,273,930
JAFFARABAD DISTRICT,56,Female,721,288,1009
JAFFARABAD DISTRICT,56,Transgender,0,0,0
JAFFARABAD DISTRICT,57,Male,939,435,1374
JAFFARABAD DISTRICT,57,Female,1054,583,1637
JAFFARABAD DISTRICT,57,Transgender,1,0,1
JAFFARABAD DISTRICT,58,Male,511,249,760
JAFFARABAD DISTRICT,58,Female,538,244,782
JAFFARABAD DISTRICT,58,Transgender,0,0,0
JAFFARABAD DISTRICT,59,Male,674,306,980
JAFFARABAD DISTRICT,59,Female,581,313,894
JAFFARABAD DISTRICT,59,Transgender,0,0,0
JAFFARABAD DISTRICT,60,Male,477,189,666
JAFFARABAD DISTRICT,60,Female,615,205,820
JAFFARABAD DISTRICT,60,Transgender,0,0,0
JAFFARABAD DISTRICT,61,Male,551,289,840
JAFFARABAD DISTRICT,61,Female,580,311,891
JAFFARABAD DISTRICT,61,Transgender,1,2,3
JAFFARABAD DISTRICT,62,Male,553,257,810
JAFFARABAD DISTRICT,62,Female,700,337,1037
JAFFARABAD DISTRICT,62,Transgender,0,0,0
JAFFARABAD DISTRICT,63,Male,503,209,712
JAFFARABAD DISTRICT,63,Female,484,215,699
JAFFARABAD DISTRICT,63,Transgender,0,0,0
JAFFARABAD DISTRICT,64,Male,519,184,703
JAFFARABAD DISTRICT,64,Female,460,183,643
JAFFARABAD DISTRICT,64,Transgender,2,0,2
JAFFARABAD DISTRICT,65,Male,396,161,557
JAFFARABAD DISTRICT,65,Female,370,171,541
JAFFARABAD DISTRICT,65,Transgender,2,0,2
JAFFARABAD DISTRICT,66,Male,433,177,610
JAFFARABAD DISTRICT,66,Female,478,199,677
JAFFARABAD DISTRICT,66,Transgender,0,0,0
JAFFARABAD DISTRICT,67,Male,502,209,711
JAFFARABAD DISTRICT,67,Female,661,344,1005
JAFFARABAD DISTRICT,67,Transgender,1,0,1
JAFFARABAD DISTRICT,68,Male,316,118,434
JAFFARABAD DISTRICT,68,Female,311,128,439
JAFFARABAD DISTRICT,68,Transgender,0,0,0
JAFFARABAD DISTRICT,69,Male,364,132,496
JAFFARABAD DISTRICT,69,Female,328,162,490
JAFFARABAD DISTRICT,69,Transgender,0,0,0
JAFFARABAD DISTRICT,70,Male,274,78,352
JAFFARABAD DISTRICT,70,Female,296,105,401
JAFFARABAD DISTRICT,70,Transgender,0,0,0
JAFFARABAD DISTRICT,71,Male,280,117,397
JAFFARABAD DISTRICT,71,Female,325,139,464
JAFFARABAD DISTRICT,71,Transgender,0,0,0
JAFFARABAD DISTRICT,72,Male,225,81,306
JAFFARABAD DISTRICT,72,Female,294,110,404
JAFFARABAD DISTRICT,72,Transgender,0,0,0
JAFFARABAD DISTRICT,73,Male,210,64,274
JAFFARABAD DISTRICT,73,Female,203,71,274
JAFFARABAD DISTRICT,73,Transgender,0,0,0
JAFFARABAD DISTRICT,74,Male,198,48,246
JAFFARABAD DISTRICT,74,Female,192,80,272
JAFFARABAD DISTRICT,74,Transgender,0,1,1
JAFFARABAD DISTRICT,>=75,Male,1441,535,1976
JAFFARABAD DISTRICT,>=75,Female,1869,795,2664
JAFFARABAD DISTRICT,>=75,Transgender,2,0,2
JAMSHORO DISTRICT,<1,Male,6311,4874,11185
JAMSHORO DISTRICT,<1,Female,5760,4350,10110
JAMSHORO DISTRICT,<1,Transgender,0,0,0
JAMSHORO DISTRICT,1,Male,7295,5453,12748
JAMSHORO DISTRICT,1,Female,7054,5230,12284
JAMSHORO DISTRICT,1,Transgender,0,0,0
JAMSHORO DISTRICT,2,Male,8408,6275,14683
JAMSHORO DISTRICT,2,Female,8463,5911,14374
JAMSHORO DISTRICT,2,Transgender,0,0,0
JAMSHORO DISTRICT,3,Male,9588,7118,16706
JAMSHORO DISTRICT,3,Female,9314,6718,16032
JAMSHORO DISTRICT,3,Transgender,0,0,0
JAMSHORO DISTRICT,4,Male,9658,6535,16193
JAMSHORO DISTRICT,4,Female,9288,6421,15709
JAMSHORO DISTRICT,4,Transgender,0,0,0
JAMSHORO DISTRICT,5,Male,10057,7282,17339
JAMSHORO DISTRICT,5,Female,9399,6461,15860
JAMSHORO DISTRICT,5,Transgender,0,0,0
JAMSHORO DISTRICT,6,Male,10012,6540,16552
JAMSHORO DISTRICT,6,Female,9030,6152,15182
JAMSHORO DISTRICT,6,Transgender,0,0,0
JAMSHORO DISTRICT,7,Male,8551,6773,15324
JAMSHORO DISTRICT,7,Female,7720,6187,13907
JAMSHORO DISTRICT,7,Transgender,0,0,0
JAMSHORO DISTRICT,8,Male,10170,6813,16983
JAMSHORO DISTRICT,8,Female,9012,6036,15048
JAMSHORO DISTRICT,8,Transgender,0,0,0
JAMSHORO DISTRICT,9,Male,7505,6099,13604
JAMSHORO DISTRICT,9,Female,6697,5562,12259
JAMSHORO DISTRICT,9,Transgender,0,0,0
JAMSHORO DISTRICT,10,Male,9250,6181,15431
JAMSHORO DISTRICT,10,Female,8007,5307,13314
JAMSHORO DISTRICT,10,Transgender,0,0,0
JAMSHORO DISTRICT,11,Male,6356,5364,11720
JAMSHORO DISTRICT,11,Female,5246,4704,9950
JAMSHORO DISTRICT,11,Transgender,0,0,0
JAMSHORO DISTRICT,12,Male,7438,5584,13022
JAMSHORO DISTRICT,12,Female,6092,4773,10865
JAMSHORO DISTRICT,12,Transgender,0,0,0
JAMSHORO DISTRICT,13,Male,5586,4916,10502
JAMSHORO DISTRICT,13,Female,4657,4254,8911
JAMSHORO DISTRICT,13,Transgender,0,0,0
JAMSHORO DISTRICT,14,Male,5937,4633,10570
JAMSHORO DISTRICT,14,Female,4981,4153,9134
JAMSHORO DISTRICT,14,Transgender,0,0,0
JAMSHORO DISTRICT,15,Male,6375,5251,11626
JAMSHORO DISTRICT,15,Female,5082,4613,9695
JAMSHORO DISTRICT,15,Transgender,2,3,5
JAMSHORO DISTRICT,16,Male,5848,4728,10576
JAMSHORO DISTRICT,16,Female,5009,4253,9262
JAMSHORO DISTRICT,16,Transgender,2,0,2
JAMSHORO DISTRICT,17,Male,5351,4920,10271
JAMSHORO DISTRICT,17,Female,4488,4284,8772
JAMSHORO DISTRICT,17,Transgender,0,2,2
JAMSHORO DISTRICT,18,Male,6490,4859,11349
JAMSHORO DISTRICT,18,Female,5609,4455,10064
JAMSHORO DISTRICT,18,Transgender,1,7,8
JAMSHORO DISTRICT,19,Male,5461,4347,9808
JAMSHORO DISTRICT,19,Female,4521,4216,8737
JAMSHORO DISTRICT,19,Transgender,1,1,2
JAMSHORO DISTRICT,20,Male,6537,4541,11078
JAMSHORO DISTRICT,20,Female,5628,4482,10110
JAMSHORO DISTRICT,20,Transgender,1,1,2
JAMSHORO DISTRICT,21,Male,5314,4267,9581
JAMSHORO DISTRICT,21,Female,4369,3799,8168
JAMSHORO DISTRICT,21,Transgender,0,1,1
JAMSHORO DISTRICT,22,Male,5324,4310,9634
JAMSHORO DISTRICT,22,Female,4358,3869,8227
JAMSHORO DISTRICT,22,Transgender,3,1,4
JAMSHORO DISTRICT,23,Male,4703,3883,8586
JAMSHORO DISTRICT,23,Female,3914,3513,7427
JAMSHORO DISTRICT,23,Transgender,2,1,3
JAMSHORO DISTRICT,24,Male,4461,3646,8107
JAMSHORO DISTRICT,24,Female,3833,3267,7100
JAMSHORO DISTRICT,24,Transgender,1,0,1
JAMSHORO DISTRICT,25,Male,5403,3830,9233
JAMSHORO DISTRICT,25,Female,4719,3898,8617
JAMSHORO DISTRICT,25,Transgender,2,7,9
JAMSHORO DISTRICT,26,Male,4586,3532,8118
JAMSHORO DISTRICT,26,Female,3957,3305,7262
JAMSHORO DISTRICT,26,Transgender,0,4,4
JAMSHORO DISTRICT,27,Male,4730,3568,8298
JAMSHORO DISTRICT,27,Female,4127,3547,7674
JAMSHORO DISTRICT,27,Transgender,0,0,0
JAMSHORO DISTRICT,28,Male,4624,3539,8163
JAMSHORO DISTRICT,28,Female,4232,3466,7698
JAMSHORO DISTRICT,28,Transgender,1,4,5
JAMSHORO DISTRICT,29,Male,4552,3605,8157
JAMSHORO DISTRICT,29,Female,4358,3666,8024
JAMSHORO DISTRICT,29,Transgender,0,2,2
JAMSHORO DISTRICT,30,Male,4613,3545,8158
JAMSHORO DISTRICT,30,Female,4473,3542,8015
JAMSHORO DISTRICT,30,Transgender,3,3,6
JAMSHORO DISTRICT,31,Male,4432,3448,7880
JAMSHORO DISTRICT,31,Female,4172,3182,7354
JAMSHORO DISTRICT,31,Transgender,1,1,2
JAMSHORO DISTRICT,32,Male,4129,3284,7413
JAMSHORO DISTRICT,32,Female,3685,3043,6728
JAMSHORO DISTRICT,32,Transgender,2,3,5
JAMSHORO DISTRICT,33,Male,3804,2920,6724
JAMSHORO DISTRICT,33,Female,3618,2855,6473
JAMSHORO DISTRICT,33,Transgender,1,0,1
JAMSHORO DISTRICT,34,Male,3688,2809,6497
JAMSHORO DISTRICT,34,Female,3208,2627,5835
JAMSHORO DISTRICT,34,Transgender,0,0,0
JAMSHORO DISTRICT,35,Male,4179,3042,7221
JAMSHORO DISTRICT,35,Female,3586,2730,6316
JAMSHORO DISTRICT,35,Transgender,1,9,10
JAMSHORO DISTRICT,36,Male,3567,2608,6175
JAMSHORO DISTRICT,36,Female,2899,2271,5170
JAMSHORO DISTRICT,36,Transgender,1,3,4
JAMSHORO DISTRICT,37,Male,4051,2804,6855
JAMSHORO DISTRICT,37,Female,3210,2497,5707
JAMSHORO DISTRICT,37,Transgender,2,1,3
JAMSHORO DISTRICT,38,Male,3312,2598,5910
JAMSHORO DISTRICT,38,Female,2975,2424,5399
JAMSHORO DISTRICT,38,Transgender,2,1,3
JAMSHORO DISTRICT,39,Male,3582,2726,6308
JAMSHORO DISTRICT,39,Female,3236,2510,5746
JAMSHORO DISTRICT,39,Transgender,0,1,1
JAMSHORO DISTRICT,40,Male,3267,2527,5794
JAMSHORO DISTRICT,40,Female,3088,2434,5522
JAMSHORO DISTRICT,40,Transgender,3,4,7
JAMSHORO DISTRICT,41,Male,3147,2384,5531
JAMSHORO DISTRICT,41,Female,2752,2082,4834
JAMSHORO DISTRICT,41,Transgender,0,0,0
JAMSHORO DISTRICT,42,Male,3020,2203,5223
JAMSHORO DISTRICT,42,Female,2592,1974,4566
JAMSHORO DISTRICT,42,Transgender,2,2,4
JAMSHORO DISTRICT,43,Male,2553,2014,4567
JAMSHORO DISTRICT,43,Female,2377,1885,4262
JAMSHORO DISTRICT,43,Transgender,1,1,2
JAMSHORO DISTRICT,44,Male,2630,1941,4571
JAMSHORO DISTRICT,44,Female,2173,1717,3890
JAMSHORO DISTRICT,44,Transgender,0,1,1
JAMSHORO DISTRICT,45,Male,2546,1970,4516
JAMSHORO DISTRICT,45,Female,2257,1739,3996
JAMSHORO DISTRICT,45,Transgender,0,8,8
JAMSHORO DISTRICT,46,Male,2258,1835,4093
JAMSHORO DISTRICT,46,Female,1869,1489,3358
JAMSHORO DISTRICT,46,Transgender,1,1,2
JAMSHORO DISTRICT,47,Male,2516,1893,4409
JAMSHORO DISTRICT,47,Female,2109,1703,3812
JAMSHORO DISTRICT,47,Transgender,0,2,2
JAMSHORO DISTRICT,48,Male,2209,1748,3957
JAMSHORO DISTRICT,48,Female,1867,1467,3334
JAMSHORO DISTRICT,48,Transgender,1,0,1
JAMSHORO DISTRICT,49,Male,2214,1803,4017
JAMSHORO DISTRICT,49,Female,1919,1573,3492
JAMSHORO DISTRICT,49,Transgender,0,0,0
JAMSHORO DISTRICT,50,Male,2140,1691,3831
JAMSHORO DISTRICT,50,Female,1780,1365,3145
JAMSHORO DISTRICT,50,Transgender,0,2,2
JAMSHORO DISTRICT,51,Male,1844,1604,3448
JAMSHORO DISTRICT,51,Female,1589,1299,2888
JAMSHORO DISTRICT,51,Transgender,1,1,2
JAMSHORO DISTRICT,52,Male,1823,1477,3300
JAMSHORO DISTRICT,52,Female,1583,1229,2812
JAMSHORO DISTRICT,52,Transgender,0,1,1
JAMSHORO DISTRICT,53,Male,1544,1428,2972
JAMSHORO DISTRICT,53,Female,1232,1005,2237
JAMSHORO DISTRICT,53,Transgender,0,0,0
JAMSHORO DISTRICT,54,Male,1514,1174,2688
JAMSHORO DISTRICT,54,Female,1167,989,2156
JAMSHORO DISTRICT,54,Transgender,0,0,0
JAMSHORO DISTRICT,55,Male,1438,1248,2686
JAMSHORO DISTRICT,55,Female,1205,1010,2215
JAMSHORO DISTRICT,55,Transgender,0,2,2
JAMSHORO DISTRICT,56,Male,1246,1030,2276
JAMSHORO DISTRICT,56,Female,988,778,1766
JAMSHORO DISTRICT,56,Transgender,1,2,3
JAMSHORO DISTRICT,57,Male,1295,1054,2349
JAMSHORO DISTRICT,57,Female,1230,855,2085
JAMSHORO DISTRICT,57,Transgender,1,0,1
JAMSHORO DISTRICT,58,Male,1183,973,2156
JAMSHORO DISTRICT,58,Female,995,830,1825
JAMSHORO DISTRICT,58,Transgender,0,0,0
JAMSHORO DISTRICT,59,Male,1161,908,2069
JAMSHORO DISTRICT,59,Female,1108,808,1916
JAMSHORO DISTRICT,59,Transgender,0,1,1
JAMSHORO DISTRICT,60,Male,1173,870,2043
JAMSHORO DISTRICT,60,Female,1079,794,1873
JAMSHORO DISTRICT,60,Transgender,0,4,4
JAMSHORO DISTRICT,61,Male,998,832,1830
JAMSHORO DISTRICT,61,Female,1050,859,1909
JAMSHORO DISTRICT,61,Transgender,0,2,2
JAMSHORO DISTRICT,62,Male,1033,816,1849
JAMSHORO DISTRICT,62,Female,1125,786,1911
JAMSHORO DISTRICT,62,Transgender,0,1,1
JAMSHORO DISTRICT,63,Male,986,764,1750
JAMSHORO DISTRICT,63,Female,940,733,1673
JAMSHORO DISTRICT,63,Transgender,0,0,0
JAMSHORO DISTRICT,64,Male,1036,687,1723
JAMSHORO DISTRICT,64,Female,924,623,1547
JAMSHORO DISTRICT,64,Transgender,0,0,0
JAMSHORO DISTRICT,65,Male,893,619,1512
JAMSHORO DISTRICT,65,Female,795,587,1382
JAMSHORO DISTRICT,65,Transgender,2,0,2
JAMSHORO DISTRICT,66,Male,688,516,1204
JAMSHORO DISTRICT,66,Female,668,452,1120
JAMSHORO DISTRICT,66,Transgender,0,1,1
JAMSHORO DISTRICT,67,Male,696,505,1201
JAMSHORO DISTRICT,67,Female,791,481,1272
JAMSHORO DISTRICT,67,Transgender,0,0,0
JAMSHORO DISTRICT,68,Male,655,518,1173
JAMSHORO DISTRICT,68,Female,656,440,1096
JAMSHORO DISTRICT,68,Transgender,0,0,0
JAMSHORO DISTRICT,69,Male,738,438,1176
JAMSHORO DISTRICT,69,Female,724,407,1131
JAMSHORO DISTRICT,69,Transgender,0,0,0
JAMSHORO DISTRICT,70,Male,625,363,988
JAMSHORO DISTRICT,70,Female,574,350,924
JAMSHORO DISTRICT,70,Transgender,1,0,1
JAMSHORO DISTRICT,71,Male,462,332,794
JAMSHORO DISTRICT,71,Female,479,371,850
JAMSHORO DISTRICT,71,Transgender,0,0,0
JAMSHORO DISTRICT,72,Male,457,277,734
JAMSHORO DISTRICT,72,Female,519,349,868
JAMSHORO DISTRICT,72,Transgender,0,0,0
JAMSHORO DISTRICT,73,Male,482,335,817
JAMSHORO DISTRICT,73,Female,417,292,709
JAMSHORO DISTRICT,73,Transgender,0,0,0
JAMSHORO DISTRICT,74,Male,506,233,739
JAMSHORO DISTRICT,74,Female,394,247,641
JAMSHORO DISTRICT,74,Transgender,0,0,0
JAMSHORO DISTRICT,>=75,Male,2916,1879,4795
JAMSHORO DISTRICT,>=75,Female,3112,2054,5166
JAMSHORO DISTRICT,>=75,Transgender,1,1,2
JHAL MAGSI DISTRICT,<1,Male,1953,70,2023
JHAL MAGSI DISTRICT,<1,Female,2050,79,2129
JHAL MAGSI DISTRICT,<1,Transgender,0,0,0
JHAL MAGSI DISTRICT,1,Male,2417,117,2534
JHAL MAGSI DISTRICT,1,Female,2452,124,2576
JHAL MAGSI DISTRICT,1,Transgender,0,0,0
JHAL MAGSI DISTRICT,2,Male,3009,105,3114
JHAL MAGSI DISTRICT,2,Female,3177,102,3279
JHAL MAGSI DISTRICT,2,Transgender,0,0,0
JHAL MAGSI DISTRICT,3,Male,2970,125,3095
JHAL MAGSI DISTRICT,3,Female,2870,124,2994
JHAL MAGSI DISTRICT,3,Transgender,0,0,0
JHAL MAGSI DISTRICT,4,Male,3331,147,3478
JHAL MAGSI DISTRICT,4,Female,3180,146,3326
JHAL MAGSI DISTRICT,4,Transgender,0,0,0
JHAL MAGSI DISTRICT,5,Male,2926,123,3049
JHAL MAGSI DISTRICT,5,Female,2762,117,2879
JHAL MAGSI DISTRICT,5,Transgender,0,0,0
JHAL MAGSI DISTRICT,6,Male,3308,120,3428
JHAL MAGSI DISTRICT,6,Female,2841,125,2966
JHAL MAGSI DISTRICT,6,Transgender,0,0,0
JHAL MAGSI DISTRICT,7,Male,2857,151,3008
JHAL MAGSI DISTRICT,7,Female,2392,146,2538
JHAL MAGSI DISTRICT,7,Transgender,0,0,0
JHAL MAGSI DISTRICT,8,Male,3360,134,3494
JHAL MAGSI DISTRICT,8,Female,2758,125,2883
JHAL MAGSI DISTRICT,8,Transgender,0,0,0
JHAL MAGSI DISTRICT,9,Male,2437,149,2586
JHAL MAGSI DISTRICT,9,Female,1955,112,2067
JHAL MAGSI DISTRICT,9,Transgender,0,0,0
JHAL MAGSI DISTRICT,10,Male,2753,130,2883
JHAL MAGSI DISTRICT,10,Female,2242,115,2357
JHAL MAGSI DISTRICT,10,Transgender,0,0,0
JHAL MAGSI DISTRICT,11,Male,1731,113,1844
JHAL MAGSI DISTRICT,11,Female,1418,100,1518
JHAL MAGSI DISTRICT,11,Transgender,0,0,0
JHAL MAGSI DISTRICT,12,Male,2120,102,2222
JHAL MAGSI DISTRICT,12,Female,1636,80,1716
JHAL MAGSI DISTRICT,12,Transgender,0,0,0
JHAL MAGSI DISTRICT,13,Male,1466,96,1562
JHAL MAGSI DISTRICT,13,Female,1117,94,1211
JHAL MAGSI DISTRICT,13,Transgender,0,0,0
JHAL MAGSI DISTRICT,14,Male,1619,100,1719
JHAL MAGSI DISTRICT,14,Female,1244,90,1334
JHAL MAGSI DISTRICT,14,Transgender,0,0,0
JHAL MAGSI DISTRICT,15,Male,1405,108,1513
JHAL MAGSI DISTRICT,15,Female,1034,98,1132
JHAL MAGSI DISTRICT,15,Transgender,0,0,0
JHAL MAGSI DISTRICT,16,Male,1417,91,1508
JHAL MAGSI DISTRICT,16,Female,1107,85,1192
JHAL MAGSI DISTRICT,16,Transgender,0,0,0
JHAL MAGSI DISTRICT,17,Male,1040,103,1143
JHAL MAGSI DISTRICT,17,Female,945,99,1044
JHAL MAGSI DISTRICT,17,Transgender,0,0,0
JHAL MAGSI DISTRICT,18,Male,1560,92,1652
JHAL MAGSI DISTRICT,18,Female,1439,79,1518
JHAL MAGSI DISTRICT,18,Transgender,0,0,0
JHAL MAGSI DISTRICT,19,Male,1167,64,1231
JHAL MAGSI DISTRICT,19,Female,1129,75,1204
JHAL MAGSI DISTRICT,19,Transgender,0,0,0
JHAL MAGSI DISTRICT,20,Male,1358,63,1421
JHAL MAGSI DISTRICT,20,Female,1259,89,1348
JHAL MAGSI DISTRICT,20,Transgender,0,0,0
JHAL MAGSI DISTRICT,21,Male,900,74,974
JHAL MAGSI DISTRICT,21,Female,911,82,993
JHAL MAGSI DISTRICT,21,Transgender,0,0,0
JHAL MAGSI DISTRICT,22,Male,868,67,935
JHAL MAGSI DISTRICT,22,Female,721,69,790
JHAL MAGSI DISTRICT,22,Transgender,0,0,0
JHAL MAGSI DISTRICT,23,Male,707,66,773
JHAL MAGSI DISTRICT,23,Female,874,61,935
JHAL MAGSI DISTRICT,23,Transgender,0,0,0
JHAL MAGSI DISTRICT,24,Male,660,66,726
JHAL MAGSI DISTRICT,24,Female,726,36,762
JHAL MAGSI DISTRICT,24,Transgender,0,0,0
JHAL MAGSI DISTRICT,25,Male,998,69,1067
JHAL MAGSI DISTRICT,25,Female,1075,54,1129
JHAL MAGSI DISTRICT,25,Transgender,0,0,0
JHAL MAGSI DISTRICT,26,Male,683,43,726
JHAL MAGSI DISTRICT,26,Female,817,44,861
JHAL MAGSI DISTRICT,26,Transgender,0,0,0
JHAL MAGSI DISTRICT,27,Male,876,71,947
JHAL MAGSI DISTRICT,27,Female,996,69,1065
JHAL MAGSI DISTRICT,27,Transgender,0,0,0
JHAL MAGSI DISTRICT,28,Male,878,58,936
JHAL MAGSI DISTRICT,28,Female,1047,33,1080
JHAL MAGSI DISTRICT,28,Transgender,0,0,0
JHAL MAGSI DISTRICT,29,Male,1011,81,1092
JHAL MAGSI DISTRICT,29,Female,1046,78,1124
JHAL MAGSI DISTRICT,29,Transgender,0,0,0
JHAL MAGSI DISTRICT,30,Male,979,49,1028
JHAL MAGSI DISTRICT,30,Female,1079,59,1138
JHAL MAGSI DISTRICT,30,Transgender,0,0,0
JHAL MAGSI DISTRICT,31,Male,866,59,925
JHAL MAGSI DISTRICT,31,Female,908,73,981
JHAL MAGSI DISTRICT,31,Transgender,0,0,0
JHAL MAGSI DISTRICT,32,Male,785,43,828
JHAL MAGSI DISTRICT,32,Female,806,50,856
JHAL MAGSI DISTRICT,32,Transgender,0,0,0
JHAL MAGSI DISTRICT,33,Male,721,26,747
JHAL MAGSI DISTRICT,33,Female,763,42,805
JHAL MAGSI DISTRICT,33,Transgender,0,0,0
JHAL MAGSI DISTRICT,34,Male,569,38,607
JHAL MAGSI DISTRICT,34,Female,681,31,712
JHAL MAGSI DISTRICT,34,Transgender,0,0,0
JHAL MAGSI DISTRICT,35,Male,852,38,890
JHAL MAGSI DISTRICT,35,Female,850,45,895
JHAL MAGSI DISTRICT,35,Transgender,0,0,0
JHAL MAGSI DISTRICT,36,Male,607,35,642
JHAL MAGSI DISTRICT,36,Female,627,27,654
JHAL MAGSI DISTRICT,36,Transgender,0,0,0
JHAL MAGSI DISTRICT,37,Male,969,41,1010
JHAL MAGSI DISTRICT,37,Female,786,61,847
JHAL MAGSI DISTRICT,37,Transgender,0,1,1
JHAL MAGSI DISTRICT,38,Male,626,40,666
JHAL MAGSI DISTRICT,38,Female,723,29,752
JHAL MAGSI DISTRICT,38,Transgender,0,0,0
JHAL MAGSI DISTRICT,39,Male,750,45,795
JHAL MAGSI DISTRICT,39,Female,702,46,748
JHAL MAGSI DISTRICT,39,Transgender,0,0,0
JHAL MAGSI DISTRICT,40,Male,717,31,748
JHAL MAGSI DISTRICT,40,Female,760,31,791
JHAL MAGSI DISTRICT,40,Transgender,0,0,0
JHAL MAGSI DISTRICT,41,Male,571,35,606
JHAL MAGSI DISTRICT,41,Female,594,37,631
JHAL MAGSI DISTRICT,41,Transgender,0,0,0
JHAL MAGSI DISTRICT,42,Male,561,41,602
JHAL MAGSI DISTRICT,42,Female,607,37,644
JHAL MAGSI DISTRICT,42,Transgender,0,0,0
JHAL MAGSI DISTRICT,43,Male,468,38,506
JHAL MAGSI DISTRICT,43,Female,444,31,475
JHAL MAGSI DISTRICT,43,Transgender,0,0,0
JHAL MAGSI DISTRICT,44,Male,390,31,421
JHAL MAGSI DISTRICT,44,Female,459,24,483
JHAL MAGSI DISTRICT,44,Transgender,0,0,0
JHAL MAGSI DISTRICT,45,Male,483,26,509
JHAL MAGSI DISTRICT,45,Female,518,20,538
JHAL MAGSI DISTRICT,45,Transgender,0,0,0
JHAL MAGSI DISTRICT,46,Male,415,25,440
JHAL MAGSI DISTRICT,46,Female,369,22,391
JHAL MAGSI DISTRICT,46,Transgender,0,0,0
JHAL MAGSI DISTRICT,47,Male,537,24,561
JHAL MAGSI DISTRICT,47,Female,514,48,562
JHAL MAGSI DISTRICT,47,Transgender,0,0,0
JHAL MAGSI DISTRICT,48,Male,418,21,439
JHAL MAGSI DISTRICT,48,Female,410,19,429
JHAL MAGSI DISTRICT,48,Transgender,0,0,0
JHAL MAGSI DISTRICT,49,Male,453,36,489
JHAL MAGSI DISTRICT,49,Female,415,33,448
JHAL MAGSI DISTRICT,49,Transgender,0,0,0
JHAL MAGSI DISTRICT,50,Male,455,21,476
JHAL MAGSI DISTRICT,50,Female,511,28,539
JHAL MAGSI DISTRICT,50,Transgender,0,0,0
JHAL MAGSI DISTRICT,51,Male,405,25,430
JHAL MAGSI DISTRICT,51,Female,373,20,393
JHAL MAGSI DISTRICT,51,Transgender,0,0,0
JHAL MAGSI DISTRICT,52,Male,391,20,411
JHAL MAGSI DISTRICT,52,Female,309,31,340
JHAL MAGSI DISTRICT,52,Transgender,0,0,0
JHAL MAGSI DISTRICT,53,Male,300,22,322
JHAL MAGSI DISTRICT,53,Female,297,10,307
JHAL MAGSI DISTRICT,53,Transgender,0,0,0
JHAL MAGSI DISTRICT,54,Male,319,24,343
JHAL MAGSI DISTRICT,54,Female,244,13,257
JHAL MAGSI DISTRICT,54,Transgender,0,0,0
JHAL MAGSI DISTRICT,55,Male,248,11,259
JHAL MAGSI DISTRICT,55,Female,325,13,338
JHAL MAGSI DISTRICT,55,Transgender,0,0,0
JHAL MAGSI DISTRICT,56,Male,261,9,270
JHAL MAGSI DISTRICT,56,Female,228,14,242
JHAL MAGSI DISTRICT,56,Transgender,0,0,0
JHAL MAGSI DISTRICT,57,Male,365,25,390
JHAL MAGSI DISTRICT,57,Female,339,23,362
JHAL MAGSI DISTRICT,57,Transgender,0,0,0
JHAL MAGSI DISTRICT,58,Male,214,11,225
JHAL MAGSI DISTRICT,58,Female,244,16,260
JHAL MAGSI DISTRICT,58,Transgender,0,0,0
JHAL MAGSI DISTRICT,59,Male,282,19,301
JHAL MAGSI DISTRICT,59,Female,230,21,251
JHAL MAGSI DISTRICT,59,Transgender,0,0,0
JHAL MAGSI DISTRICT,60,Male,294,6,300
JHAL MAGSI DISTRICT,60,Female,302,20,322
JHAL MAGSI DISTRICT,60,Transgender,0,0,0
JHAL MAGSI DISTRICT,61,Male,176,3,179
JHAL MAGSI DISTRICT,61,Female,202,10,212
JHAL MAGSI DISTRICT,61,Transgender,0,0,0
JHAL MAGSI DISTRICT,62,Male,208,11,219
JHAL MAGSI DISTRICT,62,Female,233,17,250
JHAL MAGSI DISTRICT,62,Transgender,0,0,0
JHAL MAGSI DISTRICT,63,Male,220,10,230
JHAL MAGSI DISTRICT,63,Female,199,10,209
JHAL MAGSI DISTRICT,63,Transgender,0,0,0
JHAL MAGSI DISTRICT,64,Male,258,16,274
JHAL MAGSI DISTRICT,64,Female,194,15,209
JHAL MAGSI DISTRICT,64,Transgender,0,0,0
JHAL MAGSI DISTRICT,65,Male,188,7,195
JHAL MAGSI DISTRICT,65,Female,192,8,200
JHAL MAGSI DISTRICT,65,Transgender,0,0,0
JHAL MAGSI DISTRICT,66,Male,112,8,120
JHAL MAGSI DISTRICT,66,Female,123,4,127
JHAL MAGSI DISTRICT,66,Transgender,0,0,0
JHAL MAGSI DISTRICT,67,Male,181,14,195
JHAL MAGSI DISTRICT,67,Female,176,12,188
JHAL MAGSI DISTRICT,67,Transgender,0,0,0
JHAL MAGSI DISTRICT,68,Male,135,7,142
JHAL MAGSI DISTRICT,68,Female,120,7,127
JHAL MAGSI DISTRICT,68,Transgender,0,0,0
JHAL MAGSI DISTRICT,69,Male,184,13,197
JHAL MAGSI DISTRICT,69,Female,136,15,151
JHAL MAGSI DISTRICT,69,Transgender,0,0,0
JHAL MAGSI DISTRICT,70,Male,134,8,142
JHAL MAGSI DISTRICT,70,Female,145,3,148
JHAL MAGSI DISTRICT,70,Transgender,0,0,0
JHAL MAGSI DISTRICT,71,Male,86,4,90
JHAL MAGSI DISTRICT,71,Female,72,1,73
JHAL MAGSI DISTRICT,71,Transgender,0,0,0
JHAL MAGSI DISTRICT,72,Male,93,4,97
JHAL MAGSI DISTRICT,72,Female,121,8,129
JHAL MAGSI DISTRICT,72,Transgender,0,0,0
JHAL MAGSI DISTRICT,73,Male,84,4,88
JHAL MAGSI DISTRICT,73,Female,70,9,79
JHAL MAGSI DISTRICT,73,Transgender,0,0,0
JHAL MAGSI DISTRICT,74,Male,125,12,137
JHAL MAGSI DISTRICT,74,Female,84,5,89
JHAL MAGSI DISTRICT,74,Transgender,0,0,0
JHAL MAGSI DISTRICT,>=75,Male,528,24,552
JHAL MAGSI DISTRICT,>=75,Female,613,28,641
JHAL MAGSI DISTRICT,>=75,Transgender,0,0,0
JHANG DISTRICT,<1,Male,29651,7090,36741
JHANG DISTRICT,<1,Female,27448,6878,34326
JHANG DISTRICT,<1,Transgender,0,0,0
JHANG DISTRICT,1,Male,30726,7967,38693
JHANG DISTRICT,1,Female,29448,7581,37029
JHANG DISTRICT,1,Transgender,0,0,0
JHANG DISTRICT,2,Male,31391,7466,38857
JHANG DISTRICT,2,Female,29800,7053,36853
JHANG DISTRICT,2,Transgender,0,0,0
JHANG DISTRICT,3,Male,34221,8248,42469
JHANG DISTRICT,3,Female,32820,7759,40579
JHANG DISTRICT,3,Transgender,0,0,0
JHANG DISTRICT,4,Male,35240,7967,43207
JHANG DISTRICT,4,Female,33670,7491,41161
JHANG DISTRICT,4,Transgender,0,0,0
JHANG DISTRICT,5,Male,33689,7764,41453
JHANG DISTRICT,5,Female,31641,7392,39033
JHANG DISTRICT,5,Transgender,0,0,0
JHANG DISTRICT,6,Male,33065,7849,40914
JHANG DISTRICT,6,Female,30395,7127,37522
JHANG DISTRICT,6,Transgender,0,0,0
JHANG DISTRICT,7,Male,35551,8173,43724
JHANG DISTRICT,7,Female,33049,7723,40772
JHANG DISTRICT,7,Transgender,0,0,0
JHANG DISTRICT,8,Male,32777,7364,40141
JHANG DISTRICT,8,Female,31088,6875,37963
JHANG DISTRICT,8,Transgender,0,0,0
JHANG DISTRICT,9,Male,33060,8301,41361
JHANG DISTRICT,9,Female,30329,7702,38031
JHANG DISTRICT,9,Transgender,0,0,0
JHANG DISTRICT,10,Male,28592,6586,35178
JHANG DISTRICT,10,Female,26629,6118,32747
JHANG DISTRICT,10,Transgender,0,0,0
JHANG DISTRICT,11,Male,28265,7927,36192
JHANG DISTRICT,11,Female,25411,7605,33016
JHANG DISTRICT,11,Transgender,0,0,0
JHANG DISTRICT,12,Male,25776,6480,32256
JHANG DISTRICT,12,Female,23353,5982,29335
JHANG DISTRICT,12,Transgender,0,0,0
JHANG DISTRICT,13,Male,24782,7557,32339
JHANG DISTRICT,13,Female,21118,6707,27825
JHANG DISTRICT,13,Transgender,0,0,0
JHANG DISTRICT,14,Male,24103,6611,30714
JHANG DISTRICT,14,Female,20910,6157,27067
JHANG DISTRICT,14,Transgender,0,0,0
JHANG DISTRICT,15,Male,22425,6613,29038
JHANG DISTRICT,15,Female,19991,6169,26160
JHANG DISTRICT,15,Transgender,4,2,6
JHANG DISTRICT,16,Male,22380,6804,29184
JHANG DISTRICT,16,Female,20261,6057,26318
JHANG DISTRICT,16,Transgender,6,2,8
JHANG DISTRICT,17,Male,21715,7160,28875
JHANG DISTRICT,17,Female,20384,6469,26853
JHANG DISTRICT,17,Transgender,4,2,6
JHANG DISTRICT,18,Male,20299,5726,26025
JHANG DISTRICT,18,Female,20993,5570,26563
JHANG DISTRICT,18,Transgender,6,5,11
JHANG DISTRICT,19,Male,19882,6355,26237
JHANG DISTRICT,19,Female,19861,6441,26302
JHANG DISTRICT,19,Transgender,0,1,1
JHANG DISTRICT,20,Male,17935,5164,23099
JHANG DISTRICT,20,Female,19634,5025,24659
JHANG DISTRICT,20,Transgender,2,2,4
JHANG DISTRICT,21,Male,17865,5986,23851
JHANG DISTRICT,21,Female,18150,6246,24396
JHANG DISTRICT,21,Transgender,4,4,8
JHANG DISTRICT,22,Male,16988,5247,22235
JHANG DISTRICT,22,Female,18596,5505,24101
JHANG DISTRICT,22,Transgender,6,2,8
JHANG DISTRICT,23,Male,16695,5444,22139
JHANG DISTRICT,23,Female,16301,5669,21970
JHANG DISTRICT,23,Transgender,2,4,6
JHANG DISTRICT,24,Male,15622,5221,20843
JHANG DISTRICT,24,Female,15967,5315,21282
JHANG DISTRICT,24,Transgender,5,5,10
JHANG DISTRICT,25,Male,14895,4311,19206
JHANG DISTRICT,25,Female,17603,4545,22148
JHANG DISTRICT,25,Transgender,6,4,10
JHANG DISTRICT,26,Male,15123,4982,20105
JHANG DISTRICT,26,Female,16212,5492,21704
JHANG DISTRICT,26,Transgender,4,2,6
JHANG DISTRICT,27,Male,15198,5060,20258
JHANG DISTRICT,27,Female,15752,5529,21281
JHANG DISTRICT,27,Transgender,2,1,3
JHANG DISTRICT,28,Male,14573,4612,19185
JHANG DISTRICT,28,Female,15508,5041,20549
JHANG DISTRICT,28,Transgender,4,3,7
JHANG DISTRICT,29,Male,15681,4998,20679
JHANG DISTRICT,29,Female,16158,5241,21399
JHANG DISTRICT,29,Transgender,1,3,4
JHANG DISTRICT,30,Male,12882,3972,16854
JHANG DISTRICT,30,Female,15272,3970,19242
JHANG DISTRICT,30,Transgender,9,2,11
JHANG DISTRICT,31,Male,14411,4898,19309
JHANG DISTRICT,31,Female,15339,5104,20443
JHANG DISTRICT,31,Transgender,6,3,9
JHANG DISTRICT,32,Male,12909,4372,17281
JHANG DISTRICT,32,Female,14324,4569,18893
JHANG DISTRICT,32,Transgender,4,2,6
JHANG DISTRICT,33,Male,12392,4478,16870
JHANG DISTRICT,33,Female,12114,4330,16444
JHANG DISTRICT,33,Transgender,4,2,6
JHANG DISTRICT,34,Male,13094,4242,17336
JHANG DISTRICT,34,Female,12637,4203,16840
JHANG DISTRICT,34,Transgender,1,1,2
JHANG DISTRICT,35,Male,11768,3184,14952
JHANG DISTRICT,35,Female,12443,3279,15722
JHANG DISTRICT,35,Transgender,4,4,8
JHANG DISTRICT,36,Male,14025,4176,18201
JHANG DISTRICT,36,Female,14237,4176,18413
JHANG DISTRICT,36,Transgender,4,1,5
JHANG DISTRICT,37,Male,12696,3835,16531
JHANG DISTRICT,37,Female,12917,3813,16730
JHANG DISTRICT,37,Transgender,2,2,4
JHANG DISTRICT,38,Male,11254,3884,15138
JHANG DISTRICT,38,Female,10952,3550,14502
JHANG DISTRICT,38,Transgender,5,3,8
JHANG DISTRICT,39,Male,11320,3672,14992
JHANG DISTRICT,39,Female,11682,3550,15232
JHANG DISTRICT,39,Transgender,2,2,4
JHANG DISTRICT,40,Male,8710,2745,11455
JHANG DISTRICT,40,Female,9732,2532,12264
JHANG DISTRICT,40,Transgender,4,3,7
JHANG DISTRICT,41,Male,10203,3275,13478
JHANG DISTRICT,41,Female,11234,3348,14582
JHANG DISTRICT,41,Transgender,1,3,4
JHANG DISTRICT,42,Male,9094,2829,11923
JHANG DISTRICT,42,Female,10161,2968,13129
JHANG DISTRICT,42,Transgender,3,1,4
JHANG DISTRICT,43,Male,8547,2922,11469
JHANG DISTRICT,43,Female,8169,2819,10988
JHANG DISTRICT,43,Transgender,1,0,1
JHANG DISTRICT,44,Male,8818,2926,11744
JHANG DISTRICT,44,Female,8084,2729,10813
JHANG DISTRICT,44,Transgender,0,0,0
JHANG DISTRICT,45,Male,7571,2163,9734
JHANG DISTRICT,45,Female,7622,2036,9658
JHANG DISTRICT,45,Transgender,2,0,2
JHANG DISTRICT,46,Male,9332,2747,12079
JHANG DISTRICT,46,Female,9334,2774,12108
JHANG DISTRICT,46,Transgender,4,1,5
JHANG DISTRICT,47,Male,8938,2468,11406
JHANG DISTRICT,47,Female,9140,2487,11627
JHANG DISTRICT,47,Transgender,1,0,1
JHANG DISTRICT,48,Male,8942,2750,11692
JHANG DISTRICT,48,Female,8006,2664,10670
JHANG DISTRICT,48,Transgender,5,4,9
JHANG DISTRICT,49,Male,9525,2823,12348
JHANG DISTRICT,49,Female,8611,2581,11192
JHANG DISTRICT,49,Transgender,1,2,3
JHANG DISTRICT,50,Male,7636,2162,9798
JHANG DISTRICT,50,Female,7301,1978,9279
JHANG DISTRICT,50,Transgender,0,5,5
JHANG DISTRICT,51,Male,9296,2746,12042
JHANG DISTRICT,51,Female,9136,2699,11835
JHANG DISTRICT,51,Transgender,3,0,3
JHANG DISTRICT,52,Male,8225,2491,10716
JHANG DISTRICT,52,Female,8068,2356,10424
JHANG DISTRICT,52,Transgender,1,1,2
JHANG DISTRICT,53,Male,8203,2428,10631
JHANG DISTRICT,53,Female,6772,2229,9001
JHANG DISTRICT,53,Transgender,0,0,0
JHANG DISTRICT,54,Male,7358,2452,9810
JHANG DISTRICT,54,Female,5983,2094,8077
JHANG DISTRICT,54,Transgender,0,0,0
JHANG DISTRICT,55,Male,6042,1659,7701
JHANG DISTRICT,55,Female,4881,1476,6357
JHANG DISTRICT,55,Transgender,6,0,6
JHANG DISTRICT,56,Male,6588,2046,8634
JHANG DISTRICT,56,Female,6006,1672,7678
JHANG DISTRICT,56,Transgender,1,2,3
JHANG DISTRICT,57,Male,5635,1695,7330
JHANG DISTRICT,57,Female,5619,1341,6960
JHANG DISTRICT,57,Transgender,0,1,1
JHANG DISTRICT,58,Male,4727,1608,6335
JHANG DISTRICT,58,Female,4074,1375,5449
JHANG DISTRICT,58,Transgender,3,1,4
JHANG DISTRICT,59,Male,5052,1558,6610
JHANG DISTRICT,59,Female,4830,1541,6371
JHANG DISTRICT,59,Transgender,1,0,1
JHANG DISTRICT,60,Male,4279,1115,5394
JHANG DISTRICT,60,Female,4300,1069,5369
JHANG DISTRICT,60,Transgender,5,0,5
JHANG DISTRICT,61,Male,5779,1644,7423
JHANG DISTRICT,61,Female,5423,1543,6966
JHANG DISTRICT,61,Transgender,1,1,2
JHANG DISTRICT,62,Male,5169,1481,6650
JHANG DISTRICT,62,Female,4822,1397,6219
JHANG DISTRICT,62,Transgender,1,3,4
JHANG DISTRICT,63,Male,4839,1484,6323
JHANG DISTRICT,63,Female,4577,1299,5876
JHANG DISTRICT,63,Transgender,2,0,2
JHANG DISTRICT,64,Male,4482,1261,5743
JHANG DISTRICT,64,Female,4128,1114,5242
JHANG DISTRICT,64,Transgender,0,0,0
JHANG DISTRICT,65,Male,3940,868,4808
JHANG DISTRICT,65,Female,3608,828,4436
JHANG DISTRICT,65,Transgender,5,2,7
JHANG DISTRICT,66,Male,4885,1115,6000
JHANG DISTRICT,66,Female,4328,1037,5365
JHANG DISTRICT,66,Transgender,0,0,0
JHANG DISTRICT,67,Male,4165,892,5057
JHANG DISTRICT,67,Female,3728,844,4572
JHANG DISTRICT,67,Transgender,2,0,2
JHANG DISTRICT,68,Male,3725,836,4561
JHANG DISTRICT,68,Female,3220,834,4054
JHANG DISTRICT,68,Transgender,1,0,1
JHANG DISTRICT,69,Male,3669,770,4439
JHANG DISTRICT,69,Female,2982,734,3716
JHANG DISTRICT,69,Transgender,1,0,1
JHANG DISTRICT,70,Male,2917,558,3475
JHANG DISTRICT,70,Female,2797,599,3396
JHANG DISTRICT,70,Transgender,1,1,2
JHANG DISTRICT,71,Male,3816,785,4601
JHANG DISTRICT,71,Female,3194,686,3880
JHANG DISTRICT,71,Transgender,2,2,4
JHANG DISTRICT,72,Male,3080,713,3793
JHANG DISTRICT,72,Female,2580,691,3271
JHANG DISTRICT,72,Transgender,1,0,1
JHANG DISTRICT,73,Male,2621,601,3222
JHANG DISTRICT,73,Female,2327,559,2886
JHANG DISTRICT,73,Transgender,0,0,0
JHANG DISTRICT,74,Male,1888,479,2367
JHANG DISTRICT,74,Female,1762,393,2155
JHANG DISTRICT,74,Transgender,1,0,1
JHANG DISTRICT,>=75,Male,17872,3603,21475
JHANG DISTRICT,>=75,Female,16619,3555,20174
JHANG DISTRICT,>=75,Transgender,5,2,7
JHELUM DISTRICT,<1,Male,9410,3417,12827
JHELUM DISTRICT,<1,Female,9149,3407,12556
JHELUM DISTRICT,<1,Transgender,0,0,0
JHELUM DISTRICT,1,Male,9902,3854,13756
JHELUM DISTRICT,1,Female,9525,3730,13255
JHELUM DISTRICT,1,Transgender,0,0,0
JHELUM DISTRICT,2,Male,10021,3727,13748
JHELUM DISTRICT,2,Female,9399,3633,13032
JHELUM DISTRICT,2,Transgender,0,0,0
JHELUM DISTRICT,3,Male,10484,3884,14368
JHELUM DISTRICT,3,Female,10191,3710,13901
JHELUM DISTRICT,3,Transgender,0,0,0
JHELUM DISTRICT,4,Male,9743,3664,13407
JHELUM DISTRICT,4,Female,9473,3572,13045
JHELUM DISTRICT,4,Transgender,0,0,0
JHELUM DISTRICT,5,Male,9780,3736,13516
JHELUM DISTRICT,5,Female,9410,3612,13022
JHELUM DISTRICT,5,Transgender,0,0,0
JHELUM DISTRICT,6,Male,10063,3984,14047
JHELUM DISTRICT,6,Female,9597,3529,13126
JHELUM DISTRICT,6,Transgender,0,0,0
JHELUM DISTRICT,7,Male,10464,4221,14685
JHELUM DISTRICT,7,Female,9874,3823,13697
JHELUM DISTRICT,7,Transgender,0,0,0
JHELUM DISTRICT,8,Male,9265,3603,12868
JHELUM DISTRICT,8,Female,8834,3337,12171
JHELUM DISTRICT,8,Transgender,0,0,0
JHELUM DISTRICT,9,Male,11042,4259,15301
JHELUM DISTRICT,9,Female,10375,3949,14324
JHELUM DISTRICT,9,Transgender,0,0,0
JHELUM DISTRICT,10,Male,8611,3356,11967
JHELUM DISTRICT,10,Female,8176,3114,11290
JHELUM DISTRICT,10,Transgender,0,0,0
JHELUM DISTRICT,11,Male,10954,4248,15202
JHELUM DISTRICT,11,Female,10393,3987,14380
JHELUM DISTRICT,11,Transgender,0,0,0
JHELUM DISTRICT,12,Male,8809,3386,12195
JHELUM DISTRICT,12,Female,8216,3229,11445
JHELUM DISTRICT,12,Transgender,0,0,0
JHELUM DISTRICT,13,Male,10077,4079,14156
JHELUM DISTRICT,13,Female,9274,3618,12892
JHELUM DISTRICT,13,Transgender,0,0,0
JHELUM DISTRICT,14,Male,9151,3779,12930
JHELUM DISTRICT,14,Female,8418,3164,11582
JHELUM DISTRICT,14,Transgender,0,0,0
JHELUM DISTRICT,15,Male,8904,3687,12591
JHELUM DISTRICT,15,Female,8708,3339,12047
JHELUM DISTRICT,15,Transgender,2,1,3
JHELUM DISTRICT,16,Male,9389,3671,13060
JHELUM DISTRICT,16,Female,8989,3365,12354
JHELUM DISTRICT,16,Transgender,3,2,5
JHELUM DISTRICT,17,Male,9499,3808,13307
JHELUM DISTRICT,17,Female,9432,3611,13043
JHELUM DISTRICT,17,Transgender,2,0,2
JHELUM DISTRICT,18,Male,7751,3065,10816
JHELUM DISTRICT,18,Female,7185,2759,9944
JHELUM DISTRICT,18,Transgender,4,1,5
JHELUM DISTRICT,19,Male,9233,3781,13014
JHELUM DISTRICT,19,Female,9413,3636,13049
JHELUM DISTRICT,19,Transgender,2,0,2
JHELUM DISTRICT,20,Male,7251,3061,10312
JHELUM DISTRICT,20,Female,7123,2611,9734
JHELUM DISTRICT,20,Transgender,2,2,4
JHELUM DISTRICT,21,Male,8704,3850,12554
JHELUM DISTRICT,21,Female,9914,3951,13865
JHELUM DISTRICT,21,Transgender,3,1,4
JHELUM DISTRICT,22,Male,7082,3191,10273
JHELUM DISTRICT,22,Female,8039,2972,11011
JHELUM DISTRICT,22,Transgender,0,1,1
JHELUM DISTRICT,23,Male,7292,3583,10875
JHELUM DISTRICT,23,Female,8992,3487,12479
JHELUM DISTRICT,23,Transgender,1,2,3
JHELUM DISTRICT,24,Male,7033,3711,10744
JHELUM DISTRICT,24,Female,8803,3512,12315
JHELUM DISTRICT,24,Transgender,4,2,6
JHELUM DISTRICT,25,Male,5631,2887,8518
JHELUM DISTRICT,25,Female,6607,2492,9099
JHELUM DISTRICT,25,Transgender,2,3,5
JHELUM DISTRICT,26,Male,6147,3502,9649
JHELUM DISTRICT,26,Female,8496,3408,11904
JHELUM DISTRICT,26,Transgender,2,3,5
JHELUM DISTRICT,27,Male,5960,3434,9394
JHELUM DISTRICT,27,Female,8596,3458,12054
JHELUM DISTRICT,27,Transgender,2,1,3
JHELUM DISTRICT,28,Male,5662,3220,8882
JHELUM DISTRICT,28,Female,7386,3128,10514
JHELUM DISTRICT,28,Transgender,2,2,4
JHELUM DISTRICT,29,Male,6078,3428,9506
JHELUM DISTRICT,29,Female,8209,3480,11689
JHELUM DISTRICT,29,Transgender,2,0,2
JHELUM DISTRICT,30,Male,5084,2789,7873
JHELUM DISTRICT,30,Female,6210,2455,8665
JHELUM DISTRICT,30,Transgender,4,0,4
JHELUM DISTRICT,31,Male,5657,3517,9174
JHELUM DISTRICT,31,Female,7965,3352,11317
JHELUM DISTRICT,31,Transgender,2,2,4
JHELUM DISTRICT,32,Male,5089,3157,8246
JHELUM DISTRICT,32,Female,6966,2915,9881
JHELUM DISTRICT,32,Transgender,3,0,3
JHELUM DISTRICT,33,Male,5324,3158,8482
JHELUM DISTRICT,33,Female,7159,3031,10190
JHELUM DISTRICT,33,Transgender,3,2,5
JHELUM DISTRICT,34,Male,5380,2981,8361
JHELUM DISTRICT,34,Female,6803,2716,9519
JHELUM DISTRICT,34,Transgender,1,1,2
JHELUM DISTRICT,35,Male,4339,2170,6509
JHELUM DISTRICT,35,Female,5144,1974,7118
JHELUM DISTRICT,35,Transgender,1,2,3
JHELUM DISTRICT,36,Male,4956,2751,7707
JHELUM DISTRICT,36,Female,6301,2593,8894
JHELUM DISTRICT,36,Transgender,1,4,5
JHELUM DISTRICT,37,Male,4309,2515,6824
JHELUM DISTRICT,37,Female,5829,2304,8133
JHELUM DISTRICT,37,Transgender,2,0,2
JHELUM DISTRICT,38,Male,5050,2688,7738
JHELUM DISTRICT,38,Female,6014,2630,8644
JHELUM DISTRICT,38,Transgender,1,2,3
JHELUM DISTRICT,39,Male,4635,2461,7096
JHELUM DISTRICT,39,Female,5889,2285,8174
JHELUM DISTRICT,39,Transgender,2,0,2
JHELUM DISTRICT,40,Male,4007,2026,6033
JHELUM DISTRICT,40,Female,4499,1847,6346
JHELUM DISTRICT,40,Transgender,2,0,2
JHELUM DISTRICT,41,Male,4156,2201,6357
JHELUM DISTRICT,41,Female,5279,2181,7460
JHELUM DISTRICT,41,Transgender,1,1,2
JHELUM DISTRICT,42,Male,3722,2042,5764
JHELUM DISTRICT,42,Female,4532,1908,6440
JHELUM DISTRICT,42,Transgender,0,1,1
JHELUM DISTRICT,43,Male,3690,1901,5591
JHELUM DISTRICT,43,Female,4766,2033,6799
JHELUM DISTRICT,43,Transgender,1,1,2
JHELUM DISTRICT,44,Male,3525,1735,5260
JHELUM DISTRICT,44,Female,4491,1957,6448
JHELUM DISTRICT,44,Transgender,0,0,0
JHELUM DISTRICT,45,Male,3102,1410,4512
JHELUM DISTRICT,45,Female,3576,1350,4926
JHELUM DISTRICT,45,Transgender,2,0,2
JHELUM DISTRICT,46,Male,3621,1696,5317
JHELUM DISTRICT,46,Female,4283,1768,6051
JHELUM DISTRICT,46,Transgender,1,1,2
JHELUM DISTRICT,47,Male,3345,1551,4896
JHELUM DISTRICT,47,Female,3715,1387,5102
JHELUM DISTRICT,47,Transgender,1,3,4
JHELUM DISTRICT,48,Male,3837,1796,5633
JHELUM DISTRICT,48,Female,4486,1722,6208
JHELUM DISTRICT,48,Transgender,3,0,3
JHELUM DISTRICT,49,Male,3754,1650,5404
JHELUM DISTRICT,49,Female,4284,1787,6071
JHELUM DISTRICT,49,Transgender,1,1,2
JHELUM DISTRICT,50,Male,3330,1426,4756
JHELUM DISTRICT,50,Female,3632,1414,5046
JHELUM DISTRICT,50,Transgender,1,0,1
JHELUM DISTRICT,51,Male,3665,1525,5190
JHELUM DISTRICT,51,Female,4237,1632,5869
JHELUM DISTRICT,51,Transgender,0,0,0
JHELUM DISTRICT,52,Male,3666,1512,5178
JHELUM DISTRICT,52,Female,3967,1568,5535
JHELUM DISTRICT,52,Transgender,0,1,1
JHELUM DISTRICT,53,Male,3620,1509,5129
JHELUM DISTRICT,53,Female,4319,1540,5859
JHELUM DISTRICT,53,Transgender,1,1,2
JHELUM DISTRICT,54,Male,3517,1422,4939
JHELUM DISTRICT,54,Female,3833,1426,5259
JHELUM DISTRICT,54,Transgender,1,0,1
JHELUM DISTRICT,55,Male,2911,1161,4072
JHELUM DISTRICT,55,Female,2731,1124,3855
JHELUM DISTRICT,55,Transgender,3,0,3
JHELUM DISTRICT,56,Male,3011,1244,4255
JHELUM DISTRICT,56,Female,3131,1158,4289
JHELUM DISTRICT,56,Transgender,0,0,0
JHELUM DISTRICT,57,Male,2747,1119,3866
JHELUM DISTRICT,57,Female,2627,914,3541
JHELUM DISTRICT,57,Transgender,0,1,1
JHELUM DISTRICT,58,Male,3010,1196,4206
JHELUM DISTRICT,58,Female,2987,1114,4101
JHELUM DISTRICT,58,Transgender,0,1,1
JHELUM DISTRICT,59,Male,2898,1095,3993
JHELUM DISTRICT,59,Female,3017,1033,4050
JHELUM DISTRICT,59,Transgender,0,0,0
JHELUM DISTRICT,60,Male,2484,968,3452
JHELUM DISTRICT,60,Female,2347,831,3178
JHELUM DISTRICT,60,Transgender,2,1,3
JHELUM DISTRICT,61,Male,2849,1167,4016
JHELUM DISTRICT,61,Female,2899,1034,3933
JHELUM DISTRICT,61,Transgender,0,1,1
JHELUM DISTRICT,62,Male,2855,1058,3913
JHELUM DISTRICT,62,Female,2652,985,3637
JHELUM DISTRICT,62,Transgender,0,1,1
JHELUM DISTRICT,63,Male,2984,1018,4002
JHELUM DISTRICT,63,Female,2776,933,3709
JHELUM DISTRICT,63,Transgender,1,0,1
JHELUM DISTRICT,64,Male,2593,913,3506
JHELUM DISTRICT,64,Female,2444,807,3251
JHELUM DISTRICT,64,Transgender,0,0,0
JHELUM DISTRICT,65,Male,2041,721,2762
JHELUM DISTRICT,65,Female,1951,677,2628
JHELUM DISTRICT,65,Transgender,0,0,0
JHELUM DISTRICT,66,Male,2070,654,2724
JHELUM DISTRICT,66,Female,1883,642,2525
JHELUM DISTRICT,66,Transgender,0,0,0
JHELUM DISTRICT,67,Male,1998,637,2635
JHELUM DISTRICT,67,Female,1790,541,2331
JHELUM DISTRICT,67,Transgender,0,1,1
JHELUM DISTRICT,68,Male,1968,668,2636
JHELUM DISTRICT,68,Female,1891,648,2539
JHELUM DISTRICT,68,Transgender,0,0,0
JHELUM DISTRICT,69,Male,1767,597,2364
JHELUM DISTRICT,69,Female,1770,549,2319
JHELUM DISTRICT,69,Transgender,0,0,0
JHELUM DISTRICT,70,Male,1584,464,2048
JHELUM DISTRICT,70,Female,1461,415,1876
JHELUM DISTRICT,70,Transgender,2,1,3
JHELUM DISTRICT,71,Male,1477,530,2007
JHELUM DISTRICT,71,Female,1588,452,2040
JHELUM DISTRICT,71,Transgender,0,0,0
JHELUM DISTRICT,72,Male,1586,438,2024
JHELUM DISTRICT,72,Female,1554,473,2027
JHELUM DISTRICT,72,Transgender,0,1,1
JHELUM DISTRICT,73,Male,1470,425,1895
JHELUM DISTRICT,73,Female,1369,412,1781
JHELUM DISTRICT,73,Transgender,0,0,0
JHELUM DISTRICT,74,Male,1202,383,1585
JHELUM DISTRICT,74,Female,1258,325,1583
JHELUM DISTRICT,74,Transgender,0,0,0
JHELUM DISTRICT,>=75,Male,10198,2810,13008
JHELUM DISTRICT,>=75,Female,10049,2847,12896
JHELUM DISTRICT,>=75,Transgender,5,2,7
KACHHI DISTRICT,<1,Male,3778,535,4313
KACHHI DISTRICT,<1,Female,3465,538,4003
KACHHI DISTRICT,<1,Transgender,0,0,0
KACHHI DISTRICT,1,Male,4101,727,4828
KACHHI DISTRICT,1,Female,3799,706,4505
KACHHI DISTRICT,1,Transgender,0,0,0
KACHHI DISTRICT,2,Male,5058,856,5914
KACHHI DISTRICT,2,Female,4879,815,5694
KACHHI DISTRICT,2,Transgender,0,0,0
KACHHI DISTRICT,3,Male,4973,946,5919
KACHHI DISTRICT,3,Female,4626,892,5518
KACHHI DISTRICT,3,Transgender,0,0,0
KACHHI DISTRICT,4,Male,5473,850,6323
KACHHI DISTRICT,4,Female,5022,811,5833
KACHHI DISTRICT,4,Transgender,0,0,0
KACHHI DISTRICT,5,Male,4880,906,5786
KACHHI DISTRICT,5,Female,4474,771,5245
KACHHI DISTRICT,5,Transgender,0,0,0
KACHHI DISTRICT,6,Male,5678,783,6461
KACHHI DISTRICT,6,Female,4881,670,5551
KACHHI DISTRICT,6,Transgender,0,0,0
KACHHI DISTRICT,7,Male,5217,904,6121
KACHHI DISTRICT,7,Female,4230,794,5024
KACHHI DISTRICT,7,Transgender,0,0,0
KACHHI DISTRICT,8,Male,6044,826,6870
KACHHI DISTRICT,8,Female,4918,735,5653
KACHHI DISTRICT,8,Transgender,0,0,0
KACHHI DISTRICT,9,Male,4764,785,5549
KACHHI DISTRICT,9,Female,3777,669,4446
KACHHI DISTRICT,9,Transgender,0,0,0
KACHHI DISTRICT,10,Male,5606,670,6276
KACHHI DISTRICT,10,Female,4384,649,5033
KACHHI DISTRICT,10,Transgender,0,0,0
KACHHI DISTRICT,11,Male,3773,631,4404
KACHHI DISTRICT,11,Female,3035,575,3610
KACHHI DISTRICT,11,Transgender,0,0,0
KACHHI DISTRICT,12,Male,4080,605,4685
KACHHI DISTRICT,12,Female,3310,578,3888
KACHHI DISTRICT,12,Transgender,0,0,0
KACHHI DISTRICT,13,Male,3163,600,3763
KACHHI DISTRICT,13,Female,2432,494,2926
KACHHI DISTRICT,13,Transgender,0,0,0
KACHHI DISTRICT,14,Male,3639,571,4210
KACHHI DISTRICT,14,Female,2712,530,3242
KACHHI DISTRICT,14,Transgender,0,0,0
KACHHI DISTRICT,15,Male,3218,576,3794
KACHHI DISTRICT,15,Female,2232,532,2764
KACHHI DISTRICT,15,Transgender,0,0,0
KACHHI DISTRICT,16,Male,3316,528,3844
KACHHI DISTRICT,16,Female,2297,493,2790
KACHHI DISTRICT,16,Transgender,1,0,1
KACHHI DISTRICT,17,Male,2511,566,3077
KACHHI DISTRICT,17,Female,1817,474,2291
KACHHI DISTRICT,17,Transgender,0,0,0
KACHHI DISTRICT,18,Male,3118,468,3586
KACHHI DISTRICT,18,Female,2433,498,2931
KACHHI DISTRICT,18,Transgender,0,0,0
KACHHI DISTRICT,19,Male,2309,525,2834
KACHHI DISTRICT,19,Female,2016,463,2479
KACHHI DISTRICT,19,Transgender,0,0,0
KACHHI DISTRICT,20,Male,2762,480,3242
KACHHI DISTRICT,20,Female,2240,453,2693
KACHHI DISTRICT,20,Transgender,0,0,0
KACHHI DISTRICT,21,Male,1955,487,2442
KACHHI DISTRICT,21,Female,1803,431,2234
KACHHI DISTRICT,21,Transgender,0,0,0
KACHHI DISTRICT,22,Male,1768,461,2229
KACHHI DISTRICT,22,Female,1522,385,1907
KACHHI DISTRICT,22,Transgender,0,0,0
KACHHI DISTRICT,23,Male,1617,436,2053
KACHHI DISTRICT,23,Female,1424,401,1825
KACHHI DISTRICT,23,Transgender,0,0,0
KACHHI DISTRICT,24,Male,1270,427,1697
KACHHI DISTRICT,24,Female,1271,338,1609
KACHHI DISTRICT,24,Transgender,0,0,0
KACHHI DISTRICT,25,Male,1913,440,2353
KACHHI DISTRICT,25,Female,1918,412,2330
KACHHI DISTRICT,25,Transgender,0,0,0
KACHHI DISTRICT,26,Male,1340,395,1735
KACHHI DISTRICT,26,Female,1469,393,1862
KACHHI DISTRICT,26,Transgender,0,0,0
KACHHI DISTRICT,27,Male,1808,476,2284
KACHHI DISTRICT,27,Female,1795,444,2239
KACHHI DISTRICT,27,Transgender,0,0,0
KACHHI DISTRICT,28,Male,1479,432,1911
KACHHI DISTRICT,28,Female,1674,346,2020
KACHHI DISTRICT,28,Transgender,0,0,0
KACHHI DISTRICT,29,Male,1652,414,2066
KACHHI DISTRICT,29,Female,1775,449,2224
KACHHI DISTRICT,29,Transgender,0,0,0
KACHHI DISTRICT,30,Male,1790,394,2184
KACHHI DISTRICT,30,Female,1942,362,2304
KACHHI DISTRICT,30,Transgender,0,1,1
KACHHI DISTRICT,31,Male,1603,406,2009
KACHHI DISTRICT,31,Female,1594,351,1945
KACHHI DISTRICT,31,Transgender,1,0,1
KACHHI DISTRICT,32,Male,1421,386,1807
KACHHI DISTRICT,32,Female,1480,344,1824
KACHHI DISTRICT,32,Transgender,0,0,0
KACHHI DISTRICT,33,Male,1365,364,1729
KACHHI DISTRICT,33,Female,1396,296,1692
KACHHI DISTRICT,33,Transgender,0,0,0
KACHHI DISTRICT,34,Male,1199,325,1524
KACHHI DISTRICT,34,Female,1292,289,1581
KACHHI DISTRICT,34,Transgender,0,0,0
KACHHI DISTRICT,35,Male,1572,359,1931
KACHHI DISTRICT,35,Female,1390,295,1685
KACHHI DISTRICT,35,Transgender,1,0,1
KACHHI DISTRICT,36,Male,1096,296,1392
KACHHI DISTRICT,36,Female,1081,256,1337
KACHHI DISTRICT,36,Transgender,0,0,0
KACHHI DISTRICT,37,Male,1790,374,2164
KACHHI DISTRICT,37,Female,1359,326,1685
KACHHI DISTRICT,37,Transgender,0,0,0
KACHHI DISTRICT,38,Male,1108,333,1441
KACHHI DISTRICT,38,Female,1271,227,1498
KACHHI DISTRICT,38,Transgender,0,0,0
KACHHI DISTRICT,39,Male,1349,341,1690
KACHHI DISTRICT,39,Female,1082,298,1380
KACHHI DISTRICT,39,Transgender,0,0,0
KACHHI DISTRICT,40,Male,1209,243,1452
KACHHI DISTRICT,40,Female,1333,219,1552
KACHHI DISTRICT,40,Transgender,0,1,1
KACHHI DISTRICT,41,Male,931,243,1174
KACHHI DISTRICT,41,Female,931,196,1127
KACHHI DISTRICT,41,Transgender,0,0,0
KACHHI DISTRICT,42,Male,988,237,1225
KACHHI DISTRICT,42,Female,951,208,1159
KACHHI DISTRICT,42,Transgender,0,0,0
KACHHI DISTRICT,43,Male,735,186,921
KACHHI DISTRICT,43,Female,894,179,1073
KACHHI DISTRICT,43,Transgender,0,0,0
KACHHI DISTRICT,44,Male,623,213,836
KACHHI DISTRICT,44,Female,709,150,859
KACHHI DISTRICT,44,Transgender,0,0,0
KACHHI DISTRICT,45,Male,802,200,1002
KACHHI DISTRICT,45,Female,998,177,1175
KACHHI DISTRICT,45,Transgender,0,0,0
KACHHI DISTRICT,46,Male,689,186,875
KACHHI DISTRICT,46,Female,626,181,807
KACHHI DISTRICT,46,Transgender,0,0,0
KACHHI DISTRICT,47,Male,986,233,1219
KACHHI DISTRICT,47,Female,919,213,1132
KACHHI DISTRICT,47,Transgender,0,0,0
KACHHI DISTRICT,48,Male,725,218,943
KACHHI DISTRICT,48,Female,776,162,938
KACHHI DISTRICT,48,Transgender,0,0,0
KACHHI DISTRICT,49,Male,956,243,1199
KACHHI DISTRICT,49,Female,702,189,891
KACHHI DISTRICT,49,Transgender,0,0,0
KACHHI DISTRICT,50,Male,811,182,993
KACHHI DISTRICT,50,Female,901,146,1047
KACHHI DISTRICT,50,Transgender,0,0,0
KACHHI DISTRICT,51,Male,759,180,939
KACHHI DISTRICT,51,Female,617,143,760
KACHHI DISTRICT,51,Transgender,0,0,0
KACHHI DISTRICT,52,Male,785,156,941
KACHHI DISTRICT,52,Female,596,149,745
KACHHI DISTRICT,52,Transgender,0,0,0
KACHHI DISTRICT,53,Male,624,134,758
KACHHI DISTRICT,53,Female,566,118,684
KACHHI DISTRICT,53,Transgender,0,0,0
KACHHI DISTRICT,54,Male,586,135,721
KACHHI DISTRICT,54,Female,483,79,562
KACHHI DISTRICT,54,Transgender,0,0,0
KACHHI DISTRICT,55,Male,532,130,662
KACHHI DISTRICT,55,Female,493,93,586
KACHHI DISTRICT,55,Transgender,0,0,0
KACHHI DISTRICT,56,Male,408,117,525
KACHHI DISTRICT,56,Female,377,102,479
KACHHI DISTRICT,56,Transgender,0,0,0
KACHHI DISTRICT,57,Male,691,132,823
KACHHI DISTRICT,57,Female,621,140,761
KACHHI DISTRICT,57,Transgender,0,0,0
KACHHI DISTRICT,58,Male,366,90,456
KACHHI DISTRICT,58,Female,387,110,497
KACHHI DISTRICT,58,Transgender,0,0,0
KACHHI DISTRICT,59,Male,495,138,633
KACHHI DISTRICT,59,Female,406,103,509
KACHHI DISTRICT,59,Transgender,0,0,0
KACHHI DISTRICT,60,Male,500,117,617
KACHHI DISTRICT,60,Female,527,89,616
KACHHI DISTRICT,60,Transgender,2,0,2
KACHHI DISTRICT,61,Male,476,120,596
KACHHI DISTRICT,61,Female,439,104,543
KACHHI DISTRICT,61,Transgender,0,0,0
KACHHI DISTRICT,62,Male,417,98,515
KACHHI DISTRICT,62,Female,461,110,571
KACHHI DISTRICT,62,Transgender,0,0,0
KACHHI DISTRICT,63,Male,447,101,548
KACHHI DISTRICT,63,Female,345,82,427
KACHHI DISTRICT,63,Transgender,0,0,0
KACHHI DISTRICT,64,Male,461,72,533
KACHHI DISTRICT,64,Female,344,88,432
KACHHI DISTRICT,64,Transgender,0,0,0
KACHHI DISTRICT,65,Male,321,84,405
KACHHI DISTRICT,65,Female,308,66,374
KACHHI DISTRICT,65,Transgender,0,0,0
KACHHI DISTRICT,66,Male,345,88,433
KACHHI DISTRICT,66,Female,299,63,362
KACHHI DISTRICT,66,Transgender,0,0,0
KACHHI DISTRICT,67,Male,383,87,470
KACHHI DISTRICT,67,Female,339,93,432
KACHHI DISTRICT,67,Transgender,0,0,0
KACHHI DISTRICT,68,Male,225,42,267
KACHHI DISTRICT,68,Female,203,52,255
KACHHI DISTRICT,68,Transgender,0,0,0
KACHHI DISTRICT,69,Male,331,65,396
KACHHI DISTRICT,69,Female,218,45,263
KACHHI DISTRICT,69,Transgender,0,0,0
KACHHI DISTRICT,70,Male,238,50,288
KACHHI DISTRICT,70,Female,276,48,324
KACHHI DISTRICT,70,Transgender,0,0,0
KACHHI DISTRICT,71,Male,323,45,368
KACHHI DISTRICT,71,Female,208,38,246
KACHHI DISTRICT,71,Transgender,0,0,0
KACHHI DISTRICT,72,Male,182,46,228
KACHHI DISTRICT,72,Female,204,52,256
KACHHI DISTRICT,72,Transgender,0,0,0
KACHHI DISTRICT,73,Male,155,29,184
KACHHI DISTRICT,73,Female,175,42,217
KACHHI DISTRICT,73,Transgender,0,0,0
KACHHI DISTRICT,74,Male,187,34,221
KACHHI DISTRICT,74,Female,143,36,179
KACHHI DISTRICT,74,Transgender,0,0,0
KACHHI DISTRICT,>=75,Male,1213,272,1485
KACHHI DISTRICT,>=75,Female,1194,299,1493
KACHHI DISTRICT,>=75,Transgender,0,1,1
KALAT DISTRICT,<1,Male,6315,1281,7596
KALAT DISTRICT,<1,Female,6343,1352,7695
KALAT DISTRICT,<1,Transgender,0,0,0
KALAT DISTRICT,1,Male,6288,1359,7647
KALAT DISTRICT,1,Female,6222,1338,7560
KALAT DISTRICT,1,Transgender,0,0,0
KALAT DISTRICT,2,Male,7825,1445,9270
KALAT DISTRICT,2,Female,7802,1537,9339
KALAT DISTRICT,2,Transgender,0,0,0
KALAT DISTRICT,3,Male,6807,1465,8272
KALAT DISTRICT,3,Female,6706,1525,8231
KALAT DISTRICT,3,Transgender,0,0,0
KALAT DISTRICT,4,Male,7947,1430,9377
KALAT DISTRICT,4,Female,7702,1463,9165
KALAT DISTRICT,4,Transgender,0,0,0
KALAT DISTRICT,5,Male,6790,1437,8227
KALAT DISTRICT,5,Female,6439,1318,7757
KALAT DISTRICT,5,Transgender,0,0,0
KALAT DISTRICT,6,Male,7802,1250,9052
KALAT DISTRICT,6,Female,7238,1254,8492
KALAT DISTRICT,6,Transgender,0,0,0
KALAT DISTRICT,7,Male,6588,1348,7936
KALAT DISTRICT,7,Female,5975,1276,7251
KALAT DISTRICT,7,Transgender,0,0,0
KALAT DISTRICT,8,Male,7938,1315,9253
KALAT DISTRICT,8,Female,7136,1249,8385
KALAT DISTRICT,8,Transgender,0,0,0
KALAT DISTRICT,9,Male,6569,1317,7886
KALAT DISTRICT,9,Female,5632,1143,6775
KALAT DISTRICT,9,Transgender,0,0,0
KALAT DISTRICT,10,Male,7509,1237,8746
KALAT DISTRICT,10,Female,6456,1049,7505
KALAT DISTRICT,10,Transgender,0,0,0
KALAT DISTRICT,11,Male,5351,1080,6431
KALAT DISTRICT,11,Female,4402,946,5348
KALAT DISTRICT,11,Transgender,0,0,0
KALAT DISTRICT,12,Male,5499,976,6475
KALAT DISTRICT,12,Female,4519,955,5474
KALAT DISTRICT,12,Transgender,0,0,0
KALAT DISTRICT,13,Male,4567,970,5537
KALAT DISTRICT,13,Female,3754,889,4643
KALAT DISTRICT,13,Transgender,0,0,0
KALAT DISTRICT,14,Male,4878,926,5804
KALAT DISTRICT,14,Female,4058,859,4917
KALAT DISTRICT,14,Transgender,0,0,0
KALAT DISTRICT,15,Male,4288,887,5175
KALAT DISTRICT,15,Female,3111,812,3923
KALAT DISTRICT,15,Transgender,0,0,0
KALAT DISTRICT,16,Male,4036,866,4902
KALAT DISTRICT,16,Female,3172,812,3984
KALAT DISTRICT,16,Transgender,0,0,0
KALAT DISTRICT,17,Male,3354,745,4099
KALAT DISTRICT,17,Female,2630,736,3366
KALAT DISTRICT,17,Transgender,0,0,0
KALAT DISTRICT,18,Male,3375,711,4086
KALAT DISTRICT,18,Female,2828,702,3530
KALAT DISTRICT,18,Transgender,0,0,0
KALAT DISTRICT,19,Male,2248,596,2844
KALAT DISTRICT,19,Female,2250,597,2847
KALAT DISTRICT,19,Transgender,0,0,0
KALAT DISTRICT,20,Male,2973,589,3562
KALAT DISTRICT,20,Female,2800,621,3421
KALAT DISTRICT,20,Transgender,0,0,0
KALAT DISTRICT,21,Male,2038,527,2565
KALAT DISTRICT,21,Female,2247,609,2856
KALAT DISTRICT,21,Transgender,0,0,0
KALAT DISTRICT,22,Male,1923,454,2377
KALAT DISTRICT,22,Female,1892,505,2397
KALAT DISTRICT,22,Transgender,0,0,0
KALAT DISTRICT,23,Male,1764,470,2234
KALAT DISTRICT,23,Female,1805,478,2283
KALAT DISTRICT,23,Transgender,0,0,0
KALAT DISTRICT,24,Male,1674,445,2119
KALAT DISTRICT,24,Female,1743,465,2208
KALAT DISTRICT,24,Transgender,0,0,0
KALAT DISTRICT,25,Male,2335,487,2822
KALAT DISTRICT,25,Female,2429,536,2965
KALAT DISTRICT,25,Transgender,1,0,1
KALAT DISTRICT,26,Male,1622,420,2042
KALAT DISTRICT,26,Female,1753,504,2257
KALAT DISTRICT,26,Transgender,0,0,0
KALAT DISTRICT,27,Male,1832,489,2321
KALAT DISTRICT,27,Female,2079,589,2668
KALAT DISTRICT,27,Transgender,0,0,0
KALAT DISTRICT,28,Male,1998,438,2436
KALAT DISTRICT,28,Female,2386,588,2974
KALAT DISTRICT,28,Transgender,0,0,0
KALAT DISTRICT,29,Male,1903,462,2365
KALAT DISTRICT,29,Female,2211,510,2721
KALAT DISTRICT,29,Transgender,0,0,0
KALAT DISTRICT,30,Male,2443,452,2895
KALAT DISTRICT,30,Female,2640,557,3197
KALAT DISTRICT,30,Transgender,0,0,0
KALAT DISTRICT,31,Male,1887,471,2358
KALAT DISTRICT,31,Female,1989,521,2510
KALAT DISTRICT,31,Transgender,0,0,0
KALAT DISTRICT,32,Male,1708,374,2082
KALAT DISTRICT,32,Female,1649,418,2067
KALAT DISTRICT,32,Transgender,0,0,0
KALAT DISTRICT,33,Male,1630,396,2026
KALAT DISTRICT,33,Female,1937,389,2326
KALAT DISTRICT,33,Transgender,0,0,0
KALAT DISTRICT,34,Male,1417,330,1747
KALAT DISTRICT,34,Female,1497,359,1856
KALAT DISTRICT,34,Transgender,0,0,0
KALAT DISTRICT,35,Male,1724,306,2030
KALAT DISTRICT,35,Female,1790,346,2136
KALAT DISTRICT,35,Transgender,0,0,0
KALAT DISTRICT,36,Male,1424,338,1762
KALAT DISTRICT,36,Female,1250,297,1547
KALAT DISTRICT,36,Transgender,0,0,0
KALAT DISTRICT,37,Male,1684,338,2022
KALAT DISTRICT,37,Female,1284,354,1638
KALAT DISTRICT,37,Transgender,0,0,0
KALAT DISTRICT,38,Male,1589,331,1920
KALAT DISTRICT,38,Female,1625,314,1939
KALAT DISTRICT,38,Transgender,0,0,0
KALAT DISTRICT,39,Male,1437,324,1761
KALAT DISTRICT,39,Female,1351,325,1676
KALAT DISTRICT,39,Transgender,0,0,0
KALAT DISTRICT,40,Male,1736,308,2044
KALAT DISTRICT,40,Female,1748,312,2060
KALAT DISTRICT,40,Transgender,0,0,0
KALAT DISTRICT,41,Male,1133,258,1391
KALAT DISTRICT,41,Female,1098,291,1389
KALAT DISTRICT,41,Transgender,0,0,0
KALAT DISTRICT,42,Male,932,193,1125
KALAT DISTRICT,42,Female,884,222,1106
KALAT DISTRICT,42,Transgender,0,0,0
KALAT DISTRICT,43,Male,855,226,1081
KALAT DISTRICT,43,Female,1095,255,1350
KALAT DISTRICT,43,Transgender,0,0,0
KALAT DISTRICT,44,Male,862,220,1082
KALAT DISTRICT,44,Female,883,198,1081
KALAT DISTRICT,44,Transgender,0,0,0
KALAT DISTRICT,45,Male,1024,204,1228
KALAT DISTRICT,45,Female,995,235,1230
KALAT DISTRICT,45,Transgender,0,0,0
KALAT DISTRICT,46,Male,828,206,1034
KALAT DISTRICT,46,Female,762,175,937
KALAT DISTRICT,46,Transgender,0,0,0
KALAT DISTRICT,47,Male,913,244,1157
KALAT DISTRICT,47,Female,772,211,983
KALAT DISTRICT,47,Transgender,0,0,0
KALAT DISTRICT,48,Male,917,252,1169
KALAT DISTRICT,48,Female,959,188,1147
KALAT DISTRICT,48,Transgender,0,0,0
KALAT DISTRICT,49,Male,924,222,1146
KALAT DISTRICT,49,Female,821,216,1037
KALAT DISTRICT,49,Transgender,0,0,0
KALAT DISTRICT,50,Male,975,154,1129
KALAT DISTRICT,50,Female,1024,193,1217
KALAT DISTRICT,50,Transgender,0,0,0
KALAT DISTRICT,51,Male,726,206,932
KALAT DISTRICT,51,Female,659,165,824
KALAT DISTRICT,51,Transgender,0,0,0
KALAT DISTRICT,52,Male,635,165,800
KALAT DISTRICT,52,Female,457,161,618
KALAT DISTRICT,52,Transgender,0,0,0
KALAT DISTRICT,53,Male,626,169,795
KALAT DISTRICT,53,Female,606,125,731
KALAT DISTRICT,53,Transgender,0,0,0
KALAT DISTRICT,54,Male,570,137,707
KALAT DISTRICT,54,Female,586,155,741
KALAT DISTRICT,54,Transgender,0,0,0
KALAT DISTRICT,55,Male,558,112,670
KALAT DISTRICT,55,Female,612,138,750
KALAT DISTRICT,55,Transgender,0,0,0
KALAT DISTRICT,56,Male,504,126,630
KALAT DISTRICT,56,Female,427,84,511
KALAT DISTRICT,56,Transgender,0,0,0
KALAT DISTRICT,57,Male,505,136,641
KALAT DISTRICT,57,Female,403,114,517
KALAT DISTRICT,57,Transgender,0,0,0
KALAT DISTRICT,58,Male,396,129,525
KALAT DISTRICT,58,Female,443,116,559
KALAT DISTRICT,58,Transgender,0,0,0
KALAT DISTRICT,59,Male,436,125,561
KALAT DISTRICT,59,Female,396,119,515
KALAT DISTRICT,59,Transgender,0,0,0
KALAT DISTRICT,60,Male,582,117,699
KALAT DISTRICT,60,Female,601,124,725
KALAT DISTRICT,60,Transgender,0,0,0
KALAT DISTRICT,61,Male,444,126,570
KALAT DISTRICT,61,Female,430,135,565
KALAT DISTRICT,61,Transgender,0,0,0
KALAT DISTRICT,62,Male,365,95,460
KALAT DISTRICT,62,Female,361,89,450
KALAT DISTRICT,62,Transgender,0,0,0
KALAT DISTRICT,63,Male,384,113,497
KALAT DISTRICT,63,Female,385,97,482
KALAT DISTRICT,63,Transgender,0,0,0
KALAT DISTRICT,64,Male,380,79,459
KALAT DISTRICT,64,Female,337,82,419
KALAT DISTRICT,64,Transgender,0,0,0
KALAT DISTRICT,65,Male,378,76,454
KALAT DISTRICT,65,Female,398,60,458
KALAT DISTRICT,65,Transgender,0,0,0
KALAT DISTRICT,66,Male,420,102,522
KALAT DISTRICT,66,Female,308,71,379
KALAT DISTRICT,66,Transgender,0,0,0
KALAT DISTRICT,67,Male,321,98,419
KALAT DISTRICT,67,Female,261,57,318
KALAT DISTRICT,67,Transgender,0,0,0
KALAT DISTRICT,68,Male,243,62,305
KALAT DISTRICT,68,Female,268,55,323
KALAT DISTRICT,68,Transgender,0,0,0
KALAT DISTRICT,69,Male,244,67,311
KALAT DISTRICT,69,Female,212,70,282
KALAT DISTRICT,69,Transgender,0,0,0
KALAT DISTRICT,70,Male,335,51,386
KALAT DISTRICT,70,Female,263,32,295
KALAT DISTRICT,70,Transgender,0,0,0
KALAT DISTRICT,71,Male,307,53,360
KALAT DISTRICT,71,Female,225,54,279
KALAT DISTRICT,71,Transgender,0,0,0
KALAT DISTRICT,72,Male,210,35,245
KALAT DISTRICT,72,Female,172,40,212
KALAT DISTRICT,72,Transgender,0,0,0
KALAT DISTRICT,73,Male,179,30,209
KALAT DISTRICT,73,Female,165,35,200
KALAT DISTRICT,73,Transgender,0,0,0
KALAT DISTRICT,74,Male,149,27,176
KALAT DISTRICT,74,Female,149,22,171
KALAT DISTRICT,74,Transgender,0,0,0
KALAT DISTRICT,>=75,Male,1547,279,1826
KALAT DISTRICT,>=75,Female,1245,316,1561
KALAT DISTRICT,>=75,Transgender,0,0,0
KAMBAR SHAHDAD KOT DISTRICT,<1,Male,11945,4582,16527
KAMBAR SHAHDAD KOT DISTRICT,<1,Female,11237,4323,15560
KAMBAR SHAHDAD KOT DISTRICT,<1,Transgender,0,0,0
KAMBAR SHAHDAD KOT DISTRICT,1,Male,12602,5189,17791
KAMBAR SHAHDAD KOT DISTRICT,1,Female,13087,5271,18358
KAMBAR SHAHDAD KOT DISTRICT,1,Transgender,0,0,0
KAMBAR SHAHDAD KOT DISTRICT,2,Male,16716,6333,23049
KAMBAR SHAHDAD KOT DISTRICT,2,Female,17374,6319,23693
KAMBAR SHAHDAD KOT DISTRICT,2,Transgender,0,0,0
KAMBAR SHAHDAD KOT DISTRICT,3,Male,18415,7265,25680
KAMBAR SHAHDAD KOT DISTRICT,3,Female,18301,7090,25391
KAMBAR SHAHDAD KOT DISTRICT,3,Transgender,0,0,0
KAMBAR SHAHDAD KOT DISTRICT,4,Male,19515,7300,26815
KAMBAR SHAHDAD KOT DISTRICT,4,Female,19756,7294,27050
KAMBAR SHAHDAD KOT DISTRICT,4,Transgender,0,0,0
KAMBAR SHAHDAD KOT DISTRICT,5,Male,19717,7400,27117
KAMBAR SHAHDAD KOT DISTRICT,5,Female,18324,6980,25304
KAMBAR SHAHDAD KOT DISTRICT,5,Transgender,0,0,0
KAMBAR SHAHDAD KOT DISTRICT,6,Male,19417,7183,26600
KAMBAR SHAHDAD KOT DISTRICT,6,Female,18248,6669,24917
KAMBAR SHAHDAD KOT DISTRICT,6,Transgender,0,0,0
KAMBAR SHAHDAD KOT DISTRICT,7,Male,16939,7022,23961
KAMBAR SHAHDAD KOT DISTRICT,7,Female,15531,6359,21890
KAMBAR SHAHDAD KOT DISTRICT,7,Transgender,0,0,0
KAMBAR SHAHDAD KOT DISTRICT,8,Male,20276,7501,27777
KAMBAR SHAHDAD KOT DISTRICT,8,Female,17918,6770,24688
KAMBAR SHAHDAD KOT DISTRICT,8,Transgender,0,0,0
KAMBAR SHAHDAD KOT DISTRICT,9,Male,15316,6212,21528
KAMBAR SHAHDAD KOT DISTRICT,9,Female,13669,5493,19162
KAMBAR SHAHDAD KOT DISTRICT,9,Transgender,0,0,0
KAMBAR SHAHDAD KOT DISTRICT,10,Male,17749,6804,24553
KAMBAR SHAHDAD KOT DISTRICT,10,Female,15488,5651,21139
KAMBAR SHAHDAD KOT DISTRICT,10,Transgender,0,0,0
KAMBAR SHAHDAD KOT DISTRICT,11,Male,11815,4945,16760
KAMBAR SHAHDAD KOT DISTRICT,11,Female,10151,4392,14543
KAMBAR SHAHDAD KOT DISTRICT,11,Transgender,0,0,0
KAMBAR SHAHDAD KOT DISTRICT,12,Male,13891,5415,19306
KAMBAR SHAHDAD KOT DISTRICT,12,Female,11811,4712,16523
KAMBAR SHAHDAD KOT DISTRICT,12,Transgender,0,0,0
KAMBAR SHAHDAD KOT DISTRICT,13,Male,10850,4717,15567
KAMBAR SHAHDAD KOT DISTRICT,13,Female,9112,4222,13334
KAMBAR SHAHDAD KOT DISTRICT,13,Transgender,0,0,0
KAMBAR SHAHDAD KOT DISTRICT,14,Male,11102,4768,15870
KAMBAR SHAHDAD KOT DISTRICT,14,Female,9923,4257,14180
KAMBAR SHAHDAD KOT DISTRICT,14,Transgender,0,0,0
KAMBAR SHAHDAD KOT DISTRICT,15,Male,11287,5006,16293
KAMBAR SHAHDAD KOT DISTRICT,15,Female,9309,4465,13774
KAMBAR SHAHDAD KOT DISTRICT,15,Transgender,2,1,3
KAMBAR SHAHDAD KOT DISTRICT,16,Male,10521,4603,15124
KAMBAR SHAHDAD KOT DISTRICT,16,Female,9403,4115,13518
KAMBAR SHAHDAD KOT DISTRICT,16,Transgender,1,2,3
KAMBAR SHAHDAD KOT DISTRICT,17,Male,9181,4612,13793
KAMBAR SHAHDAD KOT DISTRICT,17,Female,8242,4239,12481
KAMBAR SHAHDAD KOT DISTRICT,17,Transgender,3,0,3
KAMBAR SHAHDAD KOT DISTRICT,18,Male,10250,4317,14567
KAMBAR SHAHDAD KOT DISTRICT,18,Female,10417,4318,14735
KAMBAR SHAHDAD KOT DISTRICT,18,Transgender,10,0,10
KAMBAR SHAHDAD KOT DISTRICT,19,Male,8161,3798,11959
KAMBAR SHAHDAD KOT DISTRICT,19,Female,8049,3778,11827
KAMBAR SHAHDAD KOT DISTRICT,19,Transgender,2,4,6
KAMBAR SHAHDAD KOT DISTRICT,20,Male,9593,3907,13500
KAMBAR SHAHDAD KOT DISTRICT,20,Female,9573,4025,13598
KAMBAR SHAHDAD KOT DISTRICT,20,Transgender,6,2,8
KAMBAR SHAHDAD KOT DISTRICT,21,Male,6844,3373,10217
KAMBAR SHAHDAD KOT DISTRICT,21,Female,6921,3214,10135
KAMBAR SHAHDAD KOT DISTRICT,21,Transgender,3,1,4
KAMBAR SHAHDAD KOT DISTRICT,22,Male,7269,3312,10581
KAMBAR SHAHDAD KOT DISTRICT,22,Female,6705,2993,9698
KAMBAR SHAHDAD KOT DISTRICT,22,Transgender,3,0,3
KAMBAR SHAHDAD KOT DISTRICT,23,Male,6181,2955,9136
KAMBAR SHAHDAD KOT DISTRICT,23,Female,5988,2903,8891
KAMBAR SHAHDAD KOT DISTRICT,23,Transgender,1,1,2
KAMBAR SHAHDAD KOT DISTRICT,24,Male,5494,2658,8152
KAMBAR SHAHDAD KOT DISTRICT,24,Female,5552,2604,8156
KAMBAR SHAHDAD KOT DISTRICT,24,Transgender,4,2,6
KAMBAR SHAHDAD KOT DISTRICT,25,Male,7059,2977,10036
KAMBAR SHAHDAD KOT DISTRICT,25,Female,7176,3205,10381
KAMBAR SHAHDAD KOT DISTRICT,25,Transgender,8,3,11
KAMBAR SHAHDAD KOT DISTRICT,26,Male,5314,2644,7958
KAMBAR SHAHDAD KOT DISTRICT,26,Female,5574,2806,8380
KAMBAR SHAHDAD KOT DISTRICT,26,Transgender,1,1,2
KAMBAR SHAHDAD KOT DISTRICT,27,Male,5800,2797,8597
KAMBAR SHAHDAD KOT DISTRICT,27,Female,6272,3001,9273
KAMBAR SHAHDAD KOT DISTRICT,27,Transgender,2,0,2
KAMBAR SHAHDAD KOT DISTRICT,28,Male,6220,2870,9090
KAMBAR SHAHDAD KOT DISTRICT,28,Female,6651,3061,9712
KAMBAR SHAHDAD KOT DISTRICT,28,Transgender,5,3,8
KAMBAR SHAHDAD KOT DISTRICT,29,Male,5987,2880,8867
KAMBAR SHAHDAD KOT DISTRICT,29,Female,6352,3071,9423
KAMBAR SHAHDAD KOT DISTRICT,29,Transgender,2,1,3
KAMBAR SHAHDAD KOT DISTRICT,30,Male,5942,2833,8775
KAMBAR SHAHDAD KOT DISTRICT,30,Female,6500,2850,9350
KAMBAR SHAHDAD KOT DISTRICT,30,Transgender,3,4,7
KAMBAR SHAHDAD KOT DISTRICT,31,Male,5457,2548,8005
KAMBAR SHAHDAD KOT DISTRICT,31,Female,5927,2662,8589
KAMBAR SHAHDAD KOT DISTRICT,31,Transgender,4,2,6
KAMBAR SHAHDAD KOT DISTRICT,32,Male,5321,2593,7914
KAMBAR SHAHDAD KOT DISTRICT,32,Female,5984,2704,8688
KAMBAR SHAHDAD KOT DISTRICT,32,Transgender,3,0,3
KAMBAR SHAHDAD KOT DISTRICT,33,Male,5115,2425,7540
KAMBAR SHAHDAD KOT DISTRICT,33,Female,5400,2393,7793
KAMBAR SHAHDAD KOT DISTRICT,33,Transgender,0,1,1
KAMBAR SHAHDAD KOT DISTRICT,34,Male,4675,2102,6777
KAMBAR SHAHDAD KOT DISTRICT,34,Female,4884,2124,7008
KAMBAR SHAHDAD KOT DISTRICT,34,Transgender,3,1,4
KAMBAR SHAHDAD KOT DISTRICT,35,Male,5648,2431,8079
KAMBAR SHAHDAD KOT DISTRICT,35,Female,5272,2260,7532
KAMBAR SHAHDAD KOT DISTRICT,35,Transgender,4,7,11
KAMBAR SHAHDAD KOT DISTRICT,36,Male,4646,2097,6743
KAMBAR SHAHDAD KOT DISTRICT,36,Female,4652,2007,6659
KAMBAR SHAHDAD KOT DISTRICT,36,Transgender,1,0,1
KAMBAR SHAHDAD KOT DISTRICT,37,Male,5442,2495,7937
KAMBAR SHAHDAD KOT DISTRICT,37,Female,5380,2542,7922
KAMBAR SHAHDAD KOT DISTRICT,37,Transgender,6,1,7
KAMBAR SHAHDAD KOT DISTRICT,38,Male,4589,2100,6689
KAMBAR SHAHDAD KOT DISTRICT,38,Female,4554,2110,6664
KAMBAR SHAHDAD KOT DISTRICT,38,Transgender,1,4,5
KAMBAR SHAHDAD KOT DISTRICT,39,Male,4800,2173,6973
KAMBAR SHAHDAD KOT DISTRICT,39,Female,4543,2123,6666
KAMBAR SHAHDAD KOT DISTRICT,39,Transgender,2,0,2
KAMBAR SHAHDAD KOT DISTRICT,40,Male,4392,1923,6315
KAMBAR SHAHDAD KOT DISTRICT,40,Female,4535,1896,6431
KAMBAR SHAHDAD KOT DISTRICT,40,Transgender,7,4,11
KAMBAR SHAHDAD KOT DISTRICT,41,Male,3681,1692,5373
KAMBAR SHAHDAD KOT DISTRICT,41,Female,3798,1585,5383
KAMBAR SHAHDAD KOT DISTRICT,41,Transgender,0,0,0
KAMBAR SHAHDAD KOT DISTRICT,42,Male,3709,1691,5400
KAMBAR SHAHDAD KOT DISTRICT,42,Female,3948,1779,5727
KAMBAR SHAHDAD KOT DISTRICT,42,Transgender,1,0,1
KAMBAR SHAHDAD KOT DISTRICT,43,Male,2895,1417,4312
KAMBAR SHAHDAD KOT DISTRICT,43,Female,3275,1439,4714
KAMBAR SHAHDAD KOT DISTRICT,43,Transgender,1,1,2
KAMBAR SHAHDAD KOT DISTRICT,44,Male,2891,1401,4292
KAMBAR SHAHDAD KOT DISTRICT,44,Female,2910,1268,4178
KAMBAR SHAHDAD KOT DISTRICT,44,Transgender,1,0,1
KAMBAR SHAHDAD KOT DISTRICT,45,Male,3212,1442,4654
KAMBAR SHAHDAD KOT DISTRICT,45,Female,3217,1316,4533
KAMBAR SHAHDAD KOT DISTRICT,45,Transgender,4,3,7
KAMBAR SHAHDAD KOT DISTRICT,46,Male,2782,1128,3910
KAMBAR SHAHDAD KOT DISTRICT,46,Female,2903,1112,4015
KAMBAR SHAHDAD KOT DISTRICT,46,Transgender,1,0,1
KAMBAR SHAHDAD KOT DISTRICT,47,Male,3129,1345,4474
KAMBAR SHAHDAD KOT DISTRICT,47,Female,3534,1634,5168
KAMBAR SHAHDAD KOT DISTRICT,47,Transgender,1,0,1
KAMBAR SHAHDAD KOT DISTRICT,48,Male,2884,1169,4053
KAMBAR SHAHDAD KOT DISTRICT,48,Female,2899,1185,4084
KAMBAR SHAHDAD KOT DISTRICT,48,Transgender,1,0,1
KAMBAR SHAHDAD KOT DISTRICT,49,Male,2828,1264,4092
KAMBAR SHAHDAD KOT DISTRICT,49,Female,2606,1260,3866
KAMBAR SHAHDAD KOT DISTRICT,49,Transgender,0,0,0
KAMBAR SHAHDAD KOT DISTRICT,50,Male,3053,1257,4310
KAMBAR SHAHDAD KOT DISTRICT,50,Female,2737,1171,3908
KAMBAR SHAHDAD KOT DISTRICT,50,Transgender,4,0,4
KAMBAR SHAHDAD KOT DISTRICT,51,Male,2497,1103,3600
KAMBAR SHAHDAD KOT DISTRICT,51,Female,2491,1077,3568
KAMBAR SHAHDAD KOT DISTRICT,51,Transgender,1,1,2
KAMBAR SHAHDAD KOT DISTRICT,52,Male,2413,1095,3508
KAMBAR SHAHDAD KOT DISTRICT,52,Female,2464,1155,3619
KAMBAR SHAHDAD KOT DISTRICT,52,Transgender,0,0,0
KAMBAR SHAHDAD KOT DISTRICT,53,Male,2121,949,3070
KAMBAR SHAHDAD KOT DISTRICT,53,Female,1905,868,2773
KAMBAR SHAHDAD KOT DISTRICT,53,Transgender,0,0,0
KAMBAR SHAHDAD KOT DISTRICT,54,Male,1878,941,2819
KAMBAR SHAHDAD KOT DISTRICT,54,Female,1678,747,2425
KAMBAR SHAHDAD KOT DISTRICT,54,Transgender,0,0,0
KAMBAR SHAHDAD KOT DISTRICT,55,Male,2196,937,3133
KAMBAR SHAHDAD KOT DISTRICT,55,Female,1996,916,2912
KAMBAR SHAHDAD KOT DISTRICT,55,Transgender,1,2,3
KAMBAR SHAHDAD KOT DISTRICT,56,Male,1811,812,2623
KAMBAR SHAHDAD KOT DISTRICT,56,Female,1839,712,2551
KAMBAR SHAHDAD KOT DISTRICT,56,Transgender,2,0,2
KAMBAR SHAHDAD KOT DISTRICT,57,Male,2051,897,2948
KAMBAR SHAHDAD KOT DISTRICT,57,Female,2366,1034,3400
KAMBAR SHAHDAD KOT DISTRICT,57,Transgender,1,0,1
KAMBAR SHAHDAD KOT DISTRICT,58,Male,1534,700,2234
KAMBAR SHAHDAD KOT DISTRICT,58,Female,1575,671,2246
KAMBAR SHAHDAD KOT DISTRICT,58,Transgender,1,0,1
KAMBAR SHAHDAD KOT DISTRICT,59,Male,1565,704,2269
KAMBAR SHAHDAD KOT DISTRICT,59,Female,1469,625,2094
KAMBAR SHAHDAD KOT DISTRICT,59,Transgender,1,1,2
KAMBAR SHAHDAD KOT DISTRICT,60,Male,1802,715,2517
KAMBAR SHAHDAD KOT DISTRICT,60,Female,1909,755,2664
KAMBAR SHAHDAD KOT DISTRICT,60,Transgender,2,1,3
KAMBAR SHAHDAD KOT DISTRICT,61,Male,1492,634,2126
KAMBAR SHAHDAD KOT DISTRICT,61,Female,1725,717,2442
KAMBAR SHAHDAD KOT DISTRICT,61,Transgender,2,0,2
KAMBAR SHAHDAD KOT DISTRICT,62,Male,1644,749,2393
KAMBAR SHAHDAD KOT DISTRICT,62,Female,2064,905,2969
KAMBAR SHAHDAD KOT DISTRICT,62,Transgender,0,0,0
KAMBAR SHAHDAD KOT DISTRICT,63,Male,1457,653,2110
KAMBAR SHAHDAD KOT DISTRICT,63,Female,1473,605,2078
KAMBAR SHAHDAD KOT DISTRICT,63,Transgender,0,0,0
KAMBAR SHAHDAD KOT DISTRICT,64,Male,1450,546,1996
KAMBAR SHAHDAD KOT DISTRICT,64,Female,1323,598,1921
KAMBAR SHAHDAD KOT DISTRICT,64,Transgender,1,0,1
KAMBAR SHAHDAD KOT DISTRICT,65,Male,1366,564,1930
KAMBAR SHAHDAD KOT DISTRICT,65,Female,1326,564,1890
KAMBAR SHAHDAD KOT DISTRICT,65,Transgender,1,0,1
KAMBAR SHAHDAD KOT DISTRICT,66,Male,1256,525,1781
KAMBAR SHAHDAD KOT DISTRICT,66,Female,1248,471,1719
KAMBAR SHAHDAD KOT DISTRICT,66,Transgender,1,0,1
KAMBAR SHAHDAD KOT DISTRICT,67,Male,1272,551,1823
KAMBAR SHAHDAD KOT DISTRICT,67,Female,1322,630,1952
KAMBAR SHAHDAD KOT DISTRICT,67,Transgender,0,0,0
KAMBAR SHAHDAD KOT DISTRICT,68,Male,978,402,1380
KAMBAR SHAHDAD KOT DISTRICT,68,Female,891,386,1277
KAMBAR SHAHDAD KOT DISTRICT,68,Transgender,1,0,1
KAMBAR SHAHDAD KOT DISTRICT,69,Male,910,403,1313
KAMBAR SHAHDAD KOT DISTRICT,69,Female,871,448,1319
KAMBAR SHAHDAD KOT DISTRICT,69,Transgender,1,0,1
KAMBAR SHAHDAD KOT DISTRICT,70,Male,933,377,1310
KAMBAR SHAHDAD KOT DISTRICT,70,Female,897,374,1271
KAMBAR SHAHDAD KOT DISTRICT,70,Transgender,2,1,3
KAMBAR SHAHDAD KOT DISTRICT,71,Male,810,318,1128
KAMBAR SHAHDAD KOT DISTRICT,71,Female,809,308,1117
KAMBAR SHAHDAD KOT DISTRICT,71,Transgender,0,0,0
KAMBAR SHAHDAD KOT DISTRICT,72,Male,767,303,1070
KAMBAR SHAHDAD KOT DISTRICT,72,Female,987,418,1405
KAMBAR SHAHDAD KOT DISTRICT,72,Transgender,0,0,0
KAMBAR SHAHDAD KOT DISTRICT,73,Male,652,254,906
KAMBAR SHAHDAD KOT DISTRICT,73,Female,659,262,921
KAMBAR SHAHDAD KOT DISTRICT,73,Transgender,1,0,1
KAMBAR SHAHDAD KOT DISTRICT,74,Male,598,239,837
KAMBAR SHAHDAD KOT DISTRICT,74,Female,565,239,804
KAMBAR SHAHDAD KOT DISTRICT,74,Transgender,0,0,0
KAMBAR SHAHDAD KOT DISTRICT,>=75,Male,4606,1749,6355
KAMBAR SHAHDAD KOT DISTRICT,>=75,Female,5110,2251,7361
KAMBAR SHAHDAD KOT DISTRICT,>=75,Transgender,2,1,3
KARACHI CENTRAL DISTRICT,<1,Male,0,30696,30696
KARACHI CENTRAL DISTRICT,<1,Female,0,29313,29313
KARACHI CENTRAL DISTRICT,<1,Transgender,0,0,0
KARACHI CENTRAL DISTRICT,1,Male,0,30490,30490
KARACHI CENTRAL DISTRICT,1,Female,0,28905,28905
KARACHI CENTRAL DISTRICT,1,Transgender,0,0,0
KARACHI CENTRAL DISTRICT,2,Male,0,31784,31784
KARACHI CENTRAL DISTRICT,2,Female,0,29917,29917
KARACHI CENTRAL DISTRICT,2,Transgender,0,0,0
KARACHI CENTRAL DISTRICT,3,Male,0,34004,34004
KARACHI CENTRAL DISTRICT,3,Female,0,33129,33129
KARACHI CENTRAL DISTRICT,3,Transgender,0,0,0
KARACHI CENTRAL DISTRICT,4,Male,0,31870,31870
KARACHI CENTRAL DISTRICT,4,Female,0,30270,30270
KARACHI CENTRAL DISTRICT,4,Transgender,0,0,0
KARACHI CENTRAL DISTRICT,5,Male,0,32416,32416
KARACHI CENTRAL DISTRICT,5,Female,0,31166,31166
KARACHI CENTRAL DISTRICT,5,Transgender,0,0,0
KARACHI CENTRAL DISTRICT,6,Male,0,32141,32141
KARACHI CENTRAL DISTRICT,6,Female,0,30590,30590
KARACHI CENTRAL DISTRICT,6,Transgender,0,0,0
KARACHI CENTRAL DISTRICT,7,Male,0,33834,33834
KARACHI CENTRAL DISTRICT,7,Female,0,32235,32235
KARACHI CENTRAL DISTRICT,7,Transgender,0,0,0
KARACHI CENTRAL DISTRICT,8,Male,0,29704,29704
KARACHI CENTRAL DISTRICT,8,Female,0,28255,28255
KARACHI CENTRAL DISTRICT,8,Transgender,0,0,0
KARACHI CENTRAL DISTRICT,9,Male,0,34495,34495
KARACHI CENTRAL DISTRICT,9,Female,0,32713,32713
KARACHI CENTRAL DISTRICT,9,Transgender,0,0,0
KARACHI CENTRAL DISTRICT,10,Male,0,28569,28569
KARACHI CENTRAL DISTRICT,10,Female,0,26408,26408
KARACHI CENTRAL DISTRICT,10,Transgender,0,0,0
KARACHI CENTRAL DISTRICT,11,Male,0,34697,34697
KARACHI CENTRAL DISTRICT,11,Female,0,32567,32567
KARACHI CENTRAL DISTRICT,11,Transgender,0,0,0
KARACHI CENTRAL DISTRICT,12,Male,0,28347,28347
KARACHI CENTRAL DISTRICT,12,Female,0,25789,25789
KARACHI CENTRAL DISTRICT,12,Transgender,0,0,0
KARACHI CENTRAL DISTRICT,13,Male,0,30595,30595
KARACHI CENTRAL DISTRICT,13,Female,0,28933,28933
KARACHI CENTRAL DISTRICT,13,Transgender,0,0,0
KARACHI CENTRAL DISTRICT,14,Male,0,28186,28186
KARACHI CENTRAL DISTRICT,14,Female,0,25628,25628
KARACHI CENTRAL DISTRICT,14,Transgender,0,0,0
KARACHI CENTRAL DISTRICT,15,Male,0,29406,29406
KARACHI CENTRAL DISTRICT,15,Female,0,27287,27287
KARACHI CENTRAL DISTRICT,15,Transgender,0,1,1
KARACHI CENTRAL DISTRICT,16,Male,0,30806,30806
KARACHI CENTRAL DISTRICT,16,Female,0,27993,27993
KARACHI CENTRAL DISTRICT,16,Transgender,0,7,7
KARACHI CENTRAL DISTRICT,17,Male,0,33098,33098
KARACHI CENTRAL DISTRICT,17,Female,0,30061,30061
KARACHI CENTRAL DISTRICT,17,Transgender,0,7,7
KARACHI CENTRAL DISTRICT,18,Male,0,28198,28198
KARACHI CENTRAL DISTRICT,18,Female,0,24466,24466
KARACHI CENTRAL DISTRICT,18,Transgender,0,12,12
KARACHI CENTRAL DISTRICT,19,Male,0,31886,31886
KARACHI CENTRAL DISTRICT,19,Female,0,30161,30161
KARACHI CENTRAL DISTRICT,19,Transgender,0,11,11
KARACHI CENTRAL DISTRICT,20,Male,0,28042,28042
KARACHI CENTRAL DISTRICT,20,Female,0,24259,24259
KARACHI CENTRAL DISTRICT,20,Transgender,0,15,15
KARACHI CENTRAL DISTRICT,21,Male,0,32961,32961
KARACHI CENTRAL DISTRICT,21,Female,0,31305,31305
KARACHI CENTRAL DISTRICT,21,Transgender,0,8,8
KARACHI CENTRAL DISTRICT,22,Male,0,28245,28245
KARACHI CENTRAL DISTRICT,22,Female,0,27382,27382
KARACHI CENTRAL DISTRICT,22,Transgender,0,14,14
KARACHI CENTRAL DISTRICT,23,Male,0,29224,29224
KARACHI CENTRAL DISTRICT,23,Female,0,28291,28291
KARACHI CENTRAL DISTRICT,23,Transgender,0,10,10
KARACHI CENTRAL DISTRICT,24,Male,0,29450,29450
KARACHI CENTRAL DISTRICT,24,Female,0,28268,28268
KARACHI CENTRAL DISTRICT,24,Transgender,0,11,11
KARACHI CENTRAL DISTRICT,25,Male,0,24066,24066
KARACHI CENTRAL DISTRICT,25,Female,0,22263,22263
KARACHI CENTRAL DISTRICT,25,Transgender,0,16,16
KARACHI CENTRAL DISTRICT,26,Male,0,28709,28709
KARACHI CENTRAL DISTRICT,26,Female,0,27797,27797
KARACHI CENTRAL DISTRICT,26,Transgender,0,18,18
KARACHI CENTRAL DISTRICT,27,Male,0,27136,27136
KARACHI CENTRAL DISTRICT,27,Female,0,26477,26477
KARACHI CENTRAL DISTRICT,27,Transgender,0,15,15
KARACHI CENTRAL DISTRICT,28,Male,0,25645,25645
KARACHI CENTRAL DISTRICT,28,Female,0,25772,25772
KARACHI CENTRAL DISTRICT,28,Transgender,0,17,17
KARACHI CENTRAL DISTRICT,29,Male,0,27371,27371
KARACHI CENTRAL DISTRICT,29,Female,0,25758,25758
KARACHI CENTRAL DISTRICT,29,Transgender,0,15,15
KARACHI CENTRAL DISTRICT,30,Male,0,23130,23130
KARACHI CENTRAL DISTRICT,30,Female,0,22858,22858
KARACHI CENTRAL DISTRICT,30,Transgender,0,35,35
KARACHI CENTRAL DISTRICT,31,Male,0,27334,27334
KARACHI CENTRAL DISTRICT,31,Female,0,26064,26064
KARACHI CENTRAL DISTRICT,31,Transgender,0,9,9
KARACHI CENTRAL DISTRICT,32,Male,0,25709,25709
KARACHI CENTRAL DISTRICT,32,Female,0,24384,24384
KARACHI CENTRAL DISTRICT,32,Transgender,0,16,16
KARACHI CENTRAL DISTRICT,33,Male,0,25543,25543
KARACHI CENTRAL DISTRICT,33,Female,0,23677,23677
KARACHI CENTRAL DISTRICT,33,Transgender,0,12,12
KARACHI CENTRAL DISTRICT,34,Male,0,25240,25240
KARACHI CENTRAL DISTRICT,34,Female,0,22718,22718
KARACHI CENTRAL DISTRICT,34,Transgender,0,3,3
KARACHI CENTRAL DISTRICT,35,Male,0,19809,19809
KARACHI CENTRAL DISTRICT,35,Female,0,18448,18448
KARACHI CENTRAL DISTRICT,35,Transgender,0,27,27
KARACHI CENTRAL DISTRICT,36,Male,0,23379,23379
KARACHI CENTRAL DISTRICT,36,Female,0,21287,21287
KARACHI CENTRAL DISTRICT,36,Transgender,0,14,14
KARACHI CENTRAL DISTRICT,37,Male,0,21873,21873
KARACHI CENTRAL DISTRICT,37,Female,0,18818,18818
KARACHI CENTRAL DISTRICT,37,Transgender,0,11,11
KARACHI CENTRAL DISTRICT,38,Male,0,22767,22767
KARACHI CENTRAL DISTRICT,38,Female,0,21238,21238
KARACHI CENTRAL DISTRICT,38,Transgender,0,10,10
KARACHI CENTRAL DISTRICT,39,Male,0,21780,21780
KARACHI CENTRAL DISTRICT,39,Female,0,20299,20299
KARACHI CENTRAL DISTRICT,39,Transgender,0,5,5
KARACHI CENTRAL DISTRICT,40,Male,0,18689,18689
KARACHI CENTRAL DISTRICT,40,Female,0,16791,16791
KARACHI CENTRAL DISTRICT,40,Transgender,0,25,25
KARACHI CENTRAL DISTRICT,41,Male,0,20649,20649
KARACHI CENTRAL DISTRICT,41,Female,0,17924,17924
KARACHI CENTRAL DISTRICT,41,Transgender,0,4,4
KARACHI CENTRAL DISTRICT,42,Male,0,18970,18970
KARACHI CENTRAL DISTRICT,42,Female,0,16645,16645
KARACHI CENTRAL DISTRICT,42,Transgender,0,16,16
KARACHI CENTRAL DISTRICT,43,Male,0,18272,18272
KARACHI CENTRAL DISTRICT,43,Female,0,17341,17341
KARACHI CENTRAL DISTRICT,43,Transgender,0,5,5
KARACHI CENTRAL DISTRICT,44,Male,0,17546,17546
KARACHI CENTRAL DISTRICT,44,Female,0,16144,16144
KARACHI CENTRAL DISTRICT,44,Transgender,0,4,4
KARACHI CENTRAL DISTRICT,45,Male,0,14228,14228
KARACHI CENTRAL DISTRICT,45,Female,0,12341,12341
KARACHI CENTRAL DISTRICT,45,Transgender,0,20,20
KARACHI CENTRAL DISTRICT,46,Male,0,16654,16654
KARACHI CENTRAL DISTRICT,46,Female,0,13700,13700
KARACHI CENTRAL DISTRICT,46,Transgender,0,5,5
KARACHI CENTRAL DISTRICT,47,Male,0,15182,15182
KARACHI CENTRAL DISTRICT,47,Female,0,11731,11731
KARACHI CENTRAL DISTRICT,47,Transgender,0,2,2
KARACHI CENTRAL DISTRICT,48,Male,0,15942,15942
KARACHI CENTRAL DISTRICT,48,Female,0,14020,14020
KARACHI CENTRAL DISTRICT,48,Transgender,0,6,6
KARACHI CENTRAL DISTRICT,49,Male,0,15582,15582
KARACHI CENTRAL DISTRICT,49,Female,0,14175,14175
KARACHI CENTRAL DISTRICT,49,Transgender,0,7,7
KARACHI CENTRAL DISTRICT,50,Male,0,13117,13117
KARACHI CENTRAL DISTRICT,50,Female,0,11698,11698
KARACHI CENTRAL DISTRICT,50,Transgender,0,11,11
KARACHI CENTRAL DISTRICT,51,Male,0,15748,15748
KARACHI CENTRAL DISTRICT,51,Female,0,13542,13542
KARACHI CENTRAL DISTRICT,51,Transgender,0,4,4
KARACHI CENTRAL DISTRICT,52,Male,0,14786,14786
KARACHI CENTRAL DISTRICT,52,Female,0,12616,12616
KARACHI CENTRAL DISTRICT,52,Transgender,0,5,5
KARACHI CENTRAL DISTRICT,53,Male,0,14366,14366
KARACHI CENTRAL DISTRICT,53,Female,0,13101,13101
KARACHI CENTRAL DISTRICT,53,Transgender,0,5,5
KARACHI CENTRAL DISTRICT,54,Male,0,13351,13351
KARACHI CENTRAL DISTRICT,54,Female,0,12052,12052
KARACHI CENTRAL DISTRICT,54,Transgender,0,4,4
KARACHI CENTRAL DISTRICT,55,Male,0,10405,10405
KARACHI CENTRAL DISTRICT,55,Female,0,8637,8637
KARACHI CENTRAL DISTRICT,55,Transgender,0,4,4
KARACHI CENTRAL DISTRICT,56,Male,0,11708,11708
KARACHI CENTRAL DISTRICT,56,Female,0,10058,10058
KARACHI CENTRAL DISTRICT,56,Transgender,0,2,2
KARACHI CENTRAL DISTRICT,57,Male,0,10821,10821
KARACHI CENTRAL DISTRICT,57,Female,0,8556,8556
KARACHI CENTRAL DISTRICT,57,Transgender,0,1,1
KARACHI CENTRAL DISTRICT,58,Male,0,10405,10405
KARACHI CENTRAL DISTRICT,58,Female,0,9181,9181
KARACHI CENTRAL DISTRICT,58,Transgender,0,1,1
KARACHI CENTRAL DISTRICT,59,Male,0,9716,9716
KARACHI CENTRAL DISTRICT,59,Female,0,8970,8970
KARACHI CENTRAL DISTRICT,59,Transgender,0,1,1
KARACHI CENTRAL DISTRICT,60,Male,0,7500,7500
KARACHI CENTRAL DISTRICT,60,Female,0,6264,6264
KARACHI CENTRAL DISTRICT,60,Transgender,0,9,9
KARACHI CENTRAL DISTRICT,61,Male,0,9669,9669
KARACHI CENTRAL DISTRICT,61,Female,0,8530,8530
KARACHI CENTRAL DISTRICT,61,Transgender,0,4,4
KARACHI CENTRAL DISTRICT,62,Male,0,9546,9546
KARACHI CENTRAL DISTRICT,62,Female,0,8110,8110
KARACHI CENTRAL DISTRICT,62,Transgender,0,3,3
KARACHI CENTRAL DISTRICT,63,Male,0,8776,8776
KARACHI CENTRAL DISTRICT,63,Female,0,7894,7894
KARACHI CENTRAL DISTRICT,63,Transgender,0,1,1
KARACHI CENTRAL DISTRICT,64,Male,0,7560,7560
KARACHI CENTRAL DISTRICT,64,Female,0,6833,6833
KARACHI CENTRAL DISTRICT,64,Transgender,0,1,1
KARACHI CENTRAL DISTRICT,65,Male,0,5668,5668
KARACHI CENTRAL DISTRICT,65,Female,0,4785,4785
KARACHI CENTRAL DISTRICT,65,Transgender,0,5,5
KARACHI CENTRAL DISTRICT,66,Male,0,5633,5633
KARACHI CENTRAL DISTRICT,66,Female,0,4924,4924
KARACHI CENTRAL DISTRICT,66,Transgender,0,2,2
KARACHI CENTRAL DISTRICT,67,Male,0,5094,5094
KARACHI CENTRAL DISTRICT,67,Female,0,4247,4247
KARACHI CENTRAL DISTRICT,67,Transgender,0,2,2
KARACHI CENTRAL DISTRICT,68,Male,0,5192,5192
KARACHI CENTRAL DISTRICT,68,Female,0,4995,4995
KARACHI CENTRAL DISTRICT,68,Transgender,0,1,1
KARACHI CENTRAL DISTRICT,69,Male,0,4640,4640
KARACHI CENTRAL DISTRICT,69,Female,0,4651,4651
KARACHI CENTRAL DISTRICT,69,Transgender,0,0,0
KARACHI CENTRAL DISTRICT,70,Male,0,3434,3434
KARACHI CENTRAL DISTRICT,70,Female,0,3124,3124
KARACHI CENTRAL DISTRICT,70,Transgender,0,4,4
KARACHI CENTRAL DISTRICT,71,Male,0,3942,3942
KARACHI CENTRAL DISTRICT,71,Female,0,3744,3744
KARACHI CENTRAL DISTRICT,71,Transgender,0,1,1
KARACHI CENTRAL DISTRICT,72,Male,0,3712,3712
KARACHI CENTRAL DISTRICT,72,Female,0,3431,3431
KARACHI CENTRAL DISTRICT,72,Transgender,0,0,0
KARACHI CENTRAL DISTRICT,73,Male,0,3394,3394
KARACHI CENTRAL DISTRICT,73,Female,0,3415,3415
KARACHI CENTRAL DISTRICT,73,Transgender,0,2,2
KARACHI CENTRAL DISTRICT,74,Male,0,2916,2916
KARACHI CENTRAL DISTRICT,74,Female,0,2814,2814
KARACHI CENTRAL DISTRICT,74,Transgender,0,0,0
KARACHI CENTRAL DISTRICT,>=75,Male,0,16580,16580
KARACHI CENTRAL DISTRICT,>=75,Female,0,18727,18727
KARACHI CENTRAL DISTRICT,>=75,Transgender,0,8,8
KARACHI EAST DISTRICT,<1,Male,0,30906,30906
KARACHI EAST DISTRICT,<1,Female,0,29471,29471
KARACHI EAST DISTRICT,<1,Transgender,0,0,0
KARACHI EAST DISTRICT,1,Male,0,32032,32032
KARACHI EAST DISTRICT,1,Female,0,30302,30302
KARACHI EAST DISTRICT,1,Transgender,0,0,0
KARACHI EAST DISTRICT,2,Male,0,33027,33027
KARACHI EAST DISTRICT,2,Female,0,31719,31719
KARACHI EAST DISTRICT,2,Transgender,0,0,0
KARACHI EAST DISTRICT,3,Male,0,36309,36309
KARACHI EAST DISTRICT,3,Female,0,34743,34743
KARACHI EAST DISTRICT,3,Transgender,0,0,0
KARACHI EAST DISTRICT,4,Male,0,33007,33007
KARACHI EAST DISTRICT,4,Female,0,31569,31569
KARACHI EAST DISTRICT,4,Transgender,0,0,0
KARACHI EAST DISTRICT,5,Male,0,34682,34682
KARACHI EAST DISTRICT,5,Female,0,32929,32929
KARACHI EAST DISTRICT,5,Transgender,0,0,0
KARACHI EAST DISTRICT,6,Male,0,33389,33389
KARACHI EAST DISTRICT,6,Female,0,31275,31275
KARACHI EAST DISTRICT,6,Transgender,0,0,0
KARACHI EAST DISTRICT,7,Male,0,36271,36271
KARACHI EAST DISTRICT,7,Female,0,33938,33938
KARACHI EAST DISTRICT,7,Transgender,0,0,0
KARACHI EAST DISTRICT,8,Male,0,32408,32408
KARACHI EAST DISTRICT,8,Female,0,29713,29713
KARACHI EAST DISTRICT,8,Transgender,0,0,0
KARACHI EAST DISTRICT,9,Male,0,35722,35722
KARACHI EAST DISTRICT,9,Female,0,33690,33690
KARACHI EAST DISTRICT,9,Transgender,0,0,0
KARACHI EAST DISTRICT,10,Male,0,30123,30123
KARACHI EAST DISTRICT,10,Female,0,27371,27371
KARACHI EAST DISTRICT,10,Transgender,0,0,0
KARACHI EAST DISTRICT,11,Male,0,34665,34665
KARACHI EAST DISTRICT,11,Female,0,31452,31452
KARACHI EAST DISTRICT,11,Transgender,0,0,0
KARACHI EAST DISTRICT,12,Male,0,29312,29312
KARACHI EAST DISTRICT,12,Female,0,26197,26197
KARACHI EAST DISTRICT,12,Transgender,0,0,0
KARACHI EAST DISTRICT,13,Male,0,30909,30909
KARACHI EAST DISTRICT,13,Female,0,27811,27811
KARACHI EAST DISTRICT,13,Transgender,0,0,0
KARACHI EAST DISTRICT,14,Male,0,28477,28477
KARACHI EAST DISTRICT,14,Female,0,24409,24409
KARACHI EAST DISTRICT,14,Transgender,0,0,0
KARACHI EAST DISTRICT,15,Male,0,29418,29418
KARACHI EAST DISTRICT,15,Female,0,26061,26061
KARACHI EAST DISTRICT,15,Transgender,0,8,8
KARACHI EAST DISTRICT,16,Male,0,29407,29407
KARACHI EAST DISTRICT,16,Female,0,26184,26184
KARACHI EAST DISTRICT,16,Transgender,0,5,5
KARACHI EAST DISTRICT,17,Male,0,32396,32396
KARACHI EAST DISTRICT,17,Female,0,27366,27366
KARACHI EAST DISTRICT,17,Transgender,0,9,9
KARACHI EAST DISTRICT,18,Male,0,29276,29276
KARACHI EAST DISTRICT,18,Female,0,24491,24491
KARACHI EAST DISTRICT,18,Transgender,0,13,13
KARACHI EAST DISTRICT,19,Male,0,31486,31486
KARACHI EAST DISTRICT,19,Female,0,28129,28129
KARACHI EAST DISTRICT,19,Transgender,0,5,5
KARACHI EAST DISTRICT,20,Male,0,28747,28747
KARACHI EAST DISTRICT,20,Female,0,24064,24064
KARACHI EAST DISTRICT,20,Transgender,0,18,18
KARACHI EAST DISTRICT,21,Male,0,32123,32123
KARACHI EAST DISTRICT,21,Female,0,28629,28629
KARACHI EAST DISTRICT,21,Transgender,0,15,15
KARACHI EAST DISTRICT,22,Male,0,28859,28859
KARACHI EAST DISTRICT,22,Female,0,25777,25777
KARACHI EAST DISTRICT,22,Transgender,0,21,21
KARACHI EAST DISTRICT,23,Male,0,29136,29136
KARACHI EAST DISTRICT,23,Female,0,26173,26173
KARACHI EAST DISTRICT,23,Transgender,0,11,11
KARACHI EAST DISTRICT,24,Male,0,28730,28730
KARACHI EAST DISTRICT,24,Female,0,25882,25882
KARACHI EAST DISTRICT,24,Transgender,0,15,15
KARACHI EAST DISTRICT,25,Male,0,25800,25800
KARACHI EAST DISTRICT,25,Female,0,22730,22730
KARACHI EAST DISTRICT,25,Transgender,0,20,20
KARACHI EAST DISTRICT,26,Male,0,27639,27639
KARACHI EAST DISTRICT,26,Female,0,25887,25887
KARACHI EAST DISTRICT,26,Transgender,0,20,20
KARACHI EAST DISTRICT,27,Male,0,26946,26946
KARACHI EAST DISTRICT,27,Female,0,25356,25356
KARACHI EAST DISTRICT,27,Transgender,0,11,11
KARACHI EAST DISTRICT,28,Male,0,25277,25277
KARACHI EAST DISTRICT,28,Female,0,24109,24109
KARACHI EAST DISTRICT,28,Transgender,0,14,14
KARACHI EAST DISTRICT,29,Male,0,26088,26088
KARACHI EAST DISTRICT,29,Female,0,24256,24256
KARACHI EAST DISTRICT,29,Transgender,0,12,12
KARACHI EAST DISTRICT,30,Male,0,23726,23726
KARACHI EAST DISTRICT,30,Female,0,22417,22417
KARACHI EAST DISTRICT,30,Transgender,0,26,26
KARACHI EAST DISTRICT,31,Male,0,25082,25082
KARACHI EAST DISTRICT,31,Female,0,23356,23356
KARACHI EAST DISTRICT,31,Transgender,0,4,4
KARACHI EAST DISTRICT,32,Male,0,24295,24295
KARACHI EAST DISTRICT,32,Female,0,21869,21869
KARACHI EAST DISTRICT,32,Transgender,0,7,7
KARACHI EAST DISTRICT,33,Male,0,23098,23098
KARACHI EAST DISTRICT,33,Female,0,21871,21871
KARACHI EAST DISTRICT,33,Transgender,0,10,10
KARACHI EAST DISTRICT,34,Male,0,22452,22452
KARACHI EAST DISTRICT,34,Female,0,20347,20347
KARACHI EAST DISTRICT,34,Transgender,0,13,13
KARACHI EAST DISTRICT,35,Male,0,19669,19669
KARACHI EAST DISTRICT,35,Female,0,17806,17806
KARACHI EAST DISTRICT,35,Transgender,0,23,23
KARACHI EAST DISTRICT,36,Male,0,20695,20695
KARACHI EAST DISTRICT,36,Female,0,18998,18998
KARACHI EAST DISTRICT,36,Transgender,0,10,10
KARACHI EAST DISTRICT,37,Male,0,19812,19812
KARACHI EAST DISTRICT,37,Female,0,17094,17094
KARACHI EAST DISTRICT,37,Transgender,0,4,4
KARACHI EAST DISTRICT,38,Male,0,20522,20522
KARACHI EAST DISTRICT,38,Female,0,19266,19266
KARACHI EAST DISTRICT,38,Transgender,0,9,9
KARACHI EAST DISTRICT,39,Male,0,19740,19740
KARACHI EAST DISTRICT,39,Female,0,17740,17740
KARACHI EAST DISTRICT,39,Transgender,0,6,6
KARACHI EAST DISTRICT,40,Male,0,18555,18555
KARACHI EAST DISTRICT,40,Female,0,16285,16285
KARACHI EAST DISTRICT,40,Transgender,0,23,23
KARACHI EAST DISTRICT,41,Male,0,18045,18045
KARACHI EAST DISTRICT,41,Female,0,15545,15545
KARACHI EAST DISTRICT,41,Transgender,0,5,5
KARACHI EAST DISTRICT,42,Male,0,16954,16954
KARACHI EAST DISTRICT,42,Female,0,14632,14632
KARACHI EAST DISTRICT,42,Transgender,0,10,10
KARACHI EAST DISTRICT,43,Male,0,16578,16578
KARACHI EAST DISTRICT,43,Female,0,15583,15583
KARACHI EAST DISTRICT,43,Transgender,0,4,4
KARACHI EAST DISTRICT,44,Male,0,14990,14990
KARACHI EAST DISTRICT,44,Female,0,13551,13551
KARACHI EAST DISTRICT,44,Transgender,0,13,13
KARACHI EAST DISTRICT,45,Male,0,13154,13154
KARACHI EAST DISTRICT,45,Female,0,11370,11370
KARACHI EAST DISTRICT,45,Transgender,0,17,17
KARACHI EAST DISTRICT,46,Male,0,13733,13733
KARACHI EAST DISTRICT,46,Female,0,11957,11957
KARACHI EAST DISTRICT,46,Transgender,0,4,4
KARACHI EAST DISTRICT,47,Male,0,13400,13400
KARACHI EAST DISTRICT,47,Female,0,10202,10202
KARACHI EAST DISTRICT,47,Transgender,0,6,6
KARACHI EAST DISTRICT,48,Male,0,13336,13336
KARACHI EAST DISTRICT,48,Female,0,12498,12498
KARACHI EAST DISTRICT,48,Transgender,0,4,4
KARACHI EAST DISTRICT,49,Male,0,13312,13312
KARACHI EAST DISTRICT,49,Female,0,12410,12410
KARACHI EAST DISTRICT,49,Transgender,0,4,4
KARACHI EAST DISTRICT,50,Male,0,12427,12427
KARACHI EAST DISTRICT,50,Female,0,11598,11598
KARACHI EAST DISTRICT,50,Transgender,0,15,15
KARACHI EAST DISTRICT,51,Male,0,12752,12752
KARACHI EAST DISTRICT,51,Female,0,11355,11355
KARACHI EAST DISTRICT,51,Transgender,0,9,9
KARACHI EAST DISTRICT,52,Male,0,12727,12727
KARACHI EAST DISTRICT,52,Female,0,11416,11416
KARACHI EAST DISTRICT,52,Transgender,0,7,7
KARACHI EAST DISTRICT,53,Male,0,12161,12161
KARACHI EAST DISTRICT,53,Female,0,11534,11534
KARACHI EAST DISTRICT,53,Transgender,0,2,2
KARACHI EAST DISTRICT,54,Male,0,11319,11319
KARACHI EAST DISTRICT,54,Female,0,10658,10658
KARACHI EAST DISTRICT,54,Transgender,0,5,5
KARACHI EAST DISTRICT,55,Male,0,10129,10129
KARACHI EAST DISTRICT,55,Female,0,8489,8489
KARACHI EAST DISTRICT,55,Transgender,0,11,11
KARACHI EAST DISTRICT,56,Male,0,10175,10175
KARACHI EAST DISTRICT,56,Female,0,9068,9068
KARACHI EAST DISTRICT,56,Transgender,0,1,1
KARACHI EAST DISTRICT,57,Male,0,9587,9587
KARACHI EAST DISTRICT,57,Female,0,7490,7490
KARACHI EAST DISTRICT,57,Transgender,0,6,6
KARACHI EAST DISTRICT,58,Male,0,9479,9479
KARACHI EAST DISTRICT,58,Female,0,8737,8737
KARACHI EAST DISTRICT,58,Transgender,0,3,3
KARACHI EAST DISTRICT,59,Male,0,9058,9058
KARACHI EAST DISTRICT,59,Female,0,8146,8146
KARACHI EAST DISTRICT,59,Transgender,0,2,2
KARACHI EAST DISTRICT,60,Male,0,7462,7462
KARACHI EAST DISTRICT,60,Female,0,6725,6725
KARACHI EAST DISTRICT,60,Transgender,0,7,7
KARACHI EAST DISTRICT,61,Male,0,8510,8510
KARACHI EAST DISTRICT,61,Female,0,7434,7434
KARACHI EAST DISTRICT,61,Transgender,0,4,4
KARACHI EAST DISTRICT,62,Male,0,8842,8842
KARACHI EAST DISTRICT,62,Female,0,7522,7522
KARACHI EAST DISTRICT,62,Transgender,0,10,10
KARACHI EAST DISTRICT,63,Male,0,8511,8511
KARACHI EAST DISTRICT,63,Female,0,7588,7588
KARACHI EAST DISTRICT,63,Transgender,0,2,2
KARACHI EAST DISTRICT,64,Male,0,7449,7449
KARACHI EAST DISTRICT,64,Female,0,6521,6521
KARACHI EAST DISTRICT,64,Transgender,0,3,3
KARACHI EAST DISTRICT,65,Male,0,5806,5806
KARACHI EAST DISTRICT,65,Female,0,4956,4956
KARACHI EAST DISTRICT,65,Transgender,0,5,5
KARACHI EAST DISTRICT,66,Male,0,5647,5647
KARACHI EAST DISTRICT,66,Female,0,4636,4636
KARACHI EAST DISTRICT,66,Transgender,0,3,3
KARACHI EAST DISTRICT,67,Male,0,5238,5238
KARACHI EAST DISTRICT,67,Female,0,3984,3984
KARACHI EAST DISTRICT,67,Transgender,0,1,1
KARACHI EAST DISTRICT,68,Male,0,5258,5258
KARACHI EAST DISTRICT,68,Female,0,4627,4627
KARACHI EAST DISTRICT,68,Transgender,0,4,4
KARACHI EAST DISTRICT,69,Male,0,4654,4654
KARACHI EAST DISTRICT,69,Female,0,4328,4328
KARACHI EAST DISTRICT,69,Transgender,0,0,0
KARACHI EAST DISTRICT,70,Male,0,3593,3593
KARACHI EAST DISTRICT,70,Female,0,3182,3182
KARACHI EAST DISTRICT,70,Transgender,0,3,3
KARACHI EAST DISTRICT,71,Male,0,3915,3915
KARACHI EAST DISTRICT,71,Female,0,3334,3334
KARACHI EAST DISTRICT,71,Transgender,0,1,1
KARACHI EAST DISTRICT,72,Male,0,3715,3715
KARACHI EAST DISTRICT,72,Female,0,3211,3211
KARACHI EAST DISTRICT,72,Transgender,0,3,3
KARACHI EAST DISTRICT,73,Male,0,3497,3497
KARACHI EAST DISTRICT,73,Female,0,3128,3128
KARACHI EAST DISTRICT,73,Transgender,0,0,0
KARACHI EAST DISTRICT,74,Male,0,2944,2944
KARACHI EAST DISTRICT,74,Female,0,2736,2736
KARACHI EAST DISTRICT,74,Transgender,0,1,1
KARACHI EAST DISTRICT,>=75,Male,0,18218,18218
KARACHI EAST DISTRICT,>=75,Female,0,19119,19119
KARACHI EAST DISTRICT,>=75,Transgender,0,18,18
KARACHI SOUTH DISTRICT,<1,Male,0,17228,17228
KARACHI SOUTH DISTRICT,<1,Female,0,16236,16236
KARACHI SOUTH DISTRICT,<1,Transgender,0,0,0
KARACHI SOUTH DISTRICT,1,Male,0,16761,16761
KARACHI SOUTH DISTRICT,1,Female,0,15785,15785
KARACHI SOUTH DISTRICT,1,Transgender,0,0,0
KARACHI SOUTH DISTRICT,2,Male,0,18510,18510
KARACHI SOUTH DISTRICT,2,Female,0,17082,17082
KARACHI SOUTH DISTRICT,2,Transgender,0,0,0
KARACHI SOUTH DISTRICT,3,Male,0,19367,19367
KARACHI SOUTH DISTRICT,3,Female,0,18745,18745
KARACHI SOUTH DISTRICT,3,Transgender,0,0,0
KARACHI SOUTH DISTRICT,4,Male,0,17832,17832
KARACHI SOUTH DISTRICT,4,Female,0,17326,17326
KARACHI SOUTH DISTRICT,4,Transgender,0,0,0
KARACHI SOUTH DISTRICT,5,Male,0,18893,18893
KARACHI SOUTH DISTRICT,5,Female,0,17866,17866
KARACHI SOUTH DISTRICT,5,Transgender,0,0,0
KARACHI SOUTH DISTRICT,6,Male,0,18232,18232
KARACHI SOUTH DISTRICT,6,Female,0,17366,17366
KARACHI SOUTH DISTRICT,6,Transgender,0,0,0
KARACHI SOUTH DISTRICT,7,Male,0,20065,20065
KARACHI SOUTH DISTRICT,7,Female,0,18607,18607
KARACHI SOUTH DISTRICT,7,Transgender,0,0,0
KARACHI SOUTH DISTRICT,8,Male,0,17194,17194
KARACHI SOUTH DISTRICT,8,Female,0,16330,16330
KARACHI SOUTH DISTRICT,8,Transgender,0,0,0
KARACHI SOUTH DISTRICT,9,Male,0,19998,19998
KARACHI SOUTH DISTRICT,9,Female,0,19249,19249
KARACHI SOUTH DISTRICT,9,Transgender,0,0,0
KARACHI SOUTH DISTRICT,10,Male,0,16306,16306
KARACHI SOUTH DISTRICT,10,Female,0,15452,15452
KARACHI SOUTH DISTRICT,10,Transgender,0,0,0
KARACHI SOUTH DISTRICT,11,Male,0,20190,20190
KARACHI SOUTH DISTRICT,11,Female,0,18847,18847
KARACHI SOUTH DISTRICT,11,Transgender,0,0,0
KARACHI SOUTH DISTRICT,12,Male,0,16889,16889
KARACHI SOUTH DISTRICT,12,Female,0,15354,15354
KARACHI SOUTH DISTRICT,12,Transgender,0,0,0
KARACHI SOUTH DISTRICT,13,Male,0,18028,18028
KARACHI SOUTH DISTRICT,13,Female,0,16909,16909
KARACHI SOUTH DISTRICT,13,Transgender,0,0,0
KARACHI SOUTH DISTRICT,14,Male,0,16547,16547
KARACHI SOUTH DISTRICT,14,Female,0,14900,14900
KARACHI SOUTH DISTRICT,14,Transgender,0,0,0
KARACHI SOUTH DISTRICT,15,Male,0,17529,17529
KARACHI SOUTH DISTRICT,15,Female,0,16043,16043
KARACHI SOUTH DISTRICT,15,Transgender,0,1,1
KARACHI SOUTH DISTRICT,16,Male,0,17783,17783
KARACHI SOUTH DISTRICT,16,Female,0,16252,16252
KARACHI SOUTH DISTRICT,16,Transgender,0,1,1
KARACHI SOUTH DISTRICT,17,Male,0,20345,20345
KARACHI SOUTH DISTRICT,17,Female,0,18048,18048
KARACHI SOUTH DISTRICT,17,Transgender,0,2,2
KARACHI SOUTH DISTRICT,18,Male,0,17570,17570
KARACHI SOUTH DISTRICT,18,Female,0,14874,14874
KARACHI SOUTH DISTRICT,18,Transgender,0,3,3
KARACHI SOUTH DISTRICT,19,Male,0,19543,19543
KARACHI SOUTH DISTRICT,19,Female,0,17678,17678
KARACHI SOUTH DISTRICT,19,Transgender,0,4,4
KARACHI SOUTH DISTRICT,20,Male,0,17113,17113
KARACHI SOUTH DISTRICT,20,Female,0,14161,14161
KARACHI SOUTH DISTRICT,20,Transgender,0,7,7
KARACHI SOUTH DISTRICT,21,Male,0,19824,19824
KARACHI SOUTH DISTRICT,21,Female,0,17878,17878
KARACHI SOUTH DISTRICT,21,Transgender,0,1,1
KARACHI SOUTH DISTRICT,22,Male,0,17671,17671
KARACHI SOUTH DISTRICT,22,Female,0,16046,16046
KARACHI SOUTH DISTRICT,22,Transgender,0,5,5
KARACHI SOUTH DISTRICT,23,Male,0,17590,17590
KARACHI SOUTH DISTRICT,23,Female,0,16384,16384
KARACHI SOUTH DISTRICT,23,Transgender,0,3,3
KARACHI SOUTH DISTRICT,24,Male,0,17861,17861
KARACHI SOUTH DISTRICT,24,Female,0,15919,15919
KARACHI SOUTH DISTRICT,24,Transgender,0,8,8
KARACHI SOUTH DISTRICT,25,Male,0,15695,15695
KARACHI SOUTH DISTRICT,25,Female,0,13613,13613
KARACHI SOUTH DISTRICT,25,Transgender,0,8,8
KARACHI SOUTH DISTRICT,26,Male,0,17132,17132
KARACHI SOUTH DISTRICT,26,Female,0,15891,15891
KARACHI SOUTH DISTRICT,26,Transgender,0,3,3
KARACHI SOUTH DISTRICT,27,Male,0,17006,17006
KARACHI SOUTH DISTRICT,27,Female,0,15600,15600
KARACHI SOUTH DISTRICT,27,Transgender,0,4,4
KARACHI SOUTH DISTRICT,28,Male,0,15866,15866
KARACHI SOUTH DISTRICT,28,Female,0,15362,15362
KARACHI SOUTH DISTRICT,28,Transgender,0,3,3
KARACHI SOUTH DISTRICT,29,Male,0,16290,16290
KARACHI SOUTH DISTRICT,29,Female,0,15385,15385
KARACHI SOUTH DISTRICT,29,Transgender,0,2,2
KARACHI SOUTH DISTRICT,30,Male,0,15386,15386
KARACHI SOUTH DISTRICT,30,Female,0,14099,14099
KARACHI SOUTH DISTRICT,30,Transgender,0,12,12
KARACHI SOUTH DISTRICT,31,Male,0,16245,16245
KARACHI SOUTH DISTRICT,31,Female,0,14748,14748
KARACHI SOUTH DISTRICT,31,Transgender,0,1,1
KARACHI SOUTH DISTRICT,32,Male,0,15795,15795
KARACHI SOUTH DISTRICT,32,Female,0,14271,14271
KARACHI SOUTH DISTRICT,32,Transgender,0,3,3
KARACHI SOUTH DISTRICT,33,Male,0,15488,15488
KARACHI SOUTH DISTRICT,33,Female,0,13968,13968
KARACHI SOUTH DISTRICT,33,Transgender,0,4,4
KARACHI SOUTH DISTRICT,34,Male,0,14748,14748
KARACHI SOUTH DISTRICT,34,Female,0,13113,13113
KARACHI SOUTH DISTRICT,34,Transgender,0,3,3
KARACHI SOUTH DISTRICT,35,Male,0,13078,13078
KARACHI SOUTH DISTRICT,35,Female,0,11798,11798
KARACHI SOUTH DISTRICT,35,Transgender,0,8,8
KARACHI SOUTH DISTRICT,36,Male,0,13760,13760
KARACHI SOUTH DISTRICT,36,Female,0,12145,12145
KARACHI SOUTH DISTRICT,36,Transgender,0,4,4
KARACHI SOUTH DISTRICT,37,Male,0,13099,13099
KARACHI SOUTH DISTRICT,37,Female,0,11044,11044
KARACHI SOUTH DISTRICT,37,Transgender,0,7,7
KARACHI SOUTH DISTRICT,38,Male,0,13959,13959
KARACHI SOUTH DISTRICT,38,Female,0,12552,12552
KARACHI SOUTH DISTRICT,38,Transgender,0,0,0
KARACHI SOUTH DISTRICT,39,Male,0,13017,13017
KARACHI SOUTH DISTRICT,39,Female,0,11809,11809
KARACHI SOUTH DISTRICT,39,Transgender,0,3,3
KARACHI SOUTH DISTRICT,40,Male,0,12780,12780
KARACHI SOUTH DISTRICT,40,Female,0,10869,10869
KARACHI SOUTH DISTRICT,40,Transgender,0,22,22
KARACHI SOUTH DISTRICT,41,Male,0,12006,12006
KARACHI SOUTH DISTRICT,41,Female,0,10252,10252
KARACHI SOUTH DISTRICT,41,Transgender,0,5,5
KARACHI SOUTH DISTRICT,42,Male,0,11479,11479
KARACHI SOUTH DISTRICT,42,Female,0,9237,9237
KARACHI SOUTH DISTRICT,42,Transgender,0,4,4
KARACHI SOUTH DISTRICT,43,Male,0,11078,11078
KARACHI SOUTH DISTRICT,43,Female,0,10125,10125
KARACHI SOUTH DISTRICT,43,Transgender,0,1,1
KARACHI SOUTH DISTRICT,44,Male,0,10106,10106
KARACHI SOUTH DISTRICT,44,Female,0,9067,9067
KARACHI SOUTH DISTRICT,44,Transgender,0,1,1
KARACHI SOUTH DISTRICT,45,Male,0,9249,9249
KARACHI SOUTH DISTRICT,45,Female,0,7504,7504
KARACHI SOUTH DISTRICT,45,Transgender,0,7,7
KARACHI SOUTH DISTRICT,46,Male,0,9815,9815
KARACHI SOUTH DISTRICT,46,Female,0,7873,7873
KARACHI SOUTH DISTRICT,46,Transgender,0,6,6
KARACHI SOUTH DISTRICT,47,Male,0,9234,9234
KARACHI SOUTH DISTRICT,47,Female,0,6822,6822
KARACHI SOUTH DISTRICT,47,Transgender,0,2,2
KARACHI SOUTH DISTRICT,48,Male,0,9578,9578
KARACHI SOUTH DISTRICT,48,Female,0,8416,8416
KARACHI SOUTH DISTRICT,48,Transgender,0,1,1
KARACHI SOUTH DISTRICT,49,Male,0,9426,9426
KARACHI SOUTH DISTRICT,49,Female,0,8061,8061
KARACHI SOUTH DISTRICT,49,Transgender,0,2,2
KARACHI SOUTH DISTRICT,50,Male,0,8904,8904
KARACHI SOUTH DISTRICT,50,Female,0,7533,7533
KARACHI SOUTH DISTRICT,50,Transgender,0,7,7
KARACHI SOUTH DISTRICT,51,Male,0,9102,9102
KARACHI SOUTH DISTRICT,51,Female,0,7505,7505
KARACHI SOUTH DISTRICT,51,Transgender,0,2,2
KARACHI SOUTH DISTRICT,52,Male,0,9068,9068
KARACHI SOUTH DISTRICT,52,Female,0,7281,7281
KARACHI SOUTH DISTRICT,52,Transgender,0,4,4
KARACHI SOUTH DISTRICT,53,Male,0,8594,8594
KARACHI SOUTH DISTRICT,53,Female,0,7479,7479
KARACHI SOUTH DISTRICT,53,Transgender,0,1,1
KARACHI SOUTH DISTRICT,54,Male,0,7978,7978
KARACHI SOUTH DISTRICT,54,Female,0,6786,6786
KARACHI SOUTH DISTRICT,54,Transgender,0,0,0
KARACHI SOUTH DISTRICT,55,Male,0,6943,6943
KARACHI SOUTH DISTRICT,55,Female,0,5562,5562
KARACHI SOUTH DISTRICT,55,Transgender,0,4,4
KARACHI SOUTH DISTRICT,56,Male,0,6588,6588
KARACHI SOUTH DISTRICT,56,Female,0,5431,5431
KARACHI SOUTH DISTRICT,56,Transgender,0,1,1
KARACHI SOUTH DISTRICT,57,Male,0,6239,6239
KARACHI SOUTH DISTRICT,57,Female,0,4669,4669
KARACHI SOUTH DISTRICT,57,Transgender,0,1,1
KARACHI SOUTH DISTRICT,58,Male,0,6434,6434
KARACHI SOUTH DISTRICT,58,Female,0,5409,5409
KARACHI SOUTH DISTRICT,58,Transgender,0,1,1
KARACHI SOUTH DISTRICT,59,Male,0,6085,6085
KARACHI SOUTH DISTRICT,59,Female,0,5071,5071
KARACHI SOUTH DISTRICT,59,Transgender,0,0,0
KARACHI SOUTH DISTRICT,60,Male,0,5252,5252
KARACHI SOUTH DISTRICT,60,Female,0,4309,4309
KARACHI SOUTH DISTRICT,60,Transgender,0,8,8
KARACHI SOUTH DISTRICT,61,Male,0,6099,6099
KARACHI SOUTH DISTRICT,61,Female,0,4987,4987
KARACHI SOUTH DISTRICT,61,Transgender,0,0,0
KARACHI SOUTH DISTRICT,62,Male,0,6081,6081
KARACHI SOUTH DISTRICT,62,Female,0,5277,5277
KARACHI SOUTH DISTRICT,62,Transgender,0,0,0
KARACHI SOUTH DISTRICT,63,Male,0,5857,5857
KARACHI SOUTH DISTRICT,63,Female,0,5303,5303
KARACHI SOUTH DISTRICT,63,Transgender,0,1,1
KARACHI SOUTH DISTRICT,64,Male,0,4878,4878
KARACHI SOUTH DISTRICT,64,Female,0,4396,4396
KARACHI SOUTH DISTRICT,64,Transgender,0,1,1
KARACHI SOUTH DISTRICT,65,Male,0,4115,4115
KARACHI SOUTH DISTRICT,65,Female,0,3294,3294
KARACHI SOUTH DISTRICT,65,Transgender,0,0,0
KARACHI SOUTH DISTRICT,66,Male,0,3749,3749
KARACHI SOUTH DISTRICT,66,Female,0,2994,2994
KARACHI SOUTH DISTRICT,66,Transgender,0,0,0
KARACHI SOUTH DISTRICT,67,Male,0,3287,3287
KARACHI SOUTH DISTRICT,67,Female,0,2536,2536
KARACHI SOUTH DISTRICT,67,Transgender,0,0,0
KARACHI SOUTH DISTRICT,68,Male,0,3577,3577
KARACHI SOUTH DISTRICT,68,Female,0,3284,3284
KARACHI SOUTH DISTRICT,68,Transgender,0,0,0
KARACHI SOUTH DISTRICT,69,Male,0,3266,3266
KARACHI SOUTH DISTRICT,69,Female,0,2951,2951
KARACHI SOUTH DISTRICT,69,Transgender,0,1,1
KARACHI SOUTH DISTRICT,70,Male,0,2385,2385
KARACHI SOUTH DISTRICT,70,Female,0,2085,2085
KARACHI SOUTH DISTRICT,70,Transgender,0,3,3
KARACHI SOUTH DISTRICT,71,Male,0,2429,2429
KARACHI SOUTH DISTRICT,71,Female,0,2183,2183
KARACHI SOUTH DISTRICT,71,Transgender,0,0,0
KARACHI SOUTH DISTRICT,72,Male,0,2236,2236
KARACHI SOUTH DISTRICT,72,Female,0,2089,2089
KARACHI SOUTH DISTRICT,72,Transgender,0,0,0
KARACHI SOUTH DISTRICT,73,Male,0,2223,2223
KARACHI SOUTH DISTRICT,73,Female,0,2266,2266
KARACHI SOUTH DISTRICT,73,Transgender,0,0,0
KARACHI SOUTH DISTRICT,74,Male,0,1764,1764
KARACHI SOUTH DISTRICT,74,Female,0,1856,1856
KARACHI SOUTH DISTRICT,74,Transgender,0,0,0
KARACHI SOUTH DISTRICT,>=75,Male,0,11374,11374
KARACHI SOUTH DISTRICT,>=75,Female,0,12852,12852
KARACHI SOUTH DISTRICT,>=75,Transgender,0,4,4
KARACHI WEST DISTRICT,<1,Male,3915,45534,49449
KARACHI WEST DISTRICT,<1,Female,3801,43655,47456
KARACHI WEST DISTRICT,<1,Transgender,0,0,0
KARACHI WEST DISTRICT,1,Male,3835,44474,48309
KARACHI WEST DISTRICT,1,Female,3507,41890,45397
KARACHI WEST DISTRICT,1,Transgender,0,0,0
KARACHI WEST DISTRICT,2,Male,4411,48176,52587
KARACHI WEST DISTRICT,2,Female,4009,45829,49838
KARACHI WEST DISTRICT,2,Transgender,0,0,0
KARACHI WEST DISTRICT,3,Male,4691,51449,56140
KARACHI WEST DISTRICT,3,Female,4464,49401,53865
KARACHI WEST DISTRICT,3,Transgender,0,0,0
KARACHI WEST DISTRICT,4,Male,4289,47115,51404
KARACHI WEST DISTRICT,4,Female,4071,44815,48886
KARACHI WEST DISTRICT,4,Transgender,0,0,0
KARACHI WEST DISTRICT,5,Male,4402,48457,52859
KARACHI WEST DISTRICT,5,Female,4206,46121,50327
KARACHI WEST DISTRICT,5,Transgender,0,0,0
KARACHI WEST DISTRICT,6,Male,4265,46766,51031
KARACHI WEST DISTRICT,6,Female,3890,43800,47690
KARACHI WEST DISTRICT,6,Transgender,0,0,0
KARACHI WEST DISTRICT,7,Male,4714,50291,55005
KARACHI WEST DISTRICT,7,Female,4462,47101,51563
KARACHI WEST DISTRICT,7,Transgender,0,0,0
KARACHI WEST DISTRICT,8,Male,4177,44214,48391
KARACHI WEST DISTRICT,8,Female,3887,41204,45091
KARACHI WEST DISTRICT,8,Transgender,0,0,0
KARACHI WEST DISTRICT,9,Male,4338,50034,54372
KARACHI WEST DISTRICT,9,Female,4117,46811,50928
KARACHI WEST DISTRICT,9,Transgender,0,0,0
KARACHI WEST DISTRICT,10,Male,3890,41224,45114
KARACHI WEST DISTRICT,10,Female,3425,37801,41226
KARACHI WEST DISTRICT,10,Transgender,0,0,0
KARACHI WEST DISTRICT,11,Male,3819,48010,51829
KARACHI WEST DISTRICT,11,Female,3443,44113,47556
KARACHI WEST DISTRICT,11,Transgender,0,0,0
KARACHI WEST DISTRICT,12,Male,3560,40050,43610
KARACHI WEST DISTRICT,12,Female,3168,36275,39443
KARACHI WEST DISTRICT,12,Transgender,0,0,0
KARACHI WEST DISTRICT,13,Male,3483,42534,46017
KARACHI WEST DISTRICT,13,Female,3165,39203,42368
KARACHI WEST DISTRICT,13,Transgender,0,0,0
KARACHI WEST DISTRICT,14,Male,3173,38697,41870
KARACHI WEST DISTRICT,14,Female,2730,34449,37179
KARACHI WEST DISTRICT,14,Transgender,0,0,0
KARACHI WEST DISTRICT,15,Male,3309,39802,43111
KARACHI WEST DISTRICT,15,Female,2953,36442,39395
KARACHI WEST DISTRICT,15,Transgender,0,1,1
KARACHI WEST DISTRICT,16,Male,3109,39864,42973
KARACHI WEST DISTRICT,16,Female,2706,36237,38943
KARACHI WEST DISTRICT,16,Transgender,0,0,0
KARACHI WEST DISTRICT,17,Male,3200,44118,47318
KARACHI WEST DISTRICT,17,Female,2717,38925,41642
KARACHI WEST DISTRICT,17,Transgender,0,1,1
KARACHI WEST DISTRICT,18,Male,3092,37602,40694
KARACHI WEST DISTRICT,18,Female,2887,34187,37074
KARACHI WEST DISTRICT,18,Transgender,0,5,5
KARACHI WEST DISTRICT,19,Male,3163,41548,44711
KARACHI WEST DISTRICT,19,Female,3050,39607,42657
KARACHI WEST DISTRICT,19,Transgender,0,3,3
KARACHI WEST DISTRICT,20,Male,2843,35662,38505
KARACHI WEST DISTRICT,20,Female,2797,33098,35895
KARACHI WEST DISTRICT,20,Transgender,0,5,5
KARACHI WEST DISTRICT,21,Male,3065,41110,44175
KARACHI WEST DISTRICT,21,Female,2715,38408,41123
KARACHI WEST DISTRICT,21,Transgender,0,1,1
KARACHI WEST DISTRICT,22,Male,2704,35311,38015
KARACHI WEST DISTRICT,22,Female,2557,34753,37310
KARACHI WEST DISTRICT,22,Transgender,0,6,6
KARACHI WEST DISTRICT,23,Male,2538,36286,38824
KARACHI WEST DISTRICT,23,Female,2419,34501,36920
KARACHI WEST DISTRICT,23,Transgender,0,4,4
KARACHI WEST DISTRICT,24,Male,2453,35386,37839
KARACHI WEST DISTRICT,24,Female,2197,33620,35817
KARACHI WEST DISTRICT,24,Transgender,0,10,10
KARACHI WEST DISTRICT,25,Male,2419,31101,33520
KARACHI WEST DISTRICT,25,Female,2516,29849,32365
KARACHI WEST DISTRICT,25,Transgender,1,10,11
KARACHI WEST DISTRICT,26,Male,2440,35156,37596
KARACHI WEST DISTRICT,26,Female,2336,32820,35156
KARACHI WEST DISTRICT,26,Transgender,0,6,6
KARACHI WEST DISTRICT,27,Male,2489,34758,37247
KARACHI WEST DISTRICT,27,Female,2349,32633,34982
KARACHI WEST DISTRICT,27,Transgender,0,4,4
KARACHI WEST DISTRICT,28,Male,2281,31163,33444
KARACHI WEST DISTRICT,28,Female,2210,29899,32109
KARACHI WEST DISTRICT,28,Transgender,0,9,9
KARACHI WEST DISTRICT,29,Male,2304,33590,35894
KARACHI WEST DISTRICT,29,Female,2205,30302,32507
KARACHI WEST DISTRICT,29,Transgender,0,10,10
KARACHI WEST DISTRICT,30,Male,2199,28042,30241
KARACHI WEST DISTRICT,30,Female,2208,27811,30019
KARACHI WEST DISTRICT,30,Transgender,0,28,28
KARACHI WEST DISTRICT,31,Male,2366,32094,34460
KARACHI WEST DISTRICT,31,Female,1982,28203,30185
KARACHI WEST DISTRICT,31,Transgender,0,5,5
KARACHI WEST DISTRICT,32,Male,2019,29871,31890
KARACHI WEST DISTRICT,32,Female,1734,25846,27580
KARACHI WEST DISTRICT,32,Transgender,1,12,13
KARACHI WEST DISTRICT,33,Male,2017,29984,32001
KARACHI WEST DISTRICT,33,Female,1789,25714,27503
KARACHI WEST DISTRICT,33,Transgender,0,5,5
KARACHI WEST DISTRICT,34,Male,2033,29950,31983
KARACHI WEST DISTRICT,34,Female,1661,24422,26083
KARACHI WEST DISTRICT,34,Transgender,0,6,6
KARACHI WEST DISTRICT,35,Male,1958,25007,26965
KARACHI WEST DISTRICT,35,Female,1770,22112,23882
KARACHI WEST DISTRICT,35,Transgender,1,28,29
KARACHI WEST DISTRICT,36,Male,1862,26602,28464
KARACHI WEST DISTRICT,36,Female,1501,21968,23469
KARACHI WEST DISTRICT,36,Transgender,1,9,10
KARACHI WEST DISTRICT,37,Male,1896,26992,28888
KARACHI WEST DISTRICT,37,Female,1513,21115,22628
KARACHI WEST DISTRICT,37,Transgender,1,7,8
KARACHI WEST DISTRICT,38,Male,1674,25371,27045
KARACHI WEST DISTRICT,38,Female,1374,21330,22704
KARACHI WEST DISTRICT,38,Transgender,1,5,6
KARACHI WEST DISTRICT,39,Male,1741,25667,27408
KARACHI WEST DISTRICT,39,Female,1375,21592,22967
KARACHI WEST DISTRICT,39,Transgender,0,8,8
KARACHI WEST DISTRICT,40,Male,1544,21145,22689
KARACHI WEST DISTRICT,40,Female,1430,18206,19636
KARACHI WEST DISTRICT,40,Transgender,2,23,25
KARACHI WEST DISTRICT,41,Male,1511,22781,24292
KARACHI WEST DISTRICT,41,Female,1250,18546,19796
KARACHI WEST DISTRICT,41,Transgender,1,4,5
KARACHI WEST DISTRICT,42,Male,1303,19786,21089
KARACHI WEST DISTRICT,42,Female,1078,15724,16802
KARACHI WEST DISTRICT,42,Transgender,0,7,7
KARACHI WEST DISTRICT,43,Male,1264,19217,20481
KARACHI WEST DISTRICT,43,Female,1141,16707,17848
KARACHI WEST DISTRICT,43,Transgender,1,2,3
KARACHI WEST DISTRICT,44,Male,1167,17960,19127
KARACHI WEST DISTRICT,44,Female,994,14668,15662
KARACHI WEST DISTRICT,44,Transgender,0,7,7
KARACHI WEST DISTRICT,45,Male,1084,15311,16395
KARACHI WEST DISTRICT,45,Female,972,12612,13584
KARACHI WEST DISTRICT,45,Transgender,0,19,19
KARACHI WEST DISTRICT,46,Male,1201,17080,18281
KARACHI WEST DISTRICT,46,Female,933,13082,14015
KARACHI WEST DISTRICT,46,Transgender,0,4,4
KARACHI WEST DISTRICT,47,Male,1158,16442,17600
KARACHI WEST DISTRICT,47,Female,883,12154,13037
KARACHI WEST DISTRICT,47,Transgender,0,8,8
KARACHI WEST DISTRICT,48,Male,1025,15509,16534
KARACHI WEST DISTRICT,48,Female,875,12651,13526
KARACHI WEST DISTRICT,48,Transgender,0,7,7
KARACHI WEST DISTRICT,49,Male,1059,15868,16927
KARACHI WEST DISTRICT,49,Female,919,13277,14196
KARACHI WEST DISTRICT,49,Transgender,0,4,4
KARACHI WEST DISTRICT,50,Male,953,13153,14106
KARACHI WEST DISTRICT,50,Female,799,11144,11943
KARACHI WEST DISTRICT,50,Transgender,0,13,13
KARACHI WEST DISTRICT,51,Male,1039,15647,16686
KARACHI WEST DISTRICT,51,Female,796,12319,13115
KARACHI WEST DISTRICT,51,Transgender,3,2,5
KARACHI WEST DISTRICT,52,Male,880,13439,14319
KARACHI WEST DISTRICT,52,Female,658,10419,11077
KARACHI WEST DISTRICT,52,Transgender,0,8,8
KARACHI WEST DISTRICT,53,Male,842,13212,14054
KARACHI WEST DISTRICT,53,Female,668,10592,11260
KARACHI WEST DISTRICT,53,Transgender,0,4,4
KARACHI WEST DISTRICT,54,Male,729,11414,12143
KARACHI WEST DISTRICT,54,Female,549,9316,9865
KARACHI WEST DISTRICT,54,Transgender,0,1,1
KARACHI WEST DISTRICT,55,Male,638,9564,10202
KARACHI WEST DISTRICT,55,Female,586,7559,8145
KARACHI WEST DISTRICT,55,Transgender,0,8,8
KARACHI WEST DISTRICT,56,Male,603,9682,10285
KARACHI WEST DISTRICT,56,Female,508,7509,8017
KARACHI WEST DISTRICT,56,Transgender,1,3,4
KARACHI WEST DISTRICT,57,Male,652,10112,10764
KARACHI WEST DISTRICT,57,Female,505,7737,8242
KARACHI WEST DISTRICT,57,Transgender,0,3,3
KARACHI WEST DISTRICT,58,Male,578,8926,9504
KARACHI WEST DISTRICT,58,Female,474,6834,7308
KARACHI WEST DISTRICT,58,Transgender,1,3,4
KARACHI WEST DISTRICT,59,Male,599,8874,9473
KARACHI WEST DISTRICT,59,Female,487,7423,7910
KARACHI WEST DISTRICT,59,Transgender,0,2,2
KARACHI WEST DISTRICT,60,Male,568,7177,7745
KARACHI WEST DISTRICT,60,Female,482,5872,6354
KARACHI WEST DISTRICT,60,Transgender,0,8,8
KARACHI WEST DISTRICT,61,Male,591,9004,9595
KARACHI WEST DISTRICT,61,Female,479,7430,7909
KARACHI WEST DISTRICT,61,Transgender,0,2,2
KARACHI WEST DISTRICT,62,Male,558,8238,8796
KARACHI WEST DISTRICT,62,Female,434,6625,7059
KARACHI WEST DISTRICT,62,Transgender,0,4,4
KARACHI WEST DISTRICT,63,Male,567,8019,8586
KARACHI WEST DISTRICT,63,Female,492,6970,7462
KARACHI WEST DISTRICT,63,Transgender,0,3,3
KARACHI WEST DISTRICT,64,Male,477,6754,7231
KARACHI WEST DISTRICT,64,Female,347,5455,5802
KARACHI WEST DISTRICT,64,Transgender,0,0,0
KARACHI WEST DISTRICT,65,Male,392,5246,5638
KARACHI WEST DISTRICT,65,Female,285,4048,4333
KARACHI WEST DISTRICT,65,Transgender,0,1,1
KARACHI WEST DISTRICT,66,Male,390,4935,5325
KARACHI WEST DISTRICT,66,Female,271,3885,4156
KARACHI WEST DISTRICT,66,Transgender,0,1,1
KARACHI WEST DISTRICT,67,Male,308,4939,5247
KARACHI WEST DISTRICT,67,Female,243,3841,4084
KARACHI WEST DISTRICT,67,Transgender,0,0,0
KARACHI WEST DISTRICT,68,Male,386,5098,5484
KARACHI WEST DISTRICT,68,Female,306,4172,4478
KARACHI WEST DISTRICT,68,Transgender,0,0,0
KARACHI WEST DISTRICT,69,Male,323,4479,4802
KARACHI WEST DISTRICT,69,Female,256,3759,4015
KARACHI WEST DISTRICT,69,Transgender,0,0,0
KARACHI WEST DISTRICT,70,Male,228,3047,3275
KARACHI WEST DISTRICT,70,Female,205,2522,2727
KARACHI WEST DISTRICT,70,Transgender,0,2,2
KARACHI WEST DISTRICT,71,Male,231,3543,3774
KARACHI WEST DISTRICT,71,Female,210,2663,2873
KARACHI WEST DISTRICT,71,Transgender,0,0,0
KARACHI WEST DISTRICT,72,Male,220,2891,3111
KARACHI WEST DISTRICT,72,Female,173,2439,2612
KARACHI WEST DISTRICT,72,Transgender,1,1,2
KARACHI WEST DISTRICT,73,Male,217,3097,3314
KARACHI WEST DISTRICT,73,Female,168,2720,2888
KARACHI WEST DISTRICT,73,Transgender,0,0,0
KARACHI WEST DISTRICT,74,Male,148,2315,2463
KARACHI WEST DISTRICT,74,Female,143,2037,2180
KARACHI WEST DISTRICT,74,Transgender,0,0,0
KARACHI WEST DISTRICT,>=75,Male,1134,14450,15584
KARACHI WEST DISTRICT,>=75,Female,1274,15662,16936
KARACHI WEST DISTRICT,>=75,Transgender,0,8,8
KARAK DISTRICT,<1,Male,9132,691,9823
KARAK DISTRICT,<1,Female,8590,655,9245
KARAK DISTRICT,<1,Transgender,0,0,0
KARAK DISTRICT,1,Male,10379,754,11133
KARAK DISTRICT,1,Female,9658,674,10332
KARAK DISTRICT,1,Transgender,0,0,0
KARAK DISTRICT,2,Male,10878,746,11624
KARAK DISTRICT,2,Female,10537,740,11277
KARAK DISTRICT,2,Transgender,0,0,0
KARAK DISTRICT,3,Male,11789,856,12645
KARAK DISTRICT,3,Female,11216,826,12042
KARAK DISTRICT,3,Transgender,0,0,0
KARAK DISTRICT,4,Male,11236,860,12096
KARAK DISTRICT,4,Female,10349,831,11180
KARAK DISTRICT,4,Transgender,0,0,0
KARAK DISTRICT,5,Male,11255,788,12043
KARAK DISTRICT,5,Female,10450,851,11301
KARAK DISTRICT,5,Transgender,0,0,0
KARAK DISTRICT,6,Male,9559,745,10304
KARAK DISTRICT,6,Female,9033,662,9695
KARAK DISTRICT,6,Transgender,0,0,0
KARAK DISTRICT,7,Male,10427,833,11260
KARAK DISTRICT,7,Female,9803,710,10513
KARAK DISTRICT,7,Transgender,0,0,0
KARAK DISTRICT,8,Male,9437,676,10113
KARAK DISTRICT,8,Female,9012,684,9696
KARAK DISTRICT,8,Transgender,0,0,0
KARAK DISTRICT,9,Male,10341,686,11027
KARAK DISTRICT,9,Female,9399,669,10068
KARAK DISTRICT,9,Transgender,0,0,0
KARAK DISTRICT,10,Male,8721,623,9344
KARAK DISTRICT,10,Female,7985,584,8569
KARAK DISTRICT,10,Transgender,0,0,0
KARAK DISTRICT,11,Male,9658,756,10414
KARAK DISTRICT,11,Female,8601,684,9285
KARAK DISTRICT,11,Transgender,0,0,0
KARAK DISTRICT,12,Male,8002,593,8595
KARAK DISTRICT,12,Female,7456,590,8046
KARAK DISTRICT,12,Transgender,0,0,0
KARAK DISTRICT,13,Male,8820,694,9514
KARAK DISTRICT,13,Female,7850,598,8448
KARAK DISTRICT,13,Transgender,0,0,0
KARAK DISTRICT,14,Male,8021,616,8637
KARAK DISTRICT,14,Female,7289,532,7821
KARAK DISTRICT,14,Transgender,0,0,0
KARAK DISTRICT,15,Male,7880,607,8487
KARAK DISTRICT,15,Female,7630,581,8211
KARAK DISTRICT,15,Transgender,2,0,2
KARAK DISTRICT,16,Male,7879,598,8477
KARAK DISTRICT,16,Female,7535,562,8097
KARAK DISTRICT,16,Transgender,2,0,2
KARAK DISTRICT,17,Male,8063,594,8657
KARAK DISTRICT,17,Female,8066,631,8697
KARAK DISTRICT,17,Transgender,3,0,3
KARAK DISTRICT,18,Male,6957,520,7477
KARAK DISTRICT,18,Female,6748,503,7251
KARAK DISTRICT,18,Transgender,2,0,2
KARAK DISTRICT,19,Male,7257,549,7806
KARAK DISTRICT,19,Female,7172,528,7700
KARAK DISTRICT,19,Transgender,0,0,0
KARAK DISTRICT,20,Male,5806,451,6257
KARAK DISTRICT,20,Female,6308,533,6841
KARAK DISTRICT,20,Transgender,1,0,1
KARAK DISTRICT,21,Male,5872,487,6359
KARAK DISTRICT,21,Female,6822,533,7355
KARAK DISTRICT,21,Transgender,0,0,0
KARAK DISTRICT,22,Male,5159,481,5640
KARAK DISTRICT,22,Female,6291,515,6806
KARAK DISTRICT,22,Transgender,5,0,5
KARAK DISTRICT,23,Male,5705,472,6177
KARAK DISTRICT,23,Female,6540,478,7018
KARAK DISTRICT,23,Transgender,3,0,3
KARAK DISTRICT,24,Male,5131,424,5555
KARAK DISTRICT,24,Female,5877,505,6382
KARAK DISTRICT,24,Transgender,0,0,0
KARAK DISTRICT,25,Male,4895,425,5320
KARAK DISTRICT,25,Female,5861,480,6341
KARAK DISTRICT,25,Transgender,1,1,2
KARAK DISTRICT,26,Male,4730,388,5118
KARAK DISTRICT,26,Female,5721,463,6184
KARAK DISTRICT,26,Transgender,1,0,1
KARAK DISTRICT,27,Male,4157,379,4536
KARAK DISTRICT,27,Female,5555,423,5978
KARAK DISTRICT,27,Transgender,0,0,0
KARAK DISTRICT,28,Male,4368,385,4753
KARAK DISTRICT,28,Female,5550,453,6003
KARAK DISTRICT,28,Transgender,1,0,1
KARAK DISTRICT,29,Male,3517,352,3869
KARAK DISTRICT,29,Female,5044,417,5461
KARAK DISTRICT,29,Transgender,0,0,0
KARAK DISTRICT,30,Male,3925,372,4297
KARAK DISTRICT,30,Female,4855,413,5268
KARAK DISTRICT,30,Transgender,0,0,0
KARAK DISTRICT,31,Male,3249,330,3579
KARAK DISTRICT,31,Female,4572,376,4948
KARAK DISTRICT,31,Transgender,1,0,1
KARAK DISTRICT,32,Male,3227,323,3550
KARAK DISTRICT,32,Female,4147,354,4501
KARAK DISTRICT,32,Transgender,2,0,2
KARAK DISTRICT,33,Male,3234,306,3540
KARAK DISTRICT,33,Female,4140,356,4496
KARAK DISTRICT,33,Transgender,0,0,0
KARAK DISTRICT,34,Male,2844,305,3149
KARAK DISTRICT,34,Female,3530,316,3846
KARAK DISTRICT,34,Transgender,0,0,0
KARAK DISTRICT,35,Male,2994,281,3275
KARAK DISTRICT,35,Female,3542,314,3856
KARAK DISTRICT,35,Transgender,2,0,2
KARAK DISTRICT,36,Male,2608,236,2844
KARAK DISTRICT,36,Female,3055,246,3301
KARAK DISTRICT,36,Transgender,1,0,1
KARAK DISTRICT,37,Male,2404,199,2603
KARAK DISTRICT,37,Female,2969,233,3202
KARAK DISTRICT,37,Transgender,0,0,0
KARAK DISTRICT,38,Male,3113,309,3422
KARAK DISTRICT,38,Female,3558,309,3867
KARAK DISTRICT,38,Transgender,1,0,1
KARAK DISTRICT,39,Male,2517,236,2753
KARAK DISTRICT,39,Female,2986,251,3237
KARAK DISTRICT,39,Transgender,1,0,1
KARAK DISTRICT,40,Male,3048,301,3349
KARAK DISTRICT,40,Female,3617,289,3906
KARAK DISTRICT,40,Transgender,0,0,0
KARAK DISTRICT,41,Male,2304,197,2501
KARAK DISTRICT,41,Female,2612,209,2821
KARAK DISTRICT,41,Transgender,0,0,0
KARAK DISTRICT,42,Male,2251,215,2466
KARAK DISTRICT,42,Female,2457,192,2649
KARAK DISTRICT,42,Transgender,1,0,1
KARAK DISTRICT,43,Male,2259,231,2490
KARAK DISTRICT,43,Female,2822,197,3019
KARAK DISTRICT,43,Transgender,0,0,0
KARAK DISTRICT,44,Male,1973,204,2177
KARAK DISTRICT,44,Female,2381,180,2561
KARAK DISTRICT,44,Transgender,0,0,0
KARAK DISTRICT,45,Male,2205,204,2409
KARAK DISTRICT,45,Female,2787,219,3006
KARAK DISTRICT,45,Transgender,0,0,0
KARAK DISTRICT,46,Male,1769,156,1925
KARAK DISTRICT,46,Female,1947,167,2114
KARAK DISTRICT,46,Transgender,0,0,0
KARAK DISTRICT,47,Male,1852,156,2008
KARAK DISTRICT,47,Female,1811,128,1939
KARAK DISTRICT,47,Transgender,0,0,0
KARAK DISTRICT,48,Male,2246,182,2428
KARAK DISTRICT,48,Female,2634,190,2824
KARAK DISTRICT,48,Transgender,1,0,1
KARAK DISTRICT,49,Male,1783,144,1927
KARAK DISTRICT,49,Female,2150,163,2313
KARAK DISTRICT,49,Transgender,0,0,0
KARAK DISTRICT,50,Male,2233,175,2408
KARAK DISTRICT,50,Female,2704,213,2917
KARAK DISTRICT,50,Transgender,3,0,3
KARAK DISTRICT,51,Male,1666,154,1820
KARAK DISTRICT,51,Female,1833,155,1988
KARAK DISTRICT,51,Transgender,1,0,1
KARAK DISTRICT,52,Male,1934,131,2065
KARAK DISTRICT,52,Female,1763,134,1897
KARAK DISTRICT,52,Transgender,1,0,1
KARAK DISTRICT,53,Male,1829,162,1991
KARAK DISTRICT,53,Female,1906,130,2036
KARAK DISTRICT,53,Transgender,0,0,0
KARAK DISTRICT,54,Male,1629,142,1771
KARAK DISTRICT,54,Female,1761,139,1900
KARAK DISTRICT,54,Transgender,0,0,0
KARAK DISTRICT,55,Male,1851,167,2018
KARAK DISTRICT,55,Female,1904,185,2089
KARAK DISTRICT,55,Transgender,0,0,0
KARAK DISTRICT,56,Male,1385,105,1490
KARAK DISTRICT,56,Female,1404,114,1518
KARAK DISTRICT,56,Transgender,0,0,0
KARAK DISTRICT,57,Male,1414,123,1537
KARAK DISTRICT,57,Female,1123,75,1198
KARAK DISTRICT,57,Transgender,1,0,1
KARAK DISTRICT,58,Male,1685,133,1818
KARAK DISTRICT,58,Female,1744,113,1857
KARAK DISTRICT,58,Transgender,0,0,0
KARAK DISTRICT,59,Male,1332,111,1443
KARAK DISTRICT,59,Female,1319,89,1408
KARAK DISTRICT,59,Transgender,0,0,0
KARAK DISTRICT,60,Male,1506,112,1618
KARAK DISTRICT,60,Female,1603,100,1703
KARAK DISTRICT,60,Transgender,1,0,1
KARAK DISTRICT,61,Male,1192,104,1296
KARAK DISTRICT,61,Female,1207,82,1289
KARAK DISTRICT,61,Transgender,1,0,1
KARAK DISTRICT,62,Male,1399,108,1507
KARAK DISTRICT,62,Female,1218,75,1293
KARAK DISTRICT,62,Transgender,0,0,0
KARAK DISTRICT,63,Male,1346,81,1427
KARAK DISTRICT,63,Female,1266,88,1354
KARAK DISTRICT,63,Transgender,1,0,1
KARAK DISTRICT,64,Male,1089,74,1163
KARAK DISTRICT,64,Female,1042,50,1092
KARAK DISTRICT,64,Transgender,0,0,0
KARAK DISTRICT,65,Male,1111,77,1188
KARAK DISTRICT,65,Female,1031,76,1107
KARAK DISTRICT,65,Transgender,0,0,0
KARAK DISTRICT,66,Male,848,64,912
KARAK DISTRICT,66,Female,749,38,787
KARAK DISTRICT,66,Transgender,0,0,0
KARAK DISTRICT,67,Male,880,60,940
KARAK DISTRICT,67,Female,727,35,762
KARAK DISTRICT,67,Transgender,0,0,0
KARAK DISTRICT,68,Male,911,48,959
KARAK DISTRICT,68,Female,826,62,888
KARAK DISTRICT,68,Transgender,0,0,0
KARAK DISTRICT,69,Male,738,49,787
KARAK DISTRICT,69,Female,666,48,714
KARAK DISTRICT,69,Transgender,0,0,0
KARAK DISTRICT,70,Male,970,59,1029
KARAK DISTRICT,70,Female,848,61,909
KARAK DISTRICT,70,Transgender,0,0,0
KARAK DISTRICT,71,Male,633,45,678
KARAK DISTRICT,71,Female,577,30,607
KARAK DISTRICT,71,Transgender,0,0,0
KARAK DISTRICT,72,Male,732,48,780
KARAK DISTRICT,72,Female,616,36,652
KARAK DISTRICT,72,Transgender,0,0,0
KARAK DISTRICT,73,Male,619,58,677
KARAK DISTRICT,73,Female,540,32,572
KARAK DISTRICT,73,Transgender,0,0,0
KARAK DISTRICT,74,Male,520,31,551
KARAK DISTRICT,74,Female,477,41,518
KARAK DISTRICT,74,Transgender,0,0,0
KARAK DISTRICT,>=75,Male,4400,290,4690
KARAK DISTRICT,>=75,Female,4172,260,4432
KARAK DISTRICT,>=75,Transgender,2,0,2
KASHMORE DISTRICT,<1,Male,10987,3348,14335
KASHMORE DISTRICT,<1,Female,10607,3067,13674
KASHMORE DISTRICT,<1,Transgender,0,0,0
KASHMORE DISTRICT,1,Male,14458,3740,18198
KASHMORE DISTRICT,1,Female,14961,3609,18570
KASHMORE DISTRICT,1,Transgender,0,0,0
KASHMORE DISTRICT,2,Male,17171,4382,21553
KASHMORE DISTRICT,2,Female,17991,4473,22464
KASHMORE DISTRICT,2,Transgender,0,0,0
KASHMORE DISTRICT,3,Male,17833,4983,22816
KASHMORE DISTRICT,3,Female,17905,4851,22756
KASHMORE DISTRICT,3,Transgender,0,0,0
KASHMORE DISTRICT,4,Male,18593,4782,23375
KASHMORE DISTRICT,4,Female,18364,4557,22921
KASHMORE DISTRICT,4,Transgender,0,0,0
KASHMORE DISTRICT,5,Male,17761,4623,22384
KASHMORE DISTRICT,5,Female,16881,4226,21107
KASHMORE DISTRICT,5,Transgender,0,0,0
KASHMORE DISTRICT,6,Male,18814,4577,23391
KASHMORE DISTRICT,6,Female,16702,4093,20795
KASHMORE DISTRICT,6,Transgender,0,0,0
KASHMORE DISTRICT,7,Male,17864,4850,22714
KASHMORE DISTRICT,7,Female,14962,4149,19111
KASHMORE DISTRICT,7,Transgender,0,0,0
KASHMORE DISTRICT,8,Male,20002,5055,25057
KASHMORE DISTRICT,8,Female,16236,4167,20403
KASHMORE DISTRICT,8,Transgender,0,0,0
KASHMORE DISTRICT,9,Male,15682,4109,19791
KASHMORE DISTRICT,9,Female,12956,3660,16616
KASHMORE DISTRICT,9,Transgender,0,0,0
KASHMORE DISTRICT,10,Male,17135,4262,21397
KASHMORE DISTRICT,10,Female,13550,3480,17030
KASHMORE DISTRICT,10,Transgender,0,0,0
KASHMORE DISTRICT,11,Male,11393,3220,14613
KASHMORE DISTRICT,11,Female,8651,2866,11517
KASHMORE DISTRICT,11,Transgender,0,0,0
KASHMORE DISTRICT,12,Male,12533,3520,16053
KASHMORE DISTRICT,12,Female,9274,2827,12101
KASHMORE DISTRICT,12,Transgender,0,0,0
KASHMORE DISTRICT,13,Male,9212,3033,12245
KASHMORE DISTRICT,13,Female,6505,2565,9070
KASHMORE DISTRICT,13,Transgender,0,0,0
KASHMORE DISTRICT,14,Male,9674,2955,12629
KASHMORE DISTRICT,14,Female,6437,2434,8871
KASHMORE DISTRICT,14,Transgender,0,0,0
KASHMORE DISTRICT,15,Male,8810,2981,11791
KASHMORE DISTRICT,15,Female,5450,2398,7848
KASHMORE DISTRICT,15,Transgender,2,1,3
KASHMORE DISTRICT,16,Male,8599,2886,11485
KASHMORE DISTRICT,16,Female,6202,2363,8565
KASHMORE DISTRICT,16,Transgender,0,0,0
KASHMORE DISTRICT,17,Male,7415,2994,10409
KASHMORE DISTRICT,17,Female,6700,2674,9374
KASHMORE DISTRICT,17,Transgender,3,1,4
KASHMORE DISTRICT,18,Male,8134,2759,10893
KASHMORE DISTRICT,18,Female,7891,2772,10663
KASHMORE DISTRICT,18,Transgender,4,0,4
KASHMORE DISTRICT,19,Male,6646,2640,9286
KASHMORE DISTRICT,19,Female,6119,2475,8594
KASHMORE DISTRICT,19,Transgender,6,0,6
KASHMORE DISTRICT,20,Male,7435,2346,9781
KASHMORE DISTRICT,20,Female,7602,2398,10000
KASHMORE DISTRICT,20,Transgender,5,0,5
KASHMORE DISTRICT,21,Male,5450,2114,7564
KASHMORE DISTRICT,21,Female,5617,2098,7715
KASHMORE DISTRICT,21,Transgender,3,0,3
KASHMORE DISTRICT,22,Male,5566,2030,7596
KASHMORE DISTRICT,22,Female,5130,1961,7091
KASHMORE DISTRICT,22,Transgender,0,1,1
KASHMORE DISTRICT,23,Male,4831,1929,6760
KASHMORE DISTRICT,23,Female,4899,1794,6693
KASHMORE DISTRICT,23,Transgender,3,0,3
KASHMORE DISTRICT,24,Male,4571,1802,6373
KASHMORE DISTRICT,24,Female,4650,1764,6414
KASHMORE DISTRICT,24,Transgender,3,0,3
KASHMORE DISTRICT,25,Male,5861,1839,7700
KASHMORE DISTRICT,25,Female,6080,1886,7966
KASHMORE DISTRICT,25,Transgender,2,5,7
KASHMORE DISTRICT,26,Male,4633,1736,6369
KASHMORE DISTRICT,26,Female,4730,1837,6567
KASHMORE DISTRICT,26,Transgender,1,1,2
KASHMORE DISTRICT,27,Male,5423,1922,7345
KASHMORE DISTRICT,27,Female,5560,1940,7500
KASHMORE DISTRICT,27,Transgender,3,3,6
KASHMORE DISTRICT,28,Male,4884,1808,6692
KASHMORE DISTRICT,28,Female,5963,1948,7911
KASHMORE DISTRICT,28,Transgender,3,1,4
KASHMORE DISTRICT,29,Male,5608,1940,7548
KASHMORE DISTRICT,29,Female,6288,1890,8178
KASHMORE DISTRICT,29,Transgender,0,0,0
KASHMORE DISTRICT,30,Male,5422,1694,7116
KASHMORE DISTRICT,30,Female,6082,1808,7890
KASHMORE DISTRICT,30,Transgender,2,2,4
KASHMORE DISTRICT,31,Male,4876,1674,6550
KASHMORE DISTRICT,31,Female,5417,1587,7004
KASHMORE DISTRICT,31,Transgender,0,0,0
KASHMORE DISTRICT,32,Male,4455,1603,6058
KASHMORE DISTRICT,32,Female,4950,1648,6598
KASHMORE DISTRICT,32,Transgender,2,2,4
KASHMORE DISTRICT,33,Male,4460,1568,6028
KASHMORE DISTRICT,33,Female,4890,1567,6457
KASHMORE DISTRICT,33,Transgender,1,1,2
KASHMORE DISTRICT,34,Male,3568,1374,4942
KASHMORE DISTRICT,34,Female,3991,1325,5316
KASHMORE DISTRICT,34,Transgender,1,0,1
KASHMORE DISTRICT,35,Male,4482,1372,5854
KASHMORE DISTRICT,35,Female,4582,1323,5905
KASHMORE DISTRICT,35,Transgender,3,3,6
KASHMORE DISTRICT,36,Male,4542,1364,5906
KASHMORE DISTRICT,36,Female,4487,1316,5803
KASHMORE DISTRICT,36,Transgender,3,1,4
KASHMORE DISTRICT,37,Male,5560,1656,7216
KASHMORE DISTRICT,37,Female,4813,1542,6355
KASHMORE DISTRICT,37,Transgender,1,0,1
KASHMORE DISTRICT,38,Male,3996,1334,5330
KASHMORE DISTRICT,38,Female,4166,1220,5386
KASHMORE DISTRICT,38,Transgender,3,1,4
KASHMORE DISTRICT,39,Male,4544,1408,5952
KASHMORE DISTRICT,39,Female,4180,1319,5499
KASHMORE DISTRICT,39,Transgender,0,2,2
KASHMORE DISTRICT,40,Male,3876,1141,5017
KASHMORE DISTRICT,40,Female,4165,1083,5248
KASHMORE DISTRICT,40,Transgender,2,1,3
KASHMORE DISTRICT,41,Male,3228,1043,4271
KASHMORE DISTRICT,41,Female,3271,938,4209
KASHMORE DISTRICT,41,Transgender,1,0,1
KASHMORE DISTRICT,42,Male,3235,983,4218
KASHMORE DISTRICT,42,Female,3168,1081,4249
KASHMORE DISTRICT,42,Transgender,0,0,0
KASHMORE DISTRICT,43,Male,2288,959,3247
KASHMORE DISTRICT,43,Female,2718,843,3561
KASHMORE DISTRICT,43,Transgender,1,0,1
KASHMORE DISTRICT,44,Male,2263,889,3152
KASHMORE DISTRICT,44,Female,2483,897,3380
KASHMORE DISTRICT,44,Transgender,0,0,0
KASHMORE DISTRICT,45,Male,2526,854,3380
KASHMORE DISTRICT,45,Female,2705,889,3594
KASHMORE DISTRICT,45,Transgender,1,3,4
KASHMORE DISTRICT,46,Male,2542,798,3340
KASHMORE DISTRICT,46,Female,2946,819,3765
KASHMORE DISTRICT,46,Transgender,0,0,0
KASHMORE DISTRICT,47,Male,3316,1048,4364
KASHMORE DISTRICT,47,Female,3496,1162,4658
KASHMORE DISTRICT,47,Transgender,2,1,3
KASHMORE DISTRICT,48,Male,2182,894,3076
KASHMORE DISTRICT,48,Female,2421,880,3301
KASHMORE DISTRICT,48,Transgender,1,0,1
KASHMORE DISTRICT,49,Male,2620,981,3601
KASHMORE DISTRICT,49,Female,2355,836,3191
KASHMORE DISTRICT,49,Transgender,0,0,0
KASHMORE DISTRICT,50,Male,2430,752,3182
KASHMORE DISTRICT,50,Female,2449,737,3186
KASHMORE DISTRICT,50,Transgender,2,1,3
KASHMORE DISTRICT,51,Male,2212,810,3022
KASHMORE DISTRICT,51,Female,2037,687,2724
KASHMORE DISTRICT,51,Transgender,0,0,0
KASHMORE DISTRICT,52,Male,2246,818,3064
KASHMORE DISTRICT,52,Female,1979,687,2666
KASHMORE DISTRICT,52,Transgender,0,1,1
KASHMORE DISTRICT,53,Male,1583,658,2241
KASHMORE DISTRICT,53,Female,1523,525,2048
KASHMORE DISTRICT,53,Transgender,1,1,2
KASHMORE DISTRICT,54,Male,1564,634,2198
KASHMORE DISTRICT,54,Female,1415,489,1904
KASHMORE DISTRICT,54,Transgender,0,1,1
KASHMORE DISTRICT,55,Male,1766,535,2301
KASHMORE DISTRICT,55,Female,1645,503,2148
KASHMORE DISTRICT,55,Transgender,1,0,1
KASHMORE DISTRICT,56,Male,1701,553,2254
KASHMORE DISTRICT,56,Female,1645,489,2134
KASHMORE DISTRICT,56,Transgender,0,0,0
KASHMORE DISTRICT,57,Male,2162,660,2822
KASHMORE DISTRICT,57,Female,2281,679,2960
KASHMORE DISTRICT,57,Transgender,1,0,1
KASHMORE DISTRICT,58,Male,1142,471,1613
KASHMORE DISTRICT,58,Female,1040,451,1491
KASHMORE DISTRICT,58,Transgender,0,0,0
KASHMORE DISTRICT,59,Male,1364,485,1849
KASHMORE DISTRICT,59,Female,1257,417,1674
KASHMORE DISTRICT,59,Transgender,0,0,0
KASHMORE DISTRICT,60,Male,1410,418,1828
KASHMORE DISTRICT,60,Female,1503,443,1946
KASHMORE DISTRICT,60,Transgender,0,0,0
KASHMORE DISTRICT,61,Male,1261,399,1660
KASHMORE DISTRICT,61,Female,1240,412,1652
KASHMORE DISTRICT,61,Transgender,0,0,0
KASHMORE DISTRICT,62,Male,1502,452,1954
KASHMORE DISTRICT,62,Female,1487,466,1953
KASHMORE DISTRICT,62,Transgender,1,0,1
KASHMORE DISTRICT,63,Male,1077,379,1456
KASHMORE DISTRICT,63,Female,947,363,1310
KASHMORE DISTRICT,63,Transgender,1,1,2
KASHMORE DISTRICT,64,Male,1079,352,1431
KASHMORE DISTRICT,64,Female,888,325,1213
KASHMORE DISTRICT,64,Transgender,0,0,0
KASHMORE DISTRICT,65,Male,1036,303,1339
KASHMORE DISTRICT,65,Female,990,304,1294
KASHMORE DISTRICT,65,Transgender,4,0,4
KASHMORE DISTRICT,66,Male,1131,280,1411
KASHMORE DISTRICT,66,Female,942,273,1215
KASHMORE DISTRICT,66,Transgender,1,0,1
KASHMORE DISTRICT,67,Male,1322,336,1658
KASHMORE DISTRICT,67,Female,1338,364,1702
KASHMORE DISTRICT,67,Transgender,0,1,1
KASHMORE DISTRICT,68,Male,739,232,971
KASHMORE DISTRICT,68,Female,670,210,880
KASHMORE DISTRICT,68,Transgender,0,0,0
KASHMORE DISTRICT,69,Male,791,226,1017
KASHMORE DISTRICT,69,Female,722,211,933
KASHMORE DISTRICT,69,Transgender,0,0,0
KASHMORE DISTRICT,70,Male,764,187,951
KASHMORE DISTRICT,70,Female,653,211,864
KASHMORE DISTRICT,70,Transgender,1,3,4
KASHMORE DISTRICT,71,Male,728,184,912
KASHMORE DISTRICT,71,Female,636,187,823
KASHMORE DISTRICT,71,Transgender,0,0,0
KASHMORE DISTRICT,72,Male,624,173,797
KASHMORE DISTRICT,72,Female,665,222,887
KASHMORE DISTRICT,72,Transgender,0,0,0
KASHMORE DISTRICT,73,Male,458,137,595
KASHMORE DISTRICT,73,Female,433,136,569
KASHMORE DISTRICT,73,Transgender,0,0,0
KASHMORE DISTRICT,74,Male,440,110,550
KASHMORE DISTRICT,74,Female,347,111,458
KASHMORE DISTRICT,74,Transgender,0,0,0
KASHMORE DISTRICT,>=75,Male,3941,885,4826
KASHMORE DISTRICT,>=75,Female,4288,1182,5470
KASHMORE DISTRICT,>=75,Transgender,1,0,1
KASUR DISTRICT,<1,Male,32700,10283,42983
KASUR DISTRICT,<1,Female,31085,9791,40876
KASUR DISTRICT,<1,Transgender,0,0,0
KASUR DISTRICT,1,Male,35735,11207,46942
KASUR DISTRICT,1,Female,33718,10701,44419
KASUR DISTRICT,1,Transgender,0,0,0
KASUR DISTRICT,2,Male,36600,11250,47850
KASUR DISTRICT,2,Female,34779,10937,45716
KASUR DISTRICT,2,Transgender,0,0,0
KASUR DISTRICT,3,Male,38543,11987,50530
KASUR DISTRICT,3,Female,37248,11538,48786
KASUR DISTRICT,3,Transgender,0,0,0
KASUR DISTRICT,4,Male,38199,11342,49541
KASUR DISTRICT,4,Female,36548,10863,47411
KASUR DISTRICT,4,Transgender,0,0,0
KASUR DISTRICT,5,Male,37230,11550,48780
KASUR DISTRICT,5,Female,35549,11066,46615
KASUR DISTRICT,5,Transgender,0,0,0
KASUR DISTRICT,6,Male,37096,11217,48313
KASUR DISTRICT,6,Female,34630,10595,45225
KASUR DISTRICT,6,Transgender,0,0,0
KASUR DISTRICT,7,Male,38519,12319,50838
KASUR DISTRICT,7,Female,36640,11295,47935
KASUR DISTRICT,7,Transgender,0,0,0
KASUR DISTRICT,8,Male,37337,10935,48272
KASUR DISTRICT,8,Female,35011,10373,45384
KASUR DISTRICT,8,Transgender,0,0,0
KASUR DISTRICT,9,Male,36098,11461,47559
KASUR DISTRICT,9,Female,34126,10829,44955
KASUR DISTRICT,9,Transgender,0,0,0
KASUR DISTRICT,10,Male,35726,10327,46053
KASUR DISTRICT,10,Female,33142,9603,42745
KASUR DISTRICT,10,Transgender,0,0,0
KASUR DISTRICT,11,Male,33522,11274,44796
KASUR DISTRICT,11,Female,31798,10558,42356
KASUR DISTRICT,11,Transgender,0,0,0
KASUR DISTRICT,12,Male,32843,10158,43001
KASUR DISTRICT,12,Female,30241,9316,39557
KASUR DISTRICT,12,Transgender,0,0,0
KASUR DISTRICT,13,Male,31195,10433,41628
KASUR DISTRICT,13,Female,28891,9695,38586
KASUR DISTRICT,13,Transgender,0,0,0
KASUR DISTRICT,14,Male,30462,9618,40080
KASUR DISTRICT,14,Female,28409,8945,37354
KASUR DISTRICT,14,Transgender,0,0,0
KASUR DISTRICT,15,Male,28996,9355,38351
KASUR DISTRICT,15,Female,28344,9307,37651
KASUR DISTRICT,15,Transgender,2,2,4
KASUR DISTRICT,16,Male,29046,9509,38555
KASUR DISTRICT,16,Female,28291,9370,37661
KASUR DISTRICT,16,Transgender,3,1,4
KASUR DISTRICT,17,Male,28055,9799,37854
KASUR DISTRICT,17,Female,26872,9588,36460
KASUR DISTRICT,17,Transgender,3,1,4
KASUR DISTRICT,18,Male,28488,9197,37685
KASUR DISTRICT,18,Female,25083,8650,33733
KASUR DISTRICT,18,Transgender,3,2,5
KASUR DISTRICT,19,Male,27680,9581,37261
KASUR DISTRICT,19,Female,25130,9215,34345
KASUR DISTRICT,19,Transgender,6,0,6
KASUR DISTRICT,20,Male,28639,9335,37974
KASUR DISTRICT,20,Female,26241,8481,34722
KASUR DISTRICT,20,Transgender,4,2,6
KASUR DISTRICT,21,Male,25754,9731,35485
KASUR DISTRICT,21,Female,24098,9479,33577
KASUR DISTRICT,21,Transgender,1,0,1
KASUR DISTRICT,22,Male,26382,9239,35621
KASUR DISTRICT,22,Female,24162,9254,33416
KASUR DISTRICT,22,Transgender,8,1,9
KASUR DISTRICT,23,Male,23633,8781,32414
KASUR DISTRICT,23,Female,21435,8726,30161
KASUR DISTRICT,23,Transgender,0,4,4
KASUR DISTRICT,24,Male,22149,8493,30642
KASUR DISTRICT,24,Female,20158,8245,28403
KASUR DISTRICT,24,Transgender,2,3,5
KASUR DISTRICT,25,Male,22575,8093,30668
KASUR DISTRICT,25,Female,21617,7814,29431
KASUR DISTRICT,25,Transgender,8,5,13
KASUR DISTRICT,26,Male,20453,7936,28389
KASUR DISTRICT,26,Female,18625,7806,26431
KASUR DISTRICT,26,Transgender,0,3,3
KASUR DISTRICT,27,Male,19064,7710,26774
KASUR DISTRICT,27,Female,17434,7503,24937
KASUR DISTRICT,27,Transgender,0,3,3
KASUR DISTRICT,28,Male,19513,7687,27200
KASUR DISTRICT,28,Female,19523,7775,27298
KASUR DISTRICT,28,Transgender,2,2,4
KASUR DISTRICT,29,Male,17940,7013,24953
KASUR DISTRICT,29,Female,17255,7020,24275
KASUR DISTRICT,29,Transgender,1,0,1
KASUR DISTRICT,30,Male,20795,7624,28419
KASUR DISTRICT,30,Female,20403,7416,27819
KASUR DISTRICT,30,Transgender,5,10,15
KASUR DISTRICT,31,Male,17316,6690,24006
KASUR DISTRICT,31,Female,16342,6604,22946
KASUR DISTRICT,31,Transgender,1,1,2
KASUR DISTRICT,32,Male,17710,7418,25128
KASUR DISTRICT,32,Female,16888,6777,23665
KASUR DISTRICT,32,Transgender,1,2,3
KASUR DISTRICT,33,Male,16049,6645,22694
KASUR DISTRICT,33,Female,15518,6233,21751
KASUR DISTRICT,33,Transgender,4,1,5
KASUR DISTRICT,34,Male,14859,6163,21022
KASUR DISTRICT,34,Female,13977,5506,19483
KASUR DISTRICT,34,Transgender,1,3,4
KASUR DISTRICT,35,Male,17827,6622,24449
KASUR DISTRICT,35,Female,15380,5959,21339
KASUR DISTRICT,35,Transgender,3,7,10
KASUR DISTRICT,36,Male,14583,5757,20340
KASUR DISTRICT,36,Female,12158,4859,17017
KASUR DISTRICT,36,Transgender,1,2,3
KASUR DISTRICT,37,Male,14660,5488,20148
KASUR DISTRICT,37,Female,12854,4892,17746
KASUR DISTRICT,37,Transgender,2,3,5
KASUR DISTRICT,38,Male,14597,5956,20553
KASUR DISTRICT,38,Female,13703,5396,19099
KASUR DISTRICT,38,Transgender,1,2,3
KASUR DISTRICT,39,Male,14245,5441,19686
KASUR DISTRICT,39,Female,13323,5082,18405
KASUR DISTRICT,39,Transgender,1,1,2
KASUR DISTRICT,40,Male,15346,6235,21581
KASUR DISTRICT,40,Female,13325,5094,18419
KASUR DISTRICT,40,Transgender,5,10,15
KASUR DISTRICT,41,Male,12185,4934,17119
KASUR DISTRICT,41,Female,11479,4283,15762
KASUR DISTRICT,41,Transgender,1,1,2
KASUR DISTRICT,42,Male,11556,4833,16389
KASUR DISTRICT,42,Female,11227,4554,15781
KASUR DISTRICT,42,Transgender,2,2,4
KASUR DISTRICT,43,Male,10667,4356,15023
KASUR DISTRICT,43,Female,10027,3863,13890
KASUR DISTRICT,43,Transgender,1,5,6
KASUR DISTRICT,44,Male,9668,3894,13562
KASUR DISTRICT,44,Female,9304,3711,13015
KASUR DISTRICT,44,Transgender,0,0,0
KASUR DISTRICT,45,Male,11391,4515,15906
KASUR DISTRICT,45,Female,10105,3869,13974
KASUR DISTRICT,45,Transgender,3,9,12
KASUR DISTRICT,46,Male,8906,3452,12358
KASUR DISTRICT,46,Female,7767,3061,10828
KASUR DISTRICT,46,Transgender,1,0,1
KASUR DISTRICT,47,Male,9558,3601,13159
KASUR DISTRICT,47,Female,8920,3324,12244
KASUR DISTRICT,47,Transgender,0,0,0
KASUR DISTRICT,48,Male,9172,3621,12793
KASUR DISTRICT,48,Female,9413,3557,12970
KASUR DISTRICT,48,Transgender,3,1,4
KASUR DISTRICT,49,Male,9605,3674,13279
KASUR DISTRICT,49,Female,9238,3444,12682
KASUR DISTRICT,49,Transgender,0,0,0
KASUR DISTRICT,50,Male,11128,4165,15293
KASUR DISTRICT,50,Female,9719,3592,13311
KASUR DISTRICT,50,Transgender,4,3,7
KASUR DISTRICT,51,Male,8939,3319,12258
KASUR DISTRICT,51,Female,7893,2966,10859
KASUR DISTRICT,51,Transgender,0,0,0
KASUR DISTRICT,52,Male,9308,3652,12960
KASUR DISTRICT,52,Female,8018,3049,11067
KASUR DISTRICT,52,Transgender,3,2,5
KASUR DISTRICT,53,Male,8374,3275,11649
KASUR DISTRICT,53,Female,7277,2832,10109
KASUR DISTRICT,53,Transgender,0,0,0
KASUR DISTRICT,54,Male,8017,3117,11134
KASUR DISTRICT,54,Female,6456,2553,9009
KASUR DISTRICT,54,Transgender,1,1,2
KASUR DISTRICT,55,Male,8426,3242,11668
KASUR DISTRICT,55,Female,6942,2684,9626
KASUR DISTRICT,55,Transgender,4,2,6
KASUR DISTRICT,56,Male,6425,2432,8857
KASUR DISTRICT,56,Female,4939,1905,6844
KASUR DISTRICT,56,Transgender,0,0,0
KASUR DISTRICT,57,Male,6114,2160,8274
KASUR DISTRICT,57,Female,5136,1740,6876
KASUR DISTRICT,57,Transgender,0,0,0
KASUR DISTRICT,58,Male,5671,2192,7863
KASUR DISTRICT,58,Female,5443,1868,7311
KASUR DISTRICT,58,Transgender,3,0,3
KASUR DISTRICT,59,Male,5616,1964,7580
KASUR DISTRICT,59,Female,5122,1943,7065
KASUR DISTRICT,59,Transgender,0,1,1
KASUR DISTRICT,60,Male,6844,2434,9278
KASUR DISTRICT,60,Female,5944,2093,8037
KASUR DISTRICT,60,Transgender,3,3,6
KASUR DISTRICT,61,Male,5075,2005,7080
KASUR DISTRICT,61,Female,4599,1627,6226
KASUR DISTRICT,61,Transgender,0,0,0
KASUR DISTRICT,62,Male,5042,2009,7051
KASUR DISTRICT,62,Female,4519,1616,6135
KASUR DISTRICT,62,Transgender,1,1,2
KASUR DISTRICT,63,Male,4762,1784,6546
KASUR DISTRICT,63,Female,4394,1672,6066
KASUR DISTRICT,63,Transgender,0,0,0
KASUR DISTRICT,64,Male,4579,1551,6130
KASUR DISTRICT,64,Female,4266,1442,5708
KASUR DISTRICT,64,Transgender,0,0,0
KASUR DISTRICT,65,Male,5202,1794,6996
KASUR DISTRICT,65,Female,4665,1600,6265
KASUR DISTRICT,65,Transgender,1,2,3
KASUR DISTRICT,66,Male,2960,987,3947
KASUR DISTRICT,66,Female,2786,993,3779
KASUR DISTRICT,66,Transgender,0,0,0
KASUR DISTRICT,67,Male,3078,1081,4159
KASUR DISTRICT,67,Female,2815,931,3746
KASUR DISTRICT,67,Transgender,1,0,1
KASUR DISTRICT,68,Male,3229,1109,4338
KASUR DISTRICT,68,Female,3327,1047,4374
KASUR DISTRICT,68,Transgender,1,1,2
KASUR DISTRICT,69,Male,3497,983,4480
KASUR DISTRICT,69,Female,3283,985,4268
KASUR DISTRICT,69,Transgender,0,0,0
KASUR DISTRICT,70,Male,4467,1438,5905
KASUR DISTRICT,70,Female,3683,1189,4872
KASUR DISTRICT,70,Transgender,3,1,4
KASUR DISTRICT,71,Male,2857,923,3780
KASUR DISTRICT,71,Female,2576,820,3396
KASUR DISTRICT,71,Transgender,0,0,0
KASUR DISTRICT,72,Male,3001,1049,4050
KASUR DISTRICT,72,Female,2446,838,3284
KASUR DISTRICT,72,Transgender,1,0,1
KASUR DISTRICT,73,Male,2996,906,3902
KASUR DISTRICT,73,Female,2450,820,3270
KASUR DISTRICT,73,Transgender,0,1,1
KASUR DISTRICT,74,Male,2743,800,3543
KASUR DISTRICT,74,Female,2320,706,3026
KASUR DISTRICT,74,Transgender,0,0,0
KASUR DISTRICT,>=75,Male,19405,5885,25290
KASUR DISTRICT,>=75,Female,16916,5343,22259
KASUR DISTRICT,>=75,Transgender,6,2,8
KECH DISTRICT,<1,Male,6983,3077,10060
KECH DISTRICT,<1,Female,5770,2547,8317
KECH DISTRICT,<1,Transgender,0,0,0
KECH DISTRICT,1,Male,7523,4446,11969
KECH DISTRICT,1,Female,6228,3676,9904
KECH DISTRICT,1,Transgender,0,0,0
KECH DISTRICT,2,Male,8899,4501,13400
KECH DISTRICT,2,Female,7675,3924,11599
KECH DISTRICT,2,Transgender,0,0,0
KECH DISTRICT,3,Male,8212,4598,12810
KECH DISTRICT,3,Female,6870,3641,10511
KECH DISTRICT,3,Transgender,0,0,0
KECH DISTRICT,4,Male,10174,4703,14877
KECH DISTRICT,4,Female,8469,3871,12340
KECH DISTRICT,4,Transgender,0,0,0
KECH DISTRICT,5,Male,9467,4894,14361
KECH DISTRICT,5,Female,8417,4043,12460
KECH DISTRICT,5,Transgender,0,0,0
KECH DISTRICT,6,Male,10551,5054,15605
KECH DISTRICT,6,Female,8624,3933,12557
KECH DISTRICT,6,Transgender,0,0,0
KECH DISTRICT,7,Male,9394,5146,14540
KECH DISTRICT,7,Female,8024,3897,11921
KECH DISTRICT,7,Transgender,0,0,0
KECH DISTRICT,8,Male,12401,6108,18509
KECH DISTRICT,8,Female,10195,4564,14759
KECH DISTRICT,8,Transgender,0,0,0
KECH DISTRICT,9,Male,10841,5570,16411
KECH DISTRICT,9,Female,8699,4056,12755
KECH DISTRICT,9,Transgender,0,0,0
KECH DISTRICT,10,Male,14334,6733,21067
KECH DISTRICT,10,Female,11909,5063,16972
KECH DISTRICT,10,Transgender,0,0,0
KECH DISTRICT,11,Male,10074,5247,15321
KECH DISTRICT,11,Female,8200,3915,12115
KECH DISTRICT,11,Transgender,0,0,0
KECH DISTRICT,12,Male,10288,5001,15289
KECH DISTRICT,12,Female,8472,3667,12139
KECH DISTRICT,12,Transgender,0,0,0
KECH DISTRICT,13,Male,9481,4757,14238
KECH DISTRICT,13,Female,7463,3340,10803
KECH DISTRICT,13,Transgender,0,0,0
KECH DISTRICT,14,Male,10463,5042,15505
KECH DISTRICT,14,Female,8159,3623,11782
KECH DISTRICT,14,Transgender,0,0,0
KECH DISTRICT,15,Male,10132,5058,15190
KECH DISTRICT,15,Female,7652,3539,11191
KECH DISTRICT,15,Transgender,1,2,3
KECH DISTRICT,16,Male,9975,4920,14895
KECH DISTRICT,16,Female,7494,3403,10897
KECH DISTRICT,16,Transgender,6,1,7
KECH DISTRICT,17,Male,8039,4072,12111
KECH DISTRICT,17,Female,6346,3189,9535
KECH DISTRICT,17,Transgender,1,2,3
KECH DISTRICT,18,Male,9561,4523,14084
KECH DISTRICT,18,Female,7003,3597,10600
KECH DISTRICT,18,Transgender,1,1,2
KECH DISTRICT,19,Male,6320,3439,9759
KECH DISTRICT,19,Female,5316,2978,8294
KECH DISTRICT,19,Transgender,0,1,1
KECH DISTRICT,20,Male,9199,4505,13704
KECH DISTRICT,20,Female,6627,3363,9990
KECH DISTRICT,20,Transgender,4,1,5
KECH DISTRICT,21,Male,5217,2853,8070
KECH DISTRICT,21,Female,4961,2739,7700
KECH DISTRICT,21,Transgender,2,0,2
KECH DISTRICT,22,Male,4693,2506,7199
KECH DISTRICT,22,Female,3464,2003,5467
KECH DISTRICT,22,Transgender,2,1,3
KECH DISTRICT,23,Male,4106,2266,6372
KECH DISTRICT,23,Female,3579,2117,5696
KECH DISTRICT,23,Transgender,1,0,1
KECH DISTRICT,24,Male,4346,1995,6341
KECH DISTRICT,24,Female,3511,1777,5288
KECH DISTRICT,24,Transgender,1,1,2
KECH DISTRICT,25,Male,5043,2660,7703
KECH DISTRICT,25,Female,4192,2298,6490
KECH DISTRICT,25,Transgender,3,2,5
KECH DISTRICT,26,Male,4175,1940,6115
KECH DISTRICT,26,Female,3645,1776,5421
KECH DISTRICT,26,Transgender,1,0,1
KECH DISTRICT,27,Male,3258,1852,5110
KECH DISTRICT,27,Female,3416,1961,5377
KECH DISTRICT,27,Transgender,1,1,2
KECH DISTRICT,28,Male,4370,2216,6586
KECH DISTRICT,28,Female,4506,2271,6777
KECH DISTRICT,28,Transgender,3,2,5
KECH DISTRICT,29,Male,3733,2087,5820
KECH DISTRICT,29,Female,4340,2312,6652
KECH DISTRICT,29,Transgender,2,1,3
KECH DISTRICT,30,Male,5762,2674,8436
KECH DISTRICT,30,Female,4828,2350,7178
KECH DISTRICT,30,Transgender,4,3,7
KECH DISTRICT,31,Male,3451,1862,5313
KECH DISTRICT,31,Female,3653,1969,5622
KECH DISTRICT,31,Transgender,1,0,1
KECH DISTRICT,32,Male,3002,1510,4512
KECH DISTRICT,32,Female,2908,1441,4349
KECH DISTRICT,32,Transgender,1,1,2
KECH DISTRICT,33,Male,3178,1731,4909
KECH DISTRICT,33,Female,3475,1798,5273
KECH DISTRICT,33,Transgender,0,0,0
KECH DISTRICT,34,Male,2454,1336,3790
KECH DISTRICT,34,Female,2725,1337,4062
KECH DISTRICT,34,Transgender,0,0,0
KECH DISTRICT,35,Male,3536,1734,5270
KECH DISTRICT,35,Female,3102,1522,4624
KECH DISTRICT,35,Transgender,3,3,6
KECH DISTRICT,36,Male,2411,1223,3634
KECH DISTRICT,36,Female,2594,1199,3793
KECH DISTRICT,36,Transgender,0,0,0
KECH DISTRICT,37,Male,2353,1317,3670
KECH DISTRICT,37,Female,2558,1264,3822
KECH DISTRICT,37,Transgender,1,1,2
KECH DISTRICT,38,Male,3385,1746,5131
KECH DISTRICT,38,Female,4103,2015,6118
KECH DISTRICT,38,Transgender,1,1,2
KECH DISTRICT,39,Male,3582,1711,5293
KECH DISTRICT,39,Female,3289,1626,4915
KECH DISTRICT,39,Transgender,0,0,0
KECH DISTRICT,40,Male,5047,2369,7416
KECH DISTRICT,40,Female,3895,1770,5665
KECH DISTRICT,40,Transgender,1,4,5
KECH DISTRICT,41,Male,2763,1349,4112
KECH DISTRICT,41,Female,2318,1114,3432
KECH DISTRICT,41,Transgender,0,0,0
KECH DISTRICT,42,Male,1970,1029,2999
KECH DISTRICT,42,Female,1925,1044,2969
KECH DISTRICT,42,Transgender,1,1,2
KECH DISTRICT,43,Male,2330,1156,3486
KECH DISTRICT,43,Female,2517,1292,3809
KECH DISTRICT,43,Transgender,1,1,2
KECH DISTRICT,44,Male,1816,994,2810
KECH DISTRICT,44,Female,2025,1010,3035
KECH DISTRICT,44,Transgender,0,0,0
KECH DISTRICT,45,Male,2318,1232,3550
KECH DISTRICT,45,Female,2033,1183,3216
KECH DISTRICT,45,Transgender,1,1,2
KECH DISTRICT,46,Male,1540,794,2334
KECH DISTRICT,46,Female,1522,827,2349
KECH DISTRICT,46,Transgender,3,0,3
KECH DISTRICT,47,Male,1489,809,2298
KECH DISTRICT,47,Female,1727,758,2485
KECH DISTRICT,47,Transgender,0,1,1
KECH DISTRICT,48,Male,2219,1274,3493
KECH DISTRICT,48,Female,2637,1322,3959
KECH DISTRICT,48,Transgender,2,0,2
KECH DISTRICT,49,Male,2378,1225,3603
KECH DISTRICT,49,Female,2235,1099,3334
KECH DISTRICT,49,Transgender,0,0,0
KECH DISTRICT,50,Male,3015,1461,4476
KECH DISTRICT,50,Female,2226,1188,3414
KECH DISTRICT,50,Transgender,0,2,2
KECH DISTRICT,51,Male,1496,784,2280
KECH DISTRICT,51,Female,1407,652,2059
KECH DISTRICT,51,Transgender,1,0,1
KECH DISTRICT,52,Male,1489,721,2210
KECH DISTRICT,52,Female,1187,609,1796
KECH DISTRICT,52,Transgender,0,0,0
KECH DISTRICT,53,Male,1614,866,2480
KECH DISTRICT,53,Female,1403,670,2073
KECH DISTRICT,53,Transgender,0,0,0
KECH DISTRICT,54,Male,1616,803,2419
KECH DISTRICT,54,Female,1465,602,2067
KECH DISTRICT,54,Transgender,1,1,2
KECH DISTRICT,55,Male,1510,835,2345
KECH DISTRICT,55,Female,1139,596,1735
KECH DISTRICT,55,Transgender,0,0,0
KECH DISTRICT,56,Male,1256,562,1818
KECH DISTRICT,56,Female,789,390,1179
KECH DISTRICT,56,Transgender,0,1,1
KECH DISTRICT,57,Male,923,473,1396
KECH DISTRICT,57,Female,771,379,1150
KECH DISTRICT,57,Transgender,0,0,0
KECH DISTRICT,58,Male,1109,538,1647
KECH DISTRICT,58,Female,1025,601,1626
KECH DISTRICT,58,Transgender,0,1,1
KECH DISTRICT,59,Male,1183,526,1709
KECH DISTRICT,59,Female,1006,517,1523
KECH DISTRICT,59,Transgender,0,0,0
KECH DISTRICT,60,Male,1680,912,2592
KECH DISTRICT,60,Female,958,519,1477
KECH DISTRICT,60,Transgender,2,0,2
KECH DISTRICT,61,Male,904,450,1354
KECH DISTRICT,61,Female,705,394,1099
KECH DISTRICT,61,Transgender,1,0,1
KECH DISTRICT,62,Male,717,385,1102
KECH DISTRICT,62,Female,639,325,964
KECH DISTRICT,62,Transgender,0,0,0
KECH DISTRICT,63,Male,913,504,1417
KECH DISTRICT,63,Female,705,374,1079
KECH DISTRICT,63,Transgender,1,0,1
KECH DISTRICT,64,Male,912,505,1417
KECH DISTRICT,64,Female,735,352,1087
KECH DISTRICT,64,Transgender,0,0,0
KECH DISTRICT,65,Male,730,408,1138
KECH DISTRICT,65,Female,501,322,823
KECH DISTRICT,65,Transgender,0,0,0
KECH DISTRICT,66,Male,524,349,873
KECH DISTRICT,66,Female,398,196,594
KECH DISTRICT,66,Transgender,0,1,1
KECH DISTRICT,67,Male,505,276,781
KECH DISTRICT,67,Female,415,213,628
KECH DISTRICT,67,Transgender,3,0,3
KECH DISTRICT,68,Male,640,335,975
KECH DISTRICT,68,Female,520,340,860
KECH DISTRICT,68,Transgender,0,0,0
KECH DISTRICT,69,Male,664,367,1031
KECH DISTRICT,69,Female,510,299,809
KECH DISTRICT,69,Transgender,0,0,0
KECH DISTRICT,70,Male,690,328,1018
KECH DISTRICT,70,Female,460,163,623
KECH DISTRICT,70,Transgender,1,1,2
KECH DISTRICT,71,Male,366,240,606
KECH DISTRICT,71,Female,314,141,455
KECH DISTRICT,71,Transgender,0,0,0
KECH DISTRICT,72,Male,346,178,524
KECH DISTRICT,72,Female,280,158,438
KECH DISTRICT,72,Transgender,0,0,0
KECH DISTRICT,73,Male,468,218,686
KECH DISTRICT,73,Female,325,134,459
KECH DISTRICT,73,Transgender,0,0,0
KECH DISTRICT,74,Male,442,218,660
KECH DISTRICT,74,Female,299,129,428
KECH DISTRICT,74,Transgender,0,0,0
KECH DISTRICT,>=75,Male,3379,1465,4844
KECH DISTRICT,>=75,Female,2296,1143,3439
KECH DISTRICT,>=75,Transgender,3,0,3
KHAIRPUR DISTRICT,<1,Male,18919,8281,27200
KHAIRPUR DISTRICT,<1,Female,18066,7907,25973
KHAIRPUR DISTRICT,<1,Transgender,0,0,0
KHAIRPUR DISTRICT,1,Male,24338,10671,35009
KHAIRPUR DISTRICT,1,Female,23522,10299,33821
KHAIRPUR DISTRICT,1,Transgender,0,0,0
KHAIRPUR DISTRICT,2,Male,29143,11935,41078
KHAIRPUR DISTRICT,2,Female,29086,11580,40666
KHAIRPUR DISTRICT,2,Transgender,0,0,0
KHAIRPUR DISTRICT,3,Male,31890,13388,45278
KHAIRPUR DISTRICT,3,Female,30767,13147,43914
KHAIRPUR DISTRICT,3,Transgender,0,0,0
KHAIRPUR DISTRICT,4,Male,34003,13184,47187
KHAIRPUR DISTRICT,4,Female,33123,13026,46149
KHAIRPUR DISTRICT,4,Transgender,0,0,0
KHAIRPUR DISTRICT,5,Male,33621,14345,47966
KHAIRPUR DISTRICT,5,Female,30225,13149,43374
KHAIRPUR DISTRICT,5,Transgender,0,0,0
KHAIRPUR DISTRICT,6,Male,32020,12831,44851
KHAIRPUR DISTRICT,6,Female,28962,11669,40631
KHAIRPUR DISTRICT,6,Transgender,0,0,0
KHAIRPUR DISTRICT,7,Male,28674,13056,41730
KHAIRPUR DISTRICT,7,Female,24816,11836,36652
KHAIRPUR DISTRICT,7,Transgender,0,0,0
KHAIRPUR DISTRICT,8,Male,33374,13364,46738
KHAIRPUR DISTRICT,8,Female,28413,11815,40228
KHAIRPUR DISTRICT,8,Transgender,0,0,0
KHAIRPUR DISTRICT,9,Male,25296,11570,36866
KHAIRPUR DISTRICT,9,Female,21577,9942,31519
KHAIRPUR DISTRICT,9,Transgender,0,0,0
KHAIRPUR DISTRICT,10,Male,28551,11708,40259
KHAIRPUR DISTRICT,10,Female,24175,10166,34341
KHAIRPUR DISTRICT,10,Transgender,0,0,0
KHAIRPUR DISTRICT,11,Male,19801,9489,29290
KHAIRPUR DISTRICT,11,Female,16557,8093,24650
KHAIRPUR DISTRICT,11,Transgender,0,0,0
KHAIRPUR DISTRICT,12,Male,22752,10266,33018
KHAIRPUR DISTRICT,12,Female,19323,8813,28136
KHAIRPUR DISTRICT,12,Transgender,0,0,0
KHAIRPUR DISTRICT,13,Male,18347,9097,27444
KHAIRPUR DISTRICT,13,Female,14736,7796,22532
KHAIRPUR DISTRICT,13,Transgender,0,0,0
KHAIRPUR DISTRICT,14,Male,19510,9221,28731
KHAIRPUR DISTRICT,14,Female,16283,8038,24321
KHAIRPUR DISTRICT,14,Transgender,0,0,0
KHAIRPUR DISTRICT,15,Male,20688,10222,30910
KHAIRPUR DISTRICT,15,Female,16111,8492,24603
KHAIRPUR DISTRICT,15,Transgender,1,0,1
KHAIRPUR DISTRICT,16,Male,19133,9341,28474
KHAIRPUR DISTRICT,16,Female,15679,7891,23570
KHAIRPUR DISTRICT,16,Transgender,1,1,2
KHAIRPUR DISTRICT,17,Male,17998,9634,27632
KHAIRPUR DISTRICT,17,Female,14407,8046,22453
KHAIRPUR DISTRICT,17,Transgender,1,2,3
KHAIRPUR DISTRICT,18,Male,19025,9382,28407
KHAIRPUR DISTRICT,18,Female,18670,8697,27367
KHAIRPUR DISTRICT,18,Transgender,1,6,7
KHAIRPUR DISTRICT,19,Male,14796,8115,22911
KHAIRPUR DISTRICT,19,Female,14886,7998,22884
KHAIRPUR DISTRICT,19,Transgender,1,3,4
KHAIRPUR DISTRICT,20,Male,16817,8090,24907
KHAIRPUR DISTRICT,20,Female,16830,7946,24776
KHAIRPUR DISTRICT,20,Transgender,1,1,2
KHAIRPUR DISTRICT,21,Male,12006,6788,18794
KHAIRPUR DISTRICT,21,Female,12398,6686,19084
KHAIRPUR DISTRICT,21,Transgender,1,3,4
KHAIRPUR DISTRICT,22,Male,13310,6919,20229
KHAIRPUR DISTRICT,22,Female,12528,6699,19227
KHAIRPUR DISTRICT,22,Transgender,1,4,5
KHAIRPUR DISTRICT,23,Male,10958,6184,17142
KHAIRPUR DISTRICT,23,Female,10864,6194,17058
KHAIRPUR DISTRICT,23,Transgender,0,3,3
KHAIRPUR DISTRICT,24,Male,10194,5512,15706
KHAIRPUR DISTRICT,24,Female,10606,5663,16269
KHAIRPUR DISTRICT,24,Transgender,0,2,2
KHAIRPUR DISTRICT,25,Male,13454,6694,20148
KHAIRPUR DISTRICT,25,Female,13109,6670,19779
KHAIRPUR DISTRICT,25,Transgender,0,4,4
KHAIRPUR DISTRICT,26,Male,10235,5654,15889
KHAIRPUR DISTRICT,26,Female,10454,5707,16161
KHAIRPUR DISTRICT,26,Transgender,0,2,2
KHAIRPUR DISTRICT,27,Male,10548,5684,16232
KHAIRPUR DISTRICT,27,Female,11053,5827,16880
KHAIRPUR DISTRICT,27,Transgender,0,1,1
KHAIRPUR DISTRICT,28,Male,10897,5925,16822
KHAIRPUR DISTRICT,28,Female,12153,6370,18523
KHAIRPUR DISTRICT,28,Transgender,0,1,1
KHAIRPUR DISTRICT,29,Male,10275,5459,15734
KHAIRPUR DISTRICT,29,Female,11354,5763,17117
KHAIRPUR DISTRICT,29,Transgender,1,1,2
KHAIRPUR DISTRICT,30,Male,11811,6158,17969
KHAIRPUR DISTRICT,30,Female,12213,5988,18201
KHAIRPUR DISTRICT,30,Transgender,2,7,9
KHAIRPUR DISTRICT,31,Male,10003,5473,15476
KHAIRPUR DISTRICT,31,Female,10771,5486,16257
KHAIRPUR DISTRICT,31,Transgender,0,0,0
KHAIRPUR DISTRICT,32,Male,10351,5373,15724
KHAIRPUR DISTRICT,32,Female,9754,4956,14710
KHAIRPUR DISTRICT,32,Transgender,0,4,4
KHAIRPUR DISTRICT,33,Male,9400,5047,14447
KHAIRPUR DISTRICT,33,Female,9652,4886,14538
KHAIRPUR DISTRICT,33,Transgender,0,0,0
KHAIRPUR DISTRICT,34,Male,8503,4489,12992
KHAIRPUR DISTRICT,34,Female,8693,4355,13048
KHAIRPUR DISTRICT,34,Transgender,0,0,0
KHAIRPUR DISTRICT,35,Male,10461,5126,15587
KHAIRPUR DISTRICT,35,Female,9488,4824,14312
KHAIRPUR DISTRICT,35,Transgender,1,7,8
KHAIRPUR DISTRICT,36,Male,7841,3912,11753
KHAIRPUR DISTRICT,36,Female,7218,3653,10871
KHAIRPUR DISTRICT,36,Transgender,0,3,3
KHAIRPUR DISTRICT,37,Male,9280,4297,13577
KHAIRPUR DISTRICT,37,Female,8924,4284,13208
KHAIRPUR DISTRICT,37,Transgender,0,0,0
KHAIRPUR DISTRICT,38,Male,7857,4209,12066
KHAIRPUR DISTRICT,38,Female,7986,4128,12114
KHAIRPUR DISTRICT,38,Transgender,0,3,3
KHAIRPUR DISTRICT,39,Male,7962,4018,11980
KHAIRPUR DISTRICT,39,Female,7801,3884,11685
KHAIRPUR DISTRICT,39,Transgender,0,0,0
KHAIRPUR DISTRICT,40,Male,7753,4293,12046
KHAIRPUR DISTRICT,40,Female,8429,4339,12768
KHAIRPUR DISTRICT,40,Transgender,0,6,6
KHAIRPUR DISTRICT,41,Male,6146,3491,9637
KHAIRPUR DISTRICT,41,Female,6679,3413,10092
KHAIRPUR DISTRICT,41,Transgender,0,1,1
KHAIRPUR DISTRICT,42,Male,6549,3433,9982
KHAIRPUR DISTRICT,42,Female,7010,3307,10317
KHAIRPUR DISTRICT,42,Transgender,1,1,2
KHAIRPUR DISTRICT,43,Male,5698,3190,8888
KHAIRPUR DISTRICT,43,Female,6054,3166,9220
KHAIRPUR DISTRICT,43,Transgender,0,0,0
KHAIRPUR DISTRICT,44,Male,5637,3027,8664
KHAIRPUR DISTRICT,44,Female,5814,2917,8731
KHAIRPUR DISTRICT,44,Transgender,0,0,0
KHAIRPUR DISTRICT,45,Male,6527,3432,9959
KHAIRPUR DISTRICT,45,Female,6332,3227,9559
KHAIRPUR DISTRICT,45,Transgender,0,6,6
KHAIRPUR DISTRICT,46,Male,5367,2823,8190
KHAIRPUR DISTRICT,46,Female,4855,2552,7407
KHAIRPUR DISTRICT,46,Transgender,0,1,1
KHAIRPUR DISTRICT,47,Male,5973,2926,8899
KHAIRPUR DISTRICT,47,Female,6022,2757,8779
KHAIRPUR DISTRICT,47,Transgender,1,1,2
KHAIRPUR DISTRICT,48,Male,5731,2996,8727
KHAIRPUR DISTRICT,48,Female,5415,2796,8211
KHAIRPUR DISTRICT,48,Transgender,0,0,0
KHAIRPUR DISTRICT,49,Male,5421,2997,8418
KHAIRPUR DISTRICT,49,Female,5308,2908,8216
KHAIRPUR DISTRICT,49,Transgender,0,1,1
KHAIRPUR DISTRICT,50,Male,5989,3182,9171
KHAIRPUR DISTRICT,50,Female,5330,2792,8122
KHAIRPUR DISTRICT,50,Transgender,1,1,2
KHAIRPUR DISTRICT,51,Male,4828,2629,7457
KHAIRPUR DISTRICT,51,Female,4063,2209,6272
KHAIRPUR DISTRICT,51,Transgender,0,0,0
KHAIRPUR DISTRICT,52,Male,4584,2390,6974
KHAIRPUR DISTRICT,52,Female,3993,2006,5999
KHAIRPUR DISTRICT,52,Transgender,0,2,2
KHAIRPUR DISTRICT,53,Male,4050,2264,6314
KHAIRPUR DISTRICT,53,Female,3249,1829,5078
KHAIRPUR DISTRICT,53,Transgender,0,0,0
KHAIRPUR DISTRICT,54,Male,3597,2044,5641
KHAIRPUR DISTRICT,54,Female,3023,1604,4627
KHAIRPUR DISTRICT,54,Transgender,0,1,1
KHAIRPUR DISTRICT,55,Male,4021,2205,6226
KHAIRPUR DISTRICT,55,Female,3448,1890,5338
KHAIRPUR DISTRICT,55,Transgender,0,1,1
KHAIRPUR DISTRICT,56,Male,2851,1617,4468
KHAIRPUR DISTRICT,56,Female,2397,1287,3684
KHAIRPUR DISTRICT,56,Transgender,0,0,0
KHAIRPUR DISTRICT,57,Male,2985,1549,4534
KHAIRPUR DISTRICT,57,Female,3104,1474,4578
KHAIRPUR DISTRICT,57,Transgender,0,0,0
KHAIRPUR DISTRICT,58,Male,2686,1509,4195
KHAIRPUR DISTRICT,58,Female,2680,1348,4028
KHAIRPUR DISTRICT,58,Transgender,1,0,1
KHAIRPUR DISTRICT,59,Male,2500,1345,3845
KHAIRPUR DISTRICT,59,Female,2663,1350,4013
KHAIRPUR DISTRICT,59,Transgender,1,0,1
KHAIRPUR DISTRICT,60,Male,3064,1545,4609
KHAIRPUR DISTRICT,60,Female,3361,1601,4962
KHAIRPUR DISTRICT,60,Transgender,0,1,1
KHAIRPUR DISTRICT,61,Male,2346,1272,3618
KHAIRPUR DISTRICT,61,Female,2733,1393,4126
KHAIRPUR DISTRICT,61,Transgender,0,0,0
KHAIRPUR DISTRICT,62,Male,2607,1317,3924
KHAIRPUR DISTRICT,62,Female,3197,1545,4742
KHAIRPUR DISTRICT,62,Transgender,1,1,2
KHAIRPUR DISTRICT,63,Male,2464,1236,3700
KHAIRPUR DISTRICT,63,Female,2799,1420,4219
KHAIRPUR DISTRICT,63,Transgender,0,1,1
KHAIRPUR DISTRICT,64,Male,2284,1132,3416
KHAIRPUR DISTRICT,64,Female,2506,1140,3646
KHAIRPUR DISTRICT,64,Transgender,0,0,0
KHAIRPUR DISTRICT,65,Male,2531,1250,3781
KHAIRPUR DISTRICT,65,Female,2414,1191,3605
KHAIRPUR DISTRICT,65,Transgender,0,0,0
KHAIRPUR DISTRICT,66,Male,1836,903,2739
KHAIRPUR DISTRICT,66,Female,1765,949,2714
KHAIRPUR DISTRICT,66,Transgender,0,0,0
KHAIRPUR DISTRICT,67,Male,2110,936,3046
KHAIRPUR DISTRICT,67,Female,2228,903,3131
KHAIRPUR DISTRICT,67,Transgender,1,0,1
KHAIRPUR DISTRICT,68,Male,1864,902,2766
KHAIRPUR DISTRICT,68,Female,1845,892,2737
KHAIRPUR DISTRICT,68,Transgender,0,0,0
KHAIRPUR DISTRICT,69,Male,1625,705,2330
KHAIRPUR DISTRICT,69,Female,1622,765,2387
KHAIRPUR DISTRICT,69,Transgender,0,0,0
KHAIRPUR DISTRICT,70,Male,1782,727,2509
KHAIRPUR DISTRICT,70,Female,1702,779,2481
KHAIRPUR DISTRICT,70,Transgender,0,0,0
KHAIRPUR DISTRICT,71,Male,1361,627,1988
KHAIRPUR DISTRICT,71,Female,1388,592,1980
KHAIRPUR DISTRICT,71,Transgender,0,1,1
KHAIRPUR DISTRICT,72,Male,1329,613,1942
KHAIRPUR DISTRICT,72,Female,1430,653,2083
KHAIRPUR DISTRICT,72,Transgender,0,1,1
KHAIRPUR DISTRICT,73,Male,1224,571,1795
KHAIRPUR DISTRICT,73,Female,1203,621,1824
KHAIRPUR DISTRICT,73,Transgender,0,0,0
KHAIRPUR DISTRICT,74,Male,898,406,1304
KHAIRPUR DISTRICT,74,Female,968,443,1411
KHAIRPUR DISTRICT,74,Transgender,1,1,2
KHAIRPUR DISTRICT,>=75,Male,7252,3147,10399
KHAIRPUR DISTRICT,>=75,Female,8389,3748,12137
KHAIRPUR DISTRICT,>=75,Transgender,1,3,4
KHANEWAL DISTRICT,<1,Male,27590,6478,34068
KHANEWAL DISTRICT,<1,Female,25967,6265,32232
KHANEWAL DISTRICT,<1,Transgender,0,0,0
KHANEWAL DISTRICT,1,Male,31398,7234,38632
KHANEWAL DISTRICT,1,Female,29860,6948,36808
KHANEWAL DISTRICT,1,Transgender,0,0,0
KHANEWAL DISTRICT,2,Male,32492,7270,39762
KHANEWAL DISTRICT,2,Female,30800,6898,37698
KHANEWAL DISTRICT,2,Transgender,0,0,0
KHANEWAL DISTRICT,3,Male,35417,7807,43224
KHANEWAL DISTRICT,3,Female,33831,7583,41414
KHANEWAL DISTRICT,3,Transgender,0,0,0
KHANEWAL DISTRICT,4,Male,35819,7648,43467
KHANEWAL DISTRICT,4,Female,34019,7188,41207
KHANEWAL DISTRICT,4,Transgender,0,0,0
KHANEWAL DISTRICT,5,Male,35216,7540,42756
KHANEWAL DISTRICT,5,Female,32826,7409,40235
KHANEWAL DISTRICT,5,Transgender,0,0,0
KHANEWAL DISTRICT,6,Male,33716,7410,41126
KHANEWAL DISTRICT,6,Female,31787,7117,38904
KHANEWAL DISTRICT,6,Transgender,0,0,0
KHANEWAL DISTRICT,7,Male,36582,8174,44756
KHANEWAL DISTRICT,7,Female,34148,7714,41862
KHANEWAL DISTRICT,7,Transgender,0,0,0
KHANEWAL DISTRICT,8,Male,35042,7224,42266
KHANEWAL DISTRICT,8,Female,32419,6909,39328
KHANEWAL DISTRICT,8,Transgender,0,0,0
KHANEWAL DISTRICT,9,Male,34482,8132,42614
KHANEWAL DISTRICT,9,Female,31703,7524,39227
KHANEWAL DISTRICT,9,Transgender,0,0,0
KHANEWAL DISTRICT,10,Male,31790,6864,38654
KHANEWAL DISTRICT,10,Female,29444,6291,35735
KHANEWAL DISTRICT,10,Transgender,0,0,0
KHANEWAL DISTRICT,11,Male,30494,7802,38296
KHANEWAL DISTRICT,11,Female,27589,7163,34752
KHANEWAL DISTRICT,11,Transgender,0,0,0
KHANEWAL DISTRICT,12,Male,28223,6593,34816
KHANEWAL DISTRICT,12,Female,25524,5933,31457
KHANEWAL DISTRICT,12,Transgender,0,0,0
KHANEWAL DISTRICT,13,Male,26559,6922,33481
KHANEWAL DISTRICT,13,Female,23995,6174,30169
KHANEWAL DISTRICT,13,Transgender,0,0,0
KHANEWAL DISTRICT,14,Male,25487,6376,31863
KHANEWAL DISTRICT,14,Female,23419,5885,29304
KHANEWAL DISTRICT,14,Transgender,0,0,0
KHANEWAL DISTRICT,15,Male,24884,6375,31259
KHANEWAL DISTRICT,15,Female,23662,6068,29730
KHANEWAL DISTRICT,15,Transgender,3,3,6
KHANEWAL DISTRICT,16,Male,24440,6229,30669
KHANEWAL DISTRICT,16,Female,23110,5964,29074
KHANEWAL DISTRICT,16,Transgender,5,0,5
KHANEWAL DISTRICT,17,Male,24301,6646,30947
KHANEWAL DISTRICT,17,Female,22344,6391,28735
KHANEWAL DISTRICT,17,Transgender,0,1,1
KHANEWAL DISTRICT,18,Male,23980,5834,29814
KHANEWAL DISTRICT,18,Female,23081,5503,28584
KHANEWAL DISTRICT,18,Transgender,5,0,5
KHANEWAL DISTRICT,19,Male,22696,6404,29100
KHANEWAL DISTRICT,19,Female,22346,6331,28677
KHANEWAL DISTRICT,19,Transgender,1,0,1
KHANEWAL DISTRICT,20,Male,21845,5626,27471
KHANEWAL DISTRICT,20,Female,22907,5384,28291
KHANEWAL DISTRICT,20,Transgender,7,0,7
KHANEWAL DISTRICT,21,Male,20392,5940,26332
KHANEWAL DISTRICT,21,Female,21012,6277,27289
KHANEWAL DISTRICT,21,Transgender,6,1,7
KHANEWAL DISTRICT,22,Male,20586,5433,26019
KHANEWAL DISTRICT,22,Female,21878,5837,27715
KHANEWAL DISTRICT,22,Transgender,8,2,10
KHANEWAL DISTRICT,23,Male,19283,5490,24773
KHANEWAL DISTRICT,23,Female,19552,5794,25346
KHANEWAL DISTRICT,23,Transgender,4,1,5
KHANEWAL DISTRICT,24,Male,17830,5354,23184
KHANEWAL DISTRICT,24,Female,18281,5661,23942
KHANEWAL DISTRICT,24,Transgender,5,7,12
KHANEWAL DISTRICT,25,Male,18432,4833,23265
KHANEWAL DISTRICT,25,Female,20483,4927,25410
KHANEWAL DISTRICT,25,Transgender,13,7,20
KHANEWAL DISTRICT,26,Male,16804,4999,21803
KHANEWAL DISTRICT,26,Female,18066,5241,23307
KHANEWAL DISTRICT,26,Transgender,6,4,10
KHANEWAL DISTRICT,27,Male,16494,4932,21426
KHANEWAL DISTRICT,27,Female,17864,5362,23226
KHANEWAL DISTRICT,27,Transgender,3,6,9
KHANEWAL DISTRICT,28,Male,16886,4700,21586
KHANEWAL DISTRICT,28,Female,17976,5091,23067
KHANEWAL DISTRICT,28,Transgender,11,3,14
KHANEWAL DISTRICT,29,Male,17297,4745,22042
KHANEWAL DISTRICT,29,Female,18198,5043,23241
KHANEWAL DISTRICT,29,Transgender,3,0,3
KHANEWAL DISTRICT,30,Male,16500,4278,20778
KHANEWAL DISTRICT,30,Female,18674,4495,23169
KHANEWAL DISTRICT,30,Transgender,7,3,10
KHANEWAL DISTRICT,31,Male,15673,4427,20100
KHANEWAL DISTRICT,31,Female,16988,4738,21726
KHANEWAL DISTRICT,31,Transgender,1,1,2
KHANEWAL DISTRICT,32,Male,14491,4127,18618
KHANEWAL DISTRICT,32,Female,15704,4404,20108
KHANEWAL DISTRICT,32,Transgender,4,6,10
KHANEWAL DISTRICT,33,Male,13469,3916,17385
KHANEWAL DISTRICT,33,Female,14729,4153,18882
KHANEWAL DISTRICT,33,Transgender,4,0,4
KHANEWAL DISTRICT,34,Male,13799,3880,17679
KHANEWAL DISTRICT,34,Female,14134,3873,18007
KHANEWAL DISTRICT,34,Transgender,1,2,3
KHANEWAL DISTRICT,35,Male,15004,3666,18670
KHANEWAL DISTRICT,35,Female,15084,3709,18793
KHANEWAL DISTRICT,35,Transgender,8,5,13
KHANEWAL DISTRICT,36,Male,15006,3819,18825
KHANEWAL DISTRICT,36,Female,14560,3869,18429
KHANEWAL DISTRICT,36,Transgender,4,1,5
KHANEWAL DISTRICT,37,Male,14594,3549,18143
KHANEWAL DISTRICT,37,Female,14550,3661,18211
KHANEWAL DISTRICT,37,Transgender,1,0,1
KHANEWAL DISTRICT,38,Male,13643,3779,17422
KHANEWAL DISTRICT,38,Female,13385,3788,17173
KHANEWAL DISTRICT,38,Transgender,4,2,6
KHANEWAL DISTRICT,39,Male,14351,3577,17928
KHANEWAL DISTRICT,39,Female,14526,3550,18076
KHANEWAL DISTRICT,39,Transgender,2,2,4
KHANEWAL DISTRICT,40,Male,12285,3195,15480
KHANEWAL DISTRICT,40,Female,12226,3087,15313
KHANEWAL DISTRICT,40,Transgender,10,3,13
KHANEWAL DISTRICT,41,Male,12594,3296,15890
KHANEWAL DISTRICT,41,Female,12302,3207,15509
KHANEWAL DISTRICT,41,Transgender,2,1,3
KHANEWAL DISTRICT,42,Male,11036,3116,14152
KHANEWAL DISTRICT,42,Female,11202,2998,14200
KHANEWAL DISTRICT,42,Transgender,1,1,2
KHANEWAL DISTRICT,43,Male,9921,2837,12758
KHANEWAL DISTRICT,43,Female,9541,2850,12391
KHANEWAL DISTRICT,43,Transgender,2,2,4
KHANEWAL DISTRICT,44,Male,9223,2728,11951
KHANEWAL DISTRICT,44,Female,9063,2550,11613
KHANEWAL DISTRICT,44,Transgender,0,1,1
KHANEWAL DISTRICT,45,Male,9309,2581,11890
KHANEWAL DISTRICT,45,Female,9094,2446,11540
KHANEWAL DISTRICT,45,Transgender,11,6,17
KHANEWAL DISTRICT,46,Male,8667,2479,11146
KHANEWAL DISTRICT,46,Female,8496,2394,10890
KHANEWAL DISTRICT,46,Transgender,3,0,3
KHANEWAL DISTRICT,47,Male,9561,2585,12146
KHANEWAL DISTRICT,47,Female,9342,2377,11719
KHANEWAL DISTRICT,47,Transgender,2,0,2
KHANEWAL DISTRICT,48,Male,8718,2469,11187
KHANEWAL DISTRICT,48,Female,8514,2499,11013
KHANEWAL DISTRICT,48,Transgender,3,4,7
KHANEWAL DISTRICT,49,Male,9294,2584,11878
KHANEWAL DISTRICT,49,Female,9226,2475,11701
KHANEWAL DISTRICT,49,Transgender,4,1,5
KHANEWAL DISTRICT,50,Male,8965,2379,11344
KHANEWAL DISTRICT,50,Female,8619,2159,10778
KHANEWAL DISTRICT,50,Transgender,10,3,13
KHANEWAL DISTRICT,51,Male,9431,2565,11996
KHANEWAL DISTRICT,51,Female,8943,2355,11298
KHANEWAL DISTRICT,51,Transgender,2,0,2
KHANEWAL DISTRICT,52,Male,9276,2462,11738
KHANEWAL DISTRICT,52,Female,8579,2214,10793
KHANEWAL DISTRICT,52,Transgender,3,0,3
KHANEWAL DISTRICT,53,Male,8292,2371,10663
KHANEWAL DISTRICT,53,Female,7376,2115,9491
KHANEWAL DISTRICT,53,Transgender,1,0,1
KHANEWAL DISTRICT,54,Male,7887,2193,10080
KHANEWAL DISTRICT,54,Female,6594,1885,8479
KHANEWAL DISTRICT,54,Transgender,1,1,2
KHANEWAL DISTRICT,55,Male,7382,1902,9284
KHANEWAL DISTRICT,55,Female,6220,1668,7888
KHANEWAL DISTRICT,55,Transgender,1,4,5
KHANEWAL DISTRICT,56,Male,6919,1809,8728
KHANEWAL DISTRICT,56,Female,5760,1458,7218
KHANEWAL DISTRICT,56,Transgender,1,1,2
KHANEWAL DISTRICT,57,Male,6689,1760,8449
KHANEWAL DISTRICT,57,Female,5968,1341,7309
KHANEWAL DISTRICT,57,Transgender,1,0,1
KHANEWAL DISTRICT,58,Male,5498,1573,7071
KHANEWAL DISTRICT,58,Female,4869,1331,6200
KHANEWAL DISTRICT,58,Transgender,1,0,1
KHANEWAL DISTRICT,59,Male,5786,1492,7278
KHANEWAL DISTRICT,59,Female,5545,1400,6945
KHANEWAL DISTRICT,59,Transgender,2,0,2
KHANEWAL DISTRICT,60,Male,5516,1351,6867
KHANEWAL DISTRICT,60,Female,5358,1281,6639
KHANEWAL DISTRICT,60,Transgender,7,1,8
KHANEWAL DISTRICT,61,Male,5775,1443,7218
KHANEWAL DISTRICT,61,Female,5442,1258,6700
KHANEWAL DISTRICT,61,Transgender,0,0,0
KHANEWAL DISTRICT,62,Male,5533,1395,6928
KHANEWAL DISTRICT,62,Female,5306,1322,6628
KHANEWAL DISTRICT,62,Transgender,0,0,0
KHANEWAL DISTRICT,63,Male,4997,1284,6281
KHANEWAL DISTRICT,63,Female,4788,1207,5995
KHANEWAL DISTRICT,63,Transgender,2,0,2
KHANEWAL DISTRICT,64,Male,4743,1161,5904
KHANEWAL DISTRICT,64,Female,4631,1117,5748
KHANEWAL DISTRICT,64,Transgender,0,0,0
KHANEWAL DISTRICT,65,Male,4350,1000,5350
KHANEWAL DISTRICT,65,Female,4126,876,5002
KHANEWAL DISTRICT,65,Transgender,3,1,4
KHANEWAL DISTRICT,66,Male,3907,836,4743
KHANEWAL DISTRICT,66,Female,3732,774,4506
KHANEWAL DISTRICT,66,Transgender,1,0,1
KHANEWAL DISTRICT,67,Male,3883,783,4666
KHANEWAL DISTRICT,67,Female,3535,743,4278
KHANEWAL DISTRICT,67,Transgender,1,0,1
KHANEWAL DISTRICT,68,Male,3336,768,4104
KHANEWAL DISTRICT,68,Female,2905,695,3600
KHANEWAL DISTRICT,68,Transgender,0,0,0
KHANEWAL DISTRICT,69,Male,3529,704,4233
KHANEWAL DISTRICT,69,Female,3132,704,3836
KHANEWAL DISTRICT,69,Transgender,0,0,0
KHANEWAL DISTRICT,70,Male,3168,641,3809
KHANEWAL DISTRICT,70,Female,2929,606,3535
KHANEWAL DISTRICT,70,Transgender,6,0,6
KHANEWAL DISTRICT,71,Male,3092,651,3743
KHANEWAL DISTRICT,71,Female,2818,655,3473
KHANEWAL DISTRICT,71,Transgender,3,0,3
KHANEWAL DISTRICT,72,Male,2555,617,3172
KHANEWAL DISTRICT,72,Female,2282,545,2827
KHANEWAL DISTRICT,72,Transgender,0,0,0
KHANEWAL DISTRICT,73,Male,2392,562,2954
KHANEWAL DISTRICT,73,Female,2208,478,2686
KHANEWAL DISTRICT,73,Transgender,0,0,0
KHANEWAL DISTRICT,74,Male,2316,447,2763
KHANEWAL DISTRICT,74,Female,2030,425,2455
KHANEWAL DISTRICT,74,Transgender,0,0,0
KHANEWAL DISTRICT,>=75,Male,16507,3298,19805
KHANEWAL DISTRICT,>=75,Female,15150,3386,18536
KHANEWAL DISTRICT,>=75,Transgender,6,0,6
KHARAN DISTRICT,<1,Male,2010,694,2704
KHARAN DISTRICT,<1,Female,1815,653,2468
KHARAN DISTRICT,<1,Transgender,0,0,0
KHARAN DISTRICT,1,Male,2089,742,2831
KHARAN DISTRICT,1,Female,1909,651,2560
KHARAN DISTRICT,1,Transgender,0,0,0
KHARAN DISTRICT,2,Male,2617,833,3450
KHARAN DISTRICT,2,Female,2554,825,3379
KHARAN DISTRICT,2,Transgender,0,0,0
KHARAN DISTRICT,3,Male,2243,910,3153
KHARAN DISTRICT,3,Female,2028,833,2861
KHARAN DISTRICT,3,Transgender,0,0,0
KHARAN DISTRICT,4,Male,2508,948,3456
KHARAN DISTRICT,4,Female,2388,845,3233
KHARAN DISTRICT,4,Transgender,0,0,0
KHARAN DISTRICT,5,Male,2233,886,3119
KHARAN DISTRICT,5,Female,1971,834,2805
KHARAN DISTRICT,5,Transgender,0,0,0
KHARAN DISTRICT,6,Male,2333,794,3127
KHARAN DISTRICT,6,Female,2023,736,2759
KHARAN DISTRICT,6,Transgender,0,0,0
KHARAN DISTRICT,7,Male,2160,943,3103
KHARAN DISTRICT,7,Female,1868,829,2697
KHARAN DISTRICT,7,Transgender,0,0,0
KHARAN DISTRICT,8,Male,2370,890,3260
KHARAN DISTRICT,8,Female,2066,778,2844
KHARAN DISTRICT,8,Transgender,0,0,0
KHARAN DISTRICT,9,Male,2029,973,3002
KHARAN DISTRICT,9,Female,1690,766,2456
KHARAN DISTRICT,9,Transgender,0,0,0
KHARAN DISTRICT,10,Male,2114,1038,3152
KHARAN DISTRICT,10,Female,1757,798,2555
KHARAN DISTRICT,10,Transgender,0,0,0
KHARAN DISTRICT,11,Male,1457,799,2256
KHARAN DISTRICT,11,Female,1237,622,1859
KHARAN DISTRICT,11,Transgender,0,0,0
KHARAN DISTRICT,12,Male,1533,843,2376
KHARAN DISTRICT,12,Female,1418,640,2058
KHARAN DISTRICT,12,Transgender,0,0,0
KHARAN DISTRICT,13,Male,1199,732,1931
KHARAN DISTRICT,13,Female,1059,579,1638
KHARAN DISTRICT,13,Transgender,0,0,0
KHARAN DISTRICT,14,Male,1340,781,2121
KHARAN DISTRICT,14,Female,1214,613,1827
KHARAN DISTRICT,14,Transgender,0,0,0
KHARAN DISTRICT,15,Male,1167,726,1893
KHARAN DISTRICT,15,Female,977,590,1567
KHARAN DISTRICT,15,Transgender,0,0,0
KHARAN DISTRICT,16,Male,1157,684,1841
KHARAN DISTRICT,16,Female,996,554,1550
KHARAN DISTRICT,16,Transgender,0,0,0
KHARAN DISTRICT,17,Male,979,670,1649
KHARAN DISTRICT,17,Female,900,539,1439
KHARAN DISTRICT,17,Transgender,0,0,0
KHARAN DISTRICT,18,Male,1211,611,1822
KHARAN DISTRICT,18,Female,1297,531,1828
KHARAN DISTRICT,18,Transgender,0,0,0
KHARAN DISTRICT,19,Male,1040,527,1567
KHARAN DISTRICT,19,Female,992,486,1478
KHARAN DISTRICT,19,Transgender,0,0,0
KHARAN DISTRICT,20,Male,1065,602,1667
KHARAN DISTRICT,20,Female,1225,571,1796
KHARAN DISTRICT,20,Transgender,0,0,0
KHARAN DISTRICT,21,Male,825,438,1263
KHARAN DISTRICT,21,Female,884,476,1360
KHARAN DISTRICT,21,Transgender,0,0,0
KHARAN DISTRICT,22,Male,744,428,1172
KHARAN DISTRICT,22,Female,751,393,1144
KHARAN DISTRICT,22,Transgender,0,0,0
KHARAN DISTRICT,23,Male,669,340,1009
KHARAN DISTRICT,23,Female,671,321,992
KHARAN DISTRICT,23,Transgender,0,0,0
KHARAN DISTRICT,24,Male,594,294,888
KHARAN DISTRICT,24,Female,669,351,1020
KHARAN DISTRICT,24,Transgender,0,0,0
KHARAN DISTRICT,25,Male,905,458,1363
KHARAN DISTRICT,25,Female,1057,517,1574
KHARAN DISTRICT,25,Transgender,0,0,0
KHARAN DISTRICT,26,Male,581,355,936
KHARAN DISTRICT,26,Female,729,342,1071
KHARAN DISTRICT,26,Transgender,0,0,0
KHARAN DISTRICT,27,Male,762,317,1079
KHARAN DISTRICT,27,Female,802,368,1170
KHARAN DISTRICT,27,Transgender,0,0,0
KHARAN DISTRICT,28,Male,745,374,1119
KHARAN DISTRICT,28,Female,839,364,1203
KHARAN DISTRICT,28,Transgender,0,0,0
KHARAN DISTRICT,29,Male,594,315,909
KHARAN DISTRICT,29,Female,804,377,1181
KHARAN DISTRICT,29,Transgender,0,0,0
KHARAN DISTRICT,30,Male,818,395,1213
KHARAN DISTRICT,30,Female,949,497,1446
KHARAN DISTRICT,30,Transgender,0,0,0
KHARAN DISTRICT,31,Male,655,325,980
KHARAN DISTRICT,31,Female,754,303,1057
KHARAN DISTRICT,31,Transgender,0,0,0
KHARAN DISTRICT,32,Male,597,263,860
KHARAN DISTRICT,32,Female,530,291,821
KHARAN DISTRICT,32,Transgender,0,0,0
KHARAN DISTRICT,33,Male,531,233,764
KHARAN DISTRICT,33,Female,590,284,874
KHARAN DISTRICT,33,Transgender,0,0,0
KHARAN DISTRICT,34,Male,444,217,661
KHARAN DISTRICT,34,Female,503,234,737
KHARAN DISTRICT,34,Transgender,0,0,0
KHARAN DISTRICT,35,Male,680,336,1016
KHARAN DISTRICT,35,Female,617,361,978
KHARAN DISTRICT,35,Transgender,0,0,0
KHARAN DISTRICT,36,Male,475,207,682
KHARAN DISTRICT,36,Female,408,212,620
KHARAN DISTRICT,36,Transgender,0,0,0
KHARAN DISTRICT,37,Male,652,241,893
KHARAN DISTRICT,37,Female,515,220,735
KHARAN DISTRICT,37,Transgender,0,0,0
KHARAN DISTRICT,38,Male,527,299,826
KHARAN DISTRICT,38,Female,497,261,758
KHARAN DISTRICT,38,Transgender,0,0,0
KHARAN DISTRICT,39,Male,516,246,762
KHARAN DISTRICT,39,Female,416,254,670
KHARAN DISTRICT,39,Transgender,0,0,0
KHARAN DISTRICT,40,Male,606,378,984
KHARAN DISTRICT,40,Female,538,321,859
KHARAN DISTRICT,40,Transgender,0,0,0
KHARAN DISTRICT,41,Male,426,261,687
KHARAN DISTRICT,41,Female,357,198,555
KHARAN DISTRICT,41,Transgender,0,0,0
KHARAN DISTRICT,42,Male,363,199,562
KHARAN DISTRICT,42,Female,336,161,497
KHARAN DISTRICT,42,Transgender,0,0,0
KHARAN DISTRICT,43,Male,335,196,531
KHARAN DISTRICT,43,Female,341,157,498
KHARAN DISTRICT,43,Transgender,0,0,0
KHARAN DISTRICT,44,Male,294,164,458
KHARAN DISTRICT,44,Female,322,162,484
KHARAN DISTRICT,44,Transgender,0,0,0
KHARAN DISTRICT,45,Male,400,219,619
KHARAN DISTRICT,45,Female,328,177,505
KHARAN DISTRICT,45,Transgender,0,0,0
KHARAN DISTRICT,46,Male,278,144,422
KHARAN DISTRICT,46,Female,273,147,420
KHARAN DISTRICT,46,Transgender,0,0,0
KHARAN DISTRICT,47,Male,360,151,511
KHARAN DISTRICT,47,Female,312,130,442
KHARAN DISTRICT,47,Transgender,0,0,0
KHARAN DISTRICT,48,Male,307,197,504
KHARAN DISTRICT,48,Female,293,136,429
KHARAN DISTRICT,48,Transgender,0,0,0
KHARAN DISTRICT,49,Male,267,193,460
KHARAN DISTRICT,49,Female,277,143,420
KHARAN DISTRICT,49,Transgender,0,0,0
KHARAN DISTRICT,50,Male,345,200,545
KHARAN DISTRICT,50,Female,344,144,488
KHARAN DISTRICT,50,Transgender,0,0,0
KHARAN DISTRICT,51,Male,287,127,414
KHARAN DISTRICT,51,Female,221,114,335
KHARAN DISTRICT,51,Transgender,0,0,0
KHARAN DISTRICT,52,Male,260,121,381
KHARAN DISTRICT,52,Female,188,89,277
KHARAN DISTRICT,52,Transgender,0,0,0
KHARAN DISTRICT,53,Male,227,105,332
KHARAN DISTRICT,53,Female,214,116,330
KHARAN DISTRICT,53,Transgender,0,0,0
KHARAN DISTRICT,54,Male,221,105,326
KHARAN DISTRICT,54,Female,200,88,288
KHARAN DISTRICT,54,Transgender,0,0,0
KHARAN DISTRICT,55,Male,241,137,378
KHARAN DISTRICT,55,Female,237,129,366
KHARAN DISTRICT,55,Transgender,0,0,0
KHARAN DISTRICT,56,Male,200,87,287
KHARAN DISTRICT,56,Female,167,85,252
KHARAN DISTRICT,56,Transgender,0,0,0
KHARAN DISTRICT,57,Male,221,86,307
KHARAN DISTRICT,57,Female,175,77,252
KHARAN DISTRICT,57,Transgender,0,0,0
KHARAN DISTRICT,58,Male,147,104,251
KHARAN DISTRICT,58,Female,146,86,232
KHARAN DISTRICT,58,Transgender,0,0,0
KHARAN DISTRICT,59,Male,207,116,323
KHARAN DISTRICT,59,Female,168,80,248
KHARAN DISTRICT,59,Transgender,0,0,0
KHARAN DISTRICT,60,Male,192,111,303
KHARAN DISTRICT,60,Female,208,88,296
KHARAN DISTRICT,60,Transgender,0,0,0
KHARAN DISTRICT,61,Male,165,92,257
KHARAN DISTRICT,61,Female,154,80,234
KHARAN DISTRICT,61,Transgender,0,0,0
KHARAN DISTRICT,62,Male,146,56,202
KHARAN DISTRICT,62,Female,118,53,171
KHARAN DISTRICT,62,Transgender,0,0,0
KHARAN DISTRICT,63,Male,152,86,238
KHARAN DISTRICT,63,Female,145,53,198
KHARAN DISTRICT,63,Transgender,0,0,0
KHARAN DISTRICT,64,Male,134,78,212
KHARAN DISTRICT,64,Female,134,51,185
KHARAN DISTRICT,64,Transgender,0,0,0
KHARAN DISTRICT,65,Male,160,72,232
KHARAN DISTRICT,65,Female,147,59,206
KHARAN DISTRICT,65,Transgender,0,0,0
KHARAN DISTRICT,66,Male,105,43,148
KHARAN DISTRICT,66,Female,112,46,158
KHARAN DISTRICT,66,Transgender,0,0,0
KHARAN DISTRICT,67,Male,132,48,180
KHARAN DISTRICT,67,Female,106,38,144
KHARAN DISTRICT,67,Transgender,0,0,0
KHARAN DISTRICT,68,Male,103,54,157
KHARAN DISTRICT,68,Female,92,41,133
KHARAN DISTRICT,68,Transgender,0,0,0
KHARAN DISTRICT,69,Male,122,47,169
KHARAN DISTRICT,69,Female,103,35,138
KHARAN DISTRICT,69,Transgender,0,0,0
KHARAN DISTRICT,70,Male,151,53,204
KHARAN DISTRICT,70,Female,70,22,92
KHARAN DISTRICT,70,Transgender,0,0,0
KHARAN DISTRICT,71,Male,112,33,145
KHARAN DISTRICT,71,Female,69,25,94
KHARAN DISTRICT,71,Transgender,0,0,0
KHARAN DISTRICT,72,Male,57,37,94
KHARAN DISTRICT,72,Female,54,28,82
KHARAN DISTRICT,72,Transgender,0,0,0
KHARAN DISTRICT,73,Male,90,28,118
KHARAN DISTRICT,73,Female,61,21,82
KHARAN DISTRICT,73,Transgender,0,0,0
KHARAN DISTRICT,74,Male,87,29,116
KHARAN DISTRICT,74,Female,56,28,84
KHARAN DISTRICT,74,Transgender,0,0,0
KHARAN DISTRICT,>=75,Male,490,209,699
KHARAN DISTRICT,>=75,Female,385,208,593
KHARAN DISTRICT,>=75,Transgender,0,0,0
KHUSHAB DISTRICT,<1,Male,9936,3842,13778
KHUSHAB DISTRICT,<1,Female,9324,3642,12966
KHUSHAB DISTRICT,<1,Transgender,0,0,0
KHUSHAB DISTRICT,1,Male,11130,4132,15262
KHUSHAB DISTRICT,1,Female,10398,3901,14299
KHUSHAB DISTRICT,1,Transgender,0,0,0
KHUSHAB DISTRICT,2,Male,11219,4313,15532
KHUSHAB DISTRICT,2,Female,10939,3884,14823
KHUSHAB DISTRICT,2,Transgender,0,0,0
KHUSHAB DISTRICT,3,Male,12103,4496,16599
KHUSHAB DISTRICT,3,Female,11685,4197,15882
KHUSHAB DISTRICT,3,Transgender,0,0,0
KHUSHAB DISTRICT,4,Male,12241,4101,16342
KHUSHAB DISTRICT,4,Female,11658,4062,15720
KHUSHAB DISTRICT,4,Transgender,0,0,0
KHUSHAB DISTRICT,5,Male,11568,4172,15740
KHUSHAB DISTRICT,5,Female,11441,3972,15413
KHUSHAB DISTRICT,5,Transgender,0,0,0
KHUSHAB DISTRICT,6,Male,11370,4120,15490
KHUSHAB DISTRICT,6,Female,10727,3874,14601
KHUSHAB DISTRICT,6,Transgender,0,0,0
KHUSHAB DISTRICT,7,Male,12356,4527,16883
KHUSHAB DISTRICT,7,Female,11431,4186,15617
KHUSHAB DISTRICT,7,Transgender,0,0,0
KHUSHAB DISTRICT,8,Male,11498,3996,15494
KHUSHAB DISTRICT,8,Female,10622,3742,14364
KHUSHAB DISTRICT,8,Transgender,0,0,0
KHUSHAB DISTRICT,9,Male,12496,4652,17148
KHUSHAB DISTRICT,9,Female,11486,4180,15666
KHUSHAB DISTRICT,9,Transgender,0,0,0
KHUSHAB DISTRICT,10,Male,10426,3782,14208
KHUSHAB DISTRICT,10,Female,9844,3599,13443
KHUSHAB DISTRICT,10,Transgender,0,0,0
KHUSHAB DISTRICT,11,Male,11359,4369,15728
KHUSHAB DISTRICT,11,Female,10395,4175,14570
KHUSHAB DISTRICT,11,Transgender,0,0,0
KHUSHAB DISTRICT,12,Male,9837,3661,13498
KHUSHAB DISTRICT,12,Female,9450,3429,12879
KHUSHAB DISTRICT,12,Transgender,0,0,0
KHUSHAB DISTRICT,13,Male,10747,4121,14868
KHUSHAB DISTRICT,13,Female,9591,3788,13379
KHUSHAB DISTRICT,13,Transgender,0,0,0
KHUSHAB DISTRICT,14,Male,9751,3765,13516
KHUSHAB DISTRICT,14,Female,9048,3392,12440
KHUSHAB DISTRICT,14,Transgender,0,0,0
KHUSHAB DISTRICT,15,Male,9969,3850,13819
KHUSHAB DISTRICT,15,Female,9569,3589,13158
KHUSHAB DISTRICT,15,Transgender,0,0,0
KHUSHAB DISTRICT,16,Male,9960,3768,13728
KHUSHAB DISTRICT,16,Female,9322,3584,12906
KHUSHAB DISTRICT,16,Transgender,1,1,2
KHUSHAB DISTRICT,17,Male,10435,4134,14569
KHUSHAB DISTRICT,17,Female,10207,3990,14197
KHUSHAB DISTRICT,17,Transgender,0,1,1
KHUSHAB DISTRICT,18,Male,8082,3331,11413
KHUSHAB DISTRICT,18,Female,7900,3073,10973
KHUSHAB DISTRICT,18,Transgender,3,0,3
KHUSHAB DISTRICT,19,Male,9000,3844,12844
KHUSHAB DISTRICT,19,Female,9154,3806,12960
KHUSHAB DISTRICT,19,Transgender,0,1,1
KHUSHAB DISTRICT,20,Male,7204,3026,10230
KHUSHAB DISTRICT,20,Female,8047,3139,11186
KHUSHAB DISTRICT,20,Transgender,1,2,3
KHUSHAB DISTRICT,21,Male,8818,3695,12513
KHUSHAB DISTRICT,21,Female,9234,3877,13111
KHUSHAB DISTRICT,21,Transgender,0,2,2
KHUSHAB DISTRICT,22,Male,7775,3041,10816
KHUSHAB DISTRICT,22,Female,8193,3194,11387
KHUSHAB DISTRICT,22,Transgender,1,0,1
KHUSHAB DISTRICT,23,Male,8398,3276,11674
KHUSHAB DISTRICT,23,Female,8499,3456,11955
KHUSHAB DISTRICT,23,Transgender,0,3,3
KHUSHAB DISTRICT,24,Male,7383,3171,10554
KHUSHAB DISTRICT,24,Female,8235,3310,11545
KHUSHAB DISTRICT,24,Transgender,1,0,1
KHUSHAB DISTRICT,25,Male,6158,2583,8741
KHUSHAB DISTRICT,25,Female,7300,2770,10070
KHUSHAB DISTRICT,25,Transgender,1,4,5
KHUSHAB DISTRICT,26,Male,6672,2761,9433
KHUSHAB DISTRICT,26,Female,8277,3245,11522
KHUSHAB DISTRICT,26,Transgender,0,1,1
KHUSHAB DISTRICT,27,Male,6891,2889,9780
KHUSHAB DISTRICT,27,Female,8215,3327,11542
KHUSHAB DISTRICT,27,Transgender,0,1,1
KHUSHAB DISTRICT,28,Male,6606,2713,9319
KHUSHAB DISTRICT,28,Female,7619,3052,10671
KHUSHAB DISTRICT,28,Transgender,0,1,1
KHUSHAB DISTRICT,29,Male,7125,2877,10002
KHUSHAB DISTRICT,29,Female,8579,3322,11901
KHUSHAB DISTRICT,29,Transgender,3,0,3
KHUSHAB DISTRICT,30,Male,5416,2475,7891
KHUSHAB DISTRICT,30,Female,6639,2578,9217
KHUSHAB DISTRICT,30,Transgender,2,3,5
KHUSHAB DISTRICT,31,Male,5961,2589,8550
KHUSHAB DISTRICT,31,Female,7582,3045,10627
KHUSHAB DISTRICT,31,Transgender,0,4,4
KHUSHAB DISTRICT,32,Male,5381,2359,7740
KHUSHAB DISTRICT,32,Female,6752,2637,9389
KHUSHAB DISTRICT,32,Transgender,2,2,4
KHUSHAB DISTRICT,33,Male,5992,2439,8431
KHUSHAB DISTRICT,33,Female,6688,2688,9376
KHUSHAB DISTRICT,33,Transgender,0,2,2
KHUSHAB DISTRICT,34,Male,6528,2403,8931
KHUSHAB DISTRICT,34,Female,6484,2562,9046
KHUSHAB DISTRICT,34,Transgender,1,0,1
KHUSHAB DISTRICT,35,Male,5017,2104,7121
KHUSHAB DISTRICT,35,Female,5357,2231,7588
KHUSHAB DISTRICT,35,Transgender,2,4,6
KHUSHAB DISTRICT,36,Male,5519,2224,7743
KHUSHAB DISTRICT,36,Female,6499,2389,8888
KHUSHAB DISTRICT,36,Transgender,2,0,2
KHUSHAB DISTRICT,37,Male,5262,2007,7269
KHUSHAB DISTRICT,37,Female,6275,2335,8610
KHUSHAB DISTRICT,37,Transgender,3,3,6
KHUSHAB DISTRICT,38,Male,5246,2128,7374
KHUSHAB DISTRICT,38,Female,5741,2387,8128
KHUSHAB DISTRICT,38,Transgender,0,0,0
KHUSHAB DISTRICT,39,Male,5191,2014,7205
KHUSHAB DISTRICT,39,Female,6114,2355,8469
KHUSHAB DISTRICT,39,Transgender,0,0,0
KHUSHAB DISTRICT,40,Male,3976,1859,5835
KHUSHAB DISTRICT,40,Female,4351,1916,6267
KHUSHAB DISTRICT,40,Transgender,1,0,1
KHUSHAB DISTRICT,41,Male,4795,1833,6628
KHUSHAB DISTRICT,41,Female,5327,1931,7258
KHUSHAB DISTRICT,41,Transgender,1,0,1
KHUSHAB DISTRICT,42,Male,4005,1615,5620
KHUSHAB DISTRICT,42,Female,4826,1786,6612
KHUSHAB DISTRICT,42,Transgender,0,1,1
KHUSHAB DISTRICT,43,Male,4266,1761,6027
KHUSHAB DISTRICT,43,Female,4648,1861,6509
KHUSHAB DISTRICT,43,Transgender,0,0,0
KHUSHAB DISTRICT,44,Male,4296,1598,5894
KHUSHAB DISTRICT,44,Female,4674,1732,6406
KHUSHAB DISTRICT,44,Transgender,0,2,2
KHUSHAB DISTRICT,45,Male,3398,1505,4903
KHUSHAB DISTRICT,45,Female,3498,1461,4959
KHUSHAB DISTRICT,45,Transgender,5,1,6
KHUSHAB DISTRICT,46,Male,4214,1515,5729
KHUSHAB DISTRICT,46,Female,4556,1635,6191
KHUSHAB DISTRICT,46,Transgender,2,1,3
KHUSHAB DISTRICT,47,Male,3887,1558,5445
KHUSHAB DISTRICT,47,Female,4348,1575,5923
KHUSHAB DISTRICT,47,Transgender,0,0,0
KHUSHAB DISTRICT,48,Male,4305,1627,5932
KHUSHAB DISTRICT,48,Female,4384,1720,6104
KHUSHAB DISTRICT,48,Transgender,2,0,2
KHUSHAB DISTRICT,49,Male,4370,1603,5973
KHUSHAB DISTRICT,49,Female,4542,1782,6324
KHUSHAB DISTRICT,49,Transgender,0,0,0
KHUSHAB DISTRICT,50,Male,3592,1650,5242
KHUSHAB DISTRICT,50,Female,3447,1421,4868
KHUSHAB DISTRICT,50,Transgender,1,0,1
KHUSHAB DISTRICT,51,Male,4624,1680,6304
KHUSHAB DISTRICT,51,Female,4655,1674,6329
KHUSHAB DISTRICT,51,Transgender,0,0,0
KHUSHAB DISTRICT,52,Male,4316,1684,6000
KHUSHAB DISTRICT,52,Female,4391,1532,5923
KHUSHAB DISTRICT,52,Transgender,6,2,8
KHUSHAB DISTRICT,53,Male,4278,1716,5994
KHUSHAB DISTRICT,53,Female,3902,1524,5426
KHUSHAB DISTRICT,53,Transgender,1,0,1
KHUSHAB DISTRICT,54,Male,4136,1563,5699
KHUSHAB DISTRICT,54,Female,3574,1417,4991
KHUSHAB DISTRICT,54,Transgender,1,2,3
KHUSHAB DISTRICT,55,Male,2955,1262,4217
KHUSHAB DISTRICT,55,Female,2477,935,3412
KHUSHAB DISTRICT,55,Transgender,0,0,0
KHUSHAB DISTRICT,56,Male,3183,1282,4465
KHUSHAB DISTRICT,56,Female,2940,1045,3985
KHUSHAB DISTRICT,56,Transgender,1,0,1
KHUSHAB DISTRICT,57,Male,2940,1171,4111
KHUSHAB DISTRICT,57,Female,2765,930,3695
KHUSHAB DISTRICT,57,Transgender,2,0,2
KHUSHAB DISTRICT,58,Male,2845,1081,3926
KHUSHAB DISTRICT,58,Female,2646,971,3617
KHUSHAB DISTRICT,58,Transgender,0,0,0
KHUSHAB DISTRICT,59,Male,2747,993,3740
KHUSHAB DISTRICT,59,Female,2724,965,3689
KHUSHAB DISTRICT,59,Transgender,0,0,0
KHUSHAB DISTRICT,60,Male,2116,832,2948
KHUSHAB DISTRICT,60,Female,2019,825,2844
KHUSHAB DISTRICT,60,Transgender,0,1,1
KHUSHAB DISTRICT,61,Male,2795,1011,3806
KHUSHAB DISTRICT,61,Female,2736,988,3724
KHUSHAB DISTRICT,61,Transgender,0,0,0
KHUSHAB DISTRICT,62,Male,2557,1016,3573
KHUSHAB DISTRICT,62,Female,2587,928,3515
KHUSHAB DISTRICT,62,Transgender,0,0,0
KHUSHAB DISTRICT,63,Male,2641,939,3580
KHUSHAB DISTRICT,63,Female,2573,945,3518
KHUSHAB DISTRICT,63,Transgender,1,0,1
KHUSHAB DISTRICT,64,Male,2604,786,3390
KHUSHAB DISTRICT,64,Female,2473,771,3244
KHUSHAB DISTRICT,64,Transgender,0,0,0
KHUSHAB DISTRICT,65,Male,1866,670,2536
KHUSHAB DISTRICT,65,Female,1831,609,2440
KHUSHAB DISTRICT,65,Transgender,4,0,4
KHUSHAB DISTRICT,66,Male,2051,612,2663
KHUSHAB DISTRICT,66,Female,1852,531,2383
KHUSHAB DISTRICT,66,Transgender,0,1,1
KHUSHAB DISTRICT,67,Male,2138,660,2798
KHUSHAB DISTRICT,67,Female,1968,636,2604
KHUSHAB DISTRICT,67,Transgender,0,0,0
KHUSHAB DISTRICT,68,Male,1960,669,2629
KHUSHAB DISTRICT,68,Female,1998,661,2659
KHUSHAB DISTRICT,68,Transgender,0,0,0
KHUSHAB DISTRICT,69,Male,1828,536,2364
KHUSHAB DISTRICT,69,Female,1752,499,2251
KHUSHAB DISTRICT,69,Transgender,0,0,0
KHUSHAB DISTRICT,70,Male,1452,469,1921
KHUSHAB DISTRICT,70,Female,1365,393,1758
KHUSHAB DISTRICT,70,Transgender,2,3,5
KHUSHAB DISTRICT,71,Male,1586,494,2080
KHUSHAB DISTRICT,71,Female,1500,449,1949
KHUSHAB DISTRICT,71,Transgender,1,0,1
KHUSHAB DISTRICT,72,Male,1760,509,2269
KHUSHAB DISTRICT,72,Female,1532,483,2015
KHUSHAB DISTRICT,72,Transgender,0,0,0
KHUSHAB DISTRICT,73,Male,1343,468,1811
KHUSHAB DISTRICT,73,Female,1325,454,1779
KHUSHAB DISTRICT,73,Transgender,1,0,1
KHUSHAB DISTRICT,74,Male,1263,333,1596
KHUSHAB DISTRICT,74,Female,1159,276,1435
KHUSHAB DISTRICT,74,Transgender,0,0,0
KHUSHAB DISTRICT,>=75,Male,9299,2751,12050
KHUSHAB DISTRICT,>=75,Female,9077,2624,11701
KHUSHAB DISTRICT,>=75,Transgender,2,1,3
KHUZDAR DISTRICT,<1,Male,10638,4715,15353
KHUZDAR DISTRICT,<1,Female,9681,4187,13868
KHUZDAR DISTRICT,<1,Transgender,0,0,0
KHUZDAR DISTRICT,1,Male,9862,4759,14621
KHUZDAR DISTRICT,1,Female,8758,4277,13035
KHUZDAR DISTRICT,1,Transgender,0,0,0
KHUZDAR DISTRICT,2,Male,12358,6163,18521
KHUZDAR DISTRICT,2,Female,11706,5678,17384
KHUZDAR DISTRICT,2,Transgender,0,0,0
KHUZDAR DISTRICT,3,Male,10334,5236,15570
KHUZDAR DISTRICT,3,Female,9746,4592,14338
KHUZDAR DISTRICT,3,Transgender,0,0,0
KHUZDAR DISTRICT,4,Male,12130,6016,18146
KHUZDAR DISTRICT,4,Female,11396,5542,16938
KHUZDAR DISTRICT,4,Transgender,0,0,0
KHUZDAR DISTRICT,5,Male,10146,5000,15146
KHUZDAR DISTRICT,5,Female,9254,4512,13766
KHUZDAR DISTRICT,5,Transgender,0,0,0
KHUZDAR DISTRICT,6,Male,12131,5930,18061
KHUZDAR DISTRICT,6,Female,10653,5225,15878
KHUZDAR DISTRICT,6,Transgender,0,0,0
KHUZDAR DISTRICT,7,Male,9769,5091,14860
KHUZDAR DISTRICT,7,Female,8380,4361,12741
KHUZDAR DISTRICT,7,Transgender,0,0,0
KHUZDAR DISTRICT,8,Male,12381,5973,18354
KHUZDAR DISTRICT,8,Female,10130,5104,15234
KHUZDAR DISTRICT,8,Transgender,0,0,0
KHUZDAR DISTRICT,9,Male,9286,4941,14227
KHUZDAR DISTRICT,9,Female,7729,4026,11755
KHUZDAR DISTRICT,9,Transgender,0,0,0
KHUZDAR DISTRICT,10,Male,11391,5830,17221
KHUZDAR DISTRICT,10,Female,9025,5006,14031
KHUZDAR DISTRICT,10,Transgender,0,0,0
KHUZDAR DISTRICT,11,Male,7281,4092,11373
KHUZDAR DISTRICT,11,Female,5778,3380,9158
KHUZDAR DISTRICT,11,Transgender,0,0,0
KHUZDAR DISTRICT,12,Male,8398,4863,13261
KHUZDAR DISTRICT,12,Female,6430,3757,10187
KHUZDAR DISTRICT,12,Transgender,0,0,0
KHUZDAR DISTRICT,13,Male,5754,3640,9394
KHUZDAR DISTRICT,13,Female,4466,2848,7314
KHUZDAR DISTRICT,13,Transgender,0,0,0
KHUZDAR DISTRICT,14,Male,6783,4017,10800
KHUZDAR DISTRICT,14,Female,5367,3429,8796
KHUZDAR DISTRICT,14,Transgender,0,0,0
KHUZDAR DISTRICT,15,Male,5741,3540,9281
KHUZDAR DISTRICT,15,Female,4167,2762,6929
KHUZDAR DISTRICT,15,Transgender,0,0,0
KHUZDAR DISTRICT,16,Male,5232,3381,8613
KHUZDAR DISTRICT,16,Female,4158,2665,6823
KHUZDAR DISTRICT,16,Transgender,0,0,0
KHUZDAR DISTRICT,17,Male,3718,2673,6391
KHUZDAR DISTRICT,17,Female,3262,2322,5584
KHUZDAR DISTRICT,17,Transgender,1,0,1
KHUZDAR DISTRICT,18,Male,5828,3228,9056
KHUZDAR DISTRICT,18,Female,5273,2835,8108
KHUZDAR DISTRICT,18,Transgender,7,2,9
KHUZDAR DISTRICT,19,Male,3682,2464,6146
KHUZDAR DISTRICT,19,Female,3685,2324,6009
KHUZDAR DISTRICT,19,Transgender,1,1,2
KHUZDAR DISTRICT,20,Male,5803,2926,8729
KHUZDAR DISTRICT,20,Female,5463,2784,8247
KHUZDAR DISTRICT,20,Transgender,1,2,3
KHUZDAR DISTRICT,21,Male,3328,2285,5613
KHUZDAR DISTRICT,21,Female,3761,2160,5921
KHUZDAR DISTRICT,21,Transgender,1,0,1
KHUZDAR DISTRICT,22,Male,3291,2065,5356
KHUZDAR DISTRICT,22,Female,3169,1997,5166
KHUZDAR DISTRICT,22,Transgender,1,0,1
KHUZDAR DISTRICT,23,Male,2836,1853,4689
KHUZDAR DISTRICT,23,Female,2716,1656,4372
KHUZDAR DISTRICT,23,Transgender,2,0,2
KHUZDAR DISTRICT,24,Male,2414,1678,4092
KHUZDAR DISTRICT,24,Female,2385,1524,3909
KHUZDAR DISTRICT,24,Transgender,2,0,2
KHUZDAR DISTRICT,25,Male,4980,2419,7399
KHUZDAR DISTRICT,25,Female,4564,2357,6921
KHUZDAR DISTRICT,25,Transgender,5,0,5
KHUZDAR DISTRICT,26,Male,2594,1530,4124
KHUZDAR DISTRICT,26,Female,2894,1591,4485
KHUZDAR DISTRICT,26,Transgender,0,0,0
KHUZDAR DISTRICT,27,Male,2875,1765,4640
KHUZDAR DISTRICT,27,Female,3202,1702,4904
KHUZDAR DISTRICT,27,Transgender,0,0,0
KHUZDAR DISTRICT,28,Male,2972,1706,4678
KHUZDAR DISTRICT,28,Female,3860,2107,5967
KHUZDAR DISTRICT,28,Transgender,5,1,6
KHUZDAR DISTRICT,29,Male,2762,1604,4366
KHUZDAR DISTRICT,29,Female,3338,1889,5227
KHUZDAR DISTRICT,29,Transgender,2,0,2
KHUZDAR DISTRICT,30,Male,4415,2025,6440
KHUZDAR DISTRICT,30,Female,4567,2232,6799
KHUZDAR DISTRICT,30,Transgender,6,0,6
KHUZDAR DISTRICT,31,Male,2884,1596,4480
KHUZDAR DISTRICT,31,Female,3121,1730,4851
KHUZDAR DISTRICT,31,Transgender,2,1,3
KHUZDAR DISTRICT,32,Male,2532,1446,3978
KHUZDAR DISTRICT,32,Female,2387,1263,3650
KHUZDAR DISTRICT,32,Transgender,1,0,1
KHUZDAR DISTRICT,33,Male,2491,1445,3936
KHUZDAR DISTRICT,33,Female,2784,1566,4350
KHUZDAR DISTRICT,33,Transgender,2,0,2
KHUZDAR DISTRICT,34,Male,1867,1122,2989
KHUZDAR DISTRICT,34,Female,2003,1085,3088
KHUZDAR DISTRICT,34,Transgender,3,0,3
KHUZDAR DISTRICT,35,Male,3289,1660,4949
KHUZDAR DISTRICT,35,Female,3126,1638,4764
KHUZDAR DISTRICT,35,Transgender,7,0,7
KHUZDAR DISTRICT,36,Male,1834,1072,2906
KHUZDAR DISTRICT,36,Female,1642,924,2566
KHUZDAR DISTRICT,36,Transgender,0,0,0
KHUZDAR DISTRICT,37,Male,2706,1354,4060
KHUZDAR DISTRICT,37,Female,2098,1050,3148
KHUZDAR DISTRICT,37,Transgender,0,0,0
KHUZDAR DISTRICT,38,Male,2207,1379,3586
KHUZDAR DISTRICT,38,Female,2628,1334,3962
KHUZDAR DISTRICT,38,Transgender,0,1,1
KHUZDAR DISTRICT,39,Male,2217,1189,3406
KHUZDAR DISTRICT,39,Female,2132,1181,3313
KHUZDAR DISTRICT,39,Transgender,0,0,0
KHUZDAR DISTRICT,40,Male,3243,1478,4721
KHUZDAR DISTRICT,40,Female,3327,1593,4920
KHUZDAR DISTRICT,40,Transgender,0,0,0
KHUZDAR DISTRICT,41,Male,1965,990,2955
KHUZDAR DISTRICT,41,Female,1833,907,2740
KHUZDAR DISTRICT,41,Transgender,1,0,1
KHUZDAR DISTRICT,42,Male,1481,851,2332
KHUZDAR DISTRICT,42,Female,1443,766,2209
KHUZDAR DISTRICT,42,Transgender,0,0,0
KHUZDAR DISTRICT,43,Male,1571,819,2390
KHUZDAR DISTRICT,43,Female,1901,895,2796
KHUZDAR DISTRICT,43,Transgender,0,0,0
KHUZDAR DISTRICT,44,Male,1403,706,2109
KHUZDAR DISTRICT,44,Female,1488,787,2275
KHUZDAR DISTRICT,44,Transgender,0,0,0
KHUZDAR DISTRICT,45,Male,2166,943,3109
KHUZDAR DISTRICT,45,Female,2039,1011,3050
KHUZDAR DISTRICT,45,Transgender,0,0,0
KHUZDAR DISTRICT,46,Male,1429,666,2095
KHUZDAR DISTRICT,46,Female,1020,541,1561
KHUZDAR DISTRICT,46,Transgender,1,0,1
KHUZDAR DISTRICT,47,Male,1524,786,2310
KHUZDAR DISTRICT,47,Female,1150,605,1755
KHUZDAR DISTRICT,47,Transgender,0,0,0
KHUZDAR DISTRICT,48,Male,1442,750,2192
KHUZDAR DISTRICT,48,Female,1469,700,2169
KHUZDAR DISTRICT,48,Transgender,1,0,1
KHUZDAR DISTRICT,49,Male,1571,842,2413
KHUZDAR DISTRICT,49,Female,1278,704,1982
KHUZDAR DISTRICT,49,Transgender,0,0,0
KHUZDAR DISTRICT,50,Male,2050,846,2896
KHUZDAR DISTRICT,50,Female,1991,939,2930
KHUZDAR DISTRICT,50,Transgender,1,2,3
KHUZDAR DISTRICT,51,Male,1183,650,1833
KHUZDAR DISTRICT,51,Female,1019,540,1559
KHUZDAR DISTRICT,51,Transgender,0,0,0
KHUZDAR DISTRICT,52,Male,1060,538,1598
KHUZDAR DISTRICT,52,Female,817,371,1188
KHUZDAR DISTRICT,52,Transgender,0,1,1
KHUZDAR DISTRICT,53,Male,1040,492,1532
KHUZDAR DISTRICT,53,Female,1030,477,1507
KHUZDAR DISTRICT,53,Transgender,0,0,0
KHUZDAR DISTRICT,54,Male,1086,538,1624
KHUZDAR DISTRICT,54,Female,876,439,1315
KHUZDAR DISTRICT,54,Transgender,0,0,0
KHUZDAR DISTRICT,55,Male,1097,520,1617
KHUZDAR DISTRICT,55,Female,1157,620,1777
KHUZDAR DISTRICT,55,Transgender,1,0,1
KHUZDAR DISTRICT,56,Male,733,430,1163
KHUZDAR DISTRICT,56,Female,634,333,967
KHUZDAR DISTRICT,56,Transgender,1,0,1
KHUZDAR DISTRICT,57,Male,948,488,1436
KHUZDAR DISTRICT,57,Female,717,354,1071
KHUZDAR DISTRICT,57,Transgender,1,0,1
KHUZDAR DISTRICT,58,Male,718,362,1080
KHUZDAR DISTRICT,58,Female,799,327,1126
KHUZDAR DISTRICT,58,Transgender,0,0,0
KHUZDAR DISTRICT,59,Male,920,376,1296
KHUZDAR DISTRICT,59,Female,705,334,1039
KHUZDAR DISTRICT,59,Transgender,0,0,0
KHUZDAR DISTRICT,60,Male,1322,495,1817
KHUZDAR DISTRICT,60,Female,1230,553,1783
KHUZDAR DISTRICT,60,Transgender,2,1,3
KHUZDAR DISTRICT,61,Male,806,373,1179
KHUZDAR DISTRICT,61,Female,747,379,1126
KHUZDAR DISTRICT,61,Transgender,0,0,0
KHUZDAR DISTRICT,62,Male,627,304,931
KHUZDAR DISTRICT,62,Female,576,297,873
KHUZDAR DISTRICT,62,Transgender,1,0,1
KHUZDAR DISTRICT,63,Male,774,340,1114
KHUZDAR DISTRICT,63,Female,711,332,1043
KHUZDAR DISTRICT,63,Transgender,2,0,2
KHUZDAR DISTRICT,64,Male,888,343,1231
KHUZDAR DISTRICT,64,Female,700,303,1003
KHUZDAR DISTRICT,64,Transgender,0,0,0
KHUZDAR DISTRICT,65,Male,731,311,1042
KHUZDAR DISTRICT,65,Female,702,321,1023
KHUZDAR DISTRICT,65,Transgender,2,0,2
KHUZDAR DISTRICT,66,Male,549,254,803
KHUZDAR DISTRICT,66,Female,459,209,668
KHUZDAR DISTRICT,66,Transgender,0,0,0
KHUZDAR DISTRICT,67,Male,607,309,916
KHUZDAR DISTRICT,67,Female,429,213,642
KHUZDAR DISTRICT,67,Transgender,0,0,0
KHUZDAR DISTRICT,68,Male,488,225,713
KHUZDAR DISTRICT,68,Female,450,201,651
KHUZDAR DISTRICT,68,Transgender,0,0,0
KHUZDAR DISTRICT,69,Male,633,202,835
KHUZDAR DISTRICT,69,Female,482,231,713
KHUZDAR DISTRICT,69,Transgender,0,0,0
KHUZDAR DISTRICT,70,Male,678,230,908
KHUZDAR DISTRICT,70,Female,636,262,898
KHUZDAR DISTRICT,70,Transgender,0,0,0
KHUZDAR DISTRICT,71,Male,422,195,617
KHUZDAR DISTRICT,71,Female,414,161,575
KHUZDAR DISTRICT,71,Transgender,0,0,0
KHUZDAR DISTRICT,72,Male,367,183,550
KHUZDAR DISTRICT,72,Female,316,164,480
KHUZDAR DISTRICT,72,Transgender,0,0,0
KHUZDAR DISTRICT,73,Male,413,127,540
KHUZDAR DISTRICT,73,Female,321,137,458
KHUZDAR DISTRICT,73,Transgender,0,0,0
KHUZDAR DISTRICT,74,Male,469,150,619
KHUZDAR DISTRICT,74,Female,334,139,473
KHUZDAR DISTRICT,74,Transgender,0,0,0
KHUZDAR DISTRICT,>=75,Male,2894,1130,4024
KHUZDAR DISTRICT,>=75,Female,2547,1090,3637
KHUZDAR DISTRICT,>=75,Transgender,2,0,2
KHYBER AGENCY,<1,Male,13158,1273,14431
KHYBER AGENCY,<1,Female,12148,1124,13272
KHYBER AGENCY,<1,Transgender,0,0,0
KHYBER AGENCY,1,Male,16961,1726,18687
KHYBER AGENCY,1,Female,15650,1502,17152
KHYBER AGENCY,1,Transgender,0,0,0
KHYBER AGENCY,2,Male,17917,1755,19672
KHYBER AGENCY,2,Female,17061,1614,18675
KHYBER AGENCY,2,Transgender,0,0,0
KHYBER AGENCY,3,Male,18576,1913,20489
KHYBER AGENCY,3,Female,17403,1691,19094
KHYBER AGENCY,3,Transgender,0,0,0
KHYBER AGENCY,4,Male,18491,2021,20512
KHYBER AGENCY,4,Female,17478,1801,19279
KHYBER AGENCY,4,Transgender,0,0,0
KHYBER AGENCY,5,Male,17755,1783,19538
KHYBER AGENCY,5,Female,16579,1798,18377
KHYBER AGENCY,5,Transgender,0,0,0
KHYBER AGENCY,6,Male,17237,1743,18980
KHYBER AGENCY,6,Female,16628,1588,18216
KHYBER AGENCY,6,Transgender,0,0,0
KHYBER AGENCY,7,Male,17291,1822,19113
KHYBER AGENCY,7,Female,15433,1578,17011
KHYBER AGENCY,7,Transgender,0,0,0
KHYBER AGENCY,8,Male,17803,1691,19494
KHYBER AGENCY,8,Female,15777,1518,17295
KHYBER AGENCY,8,Transgender,0,0,0
KHYBER AGENCY,9,Male,15876,1620,17496
KHYBER AGENCY,9,Female,13782,1518,15300
KHYBER AGENCY,9,Transgender,0,0,0
KHYBER AGENCY,10,Male,15457,1536,16993
KHYBER AGENCY,10,Female,13871,1370,15241
KHYBER AGENCY,10,Transgender,0,0,0
KHYBER AGENCY,11,Male,13398,1424,14822
KHYBER AGENCY,11,Female,11436,1259,12695
KHYBER AGENCY,11,Transgender,0,0,0
KHYBER AGENCY,12,Male,13055,1371,14426
KHYBER AGENCY,12,Female,11410,1148,12558
KHYBER AGENCY,12,Transgender,0,0,0
KHYBER AGENCY,13,Male,12583,1343,13926
KHYBER AGENCY,13,Female,10948,1212,12160
KHYBER AGENCY,13,Transgender,0,0,0
KHYBER AGENCY,14,Male,11480,1260,12740
KHYBER AGENCY,14,Female,10223,1120,11343
KHYBER AGENCY,14,Transgender,0,0,0
KHYBER AGENCY,15,Male,11293,1349,12642
KHYBER AGENCY,15,Female,10116,1170,11286
KHYBER AGENCY,15,Transgender,5,2,7
KHYBER AGENCY,16,Male,9631,1186,10817
KHYBER AGENCY,16,Female,9046,987,10033
KHYBER AGENCY,16,Transgender,6,0,6
KHYBER AGENCY,17,Male,8808,1114,9922
KHYBER AGENCY,17,Female,8454,1036,9490
KHYBER AGENCY,17,Transgender,1,0,1
KHYBER AGENCY,18,Male,8905,1091,9996
KHYBER AGENCY,18,Female,8738,929,9667
KHYBER AGENCY,18,Transgender,5,0,5
KHYBER AGENCY,19,Male,8057,978,9035
KHYBER AGENCY,19,Female,7592,932,8524
KHYBER AGENCY,19,Transgender,0,1,1
KHYBER AGENCY,20,Male,8121,958,9079
KHYBER AGENCY,20,Female,8800,941,9741
KHYBER AGENCY,20,Transgender,1,2,3
KHYBER AGENCY,21,Male,7807,892,8699
KHYBER AGENCY,21,Female,7805,880,8685
KHYBER AGENCY,21,Transgender,0,0,0
KHYBER AGENCY,22,Male,7047,797,7844
KHYBER AGENCY,22,Female,7067,790,7857
KHYBER AGENCY,22,Transgender,3,0,3
KHYBER AGENCY,23,Male,8062,903,8965
KHYBER AGENCY,23,Female,7691,829,8520
KHYBER AGENCY,23,Transgender,1,1,2
KHYBER AGENCY,24,Male,6579,717,7296
KHYBER AGENCY,24,Female,6456,703,7159
KHYBER AGENCY,24,Transgender,2,1,3
KHYBER AGENCY,25,Male,7359,829,8188
KHYBER AGENCY,25,Female,7322,834,8156
KHYBER AGENCY,25,Transgender,6,0,6
KHYBER AGENCY,26,Male,5953,680,6633
KHYBER AGENCY,26,Female,6295,737,7032
KHYBER AGENCY,26,Transgender,1,0,1
KHYBER AGENCY,27,Male,6491,790,7281
KHYBER AGENCY,27,Female,7188,813,8001
KHYBER AGENCY,27,Transgender,0,1,1
KHYBER AGENCY,28,Male,5989,767,6756
KHYBER AGENCY,28,Female,6022,767,6789
KHYBER AGENCY,28,Transgender,1,0,1
KHYBER AGENCY,29,Male,5501,636,6137
KHYBER AGENCY,29,Female,6471,749,7220
KHYBER AGENCY,29,Transgender,1,1,2
KHYBER AGENCY,30,Male,5519,766,6285
KHYBER AGENCY,30,Female,5909,685,6594
KHYBER AGENCY,30,Transgender,6,0,6
KHYBER AGENCY,31,Male,4564,578,5142
KHYBER AGENCY,31,Female,5245,529,5774
KHYBER AGENCY,31,Transgender,0,0,0
KHYBER AGENCY,32,Male,4934,579,5513
KHYBER AGENCY,32,Female,4840,582,5422
KHYBER AGENCY,32,Transgender,2,0,2
KHYBER AGENCY,33,Male,5298,657,5955
KHYBER AGENCY,33,Female,4930,615,5545
KHYBER AGENCY,33,Transgender,0,0,0
KHYBER AGENCY,34,Male,4241,526,4767
KHYBER AGENCY,34,Female,3690,437,4127
KHYBER AGENCY,34,Transgender,1,0,1
KHYBER AGENCY,35,Male,4195,631,4826
KHYBER AGENCY,35,Female,4172,503,4675
KHYBER AGENCY,35,Transgender,2,1,3
KHYBER AGENCY,36,Male,3146,392,3538
KHYBER AGENCY,36,Female,2986,312,3298
KHYBER AGENCY,36,Transgender,1,0,1
KHYBER AGENCY,37,Male,3728,493,4221
KHYBER AGENCY,37,Female,3954,462,4416
KHYBER AGENCY,37,Transgender,0,0,0
KHYBER AGENCY,38,Male,3760,496,4256
KHYBER AGENCY,38,Female,3580,509,4089
KHYBER AGENCY,38,Transgender,0,0,0
KHYBER AGENCY,39,Male,3579,520,4099
KHYBER AGENCY,39,Female,3496,432,3928
KHYBER AGENCY,39,Transgender,0,1,1
KHYBER AGENCY,40,Male,3734,533,4267
KHYBER AGENCY,40,Female,4058,466,4524
KHYBER AGENCY,40,Transgender,1,1,2
KHYBER AGENCY,41,Male,2834,420,3254
KHYBER AGENCY,41,Female,2810,324,3134
KHYBER AGENCY,41,Transgender,0,0,0
KHYBER AGENCY,42,Male,2612,366,2978
KHYBER AGENCY,42,Female,2900,354,3254
KHYBER AGENCY,42,Transgender,0,0,0
KHYBER AGENCY,43,Male,2701,364,3065
KHYBER AGENCY,43,Female,2759,352,3111
KHYBER AGENCY,43,Transgender,0,0,0
KHYBER AGENCY,44,Male,2186,331,2517
KHYBER AGENCY,44,Female,2474,286,2760
KHYBER AGENCY,44,Transgender,0,0,0
KHYBER AGENCY,45,Male,2576,351,2927
KHYBER AGENCY,45,Female,2713,318,3031
KHYBER AGENCY,45,Transgender,1,0,1
KHYBER AGENCY,46,Male,1896,228,2124
KHYBER AGENCY,46,Female,1660,170,1830
KHYBER AGENCY,46,Transgender,0,0,0
KHYBER AGENCY,47,Male,2201,300,2501
KHYBER AGENCY,47,Female,2474,282,2756
KHYBER AGENCY,47,Transgender,1,0,1
KHYBER AGENCY,48,Male,1984,254,2238
KHYBER AGENCY,48,Female,2137,294,2431
KHYBER AGENCY,48,Transgender,0,0,0
KHYBER AGENCY,49,Male,1869,279,2148
KHYBER AGENCY,49,Female,2139,259,2398
KHYBER AGENCY,49,Transgender,0,0,0
KHYBER AGENCY,50,Male,2253,360,2613
KHYBER AGENCY,50,Female,2748,326,3074
KHYBER AGENCY,50,Transgender,2,0,2
KHYBER AGENCY,51,Male,1649,209,1858
KHYBER AGENCY,51,Female,1801,225,2026
KHYBER AGENCY,51,Transgender,1,0,1
KHYBER AGENCY,52,Male,1725,228,1953
KHYBER AGENCY,52,Female,2105,235,2340
KHYBER AGENCY,52,Transgender,1,1,2
KHYBER AGENCY,53,Male,1706,214,1920
KHYBER AGENCY,53,Female,1883,190,2073
KHYBER AGENCY,53,Transgender,1,0,1
KHYBER AGENCY,54,Male,1564,199,1763
KHYBER AGENCY,54,Female,1686,170,1856
KHYBER AGENCY,54,Transgender,0,0,0
KHYBER AGENCY,55,Male,2001,245,2246
KHYBER AGENCY,55,Female,2073,225,2298
KHYBER AGENCY,55,Transgender,0,0,0
KHYBER AGENCY,56,Male,1448,151,1599
KHYBER AGENCY,56,Female,1204,113,1317
KHYBER AGENCY,56,Transgender,0,0,0
KHYBER AGENCY,57,Male,1813,237,2050
KHYBER AGENCY,57,Female,1894,242,2136
KHYBER AGENCY,57,Transgender,1,0,1
KHYBER AGENCY,58,Male,1571,188,1759
KHYBER AGENCY,58,Female,1322,139,1461
KHYBER AGENCY,58,Transgender,1,0,1
KHYBER AGENCY,59,Male,1495,193,1688
KHYBER AGENCY,59,Female,1251,143,1394
KHYBER AGENCY,59,Transgender,0,0,0
KHYBER AGENCY,60,Male,1667,168,1835
KHYBER AGENCY,60,Female,1669,165,1834
KHYBER AGENCY,60,Transgender,0,1,1
KHYBER AGENCY,61,Male,1232,128,1360
KHYBER AGENCY,61,Female,988,93,1081
KHYBER AGENCY,61,Transgender,0,0,0
KHYBER AGENCY,62,Male,1210,121,1331
KHYBER AGENCY,62,Female,1254,99,1353
KHYBER AGENCY,62,Transgender,0,0,0
KHYBER AGENCY,63,Male,1213,157,1370
KHYBER AGENCY,63,Female,1029,110,1139
KHYBER AGENCY,63,Transgender,0,0,0
KHYBER AGENCY,64,Male,1054,127,1181
KHYBER AGENCY,64,Female,846,97,943
KHYBER AGENCY,64,Transgender,1,0,1
KHYBER AGENCY,65,Male,1036,133,1169
KHYBER AGENCY,65,Female,989,122,1111
KHYBER AGENCY,65,Transgender,0,0,0
KHYBER AGENCY,66,Male,667,65,732
KHYBER AGENCY,66,Female,594,46,640
KHYBER AGENCY,66,Transgender,1,0,1
KHYBER AGENCY,67,Male,826,69,895
KHYBER AGENCY,67,Female,767,81,848
KHYBER AGENCY,67,Transgender,0,0,0
KHYBER AGENCY,68,Male,774,64,838
KHYBER AGENCY,68,Female,554,47,601
KHYBER AGENCY,68,Transgender,1,0,1
KHYBER AGENCY,69,Male,737,63,800
KHYBER AGENCY,69,Female,550,56,606
KHYBER AGENCY,69,Transgender,0,0,0
KHYBER AGENCY,70,Male,714,81,795
KHYBER AGENCY,70,Female,643,52,695
KHYBER AGENCY,70,Transgender,0,0,0
KHYBER AGENCY,71,Male,452,58,510
KHYBER AGENCY,71,Female,448,25,473
KHYBER AGENCY,71,Transgender,0,0,0
KHYBER AGENCY,72,Male,510,51,561
KHYBER AGENCY,72,Female,526,42,568
KHYBER AGENCY,72,Transgender,0,0,0
KHYBER AGENCY,73,Male,480,40,520
KHYBER AGENCY,73,Female,395,31,426
KHYBER AGENCY,73,Transgender,0,0,0
KHYBER AGENCY,74,Male,432,50,482
KHYBER AGENCY,74,Female,335,33,368
KHYBER AGENCY,74,Transgender,0,0,0
KHYBER AGENCY,>=75,Male,3176,268,3444
KHYBER AGENCY,>=75,Female,3756,327,4083
KHYBER AGENCY,>=75,Transgender,2,1,3
KILLA ABDULLAH DISTRICT,<1,Male,9752,2170,11922
KILLA ABDULLAH DISTRICT,<1,Female,8800,2025,10825
KILLA ABDULLAH DISTRICT,<1,Transgender,0,0,0
KILLA ABDULLAH DISTRICT,1,Male,13758,2837,16595
KILLA ABDULLAH DISTRICT,1,Female,11974,2526,14500
KILLA ABDULLAH DISTRICT,1,Transgender,0,0,0
KILLA ABDULLAH DISTRICT,2,Male,13604,3041,16645
KILLA ABDULLAH DISTRICT,2,Female,12313,2665,14978
KILLA ABDULLAH DISTRICT,2,Transgender,0,0,0
KILLA ABDULLAH DISTRICT,3,Male,13258,3119,16377
KILLA ABDULLAH DISTRICT,3,Female,11782,2747,14529
KILLA ABDULLAH DISTRICT,3,Transgender,0,0,0
KILLA ABDULLAH DISTRICT,4,Male,12890,2784,15674
KILLA ABDULLAH DISTRICT,4,Female,11540,2671,14211
KILLA ABDULLAH DISTRICT,4,Transgender,0,0,0
KILLA ABDULLAH DISTRICT,5,Male,12478,3048,15526
KILLA ABDULLAH DISTRICT,5,Female,10914,2614,13528
KILLA ABDULLAH DISTRICT,5,Transgender,0,0,0
KILLA ABDULLAH DISTRICT,6,Male,12224,2808,15032
KILLA ABDULLAH DISTRICT,6,Female,11010,2490,13500
KILLA ABDULLAH DISTRICT,6,Transgender,0,0,0
KILLA ABDULLAH DISTRICT,7,Male,12301,2951,15252
KILLA ABDULLAH DISTRICT,7,Female,10909,2627,13536
KILLA ABDULLAH DISTRICT,7,Transgender,0,0,0
KILLA ABDULLAH DISTRICT,8,Male,11219,2682,13901
KILLA ABDULLAH DISTRICT,8,Female,9855,2305,12160
KILLA ABDULLAH DISTRICT,8,Transgender,0,0,0
KILLA ABDULLAH DISTRICT,9,Male,11803,2913,14716
KILLA ABDULLAH DISTRICT,9,Female,10176,2610,12786
KILLA ABDULLAH DISTRICT,9,Transgender,0,0,0
KILLA ABDULLAH DISTRICT,10,Male,10150,2485,12635
KILLA ABDULLAH DISTRICT,10,Female,8884,2130,11014
KILLA ABDULLAH DISTRICT,10,Transgender,0,0,0
KILLA ABDULLAH DISTRICT,11,Male,10477,2740,13217
KILLA ABDULLAH DISTRICT,11,Female,8967,2413,11380
KILLA ABDULLAH DISTRICT,11,Transgender,0,0,0
KILLA ABDULLAH DISTRICT,12,Male,8622,2158,10780
KILLA ABDULLAH DISTRICT,12,Female,7479,1880,9359
KILLA ABDULLAH DISTRICT,12,Transgender,0,0,0
KILLA ABDULLAH DISTRICT,13,Male,9252,2544,11796
KILLA ABDULLAH DISTRICT,13,Female,7649,2096,9745
KILLA ABDULLAH DISTRICT,13,Transgender,0,0,0
KILLA ABDULLAH DISTRICT,14,Male,8269,2078,10347
KILLA ABDULLAH DISTRICT,14,Female,7118,1844,8962
KILLA ABDULLAH DISTRICT,14,Transgender,0,0,0
KILLA ABDULLAH DISTRICT,15,Male,7813,2201,10014
KILLA ABDULLAH DISTRICT,15,Female,6975,1784,8759
KILLA ABDULLAH DISTRICT,15,Transgender,0,0,0
KILLA ABDULLAH DISTRICT,16,Male,7199,1909,9108
KILLA ABDULLAH DISTRICT,16,Female,6202,1689,7891
KILLA ABDULLAH DISTRICT,16,Transgender,0,0,0
KILLA ABDULLAH DISTRICT,17,Male,6538,1855,8393
KILLA ABDULLAH DISTRICT,17,Female,6110,1599,7709
KILLA ABDULLAH DISTRICT,17,Transgender,0,0,0
KILLA ABDULLAH DISTRICT,18,Male,7124,1917,9041
KILLA ABDULLAH DISTRICT,18,Female,6021,1563,7584
KILLA ABDULLAH DISTRICT,18,Transgender,0,0,0
KILLA ABDULLAH DISTRICT,19,Male,6858,1846,8704
KILLA ABDULLAH DISTRICT,19,Female,6120,1544,7664
KILLA ABDULLAH DISTRICT,19,Transgender,1,0,1
KILLA ABDULLAH DISTRICT,20,Male,6001,1574,7575
KILLA ABDULLAH DISTRICT,20,Female,5539,1405,6944
KILLA ABDULLAH DISTRICT,20,Transgender,0,0,0
KILLA ABDULLAH DISTRICT,21,Male,5649,1566,7215
KILLA ABDULLAH DISTRICT,21,Female,5349,1352,6701
KILLA ABDULLAH DISTRICT,21,Transgender,0,0,0
KILLA ABDULLAH DISTRICT,22,Male,4530,1195,5725
KILLA ABDULLAH DISTRICT,22,Female,4416,1137,5553
KILLA ABDULLAH DISTRICT,22,Transgender,0,0,0
KILLA ABDULLAH DISTRICT,23,Male,4566,1288,5854
KILLA ABDULLAH DISTRICT,23,Female,4433,1178,5611
KILLA ABDULLAH DISTRICT,23,Transgender,0,0,0
KILLA ABDULLAH DISTRICT,24,Male,4304,976,5280
KILLA ABDULLAH DISTRICT,24,Female,4170,987,5157
KILLA ABDULLAH DISTRICT,24,Transgender,0,0,0
KILLA ABDULLAH DISTRICT,25,Male,4275,1034,5309
KILLA ABDULLAH DISTRICT,25,Female,4793,1148,5941
KILLA ABDULLAH DISTRICT,25,Transgender,0,0,0
KILLA ABDULLAH DISTRICT,26,Male,3903,966,4869
KILLA ABDULLAH DISTRICT,26,Female,3961,909,4870
KILLA ABDULLAH DISTRICT,26,Transgender,0,0,0
KILLA ABDULLAH DISTRICT,27,Male,4486,1109,5595
KILLA ABDULLAH DISTRICT,27,Female,4572,1052,5624
KILLA ABDULLAH DISTRICT,27,Transgender,0,0,0
KILLA ABDULLAH DISTRICT,28,Male,3614,957,4571
KILLA ABDULLAH DISTRICT,28,Female,3992,904,4896
KILLA ABDULLAH DISTRICT,28,Transgender,0,0,0
KILLA ABDULLAH DISTRICT,29,Male,4267,1036,5303
KILLA ABDULLAH DISTRICT,29,Female,4551,1005,5556
KILLA ABDULLAH DISTRICT,29,Transgender,0,0,0
KILLA ABDULLAH DISTRICT,30,Male,3475,798,4273
KILLA ABDULLAH DISTRICT,30,Female,3676,908,4584
KILLA ABDULLAH DISTRICT,30,Transgender,0,0,0
KILLA ABDULLAH DISTRICT,31,Male,4034,968,5002
KILLA ABDULLAH DISTRICT,31,Female,3855,874,4729
KILLA ABDULLAH DISTRICT,31,Transgender,0,0,0
KILLA ABDULLAH DISTRICT,32,Male,3275,808,4083
KILLA ABDULLAH DISTRICT,32,Female,3193,741,3934
KILLA ABDULLAH DISTRICT,32,Transgender,0,0,0
KILLA ABDULLAH DISTRICT,33,Male,3437,889,4326
KILLA ABDULLAH DISTRICT,33,Female,3197,799,3996
KILLA ABDULLAH DISTRICT,33,Transgender,0,0,0
KILLA ABDULLAH DISTRICT,34,Male,2933,670,3603
KILLA ABDULLAH DISTRICT,34,Female,2481,629,3110
KILLA ABDULLAH DISTRICT,34,Transgender,0,0,0
KILLA ABDULLAH DISTRICT,35,Male,2610,697,3307
KILLA ABDULLAH DISTRICT,35,Female,2505,674,3179
KILLA ABDULLAH DISTRICT,35,Transgender,0,0,0
KILLA ABDULLAH DISTRICT,36,Male,2618,635,3253
KILLA ABDULLAH DISTRICT,36,Female,2015,543,2558
KILLA ABDULLAH DISTRICT,36,Transgender,0,0,0
KILLA ABDULLAH DISTRICT,37,Male,3795,887,4682
KILLA ABDULLAH DISTRICT,37,Female,3000,774,3774
KILLA ABDULLAH DISTRICT,37,Transgender,0,0,0
KILLA ABDULLAH DISTRICT,38,Male,2517,651,3168
KILLA ABDULLAH DISTRICT,38,Female,2082,535,2617
KILLA ABDULLAH DISTRICT,38,Transgender,0,0,0
KILLA ABDULLAH DISTRICT,39,Male,2775,750,3525
KILLA ABDULLAH DISTRICT,39,Female,2272,546,2818
KILLA ABDULLAH DISTRICT,39,Transgender,0,0,0
KILLA ABDULLAH DISTRICT,40,Male,1779,486,2265
KILLA ABDULLAH DISTRICT,40,Female,2035,544,2579
KILLA ABDULLAH DISTRICT,40,Transgender,0,0,0
KILLA ABDULLAH DISTRICT,41,Male,2048,583,2631
KILLA ABDULLAH DISTRICT,41,Female,1751,464,2215
KILLA ABDULLAH DISTRICT,41,Transgender,0,0,0
KILLA ABDULLAH DISTRICT,42,Male,1685,439,2124
KILLA ABDULLAH DISTRICT,42,Female,1573,425,1998
KILLA ABDULLAH DISTRICT,42,Transgender,0,0,0
KILLA ABDULLAH DISTRICT,43,Male,1407,439,1846
KILLA ABDULLAH DISTRICT,43,Female,1425,416,1841
KILLA ABDULLAH DISTRICT,43,Transgender,0,0,0
KILLA ABDULLAH DISTRICT,44,Male,1309,329,1638
KILLA ABDULLAH DISTRICT,44,Female,1252,329,1581
KILLA ABDULLAH DISTRICT,44,Transgender,0,0,0
KILLA ABDULLAH DISTRICT,45,Male,1212,333,1545
KILLA ABDULLAH DISTRICT,45,Female,1362,331,1693
KILLA ABDULLAH DISTRICT,45,Transgender,0,0,0
KILLA ABDULLAH DISTRICT,46,Male,1206,327,1533
KILLA ABDULLAH DISTRICT,46,Female,1115,267,1382
KILLA ABDULLAH DISTRICT,46,Transgender,0,0,0
KILLA ABDULLAH DISTRICT,47,Male,1673,434,2107
KILLA ABDULLAH DISTRICT,47,Female,1928,465,2393
KILLA ABDULLAH DISTRICT,47,Transgender,0,0,0
KILLA ABDULLAH DISTRICT,48,Male,1273,331,1604
KILLA ABDULLAH DISTRICT,48,Female,1112,260,1372
KILLA ABDULLAH DISTRICT,48,Transgender,0,0,0
KILLA ABDULLAH DISTRICT,49,Male,1571,391,1962
KILLA ABDULLAH DISTRICT,49,Female,1314,324,1638
KILLA ABDULLAH DISTRICT,49,Transgender,0,0,0
KILLA ABDULLAH DISTRICT,50,Male,1290,372,1662
KILLA ABDULLAH DISTRICT,50,Female,1194,318,1512
KILLA ABDULLAH DISTRICT,50,Transgender,0,0,0
KILLA ABDULLAH DISTRICT,51,Male,1681,446,2127
KILLA ABDULLAH DISTRICT,51,Female,1242,303,1545
KILLA ABDULLAH DISTRICT,51,Transgender,0,0,0
KILLA ABDULLAH DISTRICT,52,Male,1348,334,1682
KILLA ABDULLAH DISTRICT,52,Female,1134,294,1428
KILLA ABDULLAH DISTRICT,52,Transgender,0,0,0
KILLA ABDULLAH DISTRICT,53,Male,1380,338,1718
KILLA ABDULLAH DISTRICT,53,Female,891,221,1112
KILLA ABDULLAH DISTRICT,53,Transgender,0,0,0
KILLA ABDULLAH DISTRICT,54,Male,1218,299,1517
KILLA ABDULLAH DISTRICT,54,Female,781,205,986
KILLA ABDULLAH DISTRICT,54,Transgender,0,0,0
KILLA ABDULLAH DISTRICT,55,Male,907,230,1137
KILLA ABDULLAH DISTRICT,55,Female,724,176,900
KILLA ABDULLAH DISTRICT,55,Transgender,0,0,0
KILLA ABDULLAH DISTRICT,56,Male,868,207,1075
KILLA ABDULLAH DISTRICT,56,Female,667,144,811
KILLA ABDULLAH DISTRICT,56,Transgender,0,0,0
KILLA ABDULLAH DISTRICT,57,Male,978,234,1212
KILLA ABDULLAH DISTRICT,57,Female,1121,327,1448
KILLA ABDULLAH DISTRICT,57,Transgender,0,0,0
KILLA ABDULLAH DISTRICT,58,Male,773,195,968
KILLA ABDULLAH DISTRICT,58,Female,627,162,789
KILLA ABDULLAH DISTRICT,58,Transgender,0,0,0
KILLA ABDULLAH DISTRICT,59,Male,875,204,1079
KILLA ABDULLAH DISTRICT,59,Female,722,171,893
KILLA ABDULLAH DISTRICT,59,Transgender,0,0,0
KILLA ABDULLAH DISTRICT,60,Male,654,177,831
KILLA ABDULLAH DISTRICT,60,Female,600,171,771
KILLA ABDULLAH DISTRICT,60,Transgender,0,0,0
KILLA ABDULLAH DISTRICT,61,Male,752,176,928
KILLA ABDULLAH DISTRICT,61,Female,713,153,866
KILLA ABDULLAH DISTRICT,61,Transgender,0,0,0
KILLA ABDULLAH DISTRICT,62,Male,655,166,821
KILLA ABDULLAH DISTRICT,62,Female,784,186,970
KILLA ABDULLAH DISTRICT,62,Transgender,0,0,0
KILLA ABDULLAH DISTRICT,63,Male,779,153,932
KILLA ABDULLAH DISTRICT,63,Female,703,135,838
KILLA ABDULLAH DISTRICT,63,Transgender,0,0,0
KILLA ABDULLAH DISTRICT,64,Male,782,139,921
KILLA ABDULLAH DISTRICT,64,Female,668,136,804
KILLA ABDULLAH DISTRICT,64,Transgender,0,0,0
KILLA ABDULLAH DISTRICT,65,Male,503,117,620
KILLA ABDULLAH DISTRICT,65,Female,426,91,517
KILLA ABDULLAH DISTRICT,65,Transgender,1,0,1
KILLA ABDULLAH DISTRICT,66,Male,527,113,640
KILLA ABDULLAH DISTRICT,66,Female,479,103,582
KILLA ABDULLAH DISTRICT,66,Transgender,0,0,0
KILLA ABDULLAH DISTRICT,67,Male,604,151,755
KILLA ABDULLAH DISTRICT,67,Female,794,179,973
KILLA ABDULLAH DISTRICT,67,Transgender,0,0,0
KILLA ABDULLAH DISTRICT,68,Male,602,146,748
KILLA ABDULLAH DISTRICT,68,Female,517,112,629
KILLA ABDULLAH DISTRICT,68,Transgender,0,0,0
KILLA ABDULLAH DISTRICT,69,Male,564,132,696
KILLA ABDULLAH DISTRICT,69,Female,508,106,614
KILLA ABDULLAH DISTRICT,69,Transgender,0,0,0
KILLA ABDULLAH DISTRICT,70,Male,343,86,429
KILLA ABDULLAH DISTRICT,70,Female,305,91,396
KILLA ABDULLAH DISTRICT,70,Transgender,0,1,1
KILLA ABDULLAH DISTRICT,71,Male,470,93,563
KILLA ABDULLAH DISTRICT,71,Female,380,89,469
KILLA ABDULLAH DISTRICT,71,Transgender,0,0,0
KILLA ABDULLAH DISTRICT,72,Male,418,107,525
KILLA ABDULLAH DISTRICT,72,Female,387,98,485
KILLA ABDULLAH DISTRICT,72,Transgender,0,0,0
KILLA ABDULLAH DISTRICT,73,Male,453,109,562
KILLA ABDULLAH DISTRICT,73,Female,349,91,440
KILLA ABDULLAH DISTRICT,73,Transgender,0,0,0
KILLA ABDULLAH DISTRICT,74,Male,383,80,463
KILLA ABDULLAH DISTRICT,74,Female,241,66,307
KILLA ABDULLAH DISTRICT,74,Transgender,0,0,0
KILLA ABDULLAH DISTRICT,>=75,Male,2694,546,3240
KILLA ABDULLAH DISTRICT,>=75,Female,2030,472,2502
KILLA ABDULLAH DISTRICT,>=75,Transgender,1,0,1
KILLA SAIFULLAH DISTRICT,<1,Male,4871,994,5865
KILLA SAIFULLAH DISTRICT,<1,Female,4321,882,5203
KILLA SAIFULLAH DISTRICT,<1,Transgender,0,0,0
KILLA SAIFULLAH DISTRICT,1,Male,5965,1262,7227
KILLA SAIFULLAH DISTRICT,1,Female,5488,1092,6580
KILLA SAIFULLAH DISTRICT,1,Transgender,0,0,0
KILLA SAIFULLAH DISTRICT,2,Male,6433,1247,7680
KILLA SAIFULLAH DISTRICT,2,Female,6141,1180,7321
KILLA SAIFULLAH DISTRICT,2,Transgender,0,0,0
KILLA SAIFULLAH DISTRICT,3,Male,6532,1353,7885
KILLA SAIFULLAH DISTRICT,3,Female,5870,1191,7061
KILLA SAIFULLAH DISTRICT,3,Transgender,0,0,0
KILLA SAIFULLAH DISTRICT,4,Male,6337,1289,7626
KILLA SAIFULLAH DISTRICT,4,Female,5914,1160,7074
KILLA SAIFULLAH DISTRICT,4,Transgender,0,0,0
KILLA SAIFULLAH DISTRICT,5,Male,6196,1301,7497
KILLA SAIFULLAH DISTRICT,5,Female,5321,1080,6401
KILLA SAIFULLAH DISTRICT,5,Transgender,0,0,0
KILLA SAIFULLAH DISTRICT,6,Male,6240,1177,7417
KILLA SAIFULLAH DISTRICT,6,Female,5348,1107,6455
KILLA SAIFULLAH DISTRICT,6,Transgender,0,0,0
KILLA SAIFULLAH DISTRICT,7,Male,6098,1210,7308
KILLA SAIFULLAH DISTRICT,7,Female,4984,1080,6064
KILLA SAIFULLAH DISTRICT,7,Transgender,0,0,0
KILLA SAIFULLAH DISTRICT,8,Male,5901,1149,7050
KILLA SAIFULLAH DISTRICT,8,Female,4838,988,5826
KILLA SAIFULLAH DISTRICT,8,Transgender,0,0,0
KILLA SAIFULLAH DISTRICT,9,Male,5443,1106,6549
KILLA SAIFULLAH DISTRICT,9,Female,4718,1010,5728
KILLA SAIFULLAH DISTRICT,9,Transgender,0,0,0
KILLA SAIFULLAH DISTRICT,10,Male,5111,955,6066
KILLA SAIFULLAH DISTRICT,10,Female,4121,792,4913
KILLA SAIFULLAH DISTRICT,10,Transgender,0,0,0
KILLA SAIFULLAH DISTRICT,11,Male,4389,993,5382
KILLA SAIFULLAH DISTRICT,11,Female,3579,786,4365
KILLA SAIFULLAH DISTRICT,11,Transgender,0,0,0
KILLA SAIFULLAH DISTRICT,12,Male,4067,847,4914
KILLA SAIFULLAH DISTRICT,12,Female,3170,695,3865
KILLA SAIFULLAH DISTRICT,12,Transgender,0,0,0
KILLA SAIFULLAH DISTRICT,13,Male,3947,843,4790
KILLA SAIFULLAH DISTRICT,13,Female,3033,736,3769
KILLA SAIFULLAH DISTRICT,13,Transgender,0,0,0
KILLA SAIFULLAH DISTRICT,14,Male,3491,763,4254
KILLA SAIFULLAH DISTRICT,14,Female,2628,633,3261
KILLA SAIFULLAH DISTRICT,14,Transgender,0,0,0
KILLA SAIFULLAH DISTRICT,15,Male,3449,746,4195
KILLA SAIFULLAH DISTRICT,15,Female,2414,612,3026
KILLA SAIFULLAH DISTRICT,15,Transgender,0,0,0
KILLA SAIFULLAH DISTRICT,16,Male,2946,719,3665
KILLA SAIFULLAH DISTRICT,16,Female,2146,568,2714
KILLA SAIFULLAH DISTRICT,16,Transgender,0,0,0
KILLA SAIFULLAH DISTRICT,17,Male,2619,632,3251
KILLA SAIFULLAH DISTRICT,17,Female,2051,565,2616
KILLA SAIFULLAH DISTRICT,17,Transgender,0,0,0
KILLA SAIFULLAH DISTRICT,18,Male,2985,710,3695
KILLA SAIFULLAH DISTRICT,18,Female,2526,662,3188
KILLA SAIFULLAH DISTRICT,18,Transgender,0,0,0
KILLA SAIFULLAH DISTRICT,19,Male,2621,646,3267
KILLA SAIFULLAH DISTRICT,19,Female,2296,636,2932
KILLA SAIFULLAH DISTRICT,19,Transgender,1,0,1
KILLA SAIFULLAH DISTRICT,20,Male,2504,583,3087
KILLA SAIFULLAH DISTRICT,20,Female,2508,597,3105
KILLA SAIFULLAH DISTRICT,20,Transgender,0,0,0
KILLA SAIFULLAH DISTRICT,21,Male,2031,571,2602
KILLA SAIFULLAH DISTRICT,21,Female,2122,614,2736
KILLA SAIFULLAH DISTRICT,21,Transgender,0,0,0
KILLA SAIFULLAH DISTRICT,22,Male,1902,486,2388
KILLA SAIFULLAH DISTRICT,22,Female,1585,506,2091
KILLA SAIFULLAH DISTRICT,22,Transgender,1,0,1
KILLA SAIFULLAH DISTRICT,23,Male,1767,524,2291
KILLA SAIFULLAH DISTRICT,23,Female,1739,501,2240
KILLA SAIFULLAH DISTRICT,23,Transgender,1,0,1
KILLA SAIFULLAH DISTRICT,24,Male,1667,433,2100
KILLA SAIFULLAH DISTRICT,24,Female,1349,430,1779
KILLA SAIFULLAH DISTRICT,24,Transgender,0,0,0
KILLA SAIFULLAH DISTRICT,25,Male,2197,523,2720
KILLA SAIFULLAH DISTRICT,25,Female,2168,555,2723
KILLA SAIFULLAH DISTRICT,25,Transgender,2,0,2
KILLA SAIFULLAH DISTRICT,26,Male,1689,460,2149
KILLA SAIFULLAH DISTRICT,26,Female,2089,563,2652
KILLA SAIFULLAH DISTRICT,26,Transgender,0,0,0
KILLA SAIFULLAH DISTRICT,27,Male,1749,448,2197
KILLA SAIFULLAH DISTRICT,27,Female,2072,474,2546
KILLA SAIFULLAH DISTRICT,27,Transgender,0,0,0
KILLA SAIFULLAH DISTRICT,28,Male,1766,463,2229
KILLA SAIFULLAH DISTRICT,28,Female,1797,470,2267
KILLA SAIFULLAH DISTRICT,28,Transgender,0,0,0
KILLA SAIFULLAH DISTRICT,29,Male,1800,433,2233
KILLA SAIFULLAH DISTRICT,29,Female,2076,534,2610
KILLA SAIFULLAH DISTRICT,29,Transgender,0,0,0
KILLA SAIFULLAH DISTRICT,30,Male,1736,436,2172
KILLA SAIFULLAH DISTRICT,30,Female,1905,466,2371
KILLA SAIFULLAH DISTRICT,30,Transgender,0,0,0
KILLA SAIFULLAH DISTRICT,31,Male,1762,382,2144
KILLA SAIFULLAH DISTRICT,31,Female,1876,427,2303
KILLA SAIFULLAH DISTRICT,31,Transgender,0,0,0
KILLA SAIFULLAH DISTRICT,32,Male,1342,354,1696
KILLA SAIFULLAH DISTRICT,32,Female,1440,325,1765
KILLA SAIFULLAH DISTRICT,32,Transgender,0,0,0
KILLA SAIFULLAH DISTRICT,33,Male,1414,365,1779
KILLA SAIFULLAH DISTRICT,33,Female,1408,325,1733
KILLA SAIFULLAH DISTRICT,33,Transgender,0,0,0
KILLA SAIFULLAH DISTRICT,34,Male,1247,313,1560
KILLA SAIFULLAH DISTRICT,34,Female,1114,304,1418
KILLA SAIFULLAH DISTRICT,34,Transgender,0,0,0
KILLA SAIFULLAH DISTRICT,35,Male,1348,318,1666
KILLA SAIFULLAH DISTRICT,35,Female,1196,311,1507
KILLA SAIFULLAH DISTRICT,35,Transgender,0,0,0
KILLA SAIFULLAH DISTRICT,36,Male,1298,299,1597
KILLA SAIFULLAH DISTRICT,36,Female,1019,289,1308
KILLA SAIFULLAH DISTRICT,36,Transgender,0,0,0
KILLA SAIFULLAH DISTRICT,37,Male,1489,317,1806
KILLA SAIFULLAH DISTRICT,37,Female,1369,293,1662
KILLA SAIFULLAH DISTRICT,37,Transgender,0,0,0
KILLA SAIFULLAH DISTRICT,38,Male,1149,315,1464
KILLA SAIFULLAH DISTRICT,38,Female,926,262,1188
KILLA SAIFULLAH DISTRICT,38,Transgender,0,0,0
KILLA SAIFULLAH DISTRICT,39,Male,1185,322,1507
KILLA SAIFULLAH DISTRICT,39,Female,1076,249,1325
KILLA SAIFULLAH DISTRICT,39,Transgender,0,0,0
KILLA SAIFULLAH DISTRICT,40,Male,1194,324,1518
KILLA SAIFULLAH DISTRICT,40,Female,1171,269,1440
KILLA SAIFULLAH DISTRICT,40,Transgender,0,0,0
KILLA SAIFULLAH DISTRICT,41,Male,907,229,1136
KILLA SAIFULLAH DISTRICT,41,Female,932,238,1170
KILLA SAIFULLAH DISTRICT,41,Transgender,0,0,0
KILLA SAIFULLAH DISTRICT,42,Male,754,179,933
KILLA SAIFULLAH DISTRICT,42,Female,780,195,975
KILLA SAIFULLAH DISTRICT,42,Transgender,0,0,0
KILLA SAIFULLAH DISTRICT,43,Male,735,199,934
KILLA SAIFULLAH DISTRICT,43,Female,717,192,909
KILLA SAIFULLAH DISTRICT,43,Transgender,0,0,0
KILLA SAIFULLAH DISTRICT,44,Male,643,182,825
KILLA SAIFULLAH DISTRICT,44,Female,630,163,793
KILLA SAIFULLAH DISTRICT,44,Transgender,0,0,0
KILLA SAIFULLAH DISTRICT,45,Male,752,222,974
KILLA SAIFULLAH DISTRICT,45,Female,698,182,880
KILLA SAIFULLAH DISTRICT,45,Transgender,0,0,0
KILLA SAIFULLAH DISTRICT,46,Male,740,174,914
KILLA SAIFULLAH DISTRICT,46,Female,653,164,817
KILLA SAIFULLAH DISTRICT,46,Transgender,0,0,0
KILLA SAIFULLAH DISTRICT,47,Male,799,197,996
KILLA SAIFULLAH DISTRICT,47,Female,787,148,935
KILLA SAIFULLAH DISTRICT,47,Transgender,0,0,0
KILLA SAIFULLAH DISTRICT,48,Male,609,181,790
KILLA SAIFULLAH DISTRICT,48,Female,513,143,656
KILLA SAIFULLAH DISTRICT,48,Transgender,0,0,0
KILLA SAIFULLAH DISTRICT,49,Male,738,170,908
KILLA SAIFULLAH DISTRICT,49,Female,620,160,780
KILLA SAIFULLAH DISTRICT,49,Transgender,0,0,0
KILLA SAIFULLAH DISTRICT,50,Male,731,188,919
KILLA SAIFULLAH DISTRICT,50,Female,632,148,780
KILLA SAIFULLAH DISTRICT,50,Transgender,0,0,0
KILLA SAIFULLAH DISTRICT,51,Male,726,171,897
KILLA SAIFULLAH DISTRICT,51,Female,513,130,643
KILLA SAIFULLAH DISTRICT,51,Transgender,0,0,0
KILLA SAIFULLAH DISTRICT,52,Male,585,158,743
KILLA SAIFULLAH DISTRICT,52,Female,424,103,527
KILLA SAIFULLAH DISTRICT,52,Transgender,0,0,0
KILLA SAIFULLAH DISTRICT,53,Male,564,159,723
KILLA SAIFULLAH DISTRICT,53,Female,433,117,550
KILLA SAIFULLAH DISTRICT,53,Transgender,0,0,0
KILLA SAIFULLAH DISTRICT,54,Male,517,109,626
KILLA SAIFULLAH DISTRICT,54,Female,387,99,486
KILLA SAIFULLAH DISTRICT,54,Transgender,0,0,0
KILLA SAIFULLAH DISTRICT,55,Male,484,172,656
KILLA SAIFULLAH DISTRICT,55,Female,399,105,504
KILLA SAIFULLAH DISTRICT,55,Transgender,0,0,0
KILLA SAIFULLAH DISTRICT,56,Male,452,125,577
KILLA SAIFULLAH DISTRICT,56,Female,406,111,517
KILLA SAIFULLAH DISTRICT,56,Transgender,0,0,0
KILLA SAIFULLAH DISTRICT,57,Male,526,99,625
KILLA SAIFULLAH DISTRICT,57,Female,471,97,568
KILLA SAIFULLAH DISTRICT,57,Transgender,0,0,0
KILLA SAIFULLAH DISTRICT,58,Male,426,119,545
KILLA SAIFULLAH DISTRICT,58,Female,384,93,477
KILLA SAIFULLAH DISTRICT,58,Transgender,0,0,0
KILLA SAIFULLAH DISTRICT,59,Male,488,108,596
KILLA SAIFULLAH DISTRICT,59,Female,371,110,481
KILLA SAIFULLAH DISTRICT,59,Transgender,0,0,0
KILLA SAIFULLAH DISTRICT,60,Male,495,133,628
KILLA SAIFULLAH DISTRICT,60,Female,455,105,560
KILLA SAIFULLAH DISTRICT,60,Transgender,0,0,0
KILLA SAIFULLAH DISTRICT,61,Male,437,100,537
KILLA SAIFULLAH DISTRICT,61,Female,380,87,467
KILLA SAIFULLAH DISTRICT,61,Transgender,0,0,0
KILLA SAIFULLAH DISTRICT,62,Male,283,77,360
KILLA SAIFULLAH DISTRICT,62,Female,368,77,445
KILLA SAIFULLAH DISTRICT,62,Transgender,0,0,0
KILLA SAIFULLAH DISTRICT,63,Male,405,83,488
KILLA SAIFULLAH DISTRICT,63,Female,342,88,430
KILLA SAIFULLAH DISTRICT,63,Transgender,0,0,0
KILLA SAIFULLAH DISTRICT,64,Male,447,107,554
KILLA SAIFULLAH DISTRICT,64,Female,387,79,466
KILLA SAIFULLAH DISTRICT,64,Transgender,0,0,0
KILLA SAIFULLAH DISTRICT,65,Male,330,79,409
KILLA SAIFULLAH DISTRICT,65,Female,271,57,328
KILLA SAIFULLAH DISTRICT,65,Transgender,0,0,0
KILLA SAIFULLAH DISTRICT,66,Male,357,68,425
KILLA SAIFULLAH DISTRICT,66,Female,303,68,371
KILLA SAIFULLAH DISTRICT,66,Transgender,0,0,0
KILLA SAIFULLAH DISTRICT,67,Male,290,60,350
KILLA SAIFULLAH DISTRICT,67,Female,393,78,471
KILLA SAIFULLAH DISTRICT,67,Transgender,0,0,0
KILLA SAIFULLAH DISTRICT,68,Male,295,66,361
KILLA SAIFULLAH DISTRICT,68,Female,237,49,286
KILLA SAIFULLAH DISTRICT,68,Transgender,0,0,0
KILLA SAIFULLAH DISTRICT,69,Male,424,66,490
KILLA SAIFULLAH DISTRICT,69,Female,287,47,334
KILLA SAIFULLAH DISTRICT,69,Transgender,0,0,0
KILLA SAIFULLAH DISTRICT,70,Male,245,59,304
KILLA SAIFULLAH DISTRICT,70,Female,211,40,251
KILLA SAIFULLAH DISTRICT,70,Transgender,0,0,0
KILLA SAIFULLAH DISTRICT,71,Male,257,67,324
KILLA SAIFULLAH DISTRICT,71,Female,198,44,242
KILLA SAIFULLAH DISTRICT,71,Transgender,0,0,0
KILLA SAIFULLAH DISTRICT,72,Male,172,48,220
KILLA SAIFULLAH DISTRICT,72,Female,143,29,172
KILLA SAIFULLAH DISTRICT,72,Transgender,0,0,0
KILLA SAIFULLAH DISTRICT,73,Male,251,59,310
KILLA SAIFULLAH DISTRICT,73,Female,147,37,184
KILLA SAIFULLAH DISTRICT,73,Transgender,0,0,0
KILLA SAIFULLAH DISTRICT,74,Male,256,43,299
KILLA SAIFULLAH DISTRICT,74,Female,133,27,160
KILLA SAIFULLAH DISTRICT,74,Transgender,0,0,0
KILLA SAIFULLAH DISTRICT,>=75,Male,1616,326,1942
KILLA SAIFULLAH DISTRICT,>=75,Female,1104,271,1375
KILLA SAIFULLAH DISTRICT,>=75,Transgender,0,0,0
KOHAT DISTRICT,<1,Male,9372,3158,12530
KOHAT DISTRICT,<1,Female,9018,3016,12034
KOHAT DISTRICT,<1,Transgender,0,0,0
KOHAT DISTRICT,1,Male,11136,3726,14862
KOHAT DISTRICT,1,Female,10117,3225,13342
KOHAT DISTRICT,1,Transgender,0,0,0
KOHAT DISTRICT,2,Male,11317,3582,14899
KOHAT DISTRICT,2,Female,10808,3345,14153
KOHAT DISTRICT,2,Transgender,0,0,0
KOHAT DISTRICT,3,Male,11832,3865,15697
KOHAT DISTRICT,3,Female,11247,3665,14912
KOHAT DISTRICT,3,Transgender,0,0,0
KOHAT DISTRICT,4,Male,11380,3574,14954
KOHAT DISTRICT,4,Female,10477,3393,13870
KOHAT DISTRICT,4,Transgender,0,0,0
KOHAT DISTRICT,5,Male,12050,3644,15694
KOHAT DISTRICT,5,Female,11113,3358,14471
KOHAT DISTRICT,5,Transgender,0,0,0
KOHAT DISTRICT,6,Male,10641,3473,14114
KOHAT DISTRICT,6,Female,10135,3181,13316
KOHAT DISTRICT,6,Transgender,0,0,0
KOHAT DISTRICT,7,Male,11477,3586,15063
KOHAT DISTRICT,7,Female,10816,3385,14201
KOHAT DISTRICT,7,Transgender,0,0,0
KOHAT DISTRICT,8,Male,10850,3378,14228
KOHAT DISTRICT,8,Female,10053,3050,13103
KOHAT DISTRICT,8,Transgender,0,0,0
KOHAT DISTRICT,9,Male,11147,3573,14720
KOHAT DISTRICT,9,Female,10113,3238,13351
KOHAT DISTRICT,9,Transgender,0,0,0
KOHAT DISTRICT,10,Male,9825,3097,12922
KOHAT DISTRICT,10,Female,9026,2830,11856
KOHAT DISTRICT,10,Transgender,0,0,0
KOHAT DISTRICT,11,Male,10311,3524,13835
KOHAT DISTRICT,11,Female,9218,3062,12280
KOHAT DISTRICT,11,Transgender,0,0,0
KOHAT DISTRICT,12,Male,9235,3141,12376
KOHAT DISTRICT,12,Female,8127,2658,10785
KOHAT DISTRICT,12,Transgender,0,0,0
KOHAT DISTRICT,13,Male,9708,3405,13113
KOHAT DISTRICT,13,Female,8715,2893,11608
KOHAT DISTRICT,13,Transgender,0,0,0
KOHAT DISTRICT,14,Male,8840,3082,11922
KOHAT DISTRICT,14,Female,7970,2650,10620
KOHAT DISTRICT,14,Transgender,0,0,0
KOHAT DISTRICT,15,Male,8768,2973,11741
KOHAT DISTRICT,15,Female,8464,2799,11263
KOHAT DISTRICT,15,Transgender,2,0,2
KOHAT DISTRICT,16,Male,8520,3041,11561
KOHAT DISTRICT,16,Female,8023,2712,10735
KOHAT DISTRICT,16,Transgender,6,2,8
KOHAT DISTRICT,17,Male,8533,3225,11758
KOHAT DISTRICT,17,Female,8450,2930,11380
KOHAT DISTRICT,17,Transgender,2,1,3
KOHAT DISTRICT,18,Male,7305,3048,10353
KOHAT DISTRICT,18,Female,7376,2522,9898
KOHAT DISTRICT,18,Transgender,2,3,5
KOHAT DISTRICT,19,Male,7311,3850,11161
KOHAT DISTRICT,19,Female,7628,2607,10235
KOHAT DISTRICT,19,Transgender,1,0,1
KOHAT DISTRICT,20,Male,6263,3343,9606
KOHAT DISTRICT,20,Female,7044,2387,9431
KOHAT DISTRICT,20,Transgender,5,0,5
KOHAT DISTRICT,21,Male,6414,3814,10228
KOHAT DISTRICT,21,Female,7264,2656,9920
KOHAT DISTRICT,21,Transgender,1,3,4
KOHAT DISTRICT,22,Male,5424,2962,8386
KOHAT DISTRICT,22,Female,6540,2424,8964
KOHAT DISTRICT,22,Transgender,0,4,4
KOHAT DISTRICT,23,Male,6039,3237,9276
KOHAT DISTRICT,23,Female,6806,2507,9313
KOHAT DISTRICT,23,Transgender,3,3,6
KOHAT DISTRICT,24,Male,5193,2548,7741
KOHAT DISTRICT,24,Female,6280,2340,8620
KOHAT DISTRICT,24,Transgender,3,3,6
KOHAT DISTRICT,25,Male,5299,2310,7609
KOHAT DISTRICT,25,Female,6609,2314,8923
KOHAT DISTRICT,25,Transgender,5,5,10
KOHAT DISTRICT,26,Male,4896,2257,7153
KOHAT DISTRICT,26,Female,6212,2320,8532
KOHAT DISTRICT,26,Transgender,3,4,7
KOHAT DISTRICT,27,Male,4772,2333,7105
KOHAT DISTRICT,27,Female,6714,2471,9185
KOHAT DISTRICT,27,Transgender,2,0,2
KOHAT DISTRICT,28,Male,4509,2211,6720
KOHAT DISTRICT,28,Female,6220,2257,8477
KOHAT DISTRICT,28,Transgender,1,1,2
KOHAT DISTRICT,29,Male,4233,2114,6347
KOHAT DISTRICT,29,Female,6153,2151,8304
KOHAT DISTRICT,29,Transgender,0,1,1
KOHAT DISTRICT,30,Male,4522,2248,6770
KOHAT DISTRICT,30,Female,5854,2219,8073
KOHAT DISTRICT,30,Transgender,1,4,5
KOHAT DISTRICT,31,Male,3952,2028,5980
KOHAT DISTRICT,31,Female,5292,2074,7366
KOHAT DISTRICT,31,Transgender,1,0,1
KOHAT DISTRICT,32,Male,3634,2038,5672
KOHAT DISTRICT,32,Female,4863,1874,6737
KOHAT DISTRICT,32,Transgender,1,1,2
KOHAT DISTRICT,33,Male,3649,1958,5607
KOHAT DISTRICT,33,Female,4675,1903,6578
KOHAT DISTRICT,33,Transgender,1,0,1
KOHAT DISTRICT,34,Male,3247,1702,4949
KOHAT DISTRICT,34,Female,4148,1596,5744
KOHAT DISTRICT,34,Transgender,1,1,2
KOHAT DISTRICT,35,Male,3408,1705,5113
KOHAT DISTRICT,35,Female,4489,1725,6214
KOHAT DISTRICT,35,Transgender,0,1,1
KOHAT DISTRICT,36,Male,2954,1555,4509
KOHAT DISTRICT,36,Female,3633,1453,5086
KOHAT DISTRICT,36,Transgender,0,0,0
KOHAT DISTRICT,37,Male,2824,1497,4321
KOHAT DISTRICT,37,Female,3805,1410,5215
KOHAT DISTRICT,37,Transgender,0,1,1
KOHAT DISTRICT,38,Male,3337,1850,5187
KOHAT DISTRICT,38,Female,3961,1660,5621
KOHAT DISTRICT,38,Transgender,0,0,0
KOHAT DISTRICT,39,Male,2987,1553,4540
KOHAT DISTRICT,39,Female,3644,1493,5137
KOHAT DISTRICT,39,Transgender,0,0,0
KOHAT DISTRICT,40,Male,3107,1681,4788
KOHAT DISTRICT,40,Female,4205,1710,5915
KOHAT DISTRICT,40,Transgender,0,0,0
KOHAT DISTRICT,41,Male,2697,1395,4092
KOHAT DISTRICT,41,Female,3173,1263,4436
KOHAT DISTRICT,41,Transgender,1,0,1
KOHAT DISTRICT,42,Male,2379,1318,3697
KOHAT DISTRICT,42,Female,2866,1174,4040
KOHAT DISTRICT,42,Transgender,1,0,1
KOHAT DISTRICT,43,Male,2596,1315,3911
KOHAT DISTRICT,43,Female,3188,1256,4444
KOHAT DISTRICT,43,Transgender,0,0,0
KOHAT DISTRICT,44,Male,2247,1126,3373
KOHAT DISTRICT,44,Female,2654,1051,3705
KOHAT DISTRICT,44,Transgender,0,0,0
KOHAT DISTRICT,45,Male,2367,1112,3479
KOHAT DISTRICT,45,Female,2995,1220,4215
KOHAT DISTRICT,45,Transgender,0,2,2
KOHAT DISTRICT,46,Male,2074,966,3040
KOHAT DISTRICT,46,Female,2395,892,3287
KOHAT DISTRICT,46,Transgender,1,0,1
KOHAT DISTRICT,47,Male,2101,947,3048
KOHAT DISTRICT,47,Female,2389,862,3251
KOHAT DISTRICT,47,Transgender,0,0,0
KOHAT DISTRICT,48,Male,2322,1142,3464
KOHAT DISTRICT,48,Female,2699,1022,3721
KOHAT DISTRICT,48,Transgender,2,0,2
KOHAT DISTRICT,49,Male,2115,943,3058
KOHAT DISTRICT,49,Female,2500,949,3449
KOHAT DISTRICT,49,Transgender,0,0,0
KOHAT DISTRICT,50,Male,2442,1170,3612
KOHAT DISTRICT,50,Female,2996,1129,4125
KOHAT DISTRICT,50,Transgender,1,2,3
KOHAT DISTRICT,51,Male,1951,806,2757
KOHAT DISTRICT,51,Female,2257,856,3113
KOHAT DISTRICT,51,Transgender,0,0,0
KOHAT DISTRICT,52,Male,1967,954,2921
KOHAT DISTRICT,52,Female,2101,843,2944
KOHAT DISTRICT,52,Transgender,0,0,0
KOHAT DISTRICT,53,Male,2021,911,2932
KOHAT DISTRICT,53,Female,2201,804,3005
KOHAT DISTRICT,53,Transgender,0,0,0
KOHAT DISTRICT,54,Male,1899,840,2739
KOHAT DISTRICT,54,Female,1980,753,2733
KOHAT DISTRICT,54,Transgender,0,0,0
KOHAT DISTRICT,55,Male,1999,899,2898
KOHAT DISTRICT,55,Female,2226,725,2951
KOHAT DISTRICT,55,Transgender,0,1,1
KOHAT DISTRICT,56,Male,1595,678,2273
KOHAT DISTRICT,56,Female,1609,551,2160
KOHAT DISTRICT,56,Transgender,0,0,0
KOHAT DISTRICT,57,Male,1657,662,2319
KOHAT DISTRICT,57,Female,1542,582,2124
KOHAT DISTRICT,57,Transgender,0,1,1
KOHAT DISTRICT,58,Male,1791,676,2467
KOHAT DISTRICT,58,Female,1703,652,2355
KOHAT DISTRICT,58,Transgender,0,0,0
KOHAT DISTRICT,59,Male,1527,613,2140
KOHAT DISTRICT,59,Female,1679,552,2231
KOHAT DISTRICT,59,Transgender,2,0,2
KOHAT DISTRICT,60,Male,1729,762,2491
KOHAT DISTRICT,60,Female,1907,646,2553
KOHAT DISTRICT,60,Transgender,3,0,3
KOHAT DISTRICT,61,Male,1496,617,2113
KOHAT DISTRICT,61,Female,1535,529,2064
KOHAT DISTRICT,61,Transgender,2,0,2
KOHAT DISTRICT,62,Male,1542,625,2167
KOHAT DISTRICT,62,Female,1422,449,1871
KOHAT DISTRICT,62,Transgender,0,0,0
KOHAT DISTRICT,63,Male,1536,653,2189
KOHAT DISTRICT,63,Female,1533,505,2038
KOHAT DISTRICT,63,Transgender,0,0,0
KOHAT DISTRICT,64,Male,1375,577,1952
KOHAT DISTRICT,64,Female,1278,430,1708
KOHAT DISTRICT,64,Transgender,0,0,0
KOHAT DISTRICT,65,Male,1346,539,1885
KOHAT DISTRICT,65,Female,1226,388,1614
KOHAT DISTRICT,65,Transgender,1,0,1
KOHAT DISTRICT,66,Male,1070,411,1481
KOHAT DISTRICT,66,Female,954,275,1229
KOHAT DISTRICT,66,Transgender,0,0,0
KOHAT DISTRICT,67,Male,1046,385,1431
KOHAT DISTRICT,67,Female,1028,306,1334
KOHAT DISTRICT,67,Transgender,0,0,0
KOHAT DISTRICT,68,Male,1111,405,1516
KOHAT DISTRICT,68,Female,994,378,1372
KOHAT DISTRICT,68,Transgender,1,0,1
KOHAT DISTRICT,69,Male,986,357,1343
KOHAT DISTRICT,69,Female,891,291,1182
KOHAT DISTRICT,69,Transgender,0,0,0
KOHAT DISTRICT,70,Male,1017,373,1390
KOHAT DISTRICT,70,Female,922,273,1195
KOHAT DISTRICT,70,Transgender,1,0,1
KOHAT DISTRICT,71,Male,841,311,1152
KOHAT DISTRICT,71,Female,761,232,993
KOHAT DISTRICT,71,Transgender,1,0,1
KOHAT DISTRICT,72,Male,894,253,1147
KOHAT DISTRICT,72,Female,758,219,977
KOHAT DISTRICT,72,Transgender,3,0,3
KOHAT DISTRICT,73,Male,832,256,1088
KOHAT DISTRICT,73,Female,670,224,894
KOHAT DISTRICT,73,Transgender,0,0,0
KOHAT DISTRICT,74,Male,682,228,910
KOHAT DISTRICT,74,Female,593,208,801
KOHAT DISTRICT,74,Transgender,0,0,0
KOHAT DISTRICT,>=75,Male,6201,1996,8197
KOHAT DISTRICT,>=75,Female,5837,1820,7657
KOHAT DISTRICT,>=75,Transgender,1,0,1
KOHISTAN DISTRICT,<1,Male,7208,0,7208
KOHISTAN DISTRICT,<1,Female,8938,0,8938
KOHISTAN DISTRICT,<1,Transgender,0,0,0
KOHISTAN DISTRICT,1,Male,8981,0,8981
KOHISTAN DISTRICT,1,Female,9940,0,9940
KOHISTAN DISTRICT,1,Transgender,0,0,0
KOHISTAN DISTRICT,2,Male,14688,0,14688
KOHISTAN DISTRICT,2,Female,16126,0,16126
KOHISTAN DISTRICT,2,Transgender,0,0,0
KOHISTAN DISTRICT,3,Male,12947,0,12947
KOHISTAN DISTRICT,3,Female,13709,0,13709
KOHISTAN DISTRICT,3,Transgender,0,0,0
KOHISTAN DISTRICT,4,Male,15988,0,15988
KOHISTAN DISTRICT,4,Female,15977,0,15977
KOHISTAN DISTRICT,4,Transgender,0,0,0
KOHISTAN DISTRICT,5,Male,14129,0,14129
KOHISTAN DISTRICT,5,Female,13322,0,13322
KOHISTAN DISTRICT,5,Transgender,0,0,0
KOHISTAN DISTRICT,6,Male,18011,0,18011
KOHISTAN DISTRICT,6,Female,15471,0,15471
KOHISTAN DISTRICT,6,Transgender,0,0,0
KOHISTAN DISTRICT,7,Male,13216,0,13216
KOHISTAN DISTRICT,7,Female,10739,0,10739
KOHISTAN DISTRICT,7,Transgender,0,0,0
KOHISTAN DISTRICT,8,Male,20842,0,20842
KOHISTAN DISTRICT,8,Female,15185,0,15185
KOHISTAN DISTRICT,8,Transgender,0,0,0
KOHISTAN DISTRICT,9,Male,13458,0,13458
KOHISTAN DISTRICT,9,Female,9638,0,9638
KOHISTAN DISTRICT,9,Transgender,0,0,0
KOHISTAN DISTRICT,10,Male,21445,0,21445
KOHISTAN DISTRICT,10,Female,13807,0,13807
KOHISTAN DISTRICT,10,Transgender,0,0,0
KOHISTAN DISTRICT,11,Male,10199,0,10199
KOHISTAN DISTRICT,11,Female,7311,0,7311
KOHISTAN DISTRICT,11,Transgender,0,0,0
KOHISTAN DISTRICT,12,Male,18617,0,18617
KOHISTAN DISTRICT,12,Female,10900,0,10900
KOHISTAN DISTRICT,12,Transgender,0,0,0
KOHISTAN DISTRICT,13,Male,10965,0,10965
KOHISTAN DISTRICT,13,Female,7183,0,7183
KOHISTAN DISTRICT,13,Transgender,0,0,0
KOHISTAN DISTRICT,14,Male,11811,0,11811
KOHISTAN DISTRICT,14,Female,8844,0,8844
KOHISTAN DISTRICT,14,Transgender,0,0,0
KOHISTAN DISTRICT,15,Male,13003,0,13003
KOHISTAN DISTRICT,15,Female,6765,0,6765
KOHISTAN DISTRICT,15,Transgender,0,0,0
KOHISTAN DISTRICT,16,Male,9878,0,9878
KOHISTAN DISTRICT,16,Female,5676,0,5676
KOHISTAN DISTRICT,16,Transgender,0,0,0
KOHISTAN DISTRICT,17,Male,8244,0,8244
KOHISTAN DISTRICT,17,Female,4724,0,4724
KOHISTAN DISTRICT,17,Transgender,0,0,0
KOHISTAN DISTRICT,18,Male,13006,0,13006
KOHISTAN DISTRICT,18,Female,8878,0,8878
KOHISTAN DISTRICT,18,Transgender,0,0,0
KOHISTAN DISTRICT,19,Male,4498,0,4498
KOHISTAN DISTRICT,19,Female,3521,0,3521
KOHISTAN DISTRICT,19,Transgender,0,0,0
KOHISTAN DISTRICT,20,Male,13172,0,13172
KOHISTAN DISTRICT,20,Female,10676,0,10676
KOHISTAN DISTRICT,20,Transgender,0,0,0
KOHISTAN DISTRICT,21,Male,3019,0,3019
KOHISTAN DISTRICT,21,Female,2385,0,2385
KOHISTAN DISTRICT,21,Transgender,0,0,0
KOHISTAN DISTRICT,22,Male,5645,0,5645
KOHISTAN DISTRICT,22,Female,4438,0,4438
KOHISTAN DISTRICT,22,Transgender,0,0,0
KOHISTAN DISTRICT,23,Male,3395,0,3395
KOHISTAN DISTRICT,23,Female,3295,0,3295
KOHISTAN DISTRICT,23,Transgender,0,0,0
KOHISTAN DISTRICT,24,Male,2899,0,2899
KOHISTAN DISTRICT,24,Female,3363,0,3363
KOHISTAN DISTRICT,24,Transgender,2,0,2
KOHISTAN DISTRICT,25,Male,12388,0,12388
KOHISTAN DISTRICT,25,Female,10532,0,10532
KOHISTAN DISTRICT,25,Transgender,0,0,0
KOHISTAN DISTRICT,26,Male,3065,0,3065
KOHISTAN DISTRICT,26,Female,2987,0,2987
KOHISTAN DISTRICT,26,Transgender,2,0,2
KOHISTAN DISTRICT,27,Male,3069,0,3069
KOHISTAN DISTRICT,27,Female,2885,0,2885
KOHISTAN DISTRICT,27,Transgender,0,0,0
KOHISTAN DISTRICT,28,Male,5308,0,5308
KOHISTAN DISTRICT,28,Female,6834,0,6834
KOHISTAN DISTRICT,28,Transgender,0,0,0
KOHISTAN DISTRICT,29,Male,1517,0,1517
KOHISTAN DISTRICT,29,Female,2062,0,2062
KOHISTAN DISTRICT,29,Transgender,0,0,0
KOHISTAN DISTRICT,30,Male,14151,0,14151
KOHISTAN DISTRICT,30,Female,12728,0,12728
KOHISTAN DISTRICT,30,Transgender,0,0,0
KOHISTAN DISTRICT,31,Male,1343,0,1343
KOHISTAN DISTRICT,31,Female,1368,0,1368
KOHISTAN DISTRICT,31,Transgender,1,0,1
KOHISTAN DISTRICT,32,Male,2637,0,2637
KOHISTAN DISTRICT,32,Female,3091,0,3091
KOHISTAN DISTRICT,32,Transgender,2,0,2
KOHISTAN DISTRICT,33,Male,2067,0,2067
KOHISTAN DISTRICT,33,Female,2674,0,2674
KOHISTAN DISTRICT,33,Transgender,2,0,2
KOHISTAN DISTRICT,34,Male,1011,0,1011
KOHISTAN DISTRICT,34,Female,1809,0,1809
KOHISTAN DISTRICT,34,Transgender,0,0,0
KOHISTAN DISTRICT,35,Male,10347,0,10347
KOHISTAN DISTRICT,35,Female,9919,0,9919
KOHISTAN DISTRICT,35,Transgender,0,0,0
KOHISTAN DISTRICT,36,Male,1418,0,1418
KOHISTAN DISTRICT,36,Female,1763,0,1763
KOHISTAN DISTRICT,36,Transgender,1,0,1
KOHISTAN DISTRICT,37,Male,1433,0,1433
KOHISTAN DISTRICT,37,Female,1662,0,1662
KOHISTAN DISTRICT,37,Transgender,1,0,1
KOHISTAN DISTRICT,38,Male,2555,0,2555
KOHISTAN DISTRICT,38,Female,4270,0,4270
KOHISTAN DISTRICT,38,Transgender,0,0,0
KOHISTAN DISTRICT,39,Male,1075,0,1075
KOHISTAN DISTRICT,39,Female,1530,0,1530
KOHISTAN DISTRICT,39,Transgender,2,0,2
KOHISTAN DISTRICT,40,Male,12787,0,12787
KOHISTAN DISTRICT,40,Female,11622,0,11622
KOHISTAN DISTRICT,40,Transgender,0,0,0
KOHISTAN DISTRICT,41,Male,949,0,949
KOHISTAN DISTRICT,41,Female,1094,0,1094
KOHISTAN DISTRICT,41,Transgender,0,0,0
KOHISTAN DISTRICT,42,Male,1077,0,1077
KOHISTAN DISTRICT,42,Female,1362,0,1362
KOHISTAN DISTRICT,42,Transgender,0,0,0
KOHISTAN DISTRICT,43,Male,1011,0,1011
KOHISTAN DISTRICT,43,Female,1322,0,1322
KOHISTAN DISTRICT,43,Transgender,0,0,0
KOHISTAN DISTRICT,44,Male,953,0,953
KOHISTAN DISTRICT,44,Female,1284,0,1284
KOHISTAN DISTRICT,44,Transgender,0,0,0
KOHISTAN DISTRICT,45,Male,6917,0,6917
KOHISTAN DISTRICT,45,Female,7338,0,7338
KOHISTAN DISTRICT,45,Transgender,0,0,0
KOHISTAN DISTRICT,46,Male,710,0,710
KOHISTAN DISTRICT,46,Female,725,0,725
KOHISTAN DISTRICT,46,Transgender,0,0,0
KOHISTAN DISTRICT,47,Male,906,0,906
KOHISTAN DISTRICT,47,Female,1046,0,1046
KOHISTAN DISTRICT,47,Transgender,0,0,0
KOHISTAN DISTRICT,48,Male,1729,0,1729
KOHISTAN DISTRICT,48,Female,2608,0,2608
KOHISTAN DISTRICT,48,Transgender,0,0,0
KOHISTAN DISTRICT,49,Male,694,0,694
KOHISTAN DISTRICT,49,Female,804,0,804
KOHISTAN DISTRICT,49,Transgender,0,0,0
KOHISTAN DISTRICT,50,Male,10625,0,10625
KOHISTAN DISTRICT,50,Female,7653,0,7653
KOHISTAN DISTRICT,50,Transgender,0,0,0
KOHISTAN DISTRICT,51,Male,714,0,714
KOHISTAN DISTRICT,51,Female,578,0,578
KOHISTAN DISTRICT,51,Transgender,0,0,0
KOHISTAN DISTRICT,52,Male,775,0,775
KOHISTAN DISTRICT,52,Female,715,0,715
KOHISTAN DISTRICT,52,Transgender,0,0,0
KOHISTAN DISTRICT,53,Male,672,0,672
KOHISTAN DISTRICT,53,Female,635,0,635
KOHISTAN DISTRICT,53,Transgender,0,0,0
KOHISTAN DISTRICT,54,Male,407,0,407
KOHISTAN DISTRICT,54,Female,435,0,435
KOHISTAN DISTRICT,54,Transgender,0,0,0
KOHISTAN DISTRICT,55,Male,4186,0,4186
KOHISTAN DISTRICT,55,Female,4893,0,4893
KOHISTAN DISTRICT,55,Transgender,0,0,0
KOHISTAN DISTRICT,56,Male,515,0,515
KOHISTAN DISTRICT,56,Female,445,0,445
KOHISTAN DISTRICT,56,Transgender,0,0,0
KOHISTAN DISTRICT,57,Male,404,0,404
KOHISTAN DISTRICT,57,Female,475,0,475
KOHISTAN DISTRICT,57,Transgender,0,0,0
KOHISTAN DISTRICT,58,Male,572,0,572
KOHISTAN DISTRICT,58,Female,900,0,900
KOHISTAN DISTRICT,58,Transgender,0,0,0
KOHISTAN DISTRICT,59,Male,273,0,273
KOHISTAN DISTRICT,59,Female,300,0,300
KOHISTAN DISTRICT,59,Transgender,0,0,0
KOHISTAN DISTRICT,60,Male,8801,0,8801
KOHISTAN DISTRICT,60,Female,5133,0,5133
KOHISTAN DISTRICT,60,Transgender,0,0,0
KOHISTAN DISTRICT,61,Male,398,0,398
KOHISTAN DISTRICT,61,Female,330,0,330
KOHISTAN DISTRICT,61,Transgender,0,0,0
KOHISTAN DISTRICT,62,Male,341,0,341
KOHISTAN DISTRICT,62,Female,316,0,316
KOHISTAN DISTRICT,62,Transgender,0,0,0
KOHISTAN DISTRICT,63,Male,290,0,290
KOHISTAN DISTRICT,63,Female,289,0,289
KOHISTAN DISTRICT,63,Transgender,0,0,0
KOHISTAN DISTRICT,64,Male,122,0,122
KOHISTAN DISTRICT,64,Female,185,0,185
KOHISTAN DISTRICT,64,Transgender,0,0,0
KOHISTAN DISTRICT,65,Male,1891,0,1891
KOHISTAN DISTRICT,65,Female,2148,0,2148
KOHISTAN DISTRICT,65,Transgender,0,0,0
KOHISTAN DISTRICT,66,Male,394,0,394
KOHISTAN DISTRICT,66,Female,342,0,342
KOHISTAN DISTRICT,66,Transgender,0,0,0
KOHISTAN DISTRICT,67,Male,280,0,280
KOHISTAN DISTRICT,67,Female,294,0,294
KOHISTAN DISTRICT,67,Transgender,0,0,0
KOHISTAN DISTRICT,68,Male,285,0,285
KOHISTAN DISTRICT,68,Female,467,0,467
KOHISTAN DISTRICT,68,Transgender,0,0,0
KOHISTAN DISTRICT,69,Male,106,0,106
KOHISTAN DISTRICT,69,Female,164,0,164
KOHISTAN DISTRICT,69,Transgender,0,0,0
KOHISTAN DISTRICT,70,Male,3886,0,3886
KOHISTAN DISTRICT,70,Female,1889,0,1889
KOHISTAN DISTRICT,70,Transgender,0,0,0
KOHISTAN DISTRICT,71,Male,780,0,780
KOHISTAN DISTRICT,71,Female,423,0,423
KOHISTAN DISTRICT,71,Transgender,0,0,0
KOHISTAN DISTRICT,72,Male,573,0,573
KOHISTAN DISTRICT,72,Female,371,0,371
KOHISTAN DISTRICT,72,Transgender,0,0,0
KOHISTAN DISTRICT,73,Male,366,0,366
KOHISTAN DISTRICT,73,Female,243,0,243
KOHISTAN DISTRICT,73,Transgender,0,0,0
KOHISTAN DISTRICT,74,Male,198,0,198
KOHISTAN DISTRICT,74,Female,135,0,135
KOHISTAN DISTRICT,74,Transgender,0,0,0
KOHISTAN DISTRICT,>=75,Male,6408,0,6408
KOHISTAN DISTRICT,>=75,Female,4167,0,4167
KOHISTAN DISTRICT,>=75,Transgender,0,0,0
KORANGI DISTRICT,<1,Male,0,28057,28057
KORANGI DISTRICT,<1,Female,0,26271,26271
KORANGI DISTRICT,<1,Transgender,0,0,0
KORANGI DISTRICT,1,Male,0,28758,28758
KORANGI DISTRICT,1,Female,0,27363,27363
KORANGI DISTRICT,1,Transgender,0,0,0
KORANGI DISTRICT,2,Male,0,30079,30079
KORANGI DISTRICT,2,Female,0,28259,28259
KORANGI DISTRICT,2,Transgender,0,0,0
KORANGI DISTRICT,3,Male,0,32041,32041
KORANGI DISTRICT,3,Female,0,30785,30785
KORANGI DISTRICT,3,Transgender,0,0,0
KORANGI DISTRICT,4,Male,0,29162,29162
KORANGI DISTRICT,4,Female,0,27690,27690
KORANGI DISTRICT,4,Transgender,0,0,0
KORANGI DISTRICT,5,Male,0,30105,30105
KORANGI DISTRICT,5,Female,0,28433,28433
KORANGI DISTRICT,5,Transgender,0,0,0
KORANGI DISTRICT,6,Male,0,29272,29272
KORANGI DISTRICT,6,Female,0,27784,27784
KORANGI DISTRICT,6,Transgender,0,0,0
KORANGI DISTRICT,7,Male,0,31230,31230
KORANGI DISTRICT,7,Female,0,29559,29559
KORANGI DISTRICT,7,Transgender,0,0,0
KORANGI DISTRICT,8,Male,0,27344,27344
KORANGI DISTRICT,8,Female,0,25855,25855
KORANGI DISTRICT,8,Transgender,0,0,0
KORANGI DISTRICT,9,Male,0,31226,31226
KORANGI DISTRICT,9,Female,0,29691,29691
KORANGI DISTRICT,9,Transgender,0,0,0
KORANGI DISTRICT,10,Male,0,25531,25531
KORANGI DISTRICT,10,Female,0,23886,23886
KORANGI DISTRICT,10,Transgender,0,0,0
KORANGI DISTRICT,11,Male,0,30887,30887
KORANGI DISTRICT,11,Female,0,29268,29268
KORANGI DISTRICT,11,Transgender,0,0,0
KORANGI DISTRICT,12,Male,0,25646,25646
KORANGI DISTRICT,12,Female,0,23581,23581
KORANGI DISTRICT,12,Transgender,0,0,0
KORANGI DISTRICT,13,Male,0,27225,27225
KORANGI DISTRICT,13,Female,0,25694,25694
KORANGI DISTRICT,13,Transgender,0,0,0
KORANGI DISTRICT,14,Male,0,25087,25087
KORANGI DISTRICT,14,Female,0,22883,22883
KORANGI DISTRICT,14,Transgender,0,0,0
KORANGI DISTRICT,15,Male,0,25675,25675
KORANGI DISTRICT,15,Female,0,24158,24158
KORANGI DISTRICT,15,Transgender,0,8,8
KORANGI DISTRICT,16,Male,0,26350,26350
KORANGI DISTRICT,16,Female,0,24526,24526
KORANGI DISTRICT,16,Transgender,0,2,2
KORANGI DISTRICT,17,Male,0,28645,28645
KORANGI DISTRICT,17,Female,0,26752,26752
KORANGI DISTRICT,17,Transgender,0,5,5
KORANGI DISTRICT,18,Male,0,24970,24970
KORANGI DISTRICT,18,Female,0,22391,22391
KORANGI DISTRICT,18,Transgender,0,10,10
KORANGI DISTRICT,19,Male,0,28762,28762
KORANGI DISTRICT,19,Female,0,26694,26694
KORANGI DISTRICT,19,Transgender,0,8,8
KORANGI DISTRICT,20,Male,0,25133,25133
KORANGI DISTRICT,20,Female,0,22167,22167
KORANGI DISTRICT,20,Transgender,0,12,12
KORANGI DISTRICT,21,Male,0,29482,29482
KORANGI DISTRICT,21,Female,0,27404,27404
KORANGI DISTRICT,21,Transgender,0,14,14
KORANGI DISTRICT,22,Male,0,26296,26296
KORANGI DISTRICT,22,Female,0,24996,24996
KORANGI DISTRICT,22,Transgender,0,12,12
KORANGI DISTRICT,23,Male,0,26555,26555
KORANGI DISTRICT,23,Female,0,25199,25199
KORANGI DISTRICT,23,Transgender,0,11,11
KORANGI DISTRICT,24,Male,0,26942,26942
KORANGI DISTRICT,24,Female,0,25246,25246
KORANGI DISTRICT,24,Transgender,0,18,18
KORANGI DISTRICT,25,Male,0,22779,22779
KORANGI DISTRICT,25,Female,0,20715,20715
KORANGI DISTRICT,25,Transgender,0,18,18
KORANGI DISTRICT,26,Male,0,26060,26060
KORANGI DISTRICT,26,Female,0,25271,25271
KORANGI DISTRICT,26,Transgender,0,10,10
KORANGI DISTRICT,27,Male,0,25366,25366
KORANGI DISTRICT,27,Female,0,23853,23853
KORANGI DISTRICT,27,Transgender,0,13,13
KORANGI DISTRICT,28,Male,0,23759,23759
KORANGI DISTRICT,28,Female,0,23634,23634
KORANGI DISTRICT,28,Transgender,0,16,16
KORANGI DISTRICT,29,Male,0,24874,24874
KORANGI DISTRICT,29,Female,0,23017,23017
KORANGI DISTRICT,29,Transgender,0,11,11
KORANGI DISTRICT,30,Male,0,22107,22107
KORANGI DISTRICT,30,Female,0,21585,21585
KORANGI DISTRICT,30,Transgender,0,28,28
KORANGI DISTRICT,31,Male,0,24418,24418
KORANGI DISTRICT,31,Female,0,22208,22208
KORANGI DISTRICT,31,Transgender,0,8,8
KORANGI DISTRICT,32,Male,0,23405,23405
KORANGI DISTRICT,32,Female,0,21313,21313
KORANGI DISTRICT,32,Transgender,0,18,18
KORANGI DISTRICT,33,Male,0,23183,23183
KORANGI DISTRICT,33,Female,0,20536,20536
KORANGI DISTRICT,33,Transgender,0,9,9
KORANGI DISTRICT,34,Male,0,22126,22126
KORANGI DISTRICT,34,Female,0,19450,19450
KORANGI DISTRICT,34,Transgender,0,7,7
KORANGI DISTRICT,35,Male,0,17974,17974
KORANGI DISTRICT,35,Female,0,16731,16731
KORANGI DISTRICT,35,Transgender,0,27,27
KORANGI DISTRICT,36,Male,0,20415,20415
KORANGI DISTRICT,36,Female,0,18008,18008
KORANGI DISTRICT,36,Transgender,0,15,15
KORANGI DISTRICT,37,Male,0,19040,19040
KORANGI DISTRICT,37,Female,0,15885,15885
KORANGI DISTRICT,37,Transgender,0,8,8
KORANGI DISTRICT,38,Male,0,20586,20586
KORANGI DISTRICT,38,Female,0,18130,18130
KORANGI DISTRICT,38,Transgender,0,20,20
KORANGI DISTRICT,39,Male,0,19274,19274
KORANGI DISTRICT,39,Female,0,16873,16873
KORANGI DISTRICT,39,Transgender,0,5,5
KORANGI DISTRICT,40,Male,0,17167,17167
KORANGI DISTRICT,40,Female,0,14697,14697
KORANGI DISTRICT,40,Transgender,0,21,21
KORANGI DISTRICT,41,Male,0,17164,17164
KORANGI DISTRICT,41,Female,0,14528,14528
KORANGI DISTRICT,41,Transgender,0,4,4
KORANGI DISTRICT,42,Male,0,16027,16027
KORANGI DISTRICT,42,Female,0,13168,13168
KORANGI DISTRICT,42,Transgender,0,16,16
KORANGI DISTRICT,43,Male,0,15476,15476
KORANGI DISTRICT,43,Female,0,13850,13850
KORANGI DISTRICT,43,Transgender,0,7,7
KORANGI DISTRICT,44,Male,0,14292,14292
KORANGI DISTRICT,44,Female,0,12528,12528
KORANGI DISTRICT,44,Transgender,0,0,0
KORANGI DISTRICT,45,Male,0,12076,12076
KORANGI DISTRICT,45,Female,0,10222,10222
KORANGI DISTRICT,45,Transgender,0,20,20
KORANGI DISTRICT,46,Male,0,13164,13164
KORANGI DISTRICT,46,Female,0,10446,10446
KORANGI DISTRICT,46,Transgender,0,5,5
KORANGI DISTRICT,47,Male,0,12434,12434
KORANGI DISTRICT,47,Female,0,9270,9270
KORANGI DISTRICT,47,Transgender,0,7,7
KORANGI DISTRICT,48,Male,0,12686,12686
KORANGI DISTRICT,48,Female,0,10924,10924
KORANGI DISTRICT,48,Transgender,0,8,8
KORANGI DISTRICT,49,Male,0,12501,12501
KORANGI DISTRICT,49,Female,0,10978,10978
KORANGI DISTRICT,49,Transgender,0,4,4
KORANGI DISTRICT,50,Male,0,10940,10940
KORANGI DISTRICT,50,Female,0,9638,9638
KORANGI DISTRICT,50,Transgender,0,15,15
KORANGI DISTRICT,51,Male,0,12101,12101
KORANGI DISTRICT,51,Female,0,10070,10070
KORANGI DISTRICT,51,Transgender,0,4,4
KORANGI DISTRICT,52,Male,0,11581,11581
KORANGI DISTRICT,52,Female,0,9369,9369
KORANGI DISTRICT,52,Transgender,0,5,5
KORANGI DISTRICT,53,Male,0,10921,10921
KORANGI DISTRICT,53,Female,0,9462,9462
KORANGI DISTRICT,53,Transgender,0,6,6
KORANGI DISTRICT,54,Male,0,10068,10068
KORANGI DISTRICT,54,Female,0,8701,8701
KORANGI DISTRICT,54,Transgender,0,4,4
KORANGI DISTRICT,55,Male,0,8295,8295
KORANGI DISTRICT,55,Female,0,6767,6767
KORANGI DISTRICT,55,Transgender,0,8,8
KORANGI DISTRICT,56,Male,0,8417,8417
KORANGI DISTRICT,56,Female,0,6968,6968
KORANGI DISTRICT,56,Transgender,0,7,7
KORANGI DISTRICT,57,Male,0,8087,8087
KORANGI DISTRICT,57,Female,0,6164,6164
KORANGI DISTRICT,57,Transgender,0,2,2
KORANGI DISTRICT,58,Male,0,7584,7584
KORANGI DISTRICT,58,Female,0,6337,6337
KORANGI DISTRICT,58,Transgender,0,3,3
KORANGI DISTRICT,59,Male,0,7190,7190
KORANGI DISTRICT,59,Female,0,6190,6190
KORANGI DISTRICT,59,Transgender,0,2,2
KORANGI DISTRICT,60,Male,0,6114,6114
KORANGI DISTRICT,60,Female,0,4970,4970
KORANGI DISTRICT,60,Transgender,0,3,3
KORANGI DISTRICT,61,Male,0,7062,7062
KORANGI DISTRICT,61,Female,0,6024,6024
KORANGI DISTRICT,61,Transgender,0,4,4
KORANGI DISTRICT,62,Male,0,6876,6876
KORANGI DISTRICT,62,Female,0,5492,5492
KORANGI DISTRICT,62,Transgender,0,4,4
KORANGI DISTRICT,63,Male,0,6386,6386
KORANGI DISTRICT,63,Female,0,5561,5561
KORANGI DISTRICT,63,Transgender,0,1,1
KORANGI DISTRICT,64,Male,0,5272,5272
KORANGI DISTRICT,64,Female,0,4559,4559
KORANGI DISTRICT,64,Transgender,0,1,1
KORANGI DISTRICT,65,Male,0,4272,4272
KORANGI DISTRICT,65,Female,0,3320,3320
KORANGI DISTRICT,65,Transgender,0,2,2
KORANGI DISTRICT,66,Male,0,3985,3985
KORANGI DISTRICT,66,Female,0,3179,3179
KORANGI DISTRICT,66,Transgender,0,0,0
KORANGI DISTRICT,67,Male,0,3623,3623
KORANGI DISTRICT,67,Female,0,2877,2877
KORANGI DISTRICT,67,Transgender,0,3,3
KORANGI DISTRICT,68,Male,0,3665,3665
KORANGI DISTRICT,68,Female,0,3298,3298
KORANGI DISTRICT,68,Transgender,0,0,0
KORANGI DISTRICT,69,Male,0,3200,3200
KORANGI DISTRICT,69,Female,0,3108,3108
KORANGI DISTRICT,69,Transgender,0,1,1
KORANGI DISTRICT,70,Male,0,2364,2364
KORANGI DISTRICT,70,Female,0,2143,2143
KORANGI DISTRICT,70,Transgender,0,4,4
KORANGI DISTRICT,71,Male,0,2598,2598
KORANGI DISTRICT,71,Female,0,2348,2348
KORANGI DISTRICT,71,Transgender,0,0,0
KORANGI DISTRICT,72,Male,0,2428,2428
KORANGI DISTRICT,72,Female,0,2135,2135
KORANGI DISTRICT,72,Transgender,0,2,2
KORANGI DISTRICT,73,Male,0,2331,2331
KORANGI DISTRICT,73,Female,0,2361,2361
KORANGI DISTRICT,73,Transgender,0,0,0
KORANGI DISTRICT,74,Male,0,1762,1762
KORANGI DISTRICT,74,Female,0,1867,1867
KORANGI DISTRICT,74,Transgender,0,1,1
KORANGI DISTRICT,>=75,Male,0,11226,11226
KORANGI DISTRICT,>=75,Female,0,12636,12636
KORANGI DISTRICT,>=75,Transgender,0,9,9
KURRAM AGENCY,<1,Male,8904,571,9475
KURRAM AGENCY,<1,Female,7941,527,8468
KURRAM AGENCY,<1,Transgender,0,0,0
KURRAM AGENCY,1,Male,9616,581,10197
KURRAM AGENCY,1,Female,8602,543,9145
KURRAM AGENCY,1,Transgender,0,0,0
KURRAM AGENCY,2,Male,10856,726,11582
KURRAM AGENCY,2,Female,10402,673,11075
KURRAM AGENCY,2,Transgender,0,0,0
KURRAM AGENCY,3,Male,11160,733,11893
KURRAM AGENCY,3,Female,10327,704,11031
KURRAM AGENCY,3,Transgender,0,0,0
KURRAM AGENCY,4,Male,11604,754,12358
KURRAM AGENCY,4,Female,10920,670,11590
KURRAM AGENCY,4,Transgender,0,0,0
KURRAM AGENCY,5,Male,10834,684,11518
KURRAM AGENCY,5,Female,9636,637,10273
KURRAM AGENCY,5,Transgender,0,0,0
KURRAM AGENCY,6,Male,10683,653,11336
KURRAM AGENCY,6,Female,9723,617,10340
KURRAM AGENCY,6,Transgender,0,0,0
KURRAM AGENCY,7,Male,10211,658,10869
KURRAM AGENCY,7,Female,8981,569,9550
KURRAM AGENCY,7,Transgender,0,0,0
KURRAM AGENCY,8,Male,10574,610,11184
KURRAM AGENCY,8,Female,9240,525,9765
KURRAM AGENCY,8,Transgender,0,0,0
KURRAM AGENCY,9,Male,9818,639,10457
KURRAM AGENCY,9,Female,8421,532,8953
KURRAM AGENCY,9,Transgender,0,0,0
KURRAM AGENCY,10,Male,9619,553,10172
KURRAM AGENCY,10,Female,8270,489,8759
KURRAM AGENCY,10,Transgender,0,0,0
KURRAM AGENCY,11,Male,7834,570,8404
KURRAM AGENCY,11,Female,6624,455,7079
KURRAM AGENCY,11,Transgender,0,0,0
KURRAM AGENCY,12,Male,7940,537,8477
KURRAM AGENCY,12,Female,7090,435,7525
KURRAM AGENCY,12,Transgender,0,0,0
KURRAM AGENCY,13,Male,7000,496,7496
KURRAM AGENCY,13,Female,6326,477,6803
KURRAM AGENCY,13,Transgender,0,0,0
KURRAM AGENCY,14,Male,6633,470,7103
KURRAM AGENCY,14,Female,6643,449,7092
KURRAM AGENCY,14,Transgender,0,0,0
KURRAM AGENCY,15,Male,6353,481,6834
KURRAM AGENCY,15,Female,6465,456,6921
KURRAM AGENCY,15,Transgender,0,0,0
KURRAM AGENCY,16,Male,5499,432,5931
KURRAM AGENCY,16,Female,5748,405,6153
KURRAM AGENCY,16,Transgender,0,0,0
KURRAM AGENCY,17,Male,4806,404,5210
KURRAM AGENCY,17,Female,5282,375,5657
KURRAM AGENCY,17,Transgender,1,0,1
KURRAM AGENCY,18,Male,5433,376,5809
KURRAM AGENCY,18,Female,5437,377,5814
KURRAM AGENCY,18,Transgender,1,1,2
KURRAM AGENCY,19,Male,5278,387,5665
KURRAM AGENCY,19,Female,5159,369,5528
KURRAM AGENCY,19,Transgender,2,1,3
KURRAM AGENCY,20,Male,5058,399,5457
KURRAM AGENCY,20,Female,5305,358,5663
KURRAM AGENCY,20,Transgender,1,1,2
KURRAM AGENCY,21,Male,4647,332,4979
KURRAM AGENCY,21,Female,4966,399,5365
KURRAM AGENCY,21,Transgender,0,0,0
KURRAM AGENCY,22,Male,4282,298,4580
KURRAM AGENCY,22,Female,4928,292,5220
KURRAM AGENCY,22,Transgender,2,0,2
KURRAM AGENCY,23,Male,4429,319,4748
KURRAM AGENCY,23,Female,5333,377,5710
KURRAM AGENCY,23,Transgender,1,0,1
KURRAM AGENCY,24,Male,4288,311,4599
KURRAM AGENCY,24,Female,5191,342,5533
KURRAM AGENCY,24,Transgender,0,0,0
KURRAM AGENCY,25,Male,5067,361,5428
KURRAM AGENCY,25,Female,5735,378,6113
KURRAM AGENCY,25,Transgender,2,1,3
KURRAM AGENCY,26,Male,4350,292,4642
KURRAM AGENCY,26,Female,5093,304,5397
KURRAM AGENCY,26,Transgender,1,1,2
KURRAM AGENCY,27,Male,4240,326,4566
KURRAM AGENCY,27,Female,5354,374,5728
KURRAM AGENCY,27,Transgender,1,0,1
KURRAM AGENCY,28,Male,3893,284,4177
KURRAM AGENCY,28,Female,4735,305,5040
KURRAM AGENCY,28,Transgender,1,1,2
KURRAM AGENCY,29,Male,3574,252,3826
KURRAM AGENCY,29,Female,4877,343,5220
KURRAM AGENCY,29,Transgender,2,0,2
KURRAM AGENCY,30,Male,3756,226,3982
KURRAM AGENCY,30,Female,4482,248,4730
KURRAM AGENCY,30,Transgender,1,1,2
KURRAM AGENCY,31,Male,3254,233,3487
KURRAM AGENCY,31,Female,4115,247,4362
KURRAM AGENCY,31,Transgender,1,0,1
KURRAM AGENCY,32,Male,2985,199,3184
KURRAM AGENCY,32,Female,3638,207,3845
KURRAM AGENCY,32,Transgender,1,0,1
KURRAM AGENCY,33,Male,3124,197,3321
KURRAM AGENCY,33,Female,3520,245,3765
KURRAM AGENCY,33,Transgender,0,0,0
KURRAM AGENCY,34,Male,2492,176,2668
KURRAM AGENCY,34,Female,2938,170,3108
KURRAM AGENCY,34,Transgender,0,0,0
KURRAM AGENCY,35,Male,2852,168,3020
KURRAM AGENCY,35,Female,3392,218,3610
KURRAM AGENCY,35,Transgender,1,0,1
KURRAM AGENCY,36,Male,2278,152,2430
KURRAM AGENCY,36,Female,2301,122,2423
KURRAM AGENCY,36,Transgender,0,0,0
KURRAM AGENCY,37,Male,2513,189,2702
KURRAM AGENCY,37,Female,2982,219,3201
KURRAM AGENCY,37,Transgender,0,0,0
KURRAM AGENCY,38,Male,2596,169,2765
KURRAM AGENCY,38,Female,2501,176,2677
KURRAM AGENCY,38,Transgender,0,0,0
KURRAM AGENCY,39,Male,2484,186,2670
KURRAM AGENCY,39,Female,2670,173,2843
KURRAM AGENCY,39,Transgender,0,0,0
KURRAM AGENCY,40,Male,2709,168,2877
KURRAM AGENCY,40,Female,3209,210,3419
KURRAM AGENCY,40,Transgender,6,0,6
KURRAM AGENCY,41,Male,2083,159,2242
KURRAM AGENCY,41,Female,2370,146,2516
KURRAM AGENCY,41,Transgender,0,0,0
KURRAM AGENCY,42,Male,1850,115,1965
KURRAM AGENCY,42,Female,2243,142,2385
KURRAM AGENCY,42,Transgender,0,0,0
KURRAM AGENCY,43,Male,1968,134,2102
KURRAM AGENCY,43,Female,1998,131,2129
KURRAM AGENCY,43,Transgender,0,0,0
KURRAM AGENCY,44,Male,1542,97,1639
KURRAM AGENCY,44,Female,1773,116,1889
KURRAM AGENCY,44,Transgender,1,0,1
KURRAM AGENCY,45,Male,1851,126,1977
KURRAM AGENCY,45,Female,2076,148,2224
KURRAM AGENCY,45,Transgender,1,0,1
KURRAM AGENCY,46,Male,1405,72,1477
KURRAM AGENCY,46,Female,1643,76,1719
KURRAM AGENCY,46,Transgender,0,0,0
KURRAM AGENCY,47,Male,1584,93,1677
KURRAM AGENCY,47,Female,2073,162,2235
KURRAM AGENCY,47,Transgender,0,0,0
KURRAM AGENCY,48,Male,1429,81,1510
KURRAM AGENCY,48,Female,1441,106,1547
KURRAM AGENCY,48,Transgender,0,0,0
KURRAM AGENCY,49,Male,1515,96,1611
KURRAM AGENCY,49,Female,1640,111,1751
KURRAM AGENCY,49,Transgender,0,0,0
KURRAM AGENCY,50,Male,1706,115,1821
KURRAM AGENCY,50,Female,2092,135,2227
KURRAM AGENCY,50,Transgender,2,0,2
KURRAM AGENCY,51,Male,1374,93,1467
KURRAM AGENCY,51,Female,1821,95,1916
KURRAM AGENCY,51,Transgender,2,0,2
KURRAM AGENCY,52,Male,1299,103,1402
KURRAM AGENCY,52,Female,1675,131,1806
KURRAM AGENCY,52,Transgender,0,0,0
KURRAM AGENCY,53,Male,1293,95,1388
KURRAM AGENCY,53,Female,1371,99,1470
KURRAM AGENCY,53,Transgender,0,0,0
KURRAM AGENCY,54,Male,1206,73,1279
KURRAM AGENCY,54,Female,1197,72,1269
KURRAM AGENCY,54,Transgender,0,0,0
KURRAM AGENCY,55,Male,1382,80,1462
KURRAM AGENCY,55,Female,1464,113,1577
KURRAM AGENCY,55,Transgender,1,0,1
KURRAM AGENCY,56,Male,1062,68,1130
KURRAM AGENCY,56,Female,1276,43,1319
KURRAM AGENCY,56,Transgender,0,0,0
KURRAM AGENCY,57,Male,1351,107,1458
KURRAM AGENCY,57,Female,1821,134,1955
KURRAM AGENCY,57,Transgender,0,0,0
KURRAM AGENCY,58,Male,1024,70,1094
KURRAM AGENCY,58,Female,952,53,1005
KURRAM AGENCY,58,Transgender,0,0,0
KURRAM AGENCY,59,Male,1051,71,1122
KURRAM AGENCY,59,Female,1044,61,1105
KURRAM AGENCY,59,Transgender,0,0,0
KURRAM AGENCY,60,Male,1405,77,1482
KURRAM AGENCY,60,Female,1344,63,1407
KURRAM AGENCY,60,Transgender,2,0,2
KURRAM AGENCY,61,Male,1124,49,1173
KURRAM AGENCY,61,Female,1032,55,1087
KURRAM AGENCY,61,Transgender,0,0,0
KURRAM AGENCY,62,Male,1178,70,1248
KURRAM AGENCY,62,Female,1110,58,1168
KURRAM AGENCY,62,Transgender,0,0,0
KURRAM AGENCY,63,Male,1026,76,1102
KURRAM AGENCY,63,Female,897,51,948
KURRAM AGENCY,63,Transgender,0,0,0
KURRAM AGENCY,64,Male,892,48,940
KURRAM AGENCY,64,Female,761,40,801
KURRAM AGENCY,64,Transgender,0,0,0
KURRAM AGENCY,65,Male,848,50,898
KURRAM AGENCY,65,Female,715,37,752
KURRAM AGENCY,65,Transgender,1,0,1
KURRAM AGENCY,66,Male,706,32,738
KURRAM AGENCY,66,Female,678,29,707
KURRAM AGENCY,66,Transgender,0,0,0
KURRAM AGENCY,67,Male,923,77,1000
KURRAM AGENCY,67,Female,934,75,1009
KURRAM AGENCY,67,Transgender,0,0,0
KURRAM AGENCY,68,Male,623,39,662
KURRAM AGENCY,68,Female,465,20,485
KURRAM AGENCY,68,Transgender,0,0,0
KURRAM AGENCY,69,Male,574,46,620
KURRAM AGENCY,69,Female,452,33,485
KURRAM AGENCY,69,Transgender,0,0,0
KURRAM AGENCY,70,Male,592,32,624
KURRAM AGENCY,70,Female,460,30,490
KURRAM AGENCY,70,Transgender,0,0,0
KURRAM AGENCY,71,Male,500,33,533
KURRAM AGENCY,71,Female,384,16,400
KURRAM AGENCY,71,Transgender,0,0,0
KURRAM AGENCY,72,Male,494,40,534
KURRAM AGENCY,72,Female,419,28,447
KURRAM AGENCY,72,Transgender,0,0,0
KURRAM AGENCY,73,Male,404,25,429
KURRAM AGENCY,73,Female,315,16,331
KURRAM AGENCY,73,Transgender,0,0,0
KURRAM AGENCY,74,Male,362,25,387
KURRAM AGENCY,74,Female,262,12,274
KURRAM AGENCY,74,Transgender,0,0,0
KURRAM AGENCY,>=75,Male,2511,153,2664
KURRAM AGENCY,>=75,Female,2927,138,3065
KURRAM AGENCY,>=75,Transgender,2,0,2
LAHORE DISTRICT,<1,Male,0,127860,127860
LAHORE DISTRICT,<1,Female,0,120844,120844
LAHORE DISTRICT,<1,Transgender,0,0,0
LAHORE DISTRICT,1,Male,0,131576,131576
LAHORE DISTRICT,1,Female,0,125415,125415
LAHORE DISTRICT,1,Transgender,0,0,0
LAHORE DISTRICT,2,Male,0,133147,133147
LAHORE DISTRICT,2,Female,0,125797,125797
LAHORE DISTRICT,2,Transgender,0,0,0
LAHORE DISTRICT,3,Male,0,143512,143512
LAHORE DISTRICT,3,Female,0,137955,137955
LAHORE DISTRICT,3,Transgender,0,0,0
LAHORE DISTRICT,4,Male,0,132476,132476
LAHORE DISTRICT,4,Female,0,125622,125622
LAHORE DISTRICT,4,Transgender,0,0,0
LAHORE DISTRICT,5,Male,0,134709,134709
LAHORE DISTRICT,5,Female,0,128429,128429
LAHORE DISTRICT,5,Transgender,0,0,0
LAHORE DISTRICT,6,Male,0,132400,132400
LAHORE DISTRICT,6,Female,0,124304,124304
LAHORE DISTRICT,6,Transgender,0,0,0
LAHORE DISTRICT,7,Male,0,141669,141669
LAHORE DISTRICT,7,Female,0,133236,133236
LAHORE DISTRICT,7,Transgender,0,0,0
LAHORE DISTRICT,8,Male,0,125471,125471
LAHORE DISTRICT,8,Female,0,118878,118878
LAHORE DISTRICT,8,Transgender,0,0,0
LAHORE DISTRICT,9,Male,0,137028,137028
LAHORE DISTRICT,9,Female,0,129631,129631
LAHORE DISTRICT,9,Transgender,0,0,0
LAHORE DISTRICT,10,Male,0,119920,119920
LAHORE DISTRICT,10,Female,0,111341,111341
LAHORE DISTRICT,10,Transgender,0,0,0
LAHORE DISTRICT,11,Male,0,134354,134354
LAHORE DISTRICT,11,Female,0,124822,124822
LAHORE DISTRICT,11,Transgender,0,0,0
LAHORE DISTRICT,12,Male,0,117060,117060
LAHORE DISTRICT,12,Female,0,106558,106558
LAHORE DISTRICT,12,Transgender,0,0,0
LAHORE DISTRICT,13,Male,0,120529,120529
LAHORE DISTRICT,13,Female,0,113166,113166
LAHORE DISTRICT,13,Transgender,0,0,0
LAHORE DISTRICT,14,Male,0,112185,112185
LAHORE DISTRICT,14,Female,0,102014,102014
LAHORE DISTRICT,14,Transgender,0,0,0
LAHORE DISTRICT,15,Male,0,112139,112139
LAHORE DISTRICT,15,Female,0,105616,105616
LAHORE DISTRICT,15,Transgender,0,33,33
LAHORE DISTRICT,16,Male,0,116275,116275
LAHORE DISTRICT,16,Female,0,105915,105915
LAHORE DISTRICT,16,Transgender,0,26,26
LAHORE DISTRICT,17,Male,0,122500,122500
LAHORE DISTRICT,17,Female,0,107610,107610
LAHORE DISTRICT,17,Transgender,0,39,39
LAHORE DISTRICT,18,Male,0,117831,117831
LAHORE DISTRICT,18,Female,0,98500,98500
LAHORE DISTRICT,18,Transgender,0,46,46
LAHORE DISTRICT,19,Male,0,123351,123351
LAHORE DISTRICT,19,Female,0,111846,111846
LAHORE DISTRICT,19,Transgender,0,29,29
LAHORE DISTRICT,20,Male,0,115609,115609
LAHORE DISTRICT,20,Female,0,100122,100122
LAHORE DISTRICT,20,Transgender,0,63,63
LAHORE DISTRICT,21,Male,0,128066,128066
LAHORE DISTRICT,21,Female,0,118880,118880
LAHORE DISTRICT,21,Transgender,0,38,38
LAHORE DISTRICT,22,Male,0,121556,121556
LAHORE DISTRICT,22,Female,0,112225,112225
LAHORE DISTRICT,22,Transgender,0,68,68
LAHORE DISTRICT,23,Male,0,118449,118449
LAHORE DISTRICT,23,Female,0,111999,111999
LAHORE DISTRICT,23,Transgender,0,52,52
LAHORE DISTRICT,24,Male,0,118196,118196
LAHORE DISTRICT,24,Female,0,108664,108664
LAHORE DISTRICT,24,Transgender,0,54,54
LAHORE DISTRICT,25,Male,0,103923,103923
LAHORE DISTRICT,25,Female,0,94547,94547
LAHORE DISTRICT,25,Transgender,0,89,89
LAHORE DISTRICT,26,Male,0,111584,111584
LAHORE DISTRICT,26,Female,0,106783,106783
LAHORE DISTRICT,26,Transgender,0,47,47
LAHORE DISTRICT,27,Male,0,103315,103315
LAHORE DISTRICT,27,Female,0,99821,99821
LAHORE DISTRICT,27,Transgender,0,56,56
LAHORE DISTRICT,28,Male,0,103747,103747
LAHORE DISTRICT,28,Female,0,102411,102411
LAHORE DISTRICT,28,Transgender,0,65,65
LAHORE DISTRICT,29,Male,0,95154,95154
LAHORE DISTRICT,29,Female,0,91467,91467
LAHORE DISTRICT,29,Transgender,0,30,30
LAHORE DISTRICT,30,Male,0,99004,99004
LAHORE DISTRICT,30,Female,0,94844,94844
LAHORE DISTRICT,30,Transgender,0,109,109
LAHORE DISTRICT,31,Male,0,89803,89803
LAHORE DISTRICT,31,Female,0,85883,85883
LAHORE DISTRICT,31,Transgender,0,33,33
LAHORE DISTRICT,32,Male,0,93922,93922
LAHORE DISTRICT,32,Female,0,88424,88424
LAHORE DISTRICT,32,Transgender,0,63,63
LAHORE DISTRICT,33,Male,0,87090,87090
LAHORE DISTRICT,33,Female,0,82715,82715
LAHORE DISTRICT,33,Transgender,0,40,40
LAHORE DISTRICT,34,Male,0,80916,80916
LAHORE DISTRICT,34,Female,0,73331,73331
LAHORE DISTRICT,34,Transgender,0,41,41
LAHORE DISTRICT,35,Male,0,82280,82280
LAHORE DISTRICT,35,Female,0,75647,75647
LAHORE DISTRICT,35,Transgender,0,110,110
LAHORE DISTRICT,36,Male,0,78084,78084
LAHORE DISTRICT,36,Female,0,69712,69712
LAHORE DISTRICT,36,Transgender,0,41,41
LAHORE DISTRICT,37,Male,0,68161,68161
LAHORE DISTRICT,37,Female,0,57566,57566
LAHORE DISTRICT,37,Transgender,0,41,41
LAHORE DISTRICT,38,Male,0,83090,83090
LAHORE DISTRICT,38,Female,0,75809,75809
LAHORE DISTRICT,38,Transgender,0,45,45
LAHORE DISTRICT,39,Male,0,70816,70816
LAHORE DISTRICT,39,Female,0,63788,63788
LAHORE DISTRICT,39,Transgender,0,22,22
LAHORE DISTRICT,40,Male,0,81686,81686
LAHORE DISTRICT,40,Female,0,68432,68432
LAHORE DISTRICT,40,Transgender,0,108,108
LAHORE DISTRICT,41,Male,0,65248,65248
LAHORE DISTRICT,41,Female,0,55336,55336
LAHORE DISTRICT,41,Transgender,0,11,11
LAHORE DISTRICT,42,Male,0,65251,65251
LAHORE DISTRICT,42,Female,0,53556,53556
LAHORE DISTRICT,42,Transgender,0,45,45
LAHORE DISTRICT,43,Male,0,60276,60276
LAHORE DISTRICT,43,Female,0,56286,56286
LAHORE DISTRICT,43,Transgender,0,18,18
LAHORE DISTRICT,44,Male,0,53218,53218
LAHORE DISTRICT,44,Female,0,49268,49268
LAHORE DISTRICT,44,Transgender,0,21,21
LAHORE DISTRICT,45,Male,0,59060,59060
LAHORE DISTRICT,45,Female,0,51867,51867
LAHORE DISTRICT,45,Transgender,0,69,69
LAHORE DISTRICT,46,Male,0,48051,48051
LAHORE DISTRICT,46,Female,0,40905,40905
LAHORE DISTRICT,46,Transgender,0,24,24
LAHORE DISTRICT,47,Male,0,44912,44912
LAHORE DISTRICT,47,Female,0,34809,34809
LAHORE DISTRICT,47,Transgender,0,25,25
LAHORE DISTRICT,48,Male,0,50791,50791
LAHORE DISTRICT,48,Female,0,47475,47475
LAHORE DISTRICT,48,Transgender,0,17,17
LAHORE DISTRICT,49,Male,0,47789,47789
LAHORE DISTRICT,49,Female,0,43720,43720
LAHORE DISTRICT,49,Transgender,0,6,6
LAHORE DISTRICT,50,Male,0,54951,54951
LAHORE DISTRICT,50,Female,0,49107,49107
LAHORE DISTRICT,50,Transgender,0,67,67
LAHORE DISTRICT,51,Male,0,43773,43773
LAHORE DISTRICT,51,Female,0,37963,37963
LAHORE DISTRICT,51,Transgender,0,14,14
LAHORE DISTRICT,52,Male,0,46558,46558
LAHORE DISTRICT,52,Female,0,39051,39051
LAHORE DISTRICT,52,Transgender,0,25,25
LAHORE DISTRICT,53,Male,0,42434,42434
LAHORE DISTRICT,53,Female,0,39574,39574
LAHORE DISTRICT,53,Transgender,0,12,12
LAHORE DISTRICT,54,Male,0,40239,40239
LAHORE DISTRICT,54,Female,0,35841,35841
LAHORE DISTRICT,54,Transgender,0,5,5
LAHORE DISTRICT,55,Male,0,42557,42557
LAHORE DISTRICT,55,Female,0,34620,34620
LAHORE DISTRICT,55,Transgender,0,32,32
LAHORE DISTRICT,56,Male,0,35286,35286
LAHORE DISTRICT,56,Female,0,27461,27461
LAHORE DISTRICT,56,Transgender,0,11,11
LAHORE DISTRICT,57,Male,0,29652,29652
LAHORE DISTRICT,57,Female,0,20477,20477
LAHORE DISTRICT,57,Transgender,0,9,9
LAHORE DISTRICT,58,Male,0,31611,31611
LAHORE DISTRICT,58,Female,0,27267,27267
LAHORE DISTRICT,58,Transgender,0,12,12
LAHORE DISTRICT,59,Male,0,28281,28281
LAHORE DISTRICT,59,Female,0,24671,24671
LAHORE DISTRICT,59,Transgender,0,7,7
LAHORE DISTRICT,60,Male,0,32266,32266
LAHORE DISTRICT,60,Female,0,26140,26140
LAHORE DISTRICT,60,Transgender,0,44,44
LAHORE DISTRICT,61,Male,0,26344,26344
LAHORE DISTRICT,61,Female,0,21037,21037
LAHORE DISTRICT,61,Transgender,0,9,9
LAHORE DISTRICT,62,Male,0,27954,27954
LAHORE DISTRICT,62,Female,0,21633,21633
LAHORE DISTRICT,62,Transgender,0,8,8
LAHORE DISTRICT,63,Male,0,26767,26767
LAHORE DISTRICT,63,Female,0,22451,22451
LAHORE DISTRICT,63,Transgender,0,3,3
LAHORE DISTRICT,64,Male,0,22629,22629
LAHORE DISTRICT,64,Female,0,19546,19546
LAHORE DISTRICT,64,Transgender,0,7,7
LAHORE DISTRICT,65,Male,0,23191,23191
LAHORE DISTRICT,65,Female,0,19303,19303
LAHORE DISTRICT,65,Transgender,0,27,27
LAHORE DISTRICT,66,Male,0,16604,16604
LAHORE DISTRICT,66,Female,0,13457,13457
LAHORE DISTRICT,66,Transgender,0,3,3
LAHORE DISTRICT,67,Male,0,14525,14525
LAHORE DISTRICT,67,Female,0,10560,10560
LAHORE DISTRICT,67,Transgender,0,4,4
LAHORE DISTRICT,68,Male,0,15918,15918
LAHORE DISTRICT,68,Female,0,13732,13732
LAHORE DISTRICT,68,Transgender,0,5,5
LAHORE DISTRICT,69,Male,0,14217,14217
LAHORE DISTRICT,69,Female,0,12958,12958
LAHORE DISTRICT,69,Transgender,0,3,3
LAHORE DISTRICT,70,Male,0,15908,15908
LAHORE DISTRICT,70,Female,0,13004,13004
LAHORE DISTRICT,70,Transgender,0,25,25
LAHORE DISTRICT,71,Male,0,11999,11999
LAHORE DISTRICT,71,Female,0,9999,9999
LAHORE DISTRICT,71,Transgender,0,1,1
LAHORE DISTRICT,72,Male,0,13162,13162
LAHORE DISTRICT,72,Female,0,9796,9796
LAHORE DISTRICT,72,Transgender,0,4,4
LAHORE DISTRICT,73,Male,0,11733,11733
LAHORE DISTRICT,73,Female,0,9720,9720
LAHORE DISTRICT,73,Transgender,0,4,4
LAHORE DISTRICT,74,Male,0,10239,10239
LAHORE DISTRICT,74,Female,0,8410,8410
LAHORE DISTRICT,74,Transgender,0,6,6
LAHORE DISTRICT,>=75,Male,0,70150,70150
LAHORE DISTRICT,>=75,Female,0,62413,62413
LAHORE DISTRICT,>=75,Transgender,0,45,45
LAKKI MARWAT DISTRICT,<1,Male,11707,1189,12896
LAKKI MARWAT DISTRICT,<1,Female,10831,1169,12000
LAKKI MARWAT DISTRICT,<1,Transgender,0,0,0
LAKKI MARWAT DISTRICT,1,Male,13221,1192,14413
LAKKI MARWAT DISTRICT,1,Female,12643,1117,13760
LAKKI MARWAT DISTRICT,1,Transgender,0,0,0
LAKKI MARWAT DISTRICT,2,Male,14972,1328,16300
LAKKI MARWAT DISTRICT,2,Female,14316,1308,15624
LAKKI MARWAT DISTRICT,2,Transgender,0,0,0
LAKKI MARWAT DISTRICT,3,Male,15705,1463,17168
LAKKI MARWAT DISTRICT,3,Female,14917,1413,16330
LAKKI MARWAT DISTRICT,3,Transgender,0,0,0
LAKKI MARWAT DISTRICT,4,Male,16591,1452,18043
LAKKI MARWAT DISTRICT,4,Female,15730,1449,17179
LAKKI MARWAT DISTRICT,4,Transgender,0,0,0
LAKKI MARWAT DISTRICT,5,Male,14186,1400,15586
LAKKI MARWAT DISTRICT,5,Female,12924,1290,14214
LAKKI MARWAT DISTRICT,5,Transgender,0,0,0
LAKKI MARWAT DISTRICT,6,Male,13761,1392,15153
LAKKI MARWAT DISTRICT,6,Female,12317,1181,13498
LAKKI MARWAT DISTRICT,6,Transgender,0,0,0
LAKKI MARWAT DISTRICT,7,Male,14450,1439,15889
LAKKI MARWAT DISTRICT,7,Female,12547,1320,13867
LAKKI MARWAT DISTRICT,7,Transgender,0,0,0
LAKKI MARWAT DISTRICT,8,Male,14042,1263,15305
LAKKI MARWAT DISTRICT,8,Female,12294,1171,13465
LAKKI MARWAT DISTRICT,8,Transgender,0,0,0
LAKKI MARWAT DISTRICT,9,Male,13466,1368,14834
LAKKI MARWAT DISTRICT,9,Female,11171,1140,12311
LAKKI MARWAT DISTRICT,9,Transgender,0,0,0
LAKKI MARWAT DISTRICT,10,Male,11741,1139,12880
LAKKI MARWAT DISTRICT,10,Female,10624,1101,11725
LAKKI MARWAT DISTRICT,10,Transgender,0,0,0
LAKKI MARWAT DISTRICT,11,Male,10895,1176,12071
LAKKI MARWAT DISTRICT,11,Female,9251,1167,10418
LAKKI MARWAT DISTRICT,11,Transgender,0,0,0
LAKKI MARWAT DISTRICT,12,Male,9601,1033,10634
LAKKI MARWAT DISTRICT,12,Female,8989,987,9976
LAKKI MARWAT DISTRICT,12,Transgender,0,0,0
LAKKI MARWAT DISTRICT,13,Male,9905,1120,11025
LAKKI MARWAT DISTRICT,13,Female,8563,1018,9581
LAKKI MARWAT DISTRICT,13,Transgender,0,0,0
LAKKI MARWAT DISTRICT,14,Male,9720,1079,10799
LAKKI MARWAT DISTRICT,14,Female,8799,1026,9825
LAKKI MARWAT DISTRICT,14,Transgender,0,0,0
LAKKI MARWAT DISTRICT,15,Male,9523,1101,10624
LAKKI MARWAT DISTRICT,15,Female,8538,1029,9567
LAKKI MARWAT DISTRICT,15,Transgender,0,0,0
LAKKI MARWAT DISTRICT,16,Male,8894,1068,9962
LAKKI MARWAT DISTRICT,16,Female,8521,1016,9537
LAKKI MARWAT DISTRICT,16,Transgender,0,0,0
LAKKI MARWAT DISTRICT,17,Male,8767,1059,9826
LAKKI MARWAT DISTRICT,17,Female,8612,1099,9711
LAKKI MARWAT DISTRICT,17,Transgender,0,0,0
LAKKI MARWAT DISTRICT,18,Male,7367,909,8276
LAKKI MARWAT DISTRICT,18,Female,7585,921,8506
LAKKI MARWAT DISTRICT,18,Transgender,1,0,1
LAKKI MARWAT DISTRICT,19,Male,7306,1003,8309
LAKKI MARWAT DISTRICT,19,Female,7113,889,8002
LAKKI MARWAT DISTRICT,19,Transgender,0,0,0
LAKKI MARWAT DISTRICT,20,Male,7036,969,8005
LAKKI MARWAT DISTRICT,20,Female,8373,914,9287
LAKKI MARWAT DISTRICT,20,Transgender,0,0,0
LAKKI MARWAT DISTRICT,21,Male,6054,824,6878
LAKKI MARWAT DISTRICT,21,Female,6736,868,7604
LAKKI MARWAT DISTRICT,21,Transgender,0,0,0
LAKKI MARWAT DISTRICT,22,Male,5903,780,6683
LAKKI MARWAT DISTRICT,22,Female,6818,795,7613
LAKKI MARWAT DISTRICT,22,Transgender,0,0,0
LAKKI MARWAT DISTRICT,23,Male,5900,845,6745
LAKKI MARWAT DISTRICT,23,Female,6389,768,7157
LAKKI MARWAT DISTRICT,23,Transgender,0,0,0
LAKKI MARWAT DISTRICT,24,Male,5533,758,6291
LAKKI MARWAT DISTRICT,24,Female,5754,779,6533
LAKKI MARWAT DISTRICT,24,Transgender,0,0,0
LAKKI MARWAT DISTRICT,25,Male,5986,778,6764
LAKKI MARWAT DISTRICT,25,Female,7086,779,7865
LAKKI MARWAT DISTRICT,25,Transgender,0,0,0
LAKKI MARWAT DISTRICT,26,Male,5403,788,6191
LAKKI MARWAT DISTRICT,26,Female,6486,788,7274
LAKKI MARWAT DISTRICT,26,Transgender,0,0,0
LAKKI MARWAT DISTRICT,27,Male,4900,761,5661
LAKKI MARWAT DISTRICT,27,Female,6128,732,6860
LAKKI MARWAT DISTRICT,27,Transgender,0,0,0
LAKKI MARWAT DISTRICT,28,Male,5064,733,5797
LAKKI MARWAT DISTRICT,28,Female,6119,735,6854
LAKKI MARWAT DISTRICT,28,Transgender,0,0,0
LAKKI MARWAT DISTRICT,29,Male,4416,650,5066
LAKKI MARWAT DISTRICT,29,Female,5977,686,6663
LAKKI MARWAT DISTRICT,29,Transgender,0,0,0
LAKKI MARWAT DISTRICT,30,Male,4965,642,5607
LAKKI MARWAT DISTRICT,30,Female,6097,669,6766
LAKKI MARWAT DISTRICT,30,Transgender,0,0,0
LAKKI MARWAT DISTRICT,31,Male,3958,599,4557
LAKKI MARWAT DISTRICT,31,Female,5001,611,5612
LAKKI MARWAT DISTRICT,31,Transgender,0,0,0
LAKKI MARWAT DISTRICT,32,Male,3771,598,4369
LAKKI MARWAT DISTRICT,32,Female,4148,543,4691
LAKKI MARWAT DISTRICT,32,Transgender,0,0,0
LAKKI MARWAT DISTRICT,33,Male,3630,558,4188
LAKKI MARWAT DISTRICT,33,Female,4288,524,4812
LAKKI MARWAT DISTRICT,33,Transgender,0,0,0
LAKKI MARWAT DISTRICT,34,Male,3308,474,3782
LAKKI MARWAT DISTRICT,34,Female,3650,454,4104
LAKKI MARWAT DISTRICT,34,Transgender,0,0,0
LAKKI MARWAT DISTRICT,35,Male,3623,487,4110
LAKKI MARWAT DISTRICT,35,Female,3993,480,4473
LAKKI MARWAT DISTRICT,35,Transgender,0,0,0
LAKKI MARWAT DISTRICT,36,Male,3083,432,3515
LAKKI MARWAT DISTRICT,36,Female,3498,462,3960
LAKKI MARWAT DISTRICT,36,Transgender,0,0,0
LAKKI MARWAT DISTRICT,37,Male,2588,395,2983
LAKKI MARWAT DISTRICT,37,Female,3327,427,3754
LAKKI MARWAT DISTRICT,37,Transgender,0,0,0
LAKKI MARWAT DISTRICT,38,Male,3226,441,3667
LAKKI MARWAT DISTRICT,38,Female,3227,449,3676
LAKKI MARWAT DISTRICT,38,Transgender,0,0,0
LAKKI MARWAT DISTRICT,39,Male,2883,396,3279
LAKKI MARWAT DISTRICT,39,Female,3129,395,3524
LAKKI MARWAT DISTRICT,39,Transgender,0,0,0
LAKKI MARWAT DISTRICT,40,Male,3426,406,3832
LAKKI MARWAT DISTRICT,40,Female,4316,451,4767
LAKKI MARWAT DISTRICT,40,Transgender,0,0,0
LAKKI MARWAT DISTRICT,41,Male,2724,387,3111
LAKKI MARWAT DISTRICT,41,Female,3261,364,3625
LAKKI MARWAT DISTRICT,41,Transgender,0,0,0
LAKKI MARWAT DISTRICT,42,Male,2634,380,3014
LAKKI MARWAT DISTRICT,42,Female,2908,373,3281
LAKKI MARWAT DISTRICT,42,Transgender,0,0,0
LAKKI MARWAT DISTRICT,43,Male,2604,377,2981
LAKKI MARWAT DISTRICT,43,Female,2917,362,3279
LAKKI MARWAT DISTRICT,43,Transgender,0,0,0
LAKKI MARWAT DISTRICT,44,Male,2483,362,2845
LAKKI MARWAT DISTRICT,44,Female,2557,342,2899
LAKKI MARWAT DISTRICT,44,Transgender,3,0,3
LAKKI MARWAT DISTRICT,45,Male,2705,341,3046
LAKKI MARWAT DISTRICT,45,Female,2986,359,3345
LAKKI MARWAT DISTRICT,45,Transgender,0,0,0
LAKKI MARWAT DISTRICT,46,Male,2384,319,2703
LAKKI MARWAT DISTRICT,46,Female,2482,300,2782
LAKKI MARWAT DISTRICT,46,Transgender,0,0,0
LAKKI MARWAT DISTRICT,47,Male,2206,301,2507
LAKKI MARWAT DISTRICT,47,Female,2427,263,2690
LAKKI MARWAT DISTRICT,47,Transgender,0,0,0
LAKKI MARWAT DISTRICT,48,Male,2480,345,2825
LAKKI MARWAT DISTRICT,48,Female,2575,331,2906
LAKKI MARWAT DISTRICT,48,Transgender,0,0,0
LAKKI MARWAT DISTRICT,49,Male,2291,284,2575
LAKKI MARWAT DISTRICT,49,Female,2434,283,2717
LAKKI MARWAT DISTRICT,49,Transgender,0,0,0
LAKKI MARWAT DISTRICT,50,Male,2835,377,3212
LAKKI MARWAT DISTRICT,50,Female,3064,362,3426
LAKKI MARWAT DISTRICT,50,Transgender,0,0,0
LAKKI MARWAT DISTRICT,51,Male,2113,325,2438
LAKKI MARWAT DISTRICT,51,Female,2117,239,2356
LAKKI MARWAT DISTRICT,51,Transgender,0,0,0
LAKKI MARWAT DISTRICT,52,Male,2081,311,2392
LAKKI MARWAT DISTRICT,52,Female,1939,247,2186
LAKKI MARWAT DISTRICT,52,Transgender,0,0,0
LAKKI MARWAT DISTRICT,53,Male,2215,311,2526
LAKKI MARWAT DISTRICT,53,Female,1984,239,2223
LAKKI MARWAT DISTRICT,53,Transgender,0,0,0
LAKKI MARWAT DISTRICT,54,Male,1908,253,2161
LAKKI MARWAT DISTRICT,54,Female,1834,250,2084
LAKKI MARWAT DISTRICT,54,Transgender,0,0,0
LAKKI MARWAT DISTRICT,55,Male,2119,231,2350
LAKKI MARWAT DISTRICT,55,Female,1984,214,2198
LAKKI MARWAT DISTRICT,55,Transgender,0,0,0
LAKKI MARWAT DISTRICT,56,Male,1735,236,1971
LAKKI MARWAT DISTRICT,56,Female,1553,184,1737
LAKKI MARWAT DISTRICT,56,Transgender,0,0,0
LAKKI MARWAT DISTRICT,57,Male,1629,198,1827
LAKKI MARWAT DISTRICT,57,Female,1464,130,1594
LAKKI MARWAT DISTRICT,57,Transgender,0,0,0
LAKKI MARWAT DISTRICT,58,Male,2117,231,2348
LAKKI MARWAT DISTRICT,58,Female,1726,233,1959
LAKKI MARWAT DISTRICT,58,Transgender,0,0,0
LAKKI MARWAT DISTRICT,59,Male,1817,232,2049
LAKKI MARWAT DISTRICT,59,Female,1554,166,1720
LAKKI MARWAT DISTRICT,59,Transgender,0,0,0
LAKKI MARWAT DISTRICT,60,Male,1960,205,2165
LAKKI MARWAT DISTRICT,60,Female,1900,188,2088
LAKKI MARWAT DISTRICT,60,Transgender,0,0,0
LAKKI MARWAT DISTRICT,61,Male,1591,209,1800
LAKKI MARWAT DISTRICT,61,Female,1484,176,1660
LAKKI MARWAT DISTRICT,61,Transgender,0,0,0
LAKKI MARWAT DISTRICT,62,Male,1630,213,1843
LAKKI MARWAT DISTRICT,62,Female,1401,165,1566
LAKKI MARWAT DISTRICT,62,Transgender,0,0,0
LAKKI MARWAT DISTRICT,63,Male,1691,184,1875
LAKKI MARWAT DISTRICT,63,Female,1427,167,1594
LAKKI MARWAT DISTRICT,63,Transgender,0,0,0
LAKKI MARWAT DISTRICT,64,Male,1565,185,1750
LAKKI MARWAT DISTRICT,64,Female,1271,154,1425
LAKKI MARWAT DISTRICT,64,Transgender,0,0,0
LAKKI MARWAT DISTRICT,65,Male,1598,146,1744
LAKKI MARWAT DISTRICT,65,Female,1179,131,1310
LAKKI MARWAT DISTRICT,65,Transgender,0,0,0
LAKKI MARWAT DISTRICT,66,Male,1107,125,1232
LAKKI MARWAT DISTRICT,66,Female,965,109,1074
LAKKI MARWAT DISTRICT,66,Transgender,0,0,0
LAKKI MARWAT DISTRICT,67,Male,896,129,1025
LAKKI MARWAT DISTRICT,67,Female,811,87,898
LAKKI MARWAT DISTRICT,67,Transgender,0,0,0
LAKKI MARWAT DISTRICT,68,Male,1078,110,1188
LAKKI MARWAT DISTRICT,68,Female,899,102,1001
LAKKI MARWAT DISTRICT,68,Transgender,0,0,0
LAKKI MARWAT DISTRICT,69,Male,1025,111,1136
LAKKI MARWAT DISTRICT,69,Female,865,94,959
LAKKI MARWAT DISTRICT,69,Transgender,0,0,0
LAKKI MARWAT DISTRICT,70,Male,1024,82,1106
LAKKI MARWAT DISTRICT,70,Female,792,75,867
LAKKI MARWAT DISTRICT,70,Transgender,0,0,0
LAKKI MARWAT DISTRICT,71,Male,768,96,864
LAKKI MARWAT DISTRICT,71,Female,678,69,747
LAKKI MARWAT DISTRICT,71,Transgender,0,0,0
LAKKI MARWAT DISTRICT,72,Male,629,70,699
LAKKI MARWAT DISTRICT,72,Female,542,68,610
LAKKI MARWAT DISTRICT,72,Transgender,0,0,0
LAKKI MARWAT DISTRICT,73,Male,714,71,785
LAKKI MARWAT DISTRICT,73,Female,537,57,594
LAKKI MARWAT DISTRICT,73,Transgender,0,0,0
LAKKI MARWAT DISTRICT,74,Male,656,80,736
LAKKI MARWAT DISTRICT,74,Female,541,58,599
LAKKI MARWAT DISTRICT,74,Transgender,0,0,0
LAKKI MARWAT DISTRICT,>=75,Male,4464,461,4925
LAKKI MARWAT DISTRICT,>=75,Female,4653,426,5079
LAKKI MARWAT DISTRICT,>=75,Transgender,0,0,0
LARKANA DISTRICT,<1,Male,9186,8247,17433
LARKANA DISTRICT,<1,Female,8990,7451,16441
LARKANA DISTRICT,<1,Transgender,0,0,0
LARKANA DISTRICT,1,Male,10270,8223,18493
LARKANA DISTRICT,1,Female,10327,8109,18436
LARKANA DISTRICT,1,Transgender,0,0,0
LARKANA DISTRICT,2,Male,13187,9701,22888
LARKANA DISTRICT,2,Female,13362,9582,22944
LARKANA DISTRICT,2,Transgender,0,0,0
LARKANA DISTRICT,3,Male,14840,11325,26165
LARKANA DISTRICT,3,Female,14422,10769,25191
LARKANA DISTRICT,3,Transgender,0,0,0
LARKANA DISTRICT,4,Male,15662,11016,26678
LARKANA DISTRICT,4,Female,15630,11101,26731
LARKANA DISTRICT,4,Transgender,0,0,0
LARKANA DISTRICT,5,Male,15873,11875,27748
LARKANA DISTRICT,5,Female,14902,11135,26037
LARKANA DISTRICT,5,Transgender,0,0,0
LARKANA DISTRICT,6,Male,15078,10555,25633
LARKANA DISTRICT,6,Female,14073,9868,23941
LARKANA DISTRICT,6,Transgender,0,0,0
LARKANA DISTRICT,7,Male,14277,10982,25259
LARKANA DISTRICT,7,Female,12858,10386,23244
LARKANA DISTRICT,7,Transgender,0,0,0
LARKANA DISTRICT,8,Male,15757,10867,26624
LARKANA DISTRICT,8,Female,14221,9903,24124
LARKANA DISTRICT,8,Transgender,0,0,0
LARKANA DISTRICT,9,Male,12741,9824,22565
LARKANA DISTRICT,9,Female,11203,8937,20140
LARKANA DISTRICT,9,Transgender,0,0,0
LARKANA DISTRICT,10,Male,14187,10017,24204
LARKANA DISTRICT,10,Female,12394,8788,21182
LARKANA DISTRICT,10,Transgender,0,0,0
LARKANA DISTRICT,11,Male,10530,8575,19105
LARKANA DISTRICT,11,Female,9025,7764,16789
LARKANA DISTRICT,11,Transgender,0,0,0
LARKANA DISTRICT,12,Male,11566,8856,20422
LARKANA DISTRICT,12,Female,10234,8017,18251
LARKANA DISTRICT,12,Transgender,0,0,0
LARKANA DISTRICT,13,Male,9929,8128,18057
LARKANA DISTRICT,13,Female,8625,7490,16115
LARKANA DISTRICT,13,Transgender,0,0,0
LARKANA DISTRICT,14,Male,10278,8194,18472
LARKANA DISTRICT,14,Female,9176,7670,16846
LARKANA DISTRICT,14,Transgender,0,0,0
LARKANA DISTRICT,15,Male,10740,8952,19692
LARKANA DISTRICT,15,Female,9134,8079,17213
LARKANA DISTRICT,15,Transgender,1,1,2
LARKANA DISTRICT,16,Male,10177,8370,18547
LARKANA DISTRICT,16,Female,9113,7840,16953
LARKANA DISTRICT,16,Transgender,3,1,4
LARKANA DISTRICT,17,Male,9779,9054,18833
LARKANA DISTRICT,17,Female,8663,8249,16912
LARKANA DISTRICT,17,Transgender,2,5,7
LARKANA DISTRICT,18,Male,9967,8638,18605
LARKANA DISTRICT,18,Female,9550,8566,18116
LARKANA DISTRICT,18,Transgender,4,15,19
LARKANA DISTRICT,19,Male,8129,7955,16084
LARKANA DISTRICT,19,Female,7641,7675,15316
LARKANA DISTRICT,19,Transgender,3,6,9
LARKANA DISTRICT,20,Male,8462,7739,16201
LARKANA DISTRICT,20,Female,8652,7718,16370
LARKANA DISTRICT,20,Transgender,4,8,12
LARKANA DISTRICT,21,Male,6417,6600,13017
LARKANA DISTRICT,21,Female,6289,6512,12801
LARKANA DISTRICT,21,Transgender,1,2,3
LARKANA DISTRICT,22,Male,6690,6812,13502
LARKANA DISTRICT,22,Female,6078,6630,12708
LARKANA DISTRICT,22,Transgender,6,6,12
LARKANA DISTRICT,23,Male,5699,6141,11840
LARKANA DISTRICT,23,Female,5432,5849,11281
LARKANA DISTRICT,23,Transgender,2,3,5
LARKANA DISTRICT,24,Male,5076,5430,10506
LARKANA DISTRICT,24,Female,5349,5595,10944
LARKANA DISTRICT,24,Transgender,4,6,10
LARKANA DISTRICT,25,Male,6401,5957,12358
LARKANA DISTRICT,25,Female,6691,6356,13047
LARKANA DISTRICT,25,Transgender,4,8,12
LARKANA DISTRICT,26,Male,5071,5213,10284
LARKANA DISTRICT,26,Female,5293,5343,10636
LARKANA DISTRICT,26,Transgender,5,5,10
LARKANA DISTRICT,27,Male,5355,5356,10711
LARKANA DISTRICT,27,Female,5953,5593,11546
LARKANA DISTRICT,27,Transgender,3,4,7
LARKANA DISTRICT,28,Male,5618,5568,11186
LARKANA DISTRICT,28,Female,6239,6089,12328
LARKANA DISTRICT,28,Transgender,3,4,7
LARKANA DISTRICT,29,Male,5481,5011,10492
LARKANA DISTRICT,29,Female,6102,5324,11426
LARKANA DISTRICT,29,Transgender,2,6,8
LARKANA DISTRICT,30,Male,5713,5691,11404
LARKANA DISTRICT,30,Female,5818,5790,11608
LARKANA DISTRICT,30,Transgender,3,11,14
LARKANA DISTRICT,31,Male,5426,5025,10451
LARKANA DISTRICT,31,Female,5606,4964,10570
LARKANA DISTRICT,31,Transgender,2,2,4
LARKANA DISTRICT,32,Male,5246,4993,10239
LARKANA DISTRICT,32,Female,5293,4590,9883
LARKANA DISTRICT,32,Transgender,6,6,12
LARKANA DISTRICT,33,Male,4781,4618,9399
LARKANA DISTRICT,33,Female,4604,4404,9008
LARKANA DISTRICT,33,Transgender,3,3,6
LARKANA DISTRICT,34,Male,4336,3965,8301
LARKANA DISTRICT,34,Female,4030,3789,7819
LARKANA DISTRICT,34,Transgender,0,3,3
LARKANA DISTRICT,35,Male,4766,4578,9344
LARKANA DISTRICT,35,Female,4503,4525,9028
LARKANA DISTRICT,35,Transgender,7,8,15
LARKANA DISTRICT,36,Male,3809,3546,7355
LARKANA DISTRICT,36,Female,3642,3274,6916
LARKANA DISTRICT,36,Transgender,2,5,7
LARKANA DISTRICT,37,Male,4747,3732,8479
LARKANA DISTRICT,37,Female,5150,3698,8848
LARKANA DISTRICT,37,Transgender,3,9,12
LARKANA DISTRICT,38,Male,4121,4036,8157
LARKANA DISTRICT,38,Female,4039,3997,8036
LARKANA DISTRICT,38,Transgender,3,7,10
LARKANA DISTRICT,39,Male,4463,3778,8241
LARKANA DISTRICT,39,Female,4493,3666,8159
LARKANA DISTRICT,39,Transgender,0,4,4
LARKANA DISTRICT,40,Male,3808,4139,7947
LARKANA DISTRICT,40,Female,3933,4051,7984
LARKANA DISTRICT,40,Transgender,4,8,12
LARKANA DISTRICT,41,Male,3292,3187,6479
LARKANA DISTRICT,41,Female,3633,3008,6641
LARKANA DISTRICT,41,Transgender,0,4,4
LARKANA DISTRICT,42,Male,3388,3050,6438
LARKANA DISTRICT,42,Female,4076,3230,7306
LARKANA DISTRICT,42,Transgender,1,1,2
LARKANA DISTRICT,43,Male,3009,3011,6020
LARKANA DISTRICT,43,Female,2961,2962,5923
LARKANA DISTRICT,43,Transgender,1,1,2
LARKANA DISTRICT,44,Male,2897,2712,5609
LARKANA DISTRICT,44,Female,2851,2535,5386
LARKANA DISTRICT,44,Transgender,0,2,2
LARKANA DISTRICT,45,Male,2998,3037,6035
LARKANA DISTRICT,45,Female,3065,3036,6101
LARKANA DISTRICT,45,Transgender,5,9,14
LARKANA DISTRICT,46,Male,2799,2378,5177
LARKANA DISTRICT,46,Female,2421,1958,4379
LARKANA DISTRICT,46,Transgender,1,3,4
LARKANA DISTRICT,47,Male,3022,2532,5554
LARKANA DISTRICT,47,Female,3363,2478,5841
LARKANA DISTRICT,47,Transgender,2,4,6
LARKANA DISTRICT,48,Male,2822,2578,5400
LARKANA DISTRICT,48,Female,2523,2459,4982
LARKANA DISTRICT,48,Transgender,2,4,6
LARKANA DISTRICT,49,Male,2842,2513,5355
LARKANA DISTRICT,49,Female,2958,2512,5470
LARKANA DISTRICT,49,Transgender,0,0,0
LARKANA DISTRICT,50,Male,2761,2775,5536
LARKANA DISTRICT,50,Female,2475,2605,5080
LARKANA DISTRICT,50,Transgender,3,6,9
LARKANA DISTRICT,51,Male,2468,2231,4699
LARKANA DISTRICT,51,Female,2333,1854,4187
LARKANA DISTRICT,51,Transgender,1,4,5
LARKANA DISTRICT,52,Male,2478,2244,4722
LARKANA DISTRICT,52,Female,2692,2118,4810
LARKANA DISTRICT,52,Transgender,0,1,1
LARKANA DISTRICT,53,Male,2075,2023,4098
LARKANA DISTRICT,53,Female,1745,1715,3460
LARKANA DISTRICT,53,Transgender,0,1,1
LARKANA DISTRICT,54,Male,1993,1894,3887
LARKANA DISTRICT,54,Female,1476,1588,3064
LARKANA DISTRICT,54,Transgender,0,0,0
LARKANA DISTRICT,55,Male,2036,2053,4089
LARKANA DISTRICT,55,Female,1756,1748,3504
LARKANA DISTRICT,55,Transgender,4,5,9
LARKANA DISTRICT,56,Male,1618,1496,3114
LARKANA DISTRICT,56,Female,1376,1170,2546
LARKANA DISTRICT,56,Transgender,1,0,1
LARKANA DISTRICT,57,Male,1861,1507,3368
LARKANA DISTRICT,57,Female,1986,1406,3392
LARKANA DISTRICT,57,Transgender,0,1,1
LARKANA DISTRICT,58,Male,1529,1450,2979
LARKANA DISTRICT,58,Female,1288,1242,2530
LARKANA DISTRICT,58,Transgender,0,0,0
LARKANA DISTRICT,59,Male,1363,1274,2637
LARKANA DISTRICT,59,Female,1463,1250,2713
LARKANA DISTRICT,59,Transgender,0,0,0
LARKANA DISTRICT,60,Male,1470,1357,2827
LARKANA DISTRICT,60,Female,1634,1514,3148
LARKANA DISTRICT,60,Transgender,1,5,6
LARKANA DISTRICT,61,Male,1335,1115,2450
LARKANA DISTRICT,61,Female,1546,1184,2730
LARKANA DISTRICT,61,Transgender,0,1,1
LARKANA DISTRICT,62,Male,1534,1253,2787
LARKANA DISTRICT,62,Female,2037,1419,3456
LARKANA DISTRICT,62,Transgender,2,1,3
LARKANA DISTRICT,63,Male,1291,1173,2464
LARKANA DISTRICT,63,Female,1231,1167,2398
LARKANA DISTRICT,63,Transgender,0,1,1
LARKANA DISTRICT,64,Male,1283,1105,2388
LARKANA DISTRICT,64,Female,1208,1039,2247
LARKANA DISTRICT,64,Transgender,0,0,0
LARKANA DISTRICT,65,Male,1120,1024,2144
LARKANA DISTRICT,65,Female,1143,980,2123
LARKANA DISTRICT,65,Transgender,2,2,4
LARKANA DISTRICT,66,Male,1030,839,1869
LARKANA DISTRICT,66,Female,977,732,1709
LARKANA DISTRICT,66,Transgender,0,1,1
LARKANA DISTRICT,67,Male,1145,803,1948
LARKANA DISTRICT,67,Female,1306,773,2079
LARKANA DISTRICT,67,Transgender,1,0,1
LARKANA DISTRICT,68,Male,826,661,1487
LARKANA DISTRICT,68,Female,773,608,1381
LARKANA DISTRICT,68,Transgender,1,0,1
LARKANA DISTRICT,69,Male,792,640,1432
LARKANA DISTRICT,69,Female,791,631,1422
LARKANA DISTRICT,69,Transgender,0,0,0
LARKANA DISTRICT,70,Male,725,615,1340
LARKANA DISTRICT,70,Female,784,721,1505
LARKANA DISTRICT,70,Transgender,3,0,3
LARKANA DISTRICT,71,Male,716,525,1241
LARKANA DISTRICT,71,Female,707,507,1214
LARKANA DISTRICT,71,Transgender,0,0,0
LARKANA DISTRICT,72,Male,716,550,1266
LARKANA DISTRICT,72,Female,856,579,1435
LARKANA DISTRICT,72,Transgender,2,0,2
LARKANA DISTRICT,73,Male,528,439,967
LARKANA DISTRICT,73,Female,539,493,1032
LARKANA DISTRICT,73,Transgender,1,1,2
LARKANA DISTRICT,74,Male,461,374,835
LARKANA DISTRICT,74,Female,481,396,877
LARKANA DISTRICT,74,Transgender,0,0,0
LARKANA DISTRICT,>=75,Male,3579,2793,6372
LARKANA DISTRICT,>=75,Female,4146,3445,7591
LARKANA DISTRICT,>=75,Transgender,1,3,4
LASBELA DISTRICT,<1,Male,3893,3799,7692
LASBELA DISTRICT,<1,Female,3640,3561,7201
LASBELA DISTRICT,<1,Transgender,0,0,0
LASBELA DISTRICT,1,Male,4275,4275,8550
LASBELA DISTRICT,1,Female,4141,3970,8111
LASBELA DISTRICT,1,Transgender,0,0,0
LASBELA DISTRICT,2,Male,5162,4547,9709
LASBELA DISTRICT,2,Female,5038,4418,9456
LASBELA DISTRICT,2,Transgender,0,0,0
LASBELA DISTRICT,3,Male,4933,4785,9718
LASBELA DISTRICT,3,Female,4548,4613,9161
LASBELA DISTRICT,3,Transgender,0,0,0
LASBELA DISTRICT,4,Male,5516,4655,10171
LASBELA DISTRICT,4,Female,5334,4505,9839
LASBELA DISTRICT,4,Transgender,0,0,0
LASBELA DISTRICT,5,Male,4659,4463,9122
LASBELA DISTRICT,5,Female,4241,4299,8540
LASBELA DISTRICT,5,Transgender,0,0,0
LASBELA DISTRICT,6,Male,5400,4539,9939
LASBELA DISTRICT,6,Female,5038,4126,9164
LASBELA DISTRICT,6,Transgender,0,0,0
LASBELA DISTRICT,7,Male,4533,4690,9223
LASBELA DISTRICT,7,Female,3851,4220,8071
LASBELA DISTRICT,7,Transgender,0,0,0
LASBELA DISTRICT,8,Male,5441,4500,9941
LASBELA DISTRICT,8,Female,4795,4068,8863
LASBELA DISTRICT,8,Transgender,0,0,0
LASBELA DISTRICT,9,Male,4224,4405,8629
LASBELA DISTRICT,9,Female,3770,3761,7531
LASBELA DISTRICT,9,Transgender,0,0,0
LASBELA DISTRICT,10,Male,4684,4283,8967
LASBELA DISTRICT,10,Female,4172,3673,7845
LASBELA DISTRICT,10,Transgender,0,0,0
LASBELA DISTRICT,11,Male,3513,3821,7334
LASBELA DISTRICT,11,Female,3073,3296,6369
LASBELA DISTRICT,11,Transgender,0,0,0
LASBELA DISTRICT,12,Male,3796,3686,7482
LASBELA DISTRICT,12,Female,3378,3147,6525
LASBELA DISTRICT,12,Transgender,0,0,0
LASBELA DISTRICT,13,Male,3083,3446,6529
LASBELA DISTRICT,13,Female,2592,2888,5480
LASBELA DISTRICT,13,Transgender,0,0,0
LASBELA DISTRICT,14,Male,3100,3171,6271
LASBELA DISTRICT,14,Female,2945,2848,5793
LASBELA DISTRICT,14,Transgender,0,0,0
LASBELA DISTRICT,15,Male,2877,3249,6126
LASBELA DISTRICT,15,Female,2629,2776,5405
LASBELA DISTRICT,15,Transgender,0,1,1
LASBELA DISTRICT,16,Male,2773,3047,5820
LASBELA DISTRICT,16,Female,2683,2577,5260
LASBELA DISTRICT,16,Transgender,0,0,0
LASBELA DISTRICT,17,Male,2569,3067,5636
LASBELA DISTRICT,17,Female,2476,2668,5144
LASBELA DISTRICT,17,Transgender,0,0,0
LASBELA DISTRICT,18,Male,3015,3278,6293
LASBELA DISTRICT,18,Female,2740,2857,5597
LASBELA DISTRICT,18,Transgender,0,0,0
LASBELA DISTRICT,19,Male,2996,3278,6274
LASBELA DISTRICT,19,Female,2500,2849,5349
LASBELA DISTRICT,19,Transgender,0,1,1
LASBELA DISTRICT,20,Male,3212,3158,6370
LASBELA DISTRICT,20,Female,2591,2718,5309
LASBELA DISTRICT,20,Transgender,0,0,0
LASBELA DISTRICT,21,Male,2770,3152,5922
LASBELA DISTRICT,21,Female,2334,2653,4987
LASBELA DISTRICT,21,Transgender,0,0,0
LASBELA DISTRICT,22,Male,2287,2617,4904
LASBELA DISTRICT,22,Female,2121,2270,4391
LASBELA DISTRICT,22,Transgender,0,0,0
LASBELA DISTRICT,23,Male,2024,2556,4580
LASBELA DISTRICT,23,Female,1865,2122,3987
LASBELA DISTRICT,23,Transgender,0,0,0
LASBELA DISTRICT,24,Male,2100,2407,4507
LASBELA DISTRICT,24,Female,2120,2181,4301
LASBELA DISTRICT,24,Transgender,0,0,0
LASBELA DISTRICT,25,Male,2133,2341,4474
LASBELA DISTRICT,25,Female,2169,2398,4567
LASBELA DISTRICT,25,Transgender,0,0,0
LASBELA DISTRICT,26,Male,2211,2318,4529
LASBELA DISTRICT,26,Female,2271,2297,4568
LASBELA DISTRICT,26,Transgender,0,0,0
LASBELA DISTRICT,27,Male,2238,2387,4625
LASBELA DISTRICT,27,Female,2323,2489,4812
LASBELA DISTRICT,27,Transgender,0,0,0
LASBELA DISTRICT,28,Male,2212,2310,4522
LASBELA DISTRICT,28,Female,2392,2297,4689
LASBELA DISTRICT,28,Transgender,0,0,0
LASBELA DISTRICT,29,Male,2211,2435,4646
LASBELA DISTRICT,29,Female,2482,2255,4737
LASBELA DISTRICT,29,Transgender,0,0,0
LASBELA DISTRICT,30,Male,2078,2276,4354
LASBELA DISTRICT,30,Female,2066,2094,4160
LASBELA DISTRICT,30,Transgender,0,0,0
LASBELA DISTRICT,31,Male,2201,2281,4482
LASBELA DISTRICT,31,Female,2248,2087,4335
LASBELA DISTRICT,31,Transgender,0,0,0
LASBELA DISTRICT,32,Male,1953,1998,3951
LASBELA DISTRICT,32,Female,1947,1850,3797
LASBELA DISTRICT,32,Transgender,0,0,0
LASBELA DISTRICT,33,Male,1801,1920,3721
LASBELA DISTRICT,33,Female,1840,1665,3505
LASBELA DISTRICT,33,Transgender,0,0,0
LASBELA DISTRICT,34,Male,1855,1788,3643
LASBELA DISTRICT,34,Female,1756,1550,3306
LASBELA DISTRICT,34,Transgender,0,0,0
LASBELA DISTRICT,35,Male,1581,1636,3217
LASBELA DISTRICT,35,Female,1465,1541,3006
LASBELA DISTRICT,35,Transgender,0,0,0
LASBELA DISTRICT,36,Male,1897,1653,3550
LASBELA DISTRICT,36,Female,1549,1454,3003
LASBELA DISTRICT,36,Transgender,0,0,0
LASBELA DISTRICT,37,Male,1984,1673,3657
LASBELA DISTRICT,37,Female,1663,1426,3089
LASBELA DISTRICT,37,Transgender,0,0,0
LASBELA DISTRICT,38,Male,1816,1601,3417
LASBELA DISTRICT,38,Female,1548,1434,2982
LASBELA DISTRICT,38,Transgender,0,0,0
LASBELA DISTRICT,39,Male,1751,1593,3344
LASBELA DISTRICT,39,Female,1550,1443,2993
LASBELA DISTRICT,39,Transgender,0,0,0
LASBELA DISTRICT,40,Male,1448,1383,2831
LASBELA DISTRICT,40,Female,1385,1343,2728
LASBELA DISTRICT,40,Transgender,1,0,1
LASBELA DISTRICT,41,Male,1511,1449,2960
LASBELA DISTRICT,41,Female,1347,1212,2559
LASBELA DISTRICT,41,Transgender,0,1,1
LASBELA DISTRICT,42,Male,1365,1149,2514
LASBELA DISTRICT,42,Female,1238,1048,2286
LASBELA DISTRICT,42,Transgender,0,0,0
LASBELA DISTRICT,43,Male,1266,1175,2441
LASBELA DISTRICT,43,Female,1250,1085,2335
LASBELA DISTRICT,43,Transgender,0,0,0
LASBELA DISTRICT,44,Male,1287,1110,2397
LASBELA DISTRICT,44,Female,1210,952,2162
LASBELA DISTRICT,44,Transgender,0,0,0
LASBELA DISTRICT,45,Male,1108,1034,2142
LASBELA DISTRICT,45,Female,940,916,1856
LASBELA DISTRICT,45,Transgender,0,1,1
LASBELA DISTRICT,46,Male,1207,1134,2341
LASBELA DISTRICT,46,Female,1167,1004,2171
LASBELA DISTRICT,46,Transgender,1,0,1
LASBELA DISTRICT,47,Male,1189,994,2183
LASBELA DISTRICT,47,Female,1099,907,2006
LASBELA DISTRICT,47,Transgender,0,1,1
LASBELA DISTRICT,48,Male,1117,1025,2142
LASBELA DISTRICT,48,Female,1095,907,2002
LASBELA DISTRICT,48,Transgender,0,0,0
LASBELA DISTRICT,49,Male,1204,1052,2256
LASBELA DISTRICT,49,Female,1165,847,2012
LASBELA DISTRICT,49,Transgender,0,0,0
LASBELA DISTRICT,50,Male,1038,988,2026
LASBELA DISTRICT,50,Female,840,793,1633
LASBELA DISTRICT,50,Transgender,0,0,0
LASBELA DISTRICT,51,Male,1251,1081,2332
LASBELA DISTRICT,51,Female,991,782,1773
LASBELA DISTRICT,51,Transgender,0,1,1
LASBELA DISTRICT,52,Male,950,754,1704
LASBELA DISTRICT,52,Female,720,616,1336
LASBELA DISTRICT,52,Transgender,0,0,0
LASBELA DISTRICT,53,Male,1056,802,1858
LASBELA DISTRICT,53,Female,709,666,1375
LASBELA DISTRICT,53,Transgender,0,0,0
LASBELA DISTRICT,54,Male,804,725,1529
LASBELA DISTRICT,54,Female,620,570,1190
LASBELA DISTRICT,54,Transgender,0,0,0
LASBELA DISTRICT,55,Male,623,624,1247
LASBELA DISTRICT,55,Female,532,475,1007
LASBELA DISTRICT,55,Transgender,0,0,0
LASBELA DISTRICT,56,Male,680,602,1282
LASBELA DISTRICT,56,Female,548,536,1084
LASBELA DISTRICT,56,Transgender,0,0,0
LASBELA DISTRICT,57,Male,613,561,1174
LASBELA DISTRICT,57,Female,559,509,1068
LASBELA DISTRICT,57,Transgender,0,0,0
LASBELA DISTRICT,58,Male,655,577,1232
LASBELA DISTRICT,58,Female,630,485,1115
LASBELA DISTRICT,58,Transgender,1,0,1
LASBELA DISTRICT,59,Male,662,589,1251
LASBELA DISTRICT,59,Female,634,530,1164
LASBELA DISTRICT,59,Transgender,0,0,0
LASBELA DISTRICT,60,Male,690,526,1216
LASBELA DISTRICT,60,Female,609,520,1129
LASBELA DISTRICT,60,Transgender,0,0,0
LASBELA DISTRICT,61,Male,735,521,1256
LASBELA DISTRICT,61,Female,712,497,1209
LASBELA DISTRICT,61,Transgender,0,0,0
LASBELA DISTRICT,62,Male,556,479,1035
LASBELA DISTRICT,62,Female,535,443,978
LASBELA DISTRICT,62,Transgender,0,0,0
LASBELA DISTRICT,63,Male,611,504,1115
LASBELA DISTRICT,63,Female,572,451,1023
LASBELA DISTRICT,63,Transgender,0,0,0
LASBELA DISTRICT,64,Male,582,459,1041
LASBELA DISTRICT,64,Female,546,410,956
LASBELA DISTRICT,64,Transgender,0,0,0
LASBELA DISTRICT,65,Male,520,381,901
LASBELA DISTRICT,65,Female,420,323,743
LASBELA DISTRICT,65,Transgender,0,1,1
LASBELA DISTRICT,66,Male,601,381,982
LASBELA DISTRICT,66,Female,568,355,923
LASBELA DISTRICT,66,Transgender,0,0,0
LASBELA DISTRICT,67,Male,375,268,643
LASBELA DISTRICT,67,Female,347,255,602
LASBELA DISTRICT,67,Transgender,0,0,0
LASBELA DISTRICT,68,Male,480,332,812
LASBELA DISTRICT,68,Female,456,312,768
LASBELA DISTRICT,68,Transgender,0,0,0
LASBELA DISTRICT,69,Male,495,264,759
LASBELA DISTRICT,69,Female,435,287,722
LASBELA DISTRICT,69,Transgender,0,0,0
LASBELA DISTRICT,70,Male,391,223,614
LASBELA DISTRICT,70,Female,366,205,571
LASBELA DISTRICT,70,Transgender,0,1,1
LASBELA DISTRICT,71,Male,474,213,687
LASBELA DISTRICT,71,Female,422,249,671
LASBELA DISTRICT,71,Transgender,0,0,0
LASBELA DISTRICT,72,Male,232,175,407
LASBELA DISTRICT,72,Female,224,184,408
LASBELA DISTRICT,72,Transgender,0,0,0
LASBELA DISTRICT,73,Male,307,215,522
LASBELA DISTRICT,73,Female,290,177,467
LASBELA DISTRICT,73,Transgender,0,0,0
LASBELA DISTRICT,74,Male,287,126,413
LASBELA DISTRICT,74,Female,239,162,401
LASBELA DISTRICT,74,Transgender,0,0,0
LASBELA DISTRICT,>=75,Male,1972,1146,3118
LASBELA DISTRICT,>=75,Female,1967,1428,3395
LASBELA DISTRICT,>=75,Transgender,0,0,0
LAYYAH DISTRICT,<1,Male,21678,3919,25597
LAYYAH DISTRICT,<1,Female,20482,3887,24369
LAYYAH DISTRICT,<1,Transgender,0,0,0
LAYYAH DISTRICT,1,Male,22842,4073,26915
LAYYAH DISTRICT,1,Female,21408,4100,25508
LAYYAH DISTRICT,1,Transgender,0,0,0
LAYYAH DISTRICT,2,Male,22789,4070,26859
LAYYAH DISTRICT,2,Female,21877,3977,25854
LAYYAH DISTRICT,2,Transgender,0,0,0
LAYYAH DISTRICT,3,Male,23776,4353,28129
LAYYAH DISTRICT,3,Female,22766,4270,27036
LAYYAH DISTRICT,3,Transgender,0,0,0
LAYYAH DISTRICT,4,Male,24759,4294,29053
LAYYAH DISTRICT,4,Female,23722,4065,27787
LAYYAH DISTRICT,4,Transgender,0,0,0
LAYYAH DISTRICT,5,Male,23862,4364,28226
LAYYAH DISTRICT,5,Female,22484,4146,26630
LAYYAH DISTRICT,5,Transgender,0,0,0
LAYYAH DISTRICT,6,Male,23033,4210,27243
LAYYAH DISTRICT,6,Female,21763,3919,25682
LAYYAH DISTRICT,6,Transgender,0,0,0
LAYYAH DISTRICT,7,Male,24665,4601,29266
LAYYAH DISTRICT,7,Female,22978,4140,27118
LAYYAH DISTRICT,7,Transgender,0,0,0
LAYYAH DISTRICT,8,Male,22913,4083,26996
LAYYAH DISTRICT,8,Female,21716,3891,25607
LAYYAH DISTRICT,8,Transgender,0,0,0
LAYYAH DISTRICT,9,Male,24247,4544,28791
LAYYAH DISTRICT,9,Female,21993,4227,26220
LAYYAH DISTRICT,9,Transgender,0,0,0
LAYYAH DISTRICT,10,Male,21140,3673,24813
LAYYAH DISTRICT,10,Female,19560,3465,23025
LAYYAH DISTRICT,10,Transgender,0,0,0
LAYYAH DISTRICT,11,Male,21504,4403,25907
LAYYAH DISTRICT,11,Female,19376,4107,23483
LAYYAH DISTRICT,11,Transgender,0,0,0
LAYYAH DISTRICT,12,Male,18881,3663,22544
LAYYAH DISTRICT,12,Female,17494,3178,20672
LAYYAH DISTRICT,12,Transgender,0,0,0
LAYYAH DISTRICT,13,Male,18437,3972,22409
LAYYAH DISTRICT,13,Female,16741,3576,20317
LAYYAH DISTRICT,13,Transgender,0,0,0
LAYYAH DISTRICT,14,Male,17523,3755,21278
LAYYAH DISTRICT,14,Female,16285,3263,19548
LAYYAH DISTRICT,14,Transgender,0,0,0
LAYYAH DISTRICT,15,Male,16907,3589,20496
LAYYAH DISTRICT,15,Female,15800,3339,19139
LAYYAH DISTRICT,15,Transgender,4,0,4
LAYYAH DISTRICT,16,Male,16437,3826,20263
LAYYAH DISTRICT,16,Female,15590,3375,18965
LAYYAH DISTRICT,16,Transgender,4,0,4
LAYYAH DISTRICT,17,Male,16129,3758,19887
LAYYAH DISTRICT,17,Female,15427,3516,18943
LAYYAH DISTRICT,17,Transgender,3,0,3
LAYYAH DISTRICT,18,Male,14906,3312,18218
LAYYAH DISTRICT,18,Female,14552,3054,17606
LAYYAH DISTRICT,18,Transgender,7,2,9
LAYYAH DISTRICT,19,Male,14760,3594,18354
LAYYAH DISTRICT,19,Female,14869,3695,18564
LAYYAH DISTRICT,19,Transgender,1,2,3
LAYYAH DISTRICT,20,Male,13050,3002,16052
LAYYAH DISTRICT,20,Female,14388,2775,17163
LAYYAH DISTRICT,20,Transgender,4,1,5
LAYYAH DISTRICT,21,Male,13437,3323,16760
LAYYAH DISTRICT,21,Female,14242,3422,17664
LAYYAH DISTRICT,21,Transgender,0,2,2
LAYYAH DISTRICT,22,Male,12343,2781,15124
LAYYAH DISTRICT,22,Female,12727,2920,15647
LAYYAH DISTRICT,22,Transgender,3,3,6
LAYYAH DISTRICT,23,Male,12776,2838,15614
LAYYAH DISTRICT,23,Female,12605,3130,15735
LAYYAH DISTRICT,23,Transgender,1,1,2
LAYYAH DISTRICT,24,Male,11903,2782,14685
LAYYAH DISTRICT,24,Female,12248,2905,15153
LAYYAH DISTRICT,24,Transgender,1,3,4
LAYYAH DISTRICT,25,Male,10568,2319,12887
LAYYAH DISTRICT,25,Female,11544,2547,14091
LAYYAH DISTRICT,25,Transgender,7,1,8
LAYYAH DISTRICT,26,Male,11435,2560,13995
LAYYAH DISTRICT,26,Female,12474,2941,15415
LAYYAH DISTRICT,26,Transgender,3,0,3
LAYYAH DISTRICT,27,Male,11061,2581,13642
LAYYAH DISTRICT,27,Female,11811,2893,14704
LAYYAH DISTRICT,27,Transgender,3,3,6
LAYYAH DISTRICT,28,Male,10046,2414,12460
LAYYAH DISTRICT,28,Female,10617,2492,13109
LAYYAH DISTRICT,28,Transgender,1,3,4
LAYYAH DISTRICT,29,Male,11152,2578,13730
LAYYAH DISTRICT,29,Female,11843,2866,14709
LAYYAH DISTRICT,29,Transgender,2,4,6
LAYYAH DISTRICT,30,Male,8514,2017,10531
LAYYAH DISTRICT,30,Female,9379,2101,11480
LAYYAH DISTRICT,30,Transgender,3,4,7
LAYYAH DISTRICT,31,Male,9529,2264,11793
LAYYAH DISTRICT,31,Female,10916,2498,13414
LAYYAH DISTRICT,31,Transgender,0,2,2
LAYYAH DISTRICT,32,Male,8114,2119,10233
LAYYAH DISTRICT,32,Female,9441,2452,11893
LAYYAH DISTRICT,32,Transgender,1,2,3
LAYYAH DISTRICT,33,Male,7732,1910,9642
LAYYAH DISTRICT,33,Female,8514,2144,10658
LAYYAH DISTRICT,33,Transgender,0,2,2
LAYYAH DISTRICT,34,Male,9274,2072,11346
LAYYAH DISTRICT,34,Female,9554,2122,11676
LAYYAH DISTRICT,34,Transgender,0,0,0
LAYYAH DISTRICT,35,Male,8058,1821,9879
LAYYAH DISTRICT,35,Female,7969,1772,9741
LAYYAH DISTRICT,35,Transgender,2,2,4
LAYYAH DISTRICT,36,Male,10222,2033,12255
LAYYAH DISTRICT,36,Female,10870,2307,13177
LAYYAH DISTRICT,36,Transgender,0,3,3
LAYYAH DISTRICT,37,Male,9102,2059,11161
LAYYAH DISTRICT,37,Female,9925,2204,12129
LAYYAH DISTRICT,37,Transgender,2,0,2
LAYYAH DISTRICT,38,Male,7485,1987,9472
LAYYAH DISTRICT,38,Female,7625,1935,9560
LAYYAH DISTRICT,38,Transgender,2,3,5
LAYYAH DISTRICT,39,Male,7997,1934,9931
LAYYAH DISTRICT,39,Female,8310,2027,10337
LAYYAH DISTRICT,39,Transgender,0,0,0
LAYYAH DISTRICT,40,Male,5572,1536,7108
LAYYAH DISTRICT,40,Female,5469,1452,6921
LAYYAH DISTRICT,40,Transgender,1,1,2
LAYYAH DISTRICT,41,Male,7261,1685,8946
LAYYAH DISTRICT,41,Female,8125,1823,9948
LAYYAH DISTRICT,41,Transgender,1,0,1
LAYYAH DISTRICT,42,Male,6195,1518,7713
LAYYAH DISTRICT,42,Female,6996,1687,8683
LAYYAH DISTRICT,42,Transgender,0,1,1
LAYYAH DISTRICT,43,Male,5821,1541,7362
LAYYAH DISTRICT,43,Female,5448,1418,6866
LAYYAH DISTRICT,43,Transgender,0,1,1
LAYYAH DISTRICT,44,Male,6132,1465,7597
LAYYAH DISTRICT,44,Female,5587,1439,7026
LAYYAH DISTRICT,44,Transgender,0,0,0
LAYYAH DISTRICT,45,Male,4791,1225,6016
LAYYAH DISTRICT,45,Female,4440,1150,5590
LAYYAH DISTRICT,45,Transgender,1,3,4
LAYYAH DISTRICT,46,Male,6417,1460,7877
LAYYAH DISTRICT,46,Female,6663,1479,8142
LAYYAH DISTRICT,46,Transgender,0,1,1
LAYYAH DISTRICT,47,Male,6068,1401,7469
LAYYAH DISTRICT,47,Female,6478,1390,7868
LAYYAH DISTRICT,47,Transgender,0,1,1
LAYYAH DISTRICT,48,Male,5888,1430,7318
LAYYAH DISTRICT,48,Female,5087,1377,6464
LAYYAH DISTRICT,48,Transgender,0,1,1
LAYYAH DISTRICT,49,Male,6213,1478,7691
LAYYAH DISTRICT,49,Female,5453,1296,6749
LAYYAH DISTRICT,49,Transgender,1,1,2
LAYYAH DISTRICT,50,Male,4745,1257,6002
LAYYAH DISTRICT,50,Female,4010,1048,5058
LAYYAH DISTRICT,50,Transgender,2,1,3
LAYYAH DISTRICT,51,Male,6208,1503,7711
LAYYAH DISTRICT,51,Female,5775,1307,7082
LAYYAH DISTRICT,51,Transgender,2,0,2
LAYYAH DISTRICT,52,Male,5493,1403,6896
LAYYAH DISTRICT,52,Female,4987,1202,6189
LAYYAH DISTRICT,52,Transgender,2,1,3
LAYYAH DISTRICT,53,Male,5373,1275,6648
LAYYAH DISTRICT,53,Female,4086,1004,5090
LAYYAH DISTRICT,53,Transgender,1,0,1
LAYYAH DISTRICT,54,Male,4947,1235,6182
LAYYAH DISTRICT,54,Female,3656,1048,4704
LAYYAH DISTRICT,54,Transgender,0,0,0
LAYYAH DISTRICT,55,Male,3526,947,4473
LAYYAH DISTRICT,55,Female,2612,760,3372
LAYYAH DISTRICT,55,Transgender,0,1,1
LAYYAH DISTRICT,56,Male,4159,1010,5169
LAYYAH DISTRICT,56,Female,3414,905,4319
LAYYAH DISTRICT,56,Transgender,1,0,1
LAYYAH DISTRICT,57,Male,3465,839,4304
LAYYAH DISTRICT,57,Female,3027,754,3781
LAYYAH DISTRICT,57,Transgender,1,0,1
LAYYAH DISTRICT,58,Male,3129,813,3942
LAYYAH DISTRICT,58,Female,2611,690,3301
LAYYAH DISTRICT,58,Transgender,1,0,1
LAYYAH DISTRICT,59,Male,3099,839,3938
LAYYAH DISTRICT,59,Female,2863,750,3613
LAYYAH DISTRICT,59,Transgender,0,0,0
LAYYAH DISTRICT,60,Male,2391,585,2976
LAYYAH DISTRICT,60,Female,2353,555,2908
LAYYAH DISTRICT,60,Transgender,0,1,1
LAYYAH DISTRICT,61,Male,3257,784,4041
LAYYAH DISTRICT,61,Female,3201,684,3885
LAYYAH DISTRICT,61,Transgender,1,0,1
LAYYAH DISTRICT,62,Male,2781,668,3449
LAYYAH DISTRICT,62,Female,2680,644,3324
LAYYAH DISTRICT,62,Transgender,0,0,0
LAYYAH DISTRICT,63,Male,2632,731,3363
LAYYAH DISTRICT,63,Female,2616,612,3228
LAYYAH DISTRICT,63,Transgender,0,1,1
LAYYAH DISTRICT,64,Male,2500,640,3140
LAYYAH DISTRICT,64,Female,2336,580,2916
LAYYAH DISTRICT,64,Transgender,0,1,1
LAYYAH DISTRICT,65,Male,2084,479,2563
LAYYAH DISTRICT,65,Female,1995,453,2448
LAYYAH DISTRICT,65,Transgender,1,0,1
LAYYAH DISTRICT,66,Male,2559,509,3068
LAYYAH DISTRICT,66,Female,2477,507,2984
LAYYAH DISTRICT,66,Transgender,0,1,1
LAYYAH DISTRICT,67,Male,2212,437,2649
LAYYAH DISTRICT,67,Female,2180,449,2629
LAYYAH DISTRICT,67,Transgender,0,0,0
LAYYAH DISTRICT,68,Male,1929,429,2358
LAYYAH DISTRICT,68,Female,1823,388,2211
LAYYAH DISTRICT,68,Transgender,0,0,0
LAYYAH DISTRICT,69,Male,1897,383,2280
LAYYAH DISTRICT,69,Female,1710,407,2117
LAYYAH DISTRICT,69,Transgender,1,0,1
LAYYAH DISTRICT,70,Male,1589,345,1934
LAYYAH DISTRICT,70,Female,1505,324,1829
LAYYAH DISTRICT,70,Transgender,2,0,2
LAYYAH DISTRICT,71,Male,2129,365,2494
LAYYAH DISTRICT,71,Female,1857,398,2255
LAYYAH DISTRICT,71,Transgender,0,0,0
LAYYAH DISTRICT,72,Male,1665,345,2010
LAYYAH DISTRICT,72,Female,1457,320,1777
LAYYAH DISTRICT,72,Transgender,0,0,0
LAYYAH DISTRICT,73,Male,1425,323,1748
LAYYAH DISTRICT,73,Female,1233,305,1538
LAYYAH DISTRICT,73,Transgender,0,1,1
LAYYAH DISTRICT,74,Male,1308,298,1606
LAYYAH DISTRICT,74,Female,1146,235,1381
LAYYAH DISTRICT,74,Transgender,0,0,0
LAYYAH DISTRICT,>=75,Male,10386,1974,12360
LAYYAH DISTRICT,>=75,Female,9267,2025,11292
LAYYAH DISTRICT,>=75,Transgender,8,0,8
LODHRAN DISTRICT,<1,Male,17986,3160,21146
LODHRAN DISTRICT,<1,Female,17033,2945,19978
LODHRAN DISTRICT,<1,Transgender,0,0,0
LODHRAN DISTRICT,1,Male,20713,3601,24314
LODHRAN DISTRICT,1,Female,19302,3513,22815
LODHRAN DISTRICT,1,Transgender,0,0,0
LODHRAN DISTRICT,2,Male,20660,3393,24053
LODHRAN DISTRICT,2,Female,19079,3225,22304
LODHRAN DISTRICT,2,Transgender,0,0,0
LODHRAN DISTRICT,3,Male,22537,3644,26181
LODHRAN DISTRICT,3,Female,21478,3632,25110
LODHRAN DISTRICT,3,Transgender,0,0,0
LODHRAN DISTRICT,4,Male,24046,3763,27809
LODHRAN DISTRICT,4,Female,22208,3607,25815
LODHRAN DISTRICT,4,Transgender,0,0,0
LODHRAN DISTRICT,5,Male,23474,3962,27436
LODHRAN DISTRICT,5,Female,21847,3602,25449
LODHRAN DISTRICT,5,Transgender,0,0,0
LODHRAN DISTRICT,6,Male,22810,3761,26571
LODHRAN DISTRICT,6,Female,21063,3444,24507
LODHRAN DISTRICT,6,Transgender,0,0,0
LODHRAN DISTRICT,7,Male,24373,4083,28456
LODHRAN DISTRICT,7,Female,22534,3751,26285
LODHRAN DISTRICT,7,Transgender,0,0,0
LODHRAN DISTRICT,8,Male,24136,3785,27921
LODHRAN DISTRICT,8,Female,21437,3457,24894
LODHRAN DISTRICT,8,Transgender,0,0,0
LODHRAN DISTRICT,9,Male,22960,4125,27085
LODHRAN DISTRICT,9,Female,20932,3871,24803
LODHRAN DISTRICT,9,Transgender,0,0,0
LODHRAN DISTRICT,10,Male,21622,3516,25138
LODHRAN DISTRICT,10,Female,19360,3164,22524
LODHRAN DISTRICT,10,Transgender,0,0,0
LODHRAN DISTRICT,11,Male,19371,3814,23185
LODHRAN DISTRICT,11,Female,17510,3585,21095
LODHRAN DISTRICT,11,Transgender,0,0,0
LODHRAN DISTRICT,12,Male,18927,3335,22262
LODHRAN DISTRICT,12,Female,16904,2984,19888
LODHRAN DISTRICT,12,Transgender,0,0,0
LODHRAN DISTRICT,13,Male,17075,3432,20507
LODHRAN DISTRICT,13,Female,15230,3076,18306
LODHRAN DISTRICT,13,Transgender,0,0,0
LODHRAN DISTRICT,14,Male,16156,3217,19373
LODHRAN DISTRICT,14,Female,14974,2805,17779
LODHRAN DISTRICT,14,Transgender,0,0,0
LODHRAN DISTRICT,15,Male,15832,3032,18864
LODHRAN DISTRICT,15,Female,14534,2822,17356
LODHRAN DISTRICT,15,Transgender,1,0,1
LODHRAN DISTRICT,16,Male,14944,2916,17860
LODHRAN DISTRICT,16,Female,13860,2831,16691
LODHRAN DISTRICT,16,Transgender,3,1,4
LODHRAN DISTRICT,17,Male,15117,3162,18279
LODHRAN DISTRICT,17,Female,14457,2929,17386
LODHRAN DISTRICT,17,Transgender,0,4,4
LODHRAN DISTRICT,18,Male,13788,2498,16286
LODHRAN DISTRICT,18,Female,13278,2340,15618
LODHRAN DISTRICT,18,Transgender,2,1,3
LODHRAN DISTRICT,19,Male,12975,2725,15700
LODHRAN DISTRICT,19,Female,12767,2717,15484
LODHRAN DISTRICT,19,Transgender,2,2,4
LODHRAN DISTRICT,20,Male,13399,2490,15889
LODHRAN DISTRICT,20,Female,13969,2422,16391
LODHRAN DISTRICT,20,Transgender,4,3,7
LODHRAN DISTRICT,21,Male,12000,2514,14514
LODHRAN DISTRICT,21,Female,11963,2773,14736
LODHRAN DISTRICT,21,Transgender,4,1,5
LODHRAN DISTRICT,22,Male,11810,2278,14088
LODHRAN DISTRICT,22,Female,12601,2572,15173
LODHRAN DISTRICT,22,Transgender,2,1,3
LODHRAN DISTRICT,23,Male,10621,2135,12756
LODHRAN DISTRICT,23,Female,11097,2314,13411
LODHRAN DISTRICT,23,Transgender,1,1,2
LODHRAN DISTRICT,24,Male,9910,2101,12011
LODHRAN DISTRICT,24,Female,10358,2373,12731
LODHRAN DISTRICT,24,Transgender,3,0,3
LODHRAN DISTRICT,25,Male,10433,2018,12451
LODHRAN DISTRICT,25,Female,12081,2281,14362
LODHRAN DISTRICT,25,Transgender,3,2,5
LODHRAN DISTRICT,26,Male,9511,2056,11567
LODHRAN DISTRICT,26,Female,10414,2269,12683
LODHRAN DISTRICT,26,Transgender,1,1,2
LODHRAN DISTRICT,27,Male,9650,2039,11689
LODHRAN DISTRICT,27,Female,10353,2182,12535
LODHRAN DISTRICT,27,Transgender,0,3,3
LODHRAN DISTRICT,28,Male,10057,1959,12016
LODHRAN DISTRICT,28,Female,10934,2110,13044
LODHRAN DISTRICT,28,Transgender,4,1,5
LODHRAN DISTRICT,29,Male,10018,2053,12071
LODHRAN DISTRICT,29,Female,10779,2215,12994
LODHRAN DISTRICT,29,Transgender,5,2,7
LODHRAN DISTRICT,30,Male,9237,1838,11075
LODHRAN DISTRICT,30,Female,10215,1961,12176
LODHRAN DISTRICT,30,Transgender,3,0,3
LODHRAN DISTRICT,31,Male,9142,1925,11067
LODHRAN DISTRICT,31,Female,10489,2077,12566
LODHRAN DISTRICT,31,Transgender,0,3,3
LODHRAN DISTRICT,32,Male,7726,1730,9456
LODHRAN DISTRICT,32,Female,9139,1756,10895
LODHRAN DISTRICT,32,Transgender,2,1,3
LODHRAN DISTRICT,33,Male,7439,1647,9086
LODHRAN DISTRICT,33,Female,8824,1884,10708
LODHRAN DISTRICT,33,Transgender,0,0,0
LODHRAN DISTRICT,34,Male,8665,1692,10357
LODHRAN DISTRICT,34,Female,9372,1768,11140
LODHRAN DISTRICT,34,Transgender,4,0,4
LODHRAN DISTRICT,35,Male,8393,1583,9976
LODHRAN DISTRICT,35,Female,8550,1582,10132
LODHRAN DISTRICT,35,Transgender,7,1,8
LODHRAN DISTRICT,36,Male,10694,1914,12608
LODHRAN DISTRICT,36,Female,10290,1855,12145
LODHRAN DISTRICT,36,Transgender,1,2,3
LODHRAN DISTRICT,37,Male,8986,1561,10547
LODHRAN DISTRICT,37,Female,8512,1596,10108
LODHRAN DISTRICT,37,Transgender,5,1,6
LODHRAN DISTRICT,38,Male,8119,1686,9805
LODHRAN DISTRICT,38,Female,8178,1583,9761
LODHRAN DISTRICT,38,Transgender,1,1,2
LODHRAN DISTRICT,39,Male,8084,1547,9631
LODHRAN DISTRICT,39,Female,8147,1589,9736
LODHRAN DISTRICT,39,Transgender,1,0,1
LODHRAN DISTRICT,40,Male,6476,1351,7827
LODHRAN DISTRICT,40,Female,6598,1282,7880
LODHRAN DISTRICT,40,Transgender,3,1,4
LODHRAN DISTRICT,41,Male,7998,1571,9569
LODHRAN DISTRICT,41,Female,8439,1589,10028
LODHRAN DISTRICT,41,Transgender,1,0,1
LODHRAN DISTRICT,42,Male,6446,1264,7710
LODHRAN DISTRICT,42,Female,6684,1226,7910
LODHRAN DISTRICT,42,Transgender,4,0,4
LODHRAN DISTRICT,43,Male,5689,1234,6923
LODHRAN DISTRICT,43,Female,5682,1148,6830
LODHRAN DISTRICT,43,Transgender,1,0,1
LODHRAN DISTRICT,44,Male,5685,1200,6885
LODHRAN DISTRICT,44,Female,5697,1086,6783
LODHRAN DISTRICT,44,Transgender,1,0,1
LODHRAN DISTRICT,45,Male,4920,1092,6012
LODHRAN DISTRICT,45,Female,5033,966,5999
LODHRAN DISTRICT,45,Transgender,0,0,0
LODHRAN DISTRICT,46,Male,6478,1119,7597
LODHRAN DISTRICT,46,Female,6939,1130,8069
LODHRAN DISTRICT,46,Transgender,0,1,1
LODHRAN DISTRICT,47,Male,5696,1081,6777
LODHRAN DISTRICT,47,Female,5422,929,6351
LODHRAN DISTRICT,47,Transgender,2,1,3
LODHRAN DISTRICT,48,Male,5468,1044,6512
LODHRAN DISTRICT,48,Female,5413,1049,6462
LODHRAN DISTRICT,48,Transgender,0,0,0
LODHRAN DISTRICT,49,Male,5601,1130,6731
LODHRAN DISTRICT,49,Female,5297,1067,6364
LODHRAN DISTRICT,49,Transgender,1,0,1
LODHRAN DISTRICT,50,Male,4778,972,5750
LODHRAN DISTRICT,50,Female,4450,868,5318
LODHRAN DISTRICT,50,Transgender,2,1,3
LODHRAN DISTRICT,51,Male,6200,1094,7294
LODHRAN DISTRICT,51,Female,5818,1094,6912
LODHRAN DISTRICT,51,Transgender,0,0,0
LODHRAN DISTRICT,52,Male,5067,1002,6069
LODHRAN DISTRICT,52,Female,4582,853,5435
LODHRAN DISTRICT,52,Transgender,0,0,0
LODHRAN DISTRICT,53,Male,4533,935,5468
LODHRAN DISTRICT,53,Female,3951,803,4754
LODHRAN DISTRICT,53,Transgender,0,1,1
LODHRAN DISTRICT,54,Male,4261,814,5075
LODHRAN DISTRICT,54,Female,3669,737,4406
LODHRAN DISTRICT,54,Transgender,0,1,1
LODHRAN DISTRICT,55,Male,3554,724,4278
LODHRAN DISTRICT,55,Female,3109,573,3682
LODHRAN DISTRICT,55,Transgender,1,0,1
LODHRAN DISTRICT,56,Male,4092,737,4829
LODHRAN DISTRICT,56,Female,3664,647,4311
LODHRAN DISTRICT,56,Transgender,1,0,1
LODHRAN DISTRICT,57,Male,3208,591,3799
LODHRAN DISTRICT,57,Female,2944,444,3388
LODHRAN DISTRICT,57,Transgender,3,0,3
LODHRAN DISTRICT,58,Male,2826,557,3383
LODHRAN DISTRICT,58,Female,2748,518,3266
LODHRAN DISTRICT,58,Transgender,1,0,1
LODHRAN DISTRICT,59,Male,2819,476,3295
LODHRAN DISTRICT,59,Female,2935,546,3481
LODHRAN DISTRICT,59,Transgender,0,2,2
LODHRAN DISTRICT,60,Male,2667,481,3148
LODHRAN DISTRICT,60,Female,2942,512,3454
LODHRAN DISTRICT,60,Transgender,3,0,3
LODHRAN DISTRICT,61,Male,3210,579,3789
LODHRAN DISTRICT,61,Female,3504,591,4095
LODHRAN DISTRICT,61,Transgender,1,1,2
LODHRAN DISTRICT,62,Male,2868,487,3355
LODHRAN DISTRICT,62,Female,3045,552,3597
LODHRAN DISTRICT,62,Transgender,4,0,4
LODHRAN DISTRICT,63,Male,2640,470,3110
LODHRAN DISTRICT,63,Female,2727,503,3230
LODHRAN DISTRICT,63,Transgender,0,0,0
LODHRAN DISTRICT,64,Male,2515,434,2949
LODHRAN DISTRICT,64,Female,2583,506,3089
LODHRAN DISTRICT,64,Transgender,0,0,0
LODHRAN DISTRICT,65,Male,2276,363,2639
LODHRAN DISTRICT,65,Female,2408,379,2787
LODHRAN DISTRICT,65,Transgender,1,0,1
LODHRAN DISTRICT,66,Male,2726,410,3136
LODHRAN DISTRICT,66,Female,2710,419,3129
LODHRAN DISTRICT,66,Transgender,0,0,0
LODHRAN DISTRICT,67,Male,2264,357,2621
LODHRAN DISTRICT,67,Female,2088,326,2414
LODHRAN DISTRICT,67,Transgender,0,0,0
LODHRAN DISTRICT,68,Male,1871,317,2188
LODHRAN DISTRICT,68,Female,1791,318,2109
LODHRAN DISTRICT,68,Transgender,0,0,0
LODHRAN DISTRICT,69,Male,1780,269,2049
LODHRAN DISTRICT,69,Female,1741,305,2046
LODHRAN DISTRICT,69,Transgender,0,0,0
LODHRAN DISTRICT,70,Male,1637,249,1886
LODHRAN DISTRICT,70,Female,1659,294,1953
LODHRAN DISTRICT,70,Transgender,3,0,3
LODHRAN DISTRICT,71,Male,1902,266,2168
LODHRAN DISTRICT,71,Female,1865,284,2149
LODHRAN DISTRICT,71,Transgender,2,0,2
LODHRAN DISTRICT,72,Male,1592,269,1861
LODHRAN DISTRICT,72,Female,1487,261,1748
LODHRAN DISTRICT,72,Transgender,3,0,3
LODHRAN DISTRICT,73,Male,1359,199,1558
LODHRAN DISTRICT,73,Female,1185,215,1400
LODHRAN DISTRICT,73,Transgender,0,0,0
LODHRAN DISTRICT,74,Male,1104,218,1322
LODHRAN DISTRICT,74,Female,1132,197,1329
LODHRAN DISTRICT,74,Transgender,1,0,1
LODHRAN DISTRICT,>=75,Male,9385,1361,10746
LODHRAN DISTRICT,>=75,Female,9010,1474,10484
LODHRAN DISTRICT,>=75,Transgender,4,0,4
LORALAI DISTRICT,<1,Male,4571,816,5387
LORALAI DISTRICT,<1,Female,4095,846,4941
LORALAI DISTRICT,<1,Transgender,0,0,0
LORALAI DISTRICT,1,Male,6590,1040,7630
LORALAI DISTRICT,1,Female,6160,903,7063
LORALAI DISTRICT,1,Transgender,0,0,0
LORALAI DISTRICT,2,Male,7079,1031,8110
LORALAI DISTRICT,2,Female,6563,993,7556
LORALAI DISTRICT,2,Transgender,0,0,0
LORALAI DISTRICT,3,Male,6957,1090,8047
LORALAI DISTRICT,3,Female,6491,1012,7503
LORALAI DISTRICT,3,Transgender,0,0,0
LORALAI DISTRICT,4,Male,6853,1055,7908
LORALAI DISTRICT,4,Female,6524,956,7480
LORALAI DISTRICT,4,Transgender,0,0,0
LORALAI DISTRICT,5,Male,7025,1108,8133
LORALAI DISTRICT,5,Female,6251,970,7221
LORALAI DISTRICT,5,Transgender,0,0,0
LORALAI DISTRICT,6,Male,6819,1068,7887
LORALAI DISTRICT,6,Female,6070,933,7003
LORALAI DISTRICT,6,Transgender,0,0,0
LORALAI DISTRICT,7,Male,6934,1109,8043
LORALAI DISTRICT,7,Female,5659,961,6620
LORALAI DISTRICT,7,Transgender,0,0,0
LORALAI DISTRICT,8,Male,6738,968,7706
LORALAI DISTRICT,8,Female,5674,858,6532
LORALAI DISTRICT,8,Transgender,0,0,0
LORALAI DISTRICT,9,Male,6191,1092,7283
LORALAI DISTRICT,9,Female,5069,925,5994
LORALAI DISTRICT,9,Transgender,0,0,0
LORALAI DISTRICT,10,Male,5725,884,6609
LORALAI DISTRICT,10,Female,4656,762,5418
LORALAI DISTRICT,10,Transgender,0,0,0
LORALAI DISTRICT,11,Male,4910,932,5842
LORALAI DISTRICT,11,Female,4011,743,4754
LORALAI DISTRICT,11,Transgender,0,0,0
LORALAI DISTRICT,12,Male,4443,801,5244
LORALAI DISTRICT,12,Female,3612,674,4286
LORALAI DISTRICT,12,Transgender,0,0,0
LORALAI DISTRICT,13,Male,4248,922,5170
LORALAI DISTRICT,13,Female,3434,687,4121
LORALAI DISTRICT,13,Transgender,0,0,0
LORALAI DISTRICT,14,Male,3881,787,4668
LORALAI DISTRICT,14,Female,3092,582,3674
LORALAI DISTRICT,14,Transgender,0,0,0
LORALAI DISTRICT,15,Male,4090,748,4838
LORALAI DISTRICT,15,Female,3159,598,3757
LORALAI DISTRICT,15,Transgender,1,0,1
LORALAI DISTRICT,16,Male,3454,727,4181
LORALAI DISTRICT,16,Female,2701,631,3332
LORALAI DISTRICT,16,Transgender,0,0,0
LORALAI DISTRICT,17,Male,3291,668,3959
LORALAI DISTRICT,17,Female,2507,616,3123
LORALAI DISTRICT,17,Transgender,0,0,0
LORALAI DISTRICT,18,Male,3656,950,4606
LORALAI DISTRICT,18,Female,2849,541,3390
LORALAI DISTRICT,18,Transgender,0,0,0
LORALAI DISTRICT,19,Male,3241,1296,4537
LORALAI DISTRICT,19,Female,2743,598,3341
LORALAI DISTRICT,19,Transgender,1,0,1
LORALAI DISTRICT,20,Male,3308,1059,4367
LORALAI DISTRICT,20,Female,2931,485,3416
LORALAI DISTRICT,20,Transgender,1,0,1
LORALAI DISTRICT,21,Male,2851,1139,3990
LORALAI DISTRICT,21,Female,2527,559,3086
LORALAI DISTRICT,21,Transgender,0,0,0
LORALAI DISTRICT,22,Male,2565,971,3536
LORALAI DISTRICT,22,Female,2136,454,2590
LORALAI DISTRICT,22,Transgender,0,0,0
LORALAI DISTRICT,23,Male,2424,843,3267
LORALAI DISTRICT,23,Female,2238,496,2734
LORALAI DISTRICT,23,Transgender,0,0,0
LORALAI DISTRICT,24,Male,2057,615,2672
LORALAI DISTRICT,24,Female,2101,437,2538
LORALAI DISTRICT,24,Transgender,0,0,0
LORALAI DISTRICT,25,Male,2678,565,3243
LORALAI DISTRICT,25,Female,3105,505,3610
LORALAI DISTRICT,25,Transgender,1,0,1
LORALAI DISTRICT,26,Male,1965,569,2534
LORALAI DISTRICT,26,Female,2202,481,2683
LORALAI DISTRICT,26,Transgender,0,0,0
LORALAI DISTRICT,27,Male,2468,599,3067
LORALAI DISTRICT,27,Female,2828,580,3408
LORALAI DISTRICT,27,Transgender,1,0,1
LORALAI DISTRICT,28,Male,2104,604,2708
LORALAI DISTRICT,28,Female,2193,455,2648
LORALAI DISTRICT,28,Transgender,0,0,0
LORALAI DISTRICT,29,Male,2186,622,2808
LORALAI DISTRICT,29,Female,2657,525,3182
LORALAI DISTRICT,29,Transgender,0,0,0
LORALAI DISTRICT,30,Male,2207,460,2667
LORALAI DISTRICT,30,Female,2219,402,2621
LORALAI DISTRICT,30,Transgender,0,0,0
LORALAI DISTRICT,31,Male,2273,527,2800
LORALAI DISTRICT,31,Female,2285,466,2751
LORALAI DISTRICT,31,Transgender,0,0,0
LORALAI DISTRICT,32,Male,1974,492,2466
LORALAI DISTRICT,32,Female,1880,401,2281
LORALAI DISTRICT,32,Transgender,0,1,1
LORALAI DISTRICT,33,Male,1868,447,2315
LORALAI DISTRICT,33,Female,1670,319,1989
LORALAI DISTRICT,33,Transgender,0,0,0
LORALAI DISTRICT,34,Male,1493,409,1902
LORALAI DISTRICT,34,Female,1325,317,1642
LORALAI DISTRICT,34,Transgender,0,0,0
LORALAI DISTRICT,35,Male,1804,365,2169
LORALAI DISTRICT,35,Female,1645,284,1929
LORALAI DISTRICT,35,Transgender,0,0,0
LORALAI DISTRICT,36,Male,1372,350,1722
LORALAI DISTRICT,36,Female,1036,247,1283
LORALAI DISTRICT,36,Transgender,1,0,1
LORALAI DISTRICT,37,Male,2100,400,2500
LORALAI DISTRICT,37,Female,1800,338,2138
LORALAI DISTRICT,37,Transgender,0,0,0
LORALAI DISTRICT,38,Male,1613,408,2021
LORALAI DISTRICT,38,Female,1265,267,1532
LORALAI DISTRICT,38,Transgender,1,0,1
LORALAI DISTRICT,39,Male,1715,392,2107
LORALAI DISTRICT,39,Female,1437,279,1716
LORALAI DISTRICT,39,Transgender,0,0,0
LORALAI DISTRICT,40,Male,1391,284,1675
LORALAI DISTRICT,40,Female,1354,250,1604
LORALAI DISTRICT,40,Transgender,1,0,1
LORALAI DISTRICT,41,Male,1211,325,1536
LORALAI DISTRICT,41,Female,1180,253,1433
LORALAI DISTRICT,41,Transgender,0,0,0
LORALAI DISTRICT,42,Male,1108,251,1359
LORALAI DISTRICT,42,Female,1142,223,1365
LORALAI DISTRICT,42,Transgender,1,0,1
LORALAI DISTRICT,43,Male,985,265,1250
LORALAI DISTRICT,43,Female,987,211,1198
LORALAI DISTRICT,43,Transgender,0,0,0
LORALAI DISTRICT,44,Male,868,231,1099
LORALAI DISTRICT,44,Female,808,183,991
LORALAI DISTRICT,44,Transgender,0,0,0
LORALAI DISTRICT,45,Male,1055,207,1262
LORALAI DISTRICT,45,Female,1099,208,1307
LORALAI DISTRICT,45,Transgender,1,0,1
LORALAI DISTRICT,46,Male,928,197,1125
LORALAI DISTRICT,46,Female,767,171,938
LORALAI DISTRICT,46,Transgender,0,1,1
LORALAI DISTRICT,47,Male,1232,222,1454
LORALAI DISTRICT,47,Female,1308,217,1525
LORALAI DISTRICT,47,Transgender,0,0,0
LORALAI DISTRICT,48,Male,918,239,1157
LORALAI DISTRICT,48,Female,711,168,879
LORALAI DISTRICT,48,Transgender,0,0,0
LORALAI DISTRICT,49,Male,1104,236,1340
LORALAI DISTRICT,49,Female,895,174,1069
LORALAI DISTRICT,49,Transgender,0,0,0
LORALAI DISTRICT,50,Male,950,199,1149
LORALAI DISTRICT,50,Female,837,148,985
LORALAI DISTRICT,50,Transgender,0,0,0
LORALAI DISTRICT,51,Male,954,231,1185
LORALAI DISTRICT,51,Female,742,179,921
LORALAI DISTRICT,51,Transgender,0,0,0
LORALAI DISTRICT,52,Male,863,151,1014
LORALAI DISTRICT,52,Female,756,162,918
LORALAI DISTRICT,52,Transgender,0,0,0
LORALAI DISTRICT,53,Male,798,188,986
LORALAI DISTRICT,53,Female,547,122,669
LORALAI DISTRICT,53,Transgender,0,0,0
LORALAI DISTRICT,54,Male,677,179,856
LORALAI DISTRICT,54,Female,519,103,622
LORALAI DISTRICT,54,Transgender,0,0,0
LORALAI DISTRICT,55,Male,589,132,721
LORALAI DISTRICT,55,Female,591,97,688
LORALAI DISTRICT,55,Transgender,0,0,0
LORALAI DISTRICT,56,Male,582,120,702
LORALAI DISTRICT,56,Female,471,93,564
LORALAI DISTRICT,56,Transgender,0,0,0
LORALAI DISTRICT,57,Male,645,132,777
LORALAI DISTRICT,57,Female,808,118,926
LORALAI DISTRICT,57,Transgender,0,0,0
LORALAI DISTRICT,58,Male,590,118,708
LORALAI DISTRICT,58,Female,423,77,500
LORALAI DISTRICT,58,Transgender,0,0,0
LORALAI DISTRICT,59,Male,738,152,890
LORALAI DISTRICT,59,Female,580,109,689
LORALAI DISTRICT,59,Transgender,0,0,0
LORALAI DISTRICT,60,Male,595,86,681
LORALAI DISTRICT,60,Female,541,85,626
LORALAI DISTRICT,60,Transgender,0,0,0
LORALAI DISTRICT,61,Male,581,123,704
LORALAI DISTRICT,61,Female,519,99,618
LORALAI DISTRICT,61,Transgender,0,0,0
LORALAI DISTRICT,62,Male,415,96,511
LORALAI DISTRICT,62,Female,566,89,655
LORALAI DISTRICT,62,Transgender,0,0,0
LORALAI DISTRICT,63,Male,521,110,631
LORALAI DISTRICT,63,Female,402,78,480
LORALAI DISTRICT,63,Transgender,0,0,0
LORALAI DISTRICT,64,Male,573,87,660
LORALAI DISTRICT,64,Female,448,77,525
LORALAI DISTRICT,64,Transgender,0,0,0
LORALAI DISTRICT,65,Male,453,68,521
LORALAI DISTRICT,65,Female,389,55,444
LORALAI DISTRICT,65,Transgender,0,0,0
LORALAI DISTRICT,66,Male,408,92,500
LORALAI DISTRICT,66,Female,368,74,442
LORALAI DISTRICT,66,Transgender,0,0,0
LORALAI DISTRICT,67,Male,443,74,517
LORALAI DISTRICT,67,Female,501,70,571
LORALAI DISTRICT,67,Transgender,0,0,0
LORALAI DISTRICT,68,Male,380,48,428
LORALAI DISTRICT,68,Female,303,54,357
LORALAI DISTRICT,68,Transgender,0,0,0
LORALAI DISTRICT,69,Male,508,73,581
LORALAI DISTRICT,69,Female,336,66,402
LORALAI DISTRICT,69,Transgender,0,0,0
LORALAI DISTRICT,70,Male,361,47,408
LORALAI DISTRICT,70,Female,227,39,266
LORALAI DISTRICT,70,Transgender,3,0,3
LORALAI DISTRICT,71,Male,386,55,441
LORALAI DISTRICT,71,Female,275,53,328
LORALAI DISTRICT,71,Transgender,0,0,0
LORALAI DISTRICT,72,Male,273,35,308
LORALAI DISTRICT,72,Female,255,48,303
LORALAI DISTRICT,72,Transgender,0,0,0
LORALAI DISTRICT,73,Male,248,45,293
LORALAI DISTRICT,73,Female,203,34,237
LORALAI DISTRICT,73,Transgender,0,0,0
LORALAI DISTRICT,74,Male,345,37,382
LORALAI DISTRICT,74,Female,193,37,230
LORALAI DISTRICT,74,Transgender,0,0,0
LORALAI DISTRICT,>=75,Male,1789,253,2042
LORALAI DISTRICT,>=75,Female,1481,263,1744
LORALAI DISTRICT,>=75,Transgender,1,0,1
LOWER DIR DISTRICT,<1,Male,19997,528,20525
LOWER DIR DISTRICT,<1,Female,19314,507,19821
LOWER DIR DISTRICT,<1,Transgender,0,0,0
LOWER DIR DISTRICT,1,Male,22150,643,22793
LOWER DIR DISTRICT,1,Female,21109,544,21653
LOWER DIR DISTRICT,1,Transgender,0,0,0
LOWER DIR DISTRICT,2,Male,24506,655,25161
LOWER DIR DISTRICT,2,Female,23326,587,23913
LOWER DIR DISTRICT,2,Transgender,0,0,0
LOWER DIR DISTRICT,3,Male,25716,641,26357
LOWER DIR DISTRICT,3,Female,24603,655,25258
LOWER DIR DISTRICT,3,Transgender,0,0,0
LOWER DIR DISTRICT,4,Male,26932,637,27569
LOWER DIR DISTRICT,4,Female,25513,681,26194
LOWER DIR DISTRICT,4,Transgender,0,0,0
LOWER DIR DISTRICT,5,Male,24437,664,25101
LOWER DIR DISTRICT,5,Female,22703,645,23348
LOWER DIR DISTRICT,5,Transgender,0,0,0
LOWER DIR DISTRICT,6,Male,23810,663,24473
LOWER DIR DISTRICT,6,Female,22600,550,23150
LOWER DIR DISTRICT,6,Transgender,0,0,0
LOWER DIR DISTRICT,7,Male,24185,600,24785
LOWER DIR DISTRICT,7,Female,22515,575,23090
LOWER DIR DISTRICT,7,Transgender,0,0,0
LOWER DIR DISTRICT,8,Male,23947,608,24555
LOWER DIR DISTRICT,8,Female,22853,595,23448
LOWER DIR DISTRICT,8,Transgender,0,0,0
LOWER DIR DISTRICT,9,Male,25133,647,25780
LOWER DIR DISTRICT,9,Female,22306,593,22899
LOWER DIR DISTRICT,9,Transgender,0,0,0
LOWER DIR DISTRICT,10,Male,21375,567,21942
LOWER DIR DISTRICT,10,Female,20026,533,20559
LOWER DIR DISTRICT,10,Transgender,0,0,0
LOWER DIR DISTRICT,11,Male,21852,606,22458
LOWER DIR DISTRICT,11,Female,19089,525,19614
LOWER DIR DISTRICT,11,Transgender,0,0,0
LOWER DIR DISTRICT,12,Male,18957,554,19511
LOWER DIR DISTRICT,12,Female,17564,519,18083
LOWER DIR DISTRICT,12,Transgender,0,0,0
LOWER DIR DISTRICT,13,Male,19654,577,20231
LOWER DIR DISTRICT,13,Female,17464,444,17908
LOWER DIR DISTRICT,13,Transgender,0,0,0
LOWER DIR DISTRICT,14,Male,18292,542,18834
LOWER DIR DISTRICT,14,Female,16806,462,17268
LOWER DIR DISTRICT,14,Transgender,0,0,0
LOWER DIR DISTRICT,15,Male,18180,535,18715
LOWER DIR DISTRICT,15,Female,16725,469,17194
LOWER DIR DISTRICT,15,Transgender,4,0,4
LOWER DIR DISTRICT,16,Male,16056,469,16525
LOWER DIR DISTRICT,16,Female,15577,469,16046
LOWER DIR DISTRICT,16,Transgender,2,0,2
LOWER DIR DISTRICT,17,Male,14389,488,14877
LOWER DIR DISTRICT,17,Female,15356,431,15787
LOWER DIR DISTRICT,17,Transgender,0,0,0
LOWER DIR DISTRICT,18,Male,14108,476,14584
LOWER DIR DISTRICT,18,Female,15087,420,15507
LOWER DIR DISTRICT,18,Transgender,1,0,1
LOWER DIR DISTRICT,19,Male,13490,416,13906
LOWER DIR DISTRICT,19,Female,13461,416,13877
LOWER DIR DISTRICT,19,Transgender,2,0,2
LOWER DIR DISTRICT,20,Male,12379,387,12766
LOWER DIR DISTRICT,20,Female,15758,414,16172
LOWER DIR DISTRICT,20,Transgender,2,1,3
LOWER DIR DISTRICT,21,Male,11019,378,11397
LOWER DIR DISTRICT,21,Female,12916,426,13342
LOWER DIR DISTRICT,21,Transgender,3,0,3
LOWER DIR DISTRICT,22,Male,11176,419,11595
LOWER DIR DISTRICT,22,Female,13182,380,13562
LOWER DIR DISTRICT,22,Transgender,2,0,2
LOWER DIR DISTRICT,23,Male,11442,378,11820
LOWER DIR DISTRICT,23,Female,12183,404,12587
LOWER DIR DISTRICT,23,Transgender,1,0,1
LOWER DIR DISTRICT,24,Male,9970,306,10276
LOWER DIR DISTRICT,24,Female,11114,365,11479
LOWER DIR DISTRICT,24,Transgender,0,0,0
LOWER DIR DISTRICT,25,Male,9772,349,10121
LOWER DIR DISTRICT,25,Female,13076,398,13474
LOWER DIR DISTRICT,25,Transgender,0,0,0
LOWER DIR DISTRICT,26,Male,9057,331,9388
LOWER DIR DISTRICT,26,Female,11285,342,11627
LOWER DIR DISTRICT,26,Transgender,1,0,1
LOWER DIR DISTRICT,27,Male,8462,345,8807
LOWER DIR DISTRICT,27,Female,11398,307,11705
LOWER DIR DISTRICT,27,Transgender,0,0,0
LOWER DIR DISTRICT,28,Male,8610,308,8918
LOWER DIR DISTRICT,28,Female,10467,318,10785
LOWER DIR DISTRICT,28,Transgender,1,0,1
LOWER DIR DISTRICT,29,Male,8394,293,8687
LOWER DIR DISTRICT,29,Female,10703,324,11027
LOWER DIR DISTRICT,29,Transgender,0,0,0
LOWER DIR DISTRICT,30,Male,8272,292,8564
LOWER DIR DISTRICT,30,Female,10062,295,10357
LOWER DIR DISTRICT,30,Transgender,1,0,1
LOWER DIR DISTRICT,31,Male,7578,308,7886
LOWER DIR DISTRICT,31,Female,9555,259,9814
LOWER DIR DISTRICT,31,Transgender,1,0,1
LOWER DIR DISTRICT,32,Male,6529,222,6751
LOWER DIR DISTRICT,32,Female,8431,214,8645
LOWER DIR DISTRICT,32,Transgender,2,0,2
LOWER DIR DISTRICT,33,Male,6871,240,7111
LOWER DIR DISTRICT,33,Female,8266,210,8476
LOWER DIR DISTRICT,33,Transgender,0,0,0
LOWER DIR DISTRICT,34,Male,6047,248,6295
LOWER DIR DISTRICT,34,Female,6850,192,7042
LOWER DIR DISTRICT,34,Transgender,0,0,0
LOWER DIR DISTRICT,35,Male,5745,229,5974
LOWER DIR DISTRICT,35,Female,7470,264,7734
LOWER DIR DISTRICT,35,Transgender,2,0,2
LOWER DIR DISTRICT,36,Male,5317,189,5506
LOWER DIR DISTRICT,36,Female,6910,195,7105
LOWER DIR DISTRICT,36,Transgender,1,0,1
LOWER DIR DISTRICT,37,Male,5209,168,5377
LOWER DIR DISTRICT,37,Female,7628,172,7800
LOWER DIR DISTRICT,37,Transgender,1,0,1
LOWER DIR DISTRICT,38,Male,6026,219,6245
LOWER DIR DISTRICT,38,Female,6194,182,6376
LOWER DIR DISTRICT,38,Transgender,1,0,1
LOWER DIR DISTRICT,39,Male,5471,218,5689
LOWER DIR DISTRICT,39,Female,6110,176,6286
LOWER DIR DISTRICT,39,Transgender,0,0,0
LOWER DIR DISTRICT,40,Male,5398,196,5594
LOWER DIR DISTRICT,40,Female,6584,201,6785
LOWER DIR DISTRICT,40,Transgender,1,0,1
LOWER DIR DISTRICT,41,Male,5080,197,5277
LOWER DIR DISTRICT,41,Female,6004,144,6148
LOWER DIR DISTRICT,41,Transgender,0,0,0
LOWER DIR DISTRICT,42,Male,4410,162,4572
LOWER DIR DISTRICT,42,Female,5654,147,5801
LOWER DIR DISTRICT,42,Transgender,1,0,1
LOWER DIR DISTRICT,43,Male,4687,148,4835
LOWER DIR DISTRICT,43,Female,4911,140,5051
LOWER DIR DISTRICT,43,Transgender,0,0,0
LOWER DIR DISTRICT,44,Male,4245,150,4395
LOWER DIR DISTRICT,44,Female,4514,132,4646
LOWER DIR DISTRICT,44,Transgender,0,0,0
LOWER DIR DISTRICT,45,Male,3905,149,4054
LOWER DIR DISTRICT,45,Female,4735,155,4890
LOWER DIR DISTRICT,45,Transgender,0,0,0
LOWER DIR DISTRICT,46,Male,3658,121,3779
LOWER DIR DISTRICT,46,Female,4293,124,4417
LOWER DIR DISTRICT,46,Transgender,0,0,0
LOWER DIR DISTRICT,47,Male,3723,127,3850
LOWER DIR DISTRICT,47,Female,4630,116,4746
LOWER DIR DISTRICT,47,Transgender,0,0,0
LOWER DIR DISTRICT,48,Male,3925,143,4068
LOWER DIR DISTRICT,48,Female,3778,113,3891
LOWER DIR DISTRICT,48,Transgender,1,0,1
LOWER DIR DISTRICT,49,Male,3604,110,3714
LOWER DIR DISTRICT,49,Female,3807,104,3911
LOWER DIR DISTRICT,49,Transgender,0,0,0
LOWER DIR DISTRICT,50,Male,3559,131,3690
LOWER DIR DISTRICT,50,Female,4411,145,4556
LOWER DIR DISTRICT,50,Transgender,1,0,1
LOWER DIR DISTRICT,51,Male,3298,103,3401
LOWER DIR DISTRICT,51,Female,3591,94,3685
LOWER DIR DISTRICT,51,Transgender,0,0,0
LOWER DIR DISTRICT,52,Male,2872,103,2975
LOWER DIR DISTRICT,52,Female,3071,90,3161
LOWER DIR DISTRICT,52,Transgender,2,0,2
LOWER DIR DISTRICT,53,Male,3042,117,3159
LOWER DIR DISTRICT,53,Female,2857,75,2932
LOWER DIR DISTRICT,53,Transgender,0,0,0
LOWER DIR DISTRICT,54,Male,2950,106,3056
LOWER DIR DISTRICT,54,Female,2547,81,2628
LOWER DIR DISTRICT,54,Transgender,0,0,0
LOWER DIR DISTRICT,55,Male,2899,109,3008
LOWER DIR DISTRICT,55,Female,3102,108,3210
LOWER DIR DISTRICT,55,Transgender,0,0,0
LOWER DIR DISTRICT,56,Male,2515,80,2595
LOWER DIR DISTRICT,56,Female,2512,70,2582
LOWER DIR DISTRICT,56,Transgender,1,0,1
LOWER DIR DISTRICT,57,Male,2418,87,2505
LOWER DIR DISTRICT,57,Female,2637,57,2694
LOWER DIR DISTRICT,57,Transgender,0,1,1
LOWER DIR DISTRICT,58,Male,2737,77,2814
LOWER DIR DISTRICT,58,Female,2752,74,2826
LOWER DIR DISTRICT,58,Transgender,0,0,0
LOWER DIR DISTRICT,59,Male,2766,91,2857
LOWER DIR DISTRICT,59,Female,2771,65,2836
LOWER DIR DISTRICT,59,Transgender,0,0,0
LOWER DIR DISTRICT,60,Male,2691,96,2787
LOWER DIR DISTRICT,60,Female,3097,80,3177
LOWER DIR DISTRICT,60,Transgender,0,1,1
LOWER DIR DISTRICT,61,Male,2606,88,2694
LOWER DIR DISTRICT,61,Female,2732,74,2806
LOWER DIR DISTRICT,61,Transgender,0,0,0
LOWER DIR DISTRICT,62,Male,2278,81,2359
LOWER DIR DISTRICT,62,Female,2298,59,2357
LOWER DIR DISTRICT,62,Transgender,0,0,0
LOWER DIR DISTRICT,63,Male,2395,77,2472
LOWER DIR DISTRICT,63,Female,2226,54,2280
LOWER DIR DISTRICT,63,Transgender,0,0,0
LOWER DIR DISTRICT,64,Male,2295,66,2361
LOWER DIR DISTRICT,64,Female,2050,39,2089
LOWER DIR DISTRICT,64,Transgender,0,0,0
LOWER DIR DISTRICT,65,Male,2036,75,2111
LOWER DIR DISTRICT,65,Female,1964,43,2007
LOWER DIR DISTRICT,65,Transgender,2,0,2
LOWER DIR DISTRICT,66,Male,2048,59,2107
LOWER DIR DISTRICT,66,Female,1710,33,1743
LOWER DIR DISTRICT,66,Transgender,0,0,0
LOWER DIR DISTRICT,67,Male,1847,58,1905
LOWER DIR DISTRICT,67,Female,1649,49,1698
LOWER DIR DISTRICT,67,Transgender,0,0,0
LOWER DIR DISTRICT,68,Male,1702,35,1737
LOWER DIR DISTRICT,68,Female,1353,26,1379
LOWER DIR DISTRICT,68,Transgender,0,0,0
LOWER DIR DISTRICT,69,Male,1748,46,1794
LOWER DIR DISTRICT,69,Female,1327,17,1344
LOWER DIR DISTRICT,69,Transgender,0,0,0
LOWER DIR DISTRICT,70,Male,1660,39,1699
LOWER DIR DISTRICT,70,Female,1557,33,1590
LOWER DIR DISTRICT,70,Transgender,3,1,4
LOWER DIR DISTRICT,71,Male,1716,44,1760
LOWER DIR DISTRICT,71,Female,1307,21,1328
LOWER DIR DISTRICT,71,Transgender,0,0,0
LOWER DIR DISTRICT,72,Male,1289,33,1322
LOWER DIR DISTRICT,72,Female,1035,19,1054
LOWER DIR DISTRICT,72,Transgender,0,0,0
LOWER DIR DISTRICT,73,Male,1104,25,1129
LOWER DIR DISTRICT,73,Female,958,20,978
LOWER DIR DISTRICT,73,Transgender,0,0,0
LOWER DIR DISTRICT,74,Male,1138,22,1160
LOWER DIR DISTRICT,74,Female,908,20,928
LOWER DIR DISTRICT,74,Transgender,0,0,0
LOWER DIR DISTRICT,>=75,Male,8222,157,8379
LOWER DIR DISTRICT,>=75,Female,7858,179,8037
LOWER DIR DISTRICT,>=75,Transgender,5,1,6
MALAKAND PROTECTED AREA,<1,Male,9312,867,10179
MALAKAND PROTECTED AREA,<1,Female,8682,800,9482
MALAKAND PROTECTED AREA,<1,Transgender,0,0,0
MALAKAND PROTECTED AREA,1,Male,9790,1060,10850
MALAKAND PROTECTED AREA,1,Female,9186,969,10155
MALAKAND PROTECTED AREA,1,Transgender,0,0,0
MALAKAND PROTECTED AREA,2,Male,10265,1105,11370
MALAKAND PROTECTED AREA,2,Female,9866,1001,10867
MALAKAND PROTECTED AREA,2,Transgender,0,0,0
MALAKAND PROTECTED AREA,3,Male,10958,1151,12109
MALAKAND PROTECTED AREA,3,Female,10297,1080,11377
MALAKAND PROTECTED AREA,3,Transgender,0,0,0
MALAKAND PROTECTED AREA,4,Male,10808,1046,11854
MALAKAND PROTECTED AREA,4,Female,9991,982,10973
MALAKAND PROTECTED AREA,4,Transgender,0,0,0
MALAKAND PROTECTED AREA,5,Male,10815,1043,11858
MALAKAND PROTECTED AREA,5,Female,10194,1036,11230
MALAKAND PROTECTED AREA,5,Transgender,0,0,0
MALAKAND PROTECTED AREA,6,Male,10074,1090,11164
MALAKAND PROTECTED AREA,6,Female,9348,999,10347
MALAKAND PROTECTED AREA,6,Transgender,0,0,0
MALAKAND PROTECTED AREA,7,Male,10785,1146,11931
MALAKAND PROTECTED AREA,7,Female,10033,1013,11046
MALAKAND PROTECTED AREA,7,Transgender,0,0,0
MALAKAND PROTECTED AREA,8,Male,10318,998,11316
MALAKAND PROTECTED AREA,8,Female,9314,988,10302
MALAKAND PROTECTED AREA,8,Transgender,0,0,0
MALAKAND PROTECTED AREA,9,Male,10824,1032,11856
MALAKAND PROTECTED AREA,9,Female,9901,1013,10914
MALAKAND PROTECTED AREA,9,Transgender,0,0,0
MALAKAND PROTECTED AREA,10,Male,9045,932,9977
MALAKAND PROTECTED AREA,10,Female,8317,799,9116
MALAKAND PROTECTED AREA,10,Transgender,0,0,0
MALAKAND PROTECTED AREA,11,Male,9619,994,10613
MALAKAND PROTECTED AREA,11,Female,8301,830,9131
MALAKAND PROTECTED AREA,11,Transgender,0,0,0
MALAKAND PROTECTED AREA,12,Male,8085,881,8966
MALAKAND PROTECTED AREA,12,Female,7483,746,8229
MALAKAND PROTECTED AREA,12,Transgender,0,0,0
MALAKAND PROTECTED AREA,13,Male,8971,923,9894
MALAKAND PROTECTED AREA,13,Female,8067,849,8916
MALAKAND PROTECTED AREA,13,Transgender,0,0,0
MALAKAND PROTECTED AREA,14,Male,8010,899,8909
MALAKAND PROTECTED AREA,14,Female,7111,708,7819
MALAKAND PROTECTED AREA,14,Transgender,0,0,0
MALAKAND PROTECTED AREA,15,Male,8398,840,9238
MALAKAND PROTECTED AREA,15,Female,7533,789,8322
MALAKAND PROTECTED AREA,15,Transgender,4,0,4
MALAKAND PROTECTED AREA,16,Male,7523,734,8257
MALAKAND PROTECTED AREA,16,Female,7066,746,7812
MALAKAND PROTECTED AREA,16,Transgender,3,0,3
MALAKAND PROTECTED AREA,17,Male,7002,697,7699
MALAKAND PROTECTED AREA,17,Female,7418,744,8162
MALAKAND PROTECTED AREA,17,Transgender,0,0,0
MALAKAND PROTECTED AREA,18,Male,6586,706,7292
MALAKAND PROTECTED AREA,18,Female,6755,720,7475
MALAKAND PROTECTED AREA,18,Transgender,1,0,1
MALAKAND PROTECTED AREA,19,Male,6373,663,7036
MALAKAND PROTECTED AREA,19,Female,6538,698,7236
MALAKAND PROTECTED AREA,19,Transgender,1,0,1
MALAKAND PROTECTED AREA,20,Male,5864,599,6463
MALAKAND PROTECTED AREA,20,Female,7103,698,7801
MALAKAND PROTECTED AREA,20,Transgender,2,0,2
MALAKAND PROTECTED AREA,21,Male,5355,596,5951
MALAKAND PROTECTED AREA,21,Female,6186,624,6810
MALAKAND PROTECTED AREA,21,Transgender,2,0,2
MALAKAND PROTECTED AREA,22,Male,5293,582,5875
MALAKAND PROTECTED AREA,22,Female,6110,589,6699
MALAKAND PROTECTED AREA,22,Transgender,0,0,0
MALAKAND PROTECTED AREA,23,Male,5165,557,5722
MALAKAND PROTECTED AREA,23,Female,5910,585,6495
MALAKAND PROTECTED AREA,23,Transgender,2,0,2
MALAKAND PROTECTED AREA,24,Male,4494,502,4996
MALAKAND PROTECTED AREA,24,Female,5480,557,6037
MALAKAND PROTECTED AREA,24,Transgender,0,0,0
MALAKAND PROTECTED AREA,25,Male,4905,517,5422
MALAKAND PROTECTED AREA,25,Female,6606,713,7319
MALAKAND PROTECTED AREA,25,Transgender,1,0,1
MALAKAND PROTECTED AREA,26,Male,4449,515,4964
MALAKAND PROTECTED AREA,26,Female,5538,544,6082
MALAKAND PROTECTED AREA,26,Transgender,0,0,0
MALAKAND PROTECTED AREA,27,Male,4314,488,4802
MALAKAND PROTECTED AREA,27,Female,5631,641,6272
MALAKAND PROTECTED AREA,27,Transgender,0,0,0
MALAKAND PROTECTED AREA,28,Male,4347,532,4879
MALAKAND PROTECTED AREA,28,Female,5163,539,5702
MALAKAND PROTECTED AREA,28,Transgender,0,0,0
MALAKAND PROTECTED AREA,29,Male,4081,498,4579
MALAKAND PROTECTED AREA,29,Female,5391,546,5937
MALAKAND PROTECTED AREA,29,Transgender,1,0,1
MALAKAND PROTECTED AREA,30,Male,4555,567,5122
MALAKAND PROTECTED AREA,30,Female,5322,547,5869
MALAKAND PROTECTED AREA,30,Transgender,1,0,1
MALAKAND PROTECTED AREA,31,Male,4076,490,4566
MALAKAND PROTECTED AREA,31,Female,4713,471,5184
MALAKAND PROTECTED AREA,31,Transgender,0,0,0
MALAKAND PROTECTED AREA,32,Male,3602,459,4061
MALAKAND PROTECTED AREA,32,Female,3928,430,4358
MALAKAND PROTECTED AREA,32,Transgender,0,0,0
MALAKAND PROTECTED AREA,33,Male,3617,429,4046
MALAKAND PROTECTED AREA,33,Female,4076,416,4492
MALAKAND PROTECTED AREA,33,Transgender,1,0,1
MALAKAND PROTECTED AREA,34,Male,3166,408,3574
MALAKAND PROTECTED AREA,34,Female,3356,364,3720
MALAKAND PROTECTED AREA,34,Transgender,0,0,0
MALAKAND PROTECTED AREA,35,Male,3282,446,3728
MALAKAND PROTECTED AREA,35,Female,3887,382,4269
MALAKAND PROTECTED AREA,35,Transgender,0,0,0
MALAKAND PROTECTED AREA,36,Male,2750,346,3096
MALAKAND PROTECTED AREA,36,Female,3301,277,3578
MALAKAND PROTECTED AREA,36,Transgender,0,0,0
MALAKAND PROTECTED AREA,37,Male,2615,350,2965
MALAKAND PROTECTED AREA,37,Female,3049,330,3379
MALAKAND PROTECTED AREA,37,Transgender,0,0,0
MALAKAND PROTECTED AREA,38,Male,3276,348,3624
MALAKAND PROTECTED AREA,38,Female,3014,365,3379
MALAKAND PROTECTED AREA,38,Transgender,1,0,1
MALAKAND PROTECTED AREA,39,Male,2784,318,3102
MALAKAND PROTECTED AREA,39,Female,3061,323,3384
MALAKAND PROTECTED AREA,39,Transgender,1,0,1
MALAKAND PROTECTED AREA,40,Male,3249,370,3619
MALAKAND PROTECTED AREA,40,Female,3829,440,4269
MALAKAND PROTECTED AREA,40,Transgender,2,0,2
MALAKAND PROTECTED AREA,41,Male,2651,311,2962
MALAKAND PROTECTED AREA,41,Female,2851,250,3101
MALAKAND PROTECTED AREA,41,Transgender,0,0,0
MALAKAND PROTECTED AREA,42,Male,2376,301,2677
MALAKAND PROTECTED AREA,42,Female,2433,242,2675
MALAKAND PROTECTED AREA,42,Transgender,0,0,0
MALAKAND PROTECTED AREA,43,Male,2588,307,2895
MALAKAND PROTECTED AREA,43,Female,2568,228,2796
MALAKAND PROTECTED AREA,43,Transgender,0,0,0
MALAKAND PROTECTED AREA,44,Male,2315,257,2572
MALAKAND PROTECTED AREA,44,Female,2348,211,2559
MALAKAND PROTECTED AREA,44,Transgender,0,0,0
MALAKAND PROTECTED AREA,45,Male,2300,290,2590
MALAKAND PROTECTED AREA,45,Female,2502,243,2745
MALAKAND PROTECTED AREA,45,Transgender,0,0,0
MALAKAND PROTECTED AREA,46,Male,2182,271,2453
MALAKAND PROTECTED AREA,46,Female,2162,181,2343
MALAKAND PROTECTED AREA,46,Transgender,0,0,0
MALAKAND PROTECTED AREA,47,Male,2094,246,2340
MALAKAND PROTECTED AREA,47,Female,1945,189,2134
MALAKAND PROTECTED AREA,47,Transgender,0,0,0
MALAKAND PROTECTED AREA,48,Male,2046,266,2312
MALAKAND PROTECTED AREA,48,Female,2009,207,2216
MALAKAND PROTECTED AREA,48,Transgender,0,0,0
MALAKAND PROTECTED AREA,49,Male,2013,246,2259
MALAKAND PROTECTED AREA,49,Female,2123,183,2306
MALAKAND PROTECTED AREA,49,Transgender,0,0,0
MALAKAND PROTECTED AREA,50,Male,2415,258,2673
MALAKAND PROTECTED AREA,50,Female,2693,252,2945
MALAKAND PROTECTED AREA,50,Transgender,0,0,0
MALAKAND PROTECTED AREA,51,Male,2066,218,2284
MALAKAND PROTECTED AREA,51,Female,1951,186,2137
MALAKAND PROTECTED AREA,51,Transgender,0,0,0
MALAKAND PROTECTED AREA,52,Male,1745,208,1953
MALAKAND PROTECTED AREA,52,Female,1478,152,1630
MALAKAND PROTECTED AREA,52,Transgender,1,0,1
MALAKAND PROTECTED AREA,53,Male,1976,194,2170
MALAKAND PROTECTED AREA,53,Female,1786,151,1937
MALAKAND PROTECTED AREA,53,Transgender,0,0,0
MALAKAND PROTECTED AREA,54,Male,1797,165,1962
MALAKAND PROTECTED AREA,54,Female,1412,159,1571
MALAKAND PROTECTED AREA,54,Transgender,0,0,0
MALAKAND PROTECTED AREA,55,Male,1802,207,2009
MALAKAND PROTECTED AREA,55,Female,1635,169,1804
MALAKAND PROTECTED AREA,55,Transgender,2,0,2
MALAKAND PROTECTED AREA,56,Male,1540,167,1707
MALAKAND PROTECTED AREA,56,Female,1104,104,1208
MALAKAND PROTECTED AREA,56,Transgender,0,0,0
MALAKAND PROTECTED AREA,57,Male,1392,131,1523
MALAKAND PROTECTED AREA,57,Female,969,82,1051
MALAKAND PROTECTED AREA,57,Transgender,0,0,0
MALAKAND PROTECTED AREA,58,Male,1487,146,1633
MALAKAND PROTECTED AREA,58,Female,1383,112,1495
MALAKAND PROTECTED AREA,58,Transgender,0,0,0
MALAKAND PROTECTED AREA,59,Male,1410,155,1565
MALAKAND PROTECTED AREA,59,Female,1407,113,1520
MALAKAND PROTECTED AREA,59,Transgender,1,0,1
MALAKAND PROTECTED AREA,60,Male,1568,185,1753
MALAKAND PROTECTED AREA,60,Female,1566,164,1730
MALAKAND PROTECTED AREA,60,Transgender,2,1,3
MALAKAND PROTECTED AREA,61,Male,1382,139,1521
MALAKAND PROTECTED AREA,61,Female,1342,119,1461
MALAKAND PROTECTED AREA,61,Transgender,0,0,0
MALAKAND PROTECTED AREA,62,Male,1214,148,1362
MALAKAND PROTECTED AREA,62,Female,952,95,1047
MALAKAND PROTECTED AREA,62,Transgender,0,1,1
MALAKAND PROTECTED AREA,63,Male,1303,130,1433
MALAKAND PROTECTED AREA,63,Female,1146,129,1275
MALAKAND PROTECTED AREA,63,Transgender,0,0,0
MALAKAND PROTECTED AREA,64,Male,1223,113,1336
MALAKAND PROTECTED AREA,64,Female,989,116,1105
MALAKAND PROTECTED AREA,64,Transgender,0,0,0
MALAKAND PROTECTED AREA,65,Male,1052,112,1164
MALAKAND PROTECTED AREA,65,Female,919,77,996
MALAKAND PROTECTED AREA,65,Transgender,0,0,0
MALAKAND PROTECTED AREA,66,Male,973,108,1081
MALAKAND PROTECTED AREA,66,Female,794,63,857
MALAKAND PROTECTED AREA,66,Transgender,0,0,0
MALAKAND PROTECTED AREA,67,Male,836,101,937
MALAKAND PROTECTED AREA,67,Female,579,62,641
MALAKAND PROTECTED AREA,67,Transgender,0,0,0
MALAKAND PROTECTED AREA,68,Male,851,64,915
MALAKAND PROTECTED AREA,68,Female,675,51,726
MALAKAND PROTECTED AREA,68,Transgender,0,0,0
MALAKAND PROTECTED AREA,69,Male,850,61,911
MALAKAND PROTECTED AREA,69,Female,663,54,717
MALAKAND PROTECTED AREA,69,Transgender,0,0,0
MALAKAND PROTECTED AREA,70,Male,864,78,942
MALAKAND PROTECTED AREA,70,Female,704,57,761
MALAKAND PROTECTED AREA,70,Transgender,1,0,1
MALAKAND PROTECTED AREA,71,Male,759,72,831
MALAKAND PROTECTED AREA,71,Female,595,63,658
MALAKAND PROTECTED AREA,71,Transgender,0,0,0
MALAKAND PROTECTED AREA,72,Male,621,60,681
MALAKAND PROTECTED AREA,72,Female,425,60,485
MALAKAND PROTECTED AREA,72,Transgender,0,0,0
MALAKAND PROTECTED AREA,73,Male,576,72,648
MALAKAND PROTECTED AREA,73,Female,473,39,512
MALAKAND PROTECTED AREA,73,Transgender,0,0,0
MALAKAND PROTECTED AREA,74,Male,562,50,612
MALAKAND PROTECTED AREA,74,Female,445,29,474
MALAKAND PROTECTED AREA,74,Transgender,0,0,0
MALAKAND PROTECTED AREA,>=75,Male,3926,324,4250
MALAKAND PROTECTED AREA,>=75,Female,3453,316,3769
MALAKAND PROTECTED AREA,>=75,Transgender,1,0,1
MALIR DISTRICT,<1,Male,10794,12803,23597
MALIR DISTRICT,<1,Female,10095,12032,22127
MALIR DISTRICT,<1,Transgender,0,0,0
MALIR DISTRICT,1,Male,11687,13442,25129
MALIR DISTRICT,1,Female,11039,12517,23556
MALIR DISTRICT,1,Transgender,0,0,0
MALIR DISTRICT,2,Male,11862,14049,25911
MALIR DISTRICT,2,Female,11278,13358,24636
MALIR DISTRICT,2,Transgender,0,0,0
MALIR DISTRICT,3,Male,13221,15076,28297
MALIR DISTRICT,3,Female,12601,14367,26968
MALIR DISTRICT,3,Transgender,0,0,0
MALIR DISTRICT,4,Male,12207,13846,26053
MALIR DISTRICT,4,Female,11730,13175,24905
MALIR DISTRICT,4,Transgender,0,0,0
MALIR DISTRICT,5,Male,12633,14185,26818
MALIR DISTRICT,5,Female,11816,13600,25416
MALIR DISTRICT,5,Transgender,0,0,0
MALIR DISTRICT,6,Male,11949,13798,25747
MALIR DISTRICT,6,Female,11200,12907,24107
MALIR DISTRICT,6,Transgender,0,0,0
MALIR DISTRICT,7,Male,13024,14535,27559
MALIR DISTRICT,7,Female,11867,13576,25443
MALIR DISTRICT,7,Transgender,0,0,0
MALIR DISTRICT,8,Male,11829,12887,24716
MALIR DISTRICT,8,Female,10765,12180,22945
MALIR DISTRICT,8,Transgender,0,0,0
MALIR DISTRICT,9,Male,11909,14180,26089
MALIR DISTRICT,9,Female,11071,13258,24329
MALIR DISTRICT,9,Transgender,0,0,0
MALIR DISTRICT,10,Male,10615,12041,22656
MALIR DISTRICT,10,Female,9549,10755,20304
MALIR DISTRICT,10,Transgender,0,0,0
MALIR DISTRICT,11,Male,10862,13419,24281
MALIR DISTRICT,11,Female,9786,12218,22004
MALIR DISTRICT,11,Transgender,0,0,0
MALIR DISTRICT,12,Male,9860,11424,21284
MALIR DISTRICT,12,Female,8513,10263,18776
MALIR DISTRICT,12,Transgender,0,0,0
MALIR DISTRICT,13,Male,9889,11851,21740
MALIR DISTRICT,13,Female,8644,10967,19611
MALIR DISTRICT,13,Transgender,0,0,0
MALIR DISTRICT,14,Male,9027,10754,19781
MALIR DISTRICT,14,Female,8076,9810,17886
MALIR DISTRICT,14,Transgender,0,0,0
MALIR DISTRICT,15,Male,9248,10993,20241
MALIR DISTRICT,15,Female,8080,10149,18229
MALIR DISTRICT,15,Transgender,1,0,1
MALIR DISTRICT,16,Male,9367,11308,20675
MALIR DISTRICT,16,Female,7963,10171,18134
MALIR DISTRICT,16,Transgender,0,0,0
MALIR DISTRICT,17,Male,9692,12537,22229
MALIR DISTRICT,17,Female,8288,10643,18931
MALIR DISTRICT,17,Transgender,2,0,2
MALIR DISTRICT,18,Male,9266,11708,20974
MALIR DISTRICT,18,Female,8389,9963,18352
MALIR DISTRICT,18,Transgender,0,3,3
MALIR DISTRICT,19,Male,10223,13621,23844
MALIR DISTRICT,19,Female,9096,11335,20431
MALIR DISTRICT,19,Transgender,1,2,3
MALIR DISTRICT,20,Male,9155,12234,21389
MALIR DISTRICT,20,Female,8061,9668,17729
MALIR DISTRICT,20,Transgender,0,2,2
MALIR DISTRICT,21,Male,10175,13256,23431
MALIR DISTRICT,21,Female,8467,10784,19251
MALIR DISTRICT,21,Transgender,1,0,1
MALIR DISTRICT,22,Male,8959,12071,21030
MALIR DISTRICT,22,Female,8054,10057,18111
MALIR DISTRICT,22,Transgender,0,7,7
MALIR DISTRICT,23,Male,8990,11972,20962
MALIR DISTRICT,23,Female,7473,9856,17329
MALIR DISTRICT,23,Transgender,0,2,2
MALIR DISTRICT,24,Male,8493,11726,20219
MALIR DISTRICT,24,Female,7278,9614,16892
MALIR DISTRICT,24,Transgender,4,4,8
MALIR DISTRICT,25,Male,7973,10542,18515
MALIR DISTRICT,25,Female,7231,8786,16017
MALIR DISTRICT,25,Transgender,3,5,8
MALIR DISTRICT,26,Male,8317,11229,19546
MALIR DISTRICT,26,Female,7446,9647,17093
MALIR DISTRICT,26,Transgender,2,1,3
MALIR DISTRICT,27,Male,8537,11190,19727
MALIR DISTRICT,27,Female,7492,9387,16879
MALIR DISTRICT,27,Transgender,2,1,3
MALIR DISTRICT,28,Male,7906,10711,18617
MALIR DISTRICT,28,Female,7193,9184,16377
MALIR DISTRICT,28,Transgender,2,4,6
MALIR DISTRICT,29,Male,8461,10826,19287
MALIR DISTRICT,29,Female,7522,9101,16623
MALIR DISTRICT,29,Transgender,3,1,4
MALIR DISTRICT,30,Male,7533,9891,17424
MALIR DISTRICT,30,Female,6564,8773,15337
MALIR DISTRICT,30,Transgender,4,6,10
MALIR DISTRICT,31,Male,7962,10528,18490
MALIR DISTRICT,31,Female,6893,8576,15469
MALIR DISTRICT,31,Transgender,0,1,1
MALIR DISTRICT,32,Male,7006,9750,16756
MALIR DISTRICT,32,Female,5763,7535,13298
MALIR DISTRICT,32,Transgender,3,6,9
MALIR DISTRICT,33,Male,6891,9475,16366
MALIR DISTRICT,33,Female,5846,7811,13657
MALIR DISTRICT,33,Transgender,1,1,2
MALIR DISTRICT,34,Male,6803,8873,15676
MALIR DISTRICT,34,Female,5606,6953,12559
MALIR DISTRICT,34,Transgender,2,0,2
MALIR DISTRICT,35,Male,5963,8110,14073
MALIR DISTRICT,35,Female,4827,6405,11232
MALIR DISTRICT,35,Transgender,5,5,10
MALIR DISTRICT,36,Male,5979,7878,13857
MALIR DISTRICT,36,Female,4898,6310,11208
MALIR DISTRICT,36,Transgender,1,3,4
MALIR DISTRICT,37,Male,6046,7460,13506
MALIR DISTRICT,37,Female,4715,5837,10552
MALIR DISTRICT,37,Transgender,2,4,6
MALIR DISTRICT,38,Male,5418,7736,13154
MALIR DISTRICT,38,Female,4498,6080,10578
MALIR DISTRICT,38,Transgender,1,1,2
MALIR DISTRICT,39,Male,5509,7295,12804
MALIR DISTRICT,39,Female,4663,5902,10565
MALIR DISTRICT,39,Transgender,0,3,3
MALIR DISTRICT,40,Male,4552,7000,11552
MALIR DISTRICT,40,Female,3835,5545,9380
MALIR DISTRICT,40,Transgender,2,3,5
MALIR DISTRICT,41,Male,4781,6372,11153
MALIR DISTRICT,41,Female,4014,5216,9230
MALIR DISTRICT,41,Transgender,0,3,3
MALIR DISTRICT,42,Male,3937,5829,9766
MALIR DISTRICT,42,Female,3381,4493,7874
MALIR DISTRICT,42,Transgender,2,2,4
MALIR DISTRICT,43,Male,3961,5758,9719
MALIR DISTRICT,43,Female,3490,4751,8241
MALIR DISTRICT,43,Transgender,3,0,3
MALIR DISTRICT,44,Male,3725,4887,8612
MALIR DISTRICT,44,Female,3394,4176,7570
MALIR DISTRICT,44,Transgender,1,1,2
MALIR DISTRICT,45,Male,3401,4871,8272
MALIR DISTRICT,45,Female,2971,3799,6770
MALIR DISTRICT,45,Transgender,2,4,6
MALIR DISTRICT,46,Male,3688,4597,8285
MALIR DISTRICT,46,Female,3154,3518,6672
MALIR DISTRICT,46,Transgender,1,1,2
MALIR DISTRICT,47,Male,3615,4422,8037
MALIR DISTRICT,47,Female,2941,3331,6272
MALIR DISTRICT,47,Transgender,0,0,0
MALIR DISTRICT,48,Male,3333,4400,7733
MALIR DISTRICT,48,Female,3003,3657,6660
MALIR DISTRICT,48,Transgender,1,0,1
MALIR DISTRICT,49,Male,3358,4364,7722
MALIR DISTRICT,49,Female,3083,3768,6851
MALIR DISTRICT,49,Transgender,0,0,0
MALIR DISTRICT,50,Male,2948,4153,7101
MALIR DISTRICT,50,Female,2530,3496,6026
MALIR DISTRICT,50,Transgender,4,3,7
MALIR DISTRICT,51,Male,3278,4052,7330
MALIR DISTRICT,51,Female,2711,3268,5979
MALIR DISTRICT,51,Transgender,0,3,3
MALIR DISTRICT,52,Male,2850,3795,6645
MALIR DISTRICT,52,Female,2372,2873,5245
MALIR DISTRICT,52,Transgender,0,1,1
MALIR DISTRICT,53,Male,2754,3695,6449
MALIR DISTRICT,53,Female,2273,2994,5267
MALIR DISTRICT,53,Transgender,0,2,2
MALIR DISTRICT,54,Male,2482,3320,5802
MALIR DISTRICT,54,Female,2073,2760,4833
MALIR DISTRICT,54,Transgender,0,0,0
MALIR DISTRICT,55,Male,2178,3056,5234
MALIR DISTRICT,55,Female,1718,2371,4089
MALIR DISTRICT,55,Transgender,1,0,1
MALIR DISTRICT,56,Male,2417,2912,5329
MALIR DISTRICT,56,Female,1691,2138,3829
MALIR DISTRICT,56,Transgender,0,1,1
MALIR DISTRICT,57,Male,2390,2718,5108
MALIR DISTRICT,57,Female,1759,1917,3676
MALIR DISTRICT,57,Transgender,0,1,1
MALIR DISTRICT,58,Male,2173,2649,4822
MALIR DISTRICT,58,Female,1592,2023,3615
MALIR DISTRICT,58,Transgender,0,0,0
MALIR DISTRICT,59,Male,2085,2569,4654
MALIR DISTRICT,59,Female,1610,2004,3614
MALIR DISTRICT,59,Transgender,0,0,0
MALIR DISTRICT,60,Male,1631,2346,3977
MALIR DISTRICT,60,Female,1427,1951,3378
MALIR DISTRICT,60,Transgender,1,2,3
MALIR DISTRICT,61,Male,1992,2439,4431
MALIR DISTRICT,61,Female,1604,1998,3602
MALIR DISTRICT,61,Transgender,0,0,0
MALIR DISTRICT,62,Male,1819,2306,4125
MALIR DISTRICT,62,Female,1492,1740,3232
MALIR DISTRICT,62,Transgender,0,0,0
MALIR DISTRICT,63,Male,1799,2267,4066
MALIR DISTRICT,63,Female,1521,1839,3360
MALIR DISTRICT,63,Transgender,0,0,0
MALIR DISTRICT,64,Male,1492,1998,3490
MALIR DISTRICT,64,Female,1206,1544,2750
MALIR DISTRICT,64,Transgender,0,0,0
MALIR DISTRICT,65,Male,1129,1624,2753
MALIR DISTRICT,65,Female,870,1133,2003
MALIR DISTRICT,65,Transgender,0,1,1
MALIR DISTRICT,66,Male,1142,1444,2586
MALIR DISTRICT,66,Female,880,1024,1904
MALIR DISTRICT,66,Transgender,0,0,0
MALIR DISTRICT,67,Male,1118,1309,2427
MALIR DISTRICT,67,Female,835,964,1799
MALIR DISTRICT,67,Transgender,0,0,0
MALIR DISTRICT,68,Male,1060,1375,2435
MALIR DISTRICT,68,Female,873,1049,1922
MALIR DISTRICT,68,Transgender,0,0,0
MALIR DISTRICT,69,Male,860,1191,2051
MALIR DISTRICT,69,Female,723,922,1645
MALIR DISTRICT,69,Transgender,1,0,1
MALIR DISTRICT,70,Male,620,916,1536
MALIR DISTRICT,70,Female,525,768,1293
MALIR DISTRICT,70,Transgender,1,1,2
MALIR DISTRICT,71,Male,711,915,1626
MALIR DISTRICT,71,Female,596,714,1310
MALIR DISTRICT,71,Transgender,0,0,0
MALIR DISTRICT,72,Male,652,799,1451
MALIR DISTRICT,72,Female,560,639,1199
MALIR DISTRICT,72,Transgender,0,0,0
MALIR DISTRICT,73,Male,617,870,1487
MALIR DISTRICT,73,Female,610,734,1344
MALIR DISTRICT,73,Transgender,0,0,0
MALIR DISTRICT,74,Male,454,651,1105
MALIR DISTRICT,74,Female,460,539,999
MALIR DISTRICT,74,Transgender,0,0,0
MALIR DISTRICT,>=75,Male,3365,4179,7544
MALIR DISTRICT,>=75,Female,3854,4196,8050
MALIR DISTRICT,>=75,Transgender,0,1,1
MANDI BAHAUDDIN DISTRICT,<1,Male,14731,3780,18511
MANDI BAHAUDDIN DISTRICT,<1,Female,14164,3697,17861
MANDI BAHAUDDIN DISTRICT,<1,Transgender,0,0,0
MANDI BAHAUDDIN DISTRICT,1,Male,15690,3872,19562
MANDI BAHAUDDIN DISTRICT,1,Female,14810,3709,18519
MANDI BAHAUDDIN DISTRICT,1,Transgender,0,0,0
MANDI BAHAUDDIN DISTRICT,2,Male,15842,3932,19774
MANDI BAHAUDDIN DISTRICT,2,Female,15442,3924,19366
MANDI BAHAUDDIN DISTRICT,2,Transgender,0,0,0
MANDI BAHAUDDIN DISTRICT,3,Male,17023,4227,21250
MANDI BAHAUDDIN DISTRICT,3,Female,16598,4057,20655
MANDI BAHAUDDIN DISTRICT,3,Transgender,0,0,0
MANDI BAHAUDDIN DISTRICT,4,Male,16717,3996,20713
MANDI BAHAUDDIN DISTRICT,4,Female,16063,3735,19798
MANDI BAHAUDDIN DISTRICT,4,Transgender,0,0,0
MANDI BAHAUDDIN DISTRICT,5,Male,16693,4063,20756
MANDI BAHAUDDIN DISTRICT,5,Female,16128,3831,19959
MANDI BAHAUDDIN DISTRICT,5,Transgender,0,0,0
MANDI BAHAUDDIN DISTRICT,6,Male,16773,3995,20768
MANDI BAHAUDDIN DISTRICT,6,Female,16085,3922,20007
MANDI BAHAUDDIN DISTRICT,6,Transgender,0,0,0
MANDI BAHAUDDIN DISTRICT,7,Male,16867,4325,21192
MANDI BAHAUDDIN DISTRICT,7,Female,15935,4018,19953
MANDI BAHAUDDIN DISTRICT,7,Transgender,0,0,0
MANDI BAHAUDDIN DISTRICT,8,Male,15973,3748,19721
MANDI BAHAUDDIN DISTRICT,8,Female,14745,3574,18319
MANDI BAHAUDDIN DISTRICT,8,Transgender,0,0,0
MANDI BAHAUDDIN DISTRICT,9,Male,16585,4075,20660
MANDI BAHAUDDIN DISTRICT,9,Female,15282,3909,19191
MANDI BAHAUDDIN DISTRICT,9,Transgender,0,0,0
MANDI BAHAUDDIN DISTRICT,10,Male,14838,3394,18232
MANDI BAHAUDDIN DISTRICT,10,Female,14029,3276,17305
MANDI BAHAUDDIN DISTRICT,10,Transgender,0,0,0
MANDI BAHAUDDIN DISTRICT,11,Male,15999,4325,20324
MANDI BAHAUDDIN DISTRICT,11,Female,15198,4035,19233
MANDI BAHAUDDIN DISTRICT,11,Transgender,0,0,0
MANDI BAHAUDDIN DISTRICT,12,Male,14467,3513,17980
MANDI BAHAUDDIN DISTRICT,12,Female,13609,3205,16814
MANDI BAHAUDDIN DISTRICT,12,Transgender,0,0,0
MANDI BAHAUDDIN DISTRICT,13,Male,14847,3774,18621
MANDI BAHAUDDIN DISTRICT,13,Female,13851,3626,17477
MANDI BAHAUDDIN DISTRICT,13,Transgender,0,0,0
MANDI BAHAUDDIN DISTRICT,14,Male,14198,3565,17763
MANDI BAHAUDDIN DISTRICT,14,Female,13405,3329,16734
MANDI BAHAUDDIN DISTRICT,14,Transgender,0,0,0
MANDI BAHAUDDIN DISTRICT,15,Male,13737,3523,17260
MANDI BAHAUDDIN DISTRICT,15,Female,13840,3378,17218
MANDI BAHAUDDIN DISTRICT,15,Transgender,1,0,1
MANDI BAHAUDDIN DISTRICT,16,Male,13976,3619,17595
MANDI BAHAUDDIN DISTRICT,16,Female,13960,3410,17370
MANDI BAHAUDDIN DISTRICT,16,Transgender,2,1,3
MANDI BAHAUDDIN DISTRICT,17,Male,13167,3561,16728
MANDI BAHAUDDIN DISTRICT,17,Female,14017,3654,17671
MANDI BAHAUDDIN DISTRICT,17,Transgender,2,0,2
MANDI BAHAUDDIN DISTRICT,18,Male,11873,2986,14859
MANDI BAHAUDDIN DISTRICT,18,Female,12457,2904,15361
MANDI BAHAUDDIN DISTRICT,18,Transgender,5,2,7
MANDI BAHAUDDIN DISTRICT,19,Male,12767,3354,16121
MANDI BAHAUDDIN DISTRICT,19,Female,13717,3654,17371
MANDI BAHAUDDIN DISTRICT,19,Transgender,2,2,4
MANDI BAHAUDDIN DISTRICT,20,Male,10783,2807,13590
MANDI BAHAUDDIN DISTRICT,20,Female,12108,2852,14960
MANDI BAHAUDDIN DISTRICT,20,Transgender,3,3,6
MANDI BAHAUDDIN DISTRICT,21,Male,11162,3271,14433
MANDI BAHAUDDIN DISTRICT,21,Female,13753,3793,17546
MANDI BAHAUDDIN DISTRICT,21,Transgender,2,1,3
MANDI BAHAUDDIN DISTRICT,22,Male,9876,2764,12640
MANDI BAHAUDDIN DISTRICT,22,Female,12824,3269,16093
MANDI BAHAUDDIN DISTRICT,22,Transgender,1,5,6
MANDI BAHAUDDIN DISTRICT,23,Male,9123,2713,11836
MANDI BAHAUDDIN DISTRICT,23,Female,12764,3463,16227
MANDI BAHAUDDIN DISTRICT,23,Transgender,5,4,9
MANDI BAHAUDDIN DISTRICT,24,Male,8875,2753,11628
MANDI BAHAUDDIN DISTRICT,24,Female,11801,3390,15191
MANDI BAHAUDDIN DISTRICT,24,Transgender,0,6,6
MANDI BAHAUDDIN DISTRICT,25,Male,8457,2345,10802
MANDI BAHAUDDIN DISTRICT,25,Female,11343,2716,14059
MANDI BAHAUDDIN DISTRICT,25,Transgender,5,2,7
MANDI BAHAUDDIN DISTRICT,26,Male,8017,2526,10543
MANDI BAHAUDDIN DISTRICT,26,Female,11565,3250,14815
MANDI BAHAUDDIN DISTRICT,26,Transgender,0,5,5
MANDI BAHAUDDIN DISTRICT,27,Male,7809,2457,10266
MANDI BAHAUDDIN DISTRICT,27,Female,11016,3256,14272
MANDI BAHAUDDIN DISTRICT,27,Transgender,3,4,7
MANDI BAHAUDDIN DISTRICT,28,Male,7707,2362,10069
MANDI BAHAUDDIN DISTRICT,28,Female,10659,3001,13660
MANDI BAHAUDDIN DISTRICT,28,Transgender,2,2,4
MANDI BAHAUDDIN DISTRICT,29,Male,7530,2438,9968
MANDI BAHAUDDIN DISTRICT,29,Female,10893,3068,13961
MANDI BAHAUDDIN DISTRICT,29,Transgender,2,4,6
MANDI BAHAUDDIN DISTRICT,30,Male,8003,2075,10078
MANDI BAHAUDDIN DISTRICT,30,Female,10831,2550,13381
MANDI BAHAUDDIN DISTRICT,30,Transgender,5,4,9
MANDI BAHAUDDIN DISTRICT,31,Male,7011,2215,9226
MANDI BAHAUDDIN DISTRICT,31,Female,9784,2913,12697
MANDI BAHAUDDIN DISTRICT,31,Transgender,1,1,2
MANDI BAHAUDDIN DISTRICT,32,Male,6683,2195,8878
MANDI BAHAUDDIN DISTRICT,32,Female,9276,2672,11948
MANDI BAHAUDDIN DISTRICT,32,Transgender,1,2,3
MANDI BAHAUDDIN DISTRICT,33,Male,6396,2099,8495
MANDI BAHAUDDIN DISTRICT,33,Female,8546,2646,11192
MANDI BAHAUDDIN DISTRICT,33,Transgender,3,2,5
MANDI BAHAUDDIN DISTRICT,34,Male,5960,1942,7902
MANDI BAHAUDDIN DISTRICT,34,Female,7919,2323,10242
MANDI BAHAUDDIN DISTRICT,34,Transgender,3,0,3
MANDI BAHAUDDIN DISTRICT,35,Male,6935,1821,8756
MANDI BAHAUDDIN DISTRICT,35,Female,8760,2149,10909
MANDI BAHAUDDIN DISTRICT,35,Transgender,7,6,13
MANDI BAHAUDDIN DISTRICT,36,Male,6622,1885,8507
MANDI BAHAUDDIN DISTRICT,36,Female,8037,2204,10241
MANDI BAHAUDDIN DISTRICT,36,Transgender,0,0,0
MANDI BAHAUDDIN DISTRICT,37,Male,6034,1803,7837
MANDI BAHAUDDIN DISTRICT,37,Female,7824,2193,10017
MANDI BAHAUDDIN DISTRICT,37,Transgender,1,3,4
MANDI BAHAUDDIN DISTRICT,38,Male,6343,1821,8164
MANDI BAHAUDDIN DISTRICT,38,Female,7847,2224,10071
MANDI BAHAUDDIN DISTRICT,38,Transgender,3,3,6
MANDI BAHAUDDIN DISTRICT,39,Male,5830,1748,7578
MANDI BAHAUDDIN DISTRICT,39,Female,7679,2062,9741
MANDI BAHAUDDIN DISTRICT,39,Transgender,0,0,0
MANDI BAHAUDDIN DISTRICT,40,Male,6399,1787,8186
MANDI BAHAUDDIN DISTRICT,40,Female,7555,1934,9489
MANDI BAHAUDDIN DISTRICT,40,Transgender,3,6,9
MANDI BAHAUDDIN DISTRICT,41,Male,5333,1607,6940
MANDI BAHAUDDIN DISTRICT,41,Female,6655,1915,8570
MANDI BAHAUDDIN DISTRICT,41,Transgender,1,0,1
MANDI BAHAUDDIN DISTRICT,42,Male,5300,1623,6923
MANDI BAHAUDDIN DISTRICT,42,Female,6303,1793,8096
MANDI BAHAUDDIN DISTRICT,42,Transgender,1,1,2
MANDI BAHAUDDIN DISTRICT,43,Male,4893,1434,6327
MANDI BAHAUDDIN DISTRICT,43,Female,6007,1794,7801
MANDI BAHAUDDIN DISTRICT,43,Transgender,1,1,2
MANDI BAHAUDDIN DISTRICT,44,Male,4876,1447,6323
MANDI BAHAUDDIN DISTRICT,44,Female,5558,1522,7080
MANDI BAHAUDDIN DISTRICT,44,Transgender,0,1,1
MANDI BAHAUDDIN DISTRICT,45,Male,5676,1446,7122
MANDI BAHAUDDIN DISTRICT,45,Female,5905,1474,7379
MANDI BAHAUDDIN DISTRICT,45,Transgender,2,3,5
MANDI BAHAUDDIN DISTRICT,46,Male,5118,1332,6450
MANDI BAHAUDDIN DISTRICT,46,Female,5491,1392,6883
MANDI BAHAUDDIN DISTRICT,46,Transgender,0,1,1
MANDI BAHAUDDIN DISTRICT,47,Male,5144,1400,6544
MANDI BAHAUDDIN DISTRICT,47,Female,5271,1420,6691
MANDI BAHAUDDIN DISTRICT,47,Transgender,1,2,3
MANDI BAHAUDDIN DISTRICT,48,Male,5738,1470,7208
MANDI BAHAUDDIN DISTRICT,48,Female,5967,1580,7547
MANDI BAHAUDDIN DISTRICT,48,Transgender,0,0,0
MANDI BAHAUDDIN DISTRICT,49,Male,5612,1434,7046
MANDI BAHAUDDIN DISTRICT,49,Female,5696,1511,7207
MANDI BAHAUDDIN DISTRICT,49,Transgender,1,3,4
MANDI BAHAUDDIN DISTRICT,50,Male,6064,1490,7554
MANDI BAHAUDDIN DISTRICT,50,Female,5881,1442,7323
MANDI BAHAUDDIN DISTRICT,50,Transgender,3,1,4
MANDI BAHAUDDIN DISTRICT,51,Male,5407,1355,6762
MANDI BAHAUDDIN DISTRICT,51,Female,5257,1396,6653
MANDI BAHAUDDIN DISTRICT,51,Transgender,1,0,1
MANDI BAHAUDDIN DISTRICT,52,Male,5212,1396,6608
MANDI BAHAUDDIN DISTRICT,52,Female,4982,1324,6306
MANDI BAHAUDDIN DISTRICT,52,Transgender,1,1,2
MANDI BAHAUDDIN DISTRICT,53,Male,5092,1280,6372
MANDI BAHAUDDIN DISTRICT,53,Female,4742,1279,6021
MANDI BAHAUDDIN DISTRICT,53,Transgender,0,0,0
MANDI BAHAUDDIN DISTRICT,54,Male,4798,1246,6044
MANDI BAHAUDDIN DISTRICT,54,Female,4261,1186,5447
MANDI BAHAUDDIN DISTRICT,54,Transgender,1,2,3
MANDI BAHAUDDIN DISTRICT,55,Male,5027,1195,6222
MANDI BAHAUDDIN DISTRICT,55,Female,4232,1010,5242
MANDI BAHAUDDIN DISTRICT,55,Transgender,4,1,5
MANDI BAHAUDDIN DISTRICT,56,Male,4046,1060,5106
MANDI BAHAUDDIN DISTRICT,56,Female,3534,853,4387
MANDI BAHAUDDIN DISTRICT,56,Transgender,2,0,2
MANDI BAHAUDDIN DISTRICT,57,Male,3531,913,4444
MANDI BAHAUDDIN DISTRICT,57,Female,3165,763,3928
MANDI BAHAUDDIN DISTRICT,57,Transgender,2,0,2
MANDI BAHAUDDIN DISTRICT,58,Male,3571,888,4459
MANDI BAHAUDDIN DISTRICT,58,Female,3315,852,4167
MANDI BAHAUDDIN DISTRICT,58,Transgender,0,0,0
MANDI BAHAUDDIN DISTRICT,59,Male,3880,851,4731
MANDI BAHAUDDIN DISTRICT,59,Female,3447,890,4337
MANDI BAHAUDDIN DISTRICT,59,Transgender,0,1,1
MANDI BAHAUDDIN DISTRICT,60,Male,4435,976,5411
MANDI BAHAUDDIN DISTRICT,60,Female,3784,770,4554
MANDI BAHAUDDIN DISTRICT,60,Transgender,3,1,4
MANDI BAHAUDDIN DISTRICT,61,Male,4053,962,5015
MANDI BAHAUDDIN DISTRICT,61,Female,3310,854,4164
MANDI BAHAUDDIN DISTRICT,61,Transgender,1,0,1
MANDI BAHAUDDIN DISTRICT,62,Male,3705,963,4668
MANDI BAHAUDDIN DISTRICT,62,Female,3135,747,3882
MANDI BAHAUDDIN DISTRICT,62,Transgender,0,0,0
MANDI BAHAUDDIN DISTRICT,63,Male,3459,829,4288
MANDI BAHAUDDIN DISTRICT,63,Female,2807,740,3547
MANDI BAHAUDDIN DISTRICT,63,Transgender,0,1,1
MANDI BAHAUDDIN DISTRICT,64,Male,2937,737,3674
MANDI BAHAUDDIN DISTRICT,64,Female,2583,625,3208
MANDI BAHAUDDIN DISTRICT,64,Transgender,1,0,1
MANDI BAHAUDDIN DISTRICT,65,Male,3374,587,3961
MANDI BAHAUDDIN DISTRICT,65,Female,2911,550,3461
MANDI BAHAUDDIN DISTRICT,65,Transgender,2,1,3
MANDI BAHAUDDIN DISTRICT,66,Male,2935,498,3433
MANDI BAHAUDDIN DISTRICT,66,Female,2361,448,2809
MANDI BAHAUDDIN DISTRICT,66,Transgender,0,0,0
MANDI BAHAUDDIN DISTRICT,67,Male,2507,521,3028
MANDI BAHAUDDIN DISTRICT,67,Female,2039,424,2463
MANDI BAHAUDDIN DISTRICT,67,Transgender,1,0,1
MANDI BAHAUDDIN DISTRICT,68,Male,2109,462,2571
MANDI BAHAUDDIN DISTRICT,68,Female,1995,425,2420
MANDI BAHAUDDIN DISTRICT,68,Transgender,2,0,2
MANDI BAHAUDDIN DISTRICT,69,Male,2067,388,2455
MANDI BAHAUDDIN DISTRICT,69,Female,1907,395,2302
MANDI BAHAUDDIN DISTRICT,69,Transgender,0,0,0
MANDI BAHAUDDIN DISTRICT,70,Male,2766,461,3227
MANDI BAHAUDDIN DISTRICT,70,Female,2366,451,2817
MANDI BAHAUDDIN DISTRICT,70,Transgender,3,0,3
MANDI BAHAUDDIN DISTRICT,71,Male,2441,439,2880
MANDI BAHAUDDIN DISTRICT,71,Female,2058,412,2470
MANDI BAHAUDDIN DISTRICT,71,Transgender,1,0,1
MANDI BAHAUDDIN DISTRICT,72,Male,2170,422,2592
MANDI BAHAUDDIN DISTRICT,72,Female,1749,362,2111
MANDI BAHAUDDIN DISTRICT,72,Transgender,0,0,0
MANDI BAHAUDDIN DISTRICT,73,Male,1734,361,2095
MANDI BAHAUDDIN DISTRICT,73,Female,1507,331,1838
MANDI BAHAUDDIN DISTRICT,73,Transgender,0,0,0
MANDI BAHAUDDIN DISTRICT,74,Male,1417,248,1665
MANDI BAHAUDDIN DISTRICT,74,Female,1338,256,1594
MANDI BAHAUDDIN DISTRICT,74,Transgender,0,0,0
MANDI BAHAUDDIN DISTRICT,>=75,Male,15259,2609,17868
MANDI BAHAUDDIN DISTRICT,>=75,Female,13934,2523,16457
MANDI BAHAUDDIN DISTRICT,>=75,Transgender,8,1,9
MANSEHRA DISTRICT,<1,Male,20162,1852,22014
MANSEHRA DISTRICT,<1,Female,19148,1712,20860
MANSEHRA DISTRICT,<1,Transgender,0,0,0
MANSEHRA DISTRICT,1,Male,19819,1705,21524
MANSEHRA DISTRICT,1,Female,19023,1661,20684
MANSEHRA DISTRICT,1,Transgender,0,0,0
MANSEHRA DISTRICT,2,Male,20342,1728,22070
MANSEHRA DISTRICT,2,Female,18935,1627,20562
MANSEHRA DISTRICT,2,Transgender,0,0,0
MANSEHRA DISTRICT,3,Male,21317,2066,23383
MANSEHRA DISTRICT,3,Female,20650,1938,22588
MANSEHRA DISTRICT,3,Transgender,0,0,0
MANSEHRA DISTRICT,4,Male,21023,1865,22888
MANSEHRA DISTRICT,4,Female,19709,1651,21360
MANSEHRA DISTRICT,4,Transgender,0,0,0
MANSEHRA DISTRICT,5,Male,21639,1898,23537
MANSEHRA DISTRICT,5,Female,20587,1842,22429
MANSEHRA DISTRICT,5,Transgender,0,0,0
MANSEHRA DISTRICT,6,Male,20924,1864,22788
MANSEHRA DISTRICT,6,Female,19572,1689,21261
MANSEHRA DISTRICT,6,Transgender,0,0,0
MANSEHRA DISTRICT,7,Male,22578,2014,24592
MANSEHRA DISTRICT,7,Female,21427,2006,23433
MANSEHRA DISTRICT,7,Transgender,0,0,0
MANSEHRA DISTRICT,8,Male,20861,1789,22650
MANSEHRA DISTRICT,8,Female,19737,1727,21464
MANSEHRA DISTRICT,8,Transgender,0,0,0
MANSEHRA DISTRICT,9,Male,22123,1979,24102
MANSEHRA DISTRICT,9,Female,20881,1841,22722
MANSEHRA DISTRICT,9,Transgender,0,0,0
MANSEHRA DISTRICT,10,Male,18573,1620,20193
MANSEHRA DISTRICT,10,Female,17768,1548,19316
MANSEHRA DISTRICT,10,Transgender,0,0,0
MANSEHRA DISTRICT,11,Male,20266,1996,22262
MANSEHRA DISTRICT,11,Female,18951,1837,20788
MANSEHRA DISTRICT,11,Transgender,0,0,0
MANSEHRA DISTRICT,12,Male,17783,1701,19484
MANSEHRA DISTRICT,12,Female,16452,1570,18022
MANSEHRA DISTRICT,12,Transgender,0,0,0
MANSEHRA DISTRICT,13,Male,18337,1757,20094
MANSEHRA DISTRICT,13,Female,16844,1625,18469
MANSEHRA DISTRICT,13,Transgender,0,0,0
MANSEHRA DISTRICT,14,Male,16583,1608,18191
MANSEHRA DISTRICT,14,Female,15455,1465,16920
MANSEHRA DISTRICT,14,Transgender,0,0,0
MANSEHRA DISTRICT,15,Male,15753,1685,17438
MANSEHRA DISTRICT,15,Female,15900,1447,17347
MANSEHRA DISTRICT,15,Transgender,8,0,8
MANSEHRA DISTRICT,16,Male,15556,1629,17185
MANSEHRA DISTRICT,16,Female,15084,1520,16604
MANSEHRA DISTRICT,16,Transgender,2,1,3
MANSEHRA DISTRICT,17,Male,15233,1685,16918
MANSEHRA DISTRICT,17,Female,15160,1594,16754
MANSEHRA DISTRICT,17,Transgender,3,3,6
MANSEHRA DISTRICT,18,Male,14333,1515,15848
MANSEHRA DISTRICT,18,Female,14375,1337,15712
MANSEHRA DISTRICT,18,Transgender,2,1,3
MANSEHRA DISTRICT,19,Male,14712,1586,16298
MANSEHRA DISTRICT,19,Female,14964,1509,16473
MANSEHRA DISTRICT,19,Transgender,2,4,6
MANSEHRA DISTRICT,20,Male,12253,1317,13570
MANSEHRA DISTRICT,20,Female,13058,1242,14300
MANSEHRA DISTRICT,20,Transgender,4,6,10
MANSEHRA DISTRICT,21,Male,12692,1484,14176
MANSEHRA DISTRICT,21,Female,13750,1448,15198
MANSEHRA DISTRICT,21,Transgender,3,7,10
MANSEHRA DISTRICT,22,Male,11475,1319,12794
MANSEHRA DISTRICT,22,Female,12887,1405,14292
MANSEHRA DISTRICT,22,Transgender,5,11,16
MANSEHRA DISTRICT,23,Male,11341,1316,12657
MANSEHRA DISTRICT,23,Female,12681,1393,14074
MANSEHRA DISTRICT,23,Transgender,2,4,6
MANSEHRA DISTRICT,24,Male,10655,1408,12063
MANSEHRA DISTRICT,24,Female,12439,1455,13894
MANSEHRA DISTRICT,24,Transgender,1,8,9
MANSEHRA DISTRICT,25,Male,9368,1085,10453
MANSEHRA DISTRICT,25,Female,11259,1207,12466
MANSEHRA DISTRICT,25,Transgender,6,9,15
MANSEHRA DISTRICT,26,Male,9863,1173,11036
MANSEHRA DISTRICT,26,Female,12296,1369,13665
MANSEHRA DISTRICT,26,Transgender,5,3,8
MANSEHRA DISTRICT,27,Male,8871,1105,9976
MANSEHRA DISTRICT,27,Female,11888,1333,13221
MANSEHRA DISTRICT,27,Transgender,4,4,8
MANSEHRA DISTRICT,28,Male,8814,1091,9905
MANSEHRA DISTRICT,28,Female,11184,1284,12468
MANSEHRA DISTRICT,28,Transgender,1,5,6
MANSEHRA DISTRICT,29,Male,9128,1075,10203
MANSEHRA DISTRICT,29,Female,11730,1190,12920
MANSEHRA DISTRICT,29,Transgender,2,6,8
MANSEHRA DISTRICT,30,Male,8326,1020,9346
MANSEHRA DISTRICT,30,Female,10117,1073,11190
MANSEHRA DISTRICT,30,Transgender,7,4,11
MANSEHRA DISTRICT,31,Male,8965,997,9962
MANSEHRA DISTRICT,31,Female,11270,1124,12394
MANSEHRA DISTRICT,31,Transgender,3,2,5
MANSEHRA DISTRICT,32,Male,7957,1039,8996
MANSEHRA DISTRICT,32,Female,9822,1077,10899
MANSEHRA DISTRICT,32,Transgender,3,3,6
MANSEHRA DISTRICT,33,Male,7830,1002,8832
MANSEHRA DISTRICT,33,Female,9158,1118,10276
MANSEHRA DISTRICT,33,Transgender,2,2,4
MANSEHRA DISTRICT,34,Male,7738,924,8662
MANSEHRA DISTRICT,34,Female,8782,953,9735
MANSEHRA DISTRICT,34,Transgender,3,2,5
MANSEHRA DISTRICT,35,Male,6605,856,7461
MANSEHRA DISTRICT,35,Female,7363,894,8257
MANSEHRA DISTRICT,35,Transgender,1,4,5
MANSEHRA DISTRICT,36,Male,7333,817,8150
MANSEHRA DISTRICT,36,Female,9141,949,10090
MANSEHRA DISTRICT,36,Transgender,4,3,7
MANSEHRA DISTRICT,37,Male,6247,765,7012
MANSEHRA DISTRICT,37,Female,7583,801,8384
MANSEHRA DISTRICT,37,Transgender,0,0,0
MANSEHRA DISTRICT,38,Male,6977,981,7958
MANSEHRA DISTRICT,38,Female,7401,971,8372
MANSEHRA DISTRICT,38,Transgender,4,3,7
MANSEHRA DISTRICT,39,Male,6490,785,7275
MANSEHRA DISTRICT,39,Female,7272,857,8129
MANSEHRA DISTRICT,39,Transgender,4,2,6
MANSEHRA DISTRICT,40,Male,5574,864,6438
MANSEHRA DISTRICT,40,Female,6399,850,7249
MANSEHRA DISTRICT,40,Transgender,5,7,12
MANSEHRA DISTRICT,41,Male,5931,734,6665
MANSEHRA DISTRICT,41,Female,7354,744,8098
MANSEHRA DISTRICT,41,Transgender,0,0,0
MANSEHRA DISTRICT,42,Male,5337,704,6041
MANSEHRA DISTRICT,42,Female,6087,722,6809
MANSEHRA DISTRICT,42,Transgender,1,0,1
MANSEHRA DISTRICT,43,Male,5596,729,6325
MANSEHRA DISTRICT,43,Female,6080,727,6807
MANSEHRA DISTRICT,43,Transgender,1,2,3
MANSEHRA DISTRICT,44,Male,5482,669,6151
MANSEHRA DISTRICT,44,Female,5782,592,6374
MANSEHRA DISTRICT,44,Transgender,1,0,1
MANSEHRA DISTRICT,45,Male,4554,603,5157
MANSEHRA DISTRICT,45,Female,5016,658,5674
MANSEHRA DISTRICT,45,Transgender,5,3,8
MANSEHRA DISTRICT,46,Male,5191,619,5810
MANSEHRA DISTRICT,46,Female,6499,600,7099
MANSEHRA DISTRICT,46,Transgender,1,2,3
MANSEHRA DISTRICT,47,Male,4658,535,5193
MANSEHRA DISTRICT,47,Female,5412,472,5884
MANSEHRA DISTRICT,47,Transgender,1,0,1
MANSEHRA DISTRICT,48,Male,5274,630,5904
MANSEHRA DISTRICT,48,Female,5386,592,5978
MANSEHRA DISTRICT,48,Transgender,1,2,3
MANSEHRA DISTRICT,49,Male,5047,573,5620
MANSEHRA DISTRICT,49,Female,5516,567,6083
MANSEHRA DISTRICT,49,Transgender,0,2,2
MANSEHRA DISTRICT,50,Male,4641,639,5280
MANSEHRA DISTRICT,50,Female,4791,634,5425
MANSEHRA DISTRICT,50,Transgender,1,3,4
MANSEHRA DISTRICT,51,Male,5140,523,5663
MANSEHRA DISTRICT,51,Female,5588,568,6156
MANSEHRA DISTRICT,51,Transgender,0,0,0
MANSEHRA DISTRICT,52,Male,4563,585,5148
MANSEHRA DISTRICT,52,Female,4380,495,4875
MANSEHRA DISTRICT,52,Transgender,2,4,6
MANSEHRA DISTRICT,53,Male,4645,570,5215
MANSEHRA DISTRICT,53,Female,4331,535,4866
MANSEHRA DISTRICT,53,Transgender,0,0,0
MANSEHRA DISTRICT,54,Male,4408,532,4940
MANSEHRA DISTRICT,54,Female,3974,441,4415
MANSEHRA DISTRICT,54,Transgender,0,0,0
MANSEHRA DISTRICT,55,Male,3541,519,4060
MANSEHRA DISTRICT,55,Female,3286,463,3749
MANSEHRA DISTRICT,55,Transgender,1,2,3
MANSEHRA DISTRICT,56,Male,3748,466,4214
MANSEHRA DISTRICT,56,Female,3291,370,3661
MANSEHRA DISTRICT,56,Transgender,2,1,3
MANSEHRA DISTRICT,57,Male,3260,353,3613
MANSEHRA DISTRICT,57,Female,2577,233,2810
MANSEHRA DISTRICT,57,Transgender,0,0,0
MANSEHRA DISTRICT,58,Male,3490,447,3937
MANSEHRA DISTRICT,58,Female,2796,371,3167
MANSEHRA DISTRICT,58,Transgender,1,0,1
MANSEHRA DISTRICT,59,Male,2915,365,3280
MANSEHRA DISTRICT,59,Female,2639,290,2929
MANSEHRA DISTRICT,59,Transgender,0,1,1
MANSEHRA DISTRICT,60,Male,2964,409,3373
MANSEHRA DISTRICT,60,Female,2831,317,3148
MANSEHRA DISTRICT,60,Transgender,0,0,0
MANSEHRA DISTRICT,61,Male,3499,390,3889
MANSEHRA DISTRICT,61,Female,3370,323,3693
MANSEHRA DISTRICT,61,Transgender,0,0,0
MANSEHRA DISTRICT,62,Male,3283,382,3665
MANSEHRA DISTRICT,62,Female,2907,291,3198
MANSEHRA DISTRICT,62,Transgender,2,0,2
MANSEHRA DISTRICT,63,Male,3139,365,3504
MANSEHRA DISTRICT,63,Female,2820,316,3136
MANSEHRA DISTRICT,63,Transgender,2,0,2
MANSEHRA DISTRICT,64,Male,2778,292,3070
MANSEHRA DISTRICT,64,Female,2673,252,2925
MANSEHRA DISTRICT,64,Transgender,0,0,0
MANSEHRA DISTRICT,65,Male,2286,313,2599
MANSEHRA DISTRICT,65,Female,2182,237,2419
MANSEHRA DISTRICT,65,Transgender,2,0,2
MANSEHRA DISTRICT,66,Male,2626,261,2887
MANSEHRA DISTRICT,66,Female,2429,194,2623
MANSEHRA DISTRICT,66,Transgender,3,0,3
MANSEHRA DISTRICT,67,Male,2595,209,2804
MANSEHRA DISTRICT,67,Female,2211,141,2352
MANSEHRA DISTRICT,67,Transgender,0,0,0
MANSEHRA DISTRICT,68,Male,2525,204,2729
MANSEHRA DISTRICT,68,Female,2162,198,2360
MANSEHRA DISTRICT,68,Transgender,1,0,1
MANSEHRA DISTRICT,69,Male,2146,202,2348
MANSEHRA DISTRICT,69,Female,1759,151,1910
MANSEHRA DISTRICT,69,Transgender,0,0,0
MANSEHRA DISTRICT,70,Male,1731,195,1926
MANSEHRA DISTRICT,70,Female,1644,159,1803
MANSEHRA DISTRICT,70,Transgender,2,1,3
MANSEHRA DISTRICT,71,Male,2254,165,2419
MANSEHRA DISTRICT,71,Female,1959,142,2101
MANSEHRA DISTRICT,71,Transgender,1,0,1
MANSEHRA DISTRICT,72,Male,2050,163,2213
MANSEHRA DISTRICT,72,Female,1758,129,1887
MANSEHRA DISTRICT,72,Transgender,0,1,1
MANSEHRA DISTRICT,73,Male,1914,156,2070
MANSEHRA DISTRICT,73,Female,1547,118,1665
MANSEHRA DISTRICT,73,Transgender,1,0,1
MANSEHRA DISTRICT,74,Male,1399,104,1503
MANSEHRA DISTRICT,74,Female,1171,101,1272
MANSEHRA DISTRICT,74,Transgender,1,0,1
MANSEHRA DISTRICT,>=75,Male,11422,955,12377
MANSEHRA DISTRICT,>=75,Female,9957,960,10917
MANSEHRA DISTRICT,>=75,Transgender,7,3,10
MARDAN DISTRICT,<1,Male,26629,5671,32300
MARDAN DISTRICT,<1,Female,25422,5337,30759
MARDAN DISTRICT,<1,Transgender,0,0,0
MARDAN DISTRICT,1,Male,27043,6047,33090
MARDAN DISTRICT,1,Female,25721,5708,31429
MARDAN DISTRICT,1,Transgender,0,0,0
MARDAN DISTRICT,2,Male,29911,6354,36265
MARDAN DISTRICT,2,Female,28192,6110,34302
MARDAN DISTRICT,2,Transgender,0,0,0
MARDAN DISTRICT,3,Male,30859,6555,37414
MARDAN DISTRICT,3,Female,29536,6488,36024
MARDAN DISTRICT,3,Transgender,0,0,0
MARDAN DISTRICT,4,Male,32472,6393,38865
MARDAN DISTRICT,4,Female,30472,6045,36517
MARDAN DISTRICT,4,Transgender,0,0,0
MARDAN DISTRICT,5,Male,30291,6495,36786
MARDAN DISTRICT,5,Female,27889,6092,33981
MARDAN DISTRICT,5,Transgender,0,0,0
MARDAN DISTRICT,6,Male,29863,6212,36075
MARDAN DISTRICT,6,Female,28140,5754,33894
MARDAN DISTRICT,6,Transgender,0,0,0
MARDAN DISTRICT,7,Male,30522,6406,36928
MARDAN DISTRICT,7,Female,28164,6154,34318
MARDAN DISTRICT,7,Transgender,0,0,0
MARDAN DISTRICT,8,Male,29959,5939,35898
MARDAN DISTRICT,8,Female,28035,5473,33508
MARDAN DISTRICT,8,Transgender,0,0,0
MARDAN DISTRICT,9,Male,30121,6234,36355
MARDAN DISTRICT,9,Female,27562,5933,33495
MARDAN DISTRICT,9,Transgender,0,0,0
MARDAN DISTRICT,10,Male,27414,5602,33016
MARDAN DISTRICT,10,Female,25772,5150,30922
MARDAN DISTRICT,10,Transgender,0,0,0
MARDAN DISTRICT,11,Male,27474,5898,33372
MARDAN DISTRICT,11,Female,24540,5367,29907
MARDAN DISTRICT,11,Transgender,0,0,0
MARDAN DISTRICT,12,Male,25254,5361,30615
MARDAN DISTRICT,12,Female,22958,4781,27739
MARDAN DISTRICT,12,Transgender,0,0,0
MARDAN DISTRICT,13,Male,26758,5789,32547
MARDAN DISTRICT,13,Female,23834,5236,29070
MARDAN DISTRICT,13,Transgender,0,0,0
MARDAN DISTRICT,14,Male,24815,5236,30051
MARDAN DISTRICT,14,Female,22390,4777,27167
MARDAN DISTRICT,14,Transgender,0,0,0
MARDAN DISTRICT,15,Male,24312,5198,29510
MARDAN DISTRICT,15,Female,22595,5028,27623
MARDAN DISTRICT,15,Transgender,1,1,2
MARDAN DISTRICT,16,Male,22027,5087,27114
MARDAN DISTRICT,16,Female,21098,4661,25759
MARDAN DISTRICT,16,Transgender,0,2,2
MARDAN DISTRICT,17,Male,20977,5210,26187
MARDAN DISTRICT,17,Female,22002,5042,27044
MARDAN DISTRICT,17,Transgender,0,4,4
MARDAN DISTRICT,18,Male,19736,4692,24428
MARDAN DISTRICT,18,Female,19938,4610,24548
MARDAN DISTRICT,18,Transgender,0,1,1
MARDAN DISTRICT,19,Male,20367,5337,25704
MARDAN DISTRICT,19,Female,19175,4661,23836
MARDAN DISTRICT,19,Transgender,0,3,3
MARDAN DISTRICT,20,Male,19298,4570,23868
MARDAN DISTRICT,20,Female,20933,4434,25367
MARDAN DISTRICT,20,Transgender,1,3,4
MARDAN DISTRICT,21,Male,17988,5088,23076
MARDAN DISTRICT,21,Female,18287,4440,22727
MARDAN DISTRICT,21,Transgender,0,0,0
MARDAN DISTRICT,22,Male,16259,4266,20525
MARDAN DISTRICT,22,Female,18065,4348,22413
MARDAN DISTRICT,22,Transgender,0,3,3
MARDAN DISTRICT,23,Male,15833,4126,19959
MARDAN DISTRICT,23,Female,16529,3949,20478
MARDAN DISTRICT,23,Transgender,0,4,4
MARDAN DISTRICT,24,Male,14306,3709,18015
MARDAN DISTRICT,24,Female,16000,3890,19890
MARDAN DISTRICT,24,Transgender,0,1,1
MARDAN DISTRICT,25,Male,14097,3476,17573
MARDAN DISTRICT,25,Female,18492,3998,22490
MARDAN DISTRICT,25,Transgender,0,4,4
MARDAN DISTRICT,26,Male,14316,3607,17923
MARDAN DISTRICT,26,Female,16237,3786,20023
MARDAN DISTRICT,26,Transgender,0,1,1
MARDAN DISTRICT,27,Male,13663,3518,17181
MARDAN DISTRICT,27,Female,16429,3901,20330
MARDAN DISTRICT,27,Transgender,0,1,1
MARDAN DISTRICT,28,Male,13258,3390,16648
MARDAN DISTRICT,28,Female,14226,3529,17755
MARDAN DISTRICT,28,Transgender,0,5,5
MARDAN DISTRICT,29,Male,13139,3330,16469
MARDAN DISTRICT,29,Female,15397,3583,18980
MARDAN DISTRICT,29,Transgender,0,0,0
MARDAN DISTRICT,30,Male,13246,3240,16486
MARDAN DISTRICT,30,Female,14986,3549,18535
MARDAN DISTRICT,30,Transgender,0,2,2
MARDAN DISTRICT,31,Male,12759,3160,15919
MARDAN DISTRICT,31,Female,13789,3248,17037
MARDAN DISTRICT,31,Transgender,0,2,2
MARDAN DISTRICT,32,Male,10990,2947,13937
MARDAN DISTRICT,32,Female,11418,2959,14377
MARDAN DISTRICT,32,Transgender,0,1,1
MARDAN DISTRICT,33,Male,11188,2935,14123
MARDAN DISTRICT,33,Female,11399,2865,14264
MARDAN DISTRICT,33,Transgender,0,0,0
MARDAN DISTRICT,34,Male,10005,2641,12646
MARDAN DISTRICT,34,Female,10019,2455,12474
MARDAN DISTRICT,34,Transgender,0,2,2
MARDAN DISTRICT,35,Male,9246,2328,11574
MARDAN DISTRICT,35,Female,10608,2602,13210
MARDAN DISTRICT,35,Transgender,0,1,1
MARDAN DISTRICT,36,Male,9298,2364,11662
MARDAN DISTRICT,36,Female,9634,2300,11934
MARDAN DISTRICT,36,Transgender,0,1,1
MARDAN DISTRICT,37,Male,8652,2312,10964
MARDAN DISTRICT,37,Female,9917,2328,12245
MARDAN DISTRICT,37,Transgender,0,1,1
MARDAN DISTRICT,38,Male,8980,2523,11503
MARDAN DISTRICT,38,Female,8679,2281,10960
MARDAN DISTRICT,38,Transgender,1,0,1
MARDAN DISTRICT,39,Male,8695,2423,11118
MARDAN DISTRICT,39,Female,9347,2348,11695
MARDAN DISTRICT,39,Transgender,0,0,0
MARDAN DISTRICT,40,Male,8489,2353,10842
MARDAN DISTRICT,40,Female,9916,2397,12313
MARDAN DISTRICT,40,Transgender,0,5,5
MARDAN DISTRICT,41,Male,8287,2128,10415
MARDAN DISTRICT,41,Female,8961,2025,10986
MARDAN DISTRICT,41,Transgender,0,1,1
MARDAN DISTRICT,42,Male,7432,2053,9485
MARDAN DISTRICT,42,Female,7919,1930,9849
MARDAN DISTRICT,42,Transgender,0,1,1
MARDAN DISTRICT,43,Male,7895,2021,9916
MARDAN DISTRICT,43,Female,7739,2010,9749
MARDAN DISTRICT,43,Transgender,1,0,1
MARDAN DISTRICT,44,Male,7267,1895,9162
MARDAN DISTRICT,44,Female,7315,1786,9101
MARDAN DISTRICT,44,Transgender,0,0,0
MARDAN DISTRICT,45,Male,6181,1587,7768
MARDAN DISTRICT,45,Female,7244,1722,8966
MARDAN DISTRICT,45,Transgender,0,3,3
MARDAN DISTRICT,46,Male,6852,1742,8594
MARDAN DISTRICT,46,Female,7162,1566,8728
MARDAN DISTRICT,46,Transgender,0,0,0
MARDAN DISTRICT,47,Male,6519,1678,8197
MARDAN DISTRICT,47,Female,7038,1547,8585
MARDAN DISTRICT,47,Transgender,0,0,0
MARDAN DISTRICT,48,Male,6641,1674,8315
MARDAN DISTRICT,48,Female,6062,1569,7631
MARDAN DISTRICT,48,Transgender,0,0,0
MARDAN DISTRICT,49,Male,6584,1616,8200
MARDAN DISTRICT,49,Female,6510,1563,8073
MARDAN DISTRICT,49,Transgender,0,0,0
MARDAN DISTRICT,50,Male,6194,1564,7758
MARDAN DISTRICT,50,Female,6908,1600,8508
MARDAN DISTRICT,50,Transgender,0,0,0
MARDAN DISTRICT,51,Male,6298,1555,7853
MARDAN DISTRICT,51,Female,6298,1367,7665
MARDAN DISTRICT,51,Transgender,0,0,0
MARDAN DISTRICT,52,Male,5640,1401,7041
MARDAN DISTRICT,52,Female,5217,1323,6540
MARDAN DISTRICT,52,Transgender,0,0,0
MARDAN DISTRICT,53,Male,5834,1404,7238
MARDAN DISTRICT,53,Female,4950,1239,6189
MARDAN DISTRICT,53,Transgender,0,1,1
MARDAN DISTRICT,54,Male,5325,1322,6647
MARDAN DISTRICT,54,Female,4363,1051,5414
MARDAN DISTRICT,54,Transgender,0,0,0
MARDAN DISTRICT,55,Male,4769,1202,5971
MARDAN DISTRICT,55,Female,4513,1111,5624
MARDAN DISTRICT,55,Transgender,0,0,0
MARDAN DISTRICT,56,Male,4491,1085,5576
MARDAN DISTRICT,56,Female,4100,870,4970
MARDAN DISTRICT,56,Transgender,0,0,0
MARDAN DISTRICT,57,Male,4287,1043,5330
MARDAN DISTRICT,57,Female,3921,784,4705
MARDAN DISTRICT,57,Transgender,0,0,0
MARDAN DISTRICT,58,Male,4557,1016,5573
MARDAN DISTRICT,58,Female,3889,824,4713
MARDAN DISTRICT,58,Transgender,0,0,0
MARDAN DISTRICT,59,Male,4811,1080,5891
MARDAN DISTRICT,59,Female,4058,910,4968
MARDAN DISTRICT,59,Transgender,0,0,0
MARDAN DISTRICT,60,Male,4407,1011,5418
MARDAN DISTRICT,60,Female,4448,931,5379
MARDAN DISTRICT,60,Transgender,0,0,0
MARDAN DISTRICT,61,Male,4797,1092,5889
MARDAN DISTRICT,61,Female,4146,832,4978
MARDAN DISTRICT,61,Transgender,0,0,0
MARDAN DISTRICT,62,Male,4092,1089,5181
MARDAN DISTRICT,62,Female,3541,804,4345
MARDAN DISTRICT,62,Transgender,1,0,1
MARDAN DISTRICT,63,Male,4235,1010,5245
MARDAN DISTRICT,63,Female,3486,838,4324
MARDAN DISTRICT,63,Transgender,0,0,0
MARDAN DISTRICT,64,Male,3923,816,4739
MARDAN DISTRICT,64,Female,3234,632,3866
MARDAN DISTRICT,64,Transgender,0,0,0
MARDAN DISTRICT,65,Male,3211,744,3955
MARDAN DISTRICT,65,Female,2684,534,3218
MARDAN DISTRICT,65,Transgender,1,0,1
MARDAN DISTRICT,66,Male,3478,668,4146
MARDAN DISTRICT,66,Female,2567,461,3028
MARDAN DISTRICT,66,Transgender,1,0,1
MARDAN DISTRICT,67,Male,2973,736,3709
MARDAN DISTRICT,67,Female,2150,475,2625
MARDAN DISTRICT,67,Transgender,0,0,0
MARDAN DISTRICT,68,Male,2684,642,3326
MARDAN DISTRICT,68,Female,2071,462,2533
MARDAN DISTRICT,68,Transgender,0,0,0
MARDAN DISTRICT,69,Male,2743,523,3266
MARDAN DISTRICT,69,Female,2128,383,2511
MARDAN DISTRICT,69,Transgender,0,0,0
MARDAN DISTRICT,70,Male,2525,428,2953
MARDAN DISTRICT,70,Female,2290,400,2690
MARDAN DISTRICT,70,Transgender,1,0,1
MARDAN DISTRICT,71,Male,2501,458,2959
MARDAN DISTRICT,71,Female,2014,364,2378
MARDAN DISTRICT,71,Transgender,0,0,0
MARDAN DISTRICT,72,Male,2029,460,2489
MARDAN DISTRICT,72,Female,1610,310,1920
MARDAN DISTRICT,72,Transgender,0,0,0
MARDAN DISTRICT,73,Male,1932,467,2399
MARDAN DISTRICT,73,Female,1488,345,1833
MARDAN DISTRICT,73,Transgender,0,0,0
MARDAN DISTRICT,74,Male,1628,326,1954
MARDAN DISTRICT,74,Female,1334,244,1578
MARDAN DISTRICT,74,Transgender,0,0,0
MARDAN DISTRICT,>=75,Male,11867,2166,14033
MARDAN DISTRICT,>=75,Female,10671,2035,12706
MARDAN DISTRICT,>=75,Transgender,0,0,0
MASTUNG DISTRICT,<1,Male,3304,431,3735
MASTUNG DISTRICT,<1,Female,3188,389,3577
MASTUNG DISTRICT,<1,Transgender,0,0,0
MASTUNG DISTRICT,1,Male,4065,495,4560
MASTUNG DISTRICT,1,Female,3770,481,4251
MASTUNG DISTRICT,1,Transgender,0,0,0
MASTUNG DISTRICT,2,Male,4842,549,5391
MASTUNG DISTRICT,2,Female,4642,616,5258
MASTUNG DISTRICT,2,Transgender,0,0,0
MASTUNG DISTRICT,3,Male,4439,558,4997
MASTUNG DISTRICT,3,Female,4459,543,5002
MASTUNG DISTRICT,3,Transgender,0,0,0
MASTUNG DISTRICT,4,Male,4640,539,5179
MASTUNG DISTRICT,4,Female,4377,505,4882
MASTUNG DISTRICT,4,Transgender,0,0,0
MASTUNG DISTRICT,5,Male,4211,595,4806
MASTUNG DISTRICT,5,Female,3943,511,4454
MASTUNG DISTRICT,5,Transgender,0,0,0
MASTUNG DISTRICT,6,Male,4434,549,4983
MASTUNG DISTRICT,6,Female,4032,471,4503
MASTUNG DISTRICT,6,Transgender,0,0,0
MASTUNG DISTRICT,7,Male,4492,575,5067
MASTUNG DISTRICT,7,Female,3929,544,4473
MASTUNG DISTRICT,7,Transgender,0,0,0
MASTUNG DISTRICT,8,Male,4513,529,5042
MASTUNG DISTRICT,8,Female,4039,500,4539
MASTUNG DISTRICT,8,Transgender,0,0,0
MASTUNG DISTRICT,9,Male,3898,519,4417
MASTUNG DISTRICT,9,Female,3315,466,3781
MASTUNG DISTRICT,9,Transgender,0,0,0
MASTUNG DISTRICT,10,Male,4137,510,4647
MASTUNG DISTRICT,10,Female,3605,431,4036
MASTUNG DISTRICT,10,Transgender,0,0,0
MASTUNG DISTRICT,11,Male,2934,453,3387
MASTUNG DISTRICT,11,Female,2643,442,3085
MASTUNG DISTRICT,11,Transgender,0,0,0
MASTUNG DISTRICT,12,Male,3231,453,3684
MASTUNG DISTRICT,12,Female,2843,439,3282
MASTUNG DISTRICT,12,Transgender,0,0,0
MASTUNG DISTRICT,13,Male,2640,436,3076
MASTUNG DISTRICT,13,Female,2304,398,2702
MASTUNG DISTRICT,13,Transgender,0,0,0
MASTUNG DISTRICT,14,Male,2851,428,3279
MASTUNG DISTRICT,14,Female,2629,416,3045
MASTUNG DISTRICT,14,Transgender,0,0,0
MASTUNG DISTRICT,15,Male,2608,405,3013
MASTUNG DISTRICT,15,Female,2322,443,2765
MASTUNG DISTRICT,15,Transgender,0,0,0
MASTUNG DISTRICT,16,Male,2655,390,3045
MASTUNG DISTRICT,16,Female,2303,398,2701
MASTUNG DISTRICT,16,Transgender,0,0,0
MASTUNG DISTRICT,17,Male,2286,382,2668
MASTUNG DISTRICT,17,Female,1988,391,2379
MASTUNG DISTRICT,17,Transgender,0,0,0
MASTUNG DISTRICT,18,Male,2672,431,3103
MASTUNG DISTRICT,18,Female,2310,381,2691
MASTUNG DISTRICT,18,Transgender,0,0,0
MASTUNG DISTRICT,19,Male,2236,394,2630
MASTUNG DISTRICT,19,Female,1850,362,2212
MASTUNG DISTRICT,19,Transgender,0,0,0
MASTUNG DISTRICT,20,Male,2288,321,2609
MASTUNG DISTRICT,20,Female,2239,326,2565
MASTUNG DISTRICT,20,Transgender,0,0,0
MASTUNG DISTRICT,21,Male,1767,348,2115
MASTUNG DISTRICT,21,Female,1819,315,2134
MASTUNG DISTRICT,21,Transgender,0,0,0
MASTUNG DISTRICT,22,Male,1670,270,1940
MASTUNG DISTRICT,22,Female,1718,302,2020
MASTUNG DISTRICT,22,Transgender,1,0,1
MASTUNG DISTRICT,23,Male,1559,311,1870
MASTUNG DISTRICT,23,Female,1430,270,1700
MASTUNG DISTRICT,23,Transgender,0,0,0
MASTUNG DISTRICT,24,Male,1372,272,1644
MASTUNG DISTRICT,24,Female,1302,256,1558
MASTUNG DISTRICT,24,Transgender,0,0,0
MASTUNG DISTRICT,25,Male,1850,284,2134
MASTUNG DISTRICT,25,Female,2167,314,2481
MASTUNG DISTRICT,25,Transgender,0,0,0
MASTUNG DISTRICT,26,Male,1308,269,1577
MASTUNG DISTRICT,26,Female,1415,277,1692
MASTUNG DISTRICT,26,Transgender,0,0,0
MASTUNG DISTRICT,27,Male,1702,291,1993
MASTUNG DISTRICT,27,Female,1744,307,2051
MASTUNG DISTRICT,27,Transgender,0,0,0
MASTUNG DISTRICT,28,Male,1585,296,1881
MASTUNG DISTRICT,28,Female,1720,314,2034
MASTUNG DISTRICT,28,Transgender,0,0,0
MASTUNG DISTRICT,29,Male,1646,261,1907
MASTUNG DISTRICT,29,Female,1654,276,1930
MASTUNG DISTRICT,29,Transgender,0,0,0
MASTUNG DISTRICT,30,Male,1622,246,1868
MASTUNG DISTRICT,30,Female,2039,310,2349
MASTUNG DISTRICT,30,Transgender,0,0,0
MASTUNG DISTRICT,31,Male,1473,256,1729
MASTUNG DISTRICT,31,Female,1537,266,1803
MASTUNG DISTRICT,31,Transgender,0,0,0
MASTUNG DISTRICT,32,Male,1411,220,1631
MASTUNG DISTRICT,32,Female,1219,183,1402
MASTUNG DISTRICT,32,Transgender,0,0,0
MASTUNG DISTRICT,33,Male,1395,230,1625
MASTUNG DISTRICT,33,Female,1288,225,1513
MASTUNG DISTRICT,33,Transgender,0,0,0
MASTUNG DISTRICT,34,Male,1189,198,1387
MASTUNG DISTRICT,34,Female,975,179,1154
MASTUNG DISTRICT,34,Transgender,0,0,0
MASTUNG DISTRICT,35,Male,1343,215,1558
MASTUNG DISTRICT,35,Female,1406,222,1628
MASTUNG DISTRICT,35,Transgender,0,0,0
MASTUNG DISTRICT,36,Male,1122,180,1302
MASTUNG DISTRICT,36,Female,781,142,923
MASTUNG DISTRICT,36,Transgender,1,0,1
MASTUNG DISTRICT,37,Male,1461,219,1680
MASTUNG DISTRICT,37,Female,1088,201,1289
MASTUNG DISTRICT,37,Transgender,0,0,0
MASTUNG DISTRICT,38,Male,1061,218,1279
MASTUNG DISTRICT,38,Female,944,158,1102
MASTUNG DISTRICT,38,Transgender,0,0,0
MASTUNG DISTRICT,39,Male,1187,219,1406
MASTUNG DISTRICT,39,Female,936,166,1102
MASTUNG DISTRICT,39,Transgender,0,0,0
MASTUNG DISTRICT,40,Male,1064,141,1205
MASTUNG DISTRICT,40,Female,1308,184,1492
MASTUNG DISTRICT,40,Transgender,0,0,0
MASTUNG DISTRICT,41,Male,861,158,1019
MASTUNG DISTRICT,41,Female,791,133,924
MASTUNG DISTRICT,41,Transgender,0,0,0
MASTUNG DISTRICT,42,Male,831,173,1004
MASTUNG DISTRICT,42,Female,734,141,875
MASTUNG DISTRICT,42,Transgender,0,0,0
MASTUNG DISTRICT,43,Male,725,135,860
MASTUNG DISTRICT,43,Female,728,121,849
MASTUNG DISTRICT,43,Transgender,0,0,0
MASTUNG DISTRICT,44,Male,603,118,721
MASTUNG DISTRICT,44,Female,676,124,800
MASTUNG DISTRICT,44,Transgender,0,0,0
MASTUNG DISTRICT,45,Male,728,117,845
MASTUNG DISTRICT,45,Female,844,137,981
MASTUNG DISTRICT,45,Transgender,0,0,0
MASTUNG DISTRICT,46,Male,650,116,766
MASTUNG DISTRICT,46,Female,543,87,630
MASTUNG DISTRICT,46,Transgender,0,0,0
MASTUNG DISTRICT,47,Male,977,164,1141
MASTUNG DISTRICT,47,Female,653,155,808
MASTUNG DISTRICT,47,Transgender,0,0,0
MASTUNG DISTRICT,48,Male,613,110,723
MASTUNG DISTRICT,48,Female,538,104,642
MASTUNG DISTRICT,48,Transgender,0,0,0
MASTUNG DISTRICT,49,Male,744,106,850
MASTUNG DISTRICT,49,Female,585,139,724
MASTUNG DISTRICT,49,Transgender,0,0,0
MASTUNG DISTRICT,50,Male,693,99,792
MASTUNG DISTRICT,50,Female,891,132,1023
MASTUNG DISTRICT,50,Transgender,1,0,1
MASTUNG DISTRICT,51,Male,644,124,768
MASTUNG DISTRICT,51,Female,486,96,582
MASTUNG DISTRICT,51,Transgender,0,0,0
MASTUNG DISTRICT,52,Male,554,118,672
MASTUNG DISTRICT,52,Female,416,84,500
MASTUNG DISTRICT,52,Transgender,0,0,0
MASTUNG DISTRICT,53,Male,536,100,636
MASTUNG DISTRICT,53,Female,492,80,572
MASTUNG DISTRICT,53,Transgender,0,0,0
MASTUNG DISTRICT,54,Male,494,99,593
MASTUNG DISTRICT,54,Female,373,93,466
MASTUNG DISTRICT,54,Transgender,0,0,0
MASTUNG DISTRICT,55,Male,450,93,543
MASTUNG DISTRICT,55,Female,537,78,615
MASTUNG DISTRICT,55,Transgender,0,0,0
MASTUNG DISTRICT,56,Male,360,69,429
MASTUNG DISTRICT,56,Female,316,74,390
MASTUNG DISTRICT,56,Transgender,0,0,0
MASTUNG DISTRICT,57,Male,518,93,611
MASTUNG DISTRICT,57,Female,459,79,538
MASTUNG DISTRICT,57,Transgender,0,0,0
MASTUNG DISTRICT,58,Male,373,78,451
MASTUNG DISTRICT,58,Female,313,56,369
MASTUNG DISTRICT,58,Transgender,0,0,0
MASTUNG DISTRICT,59,Male,453,76,529
MASTUNG DISTRICT,59,Female,345,75,420
MASTUNG DISTRICT,59,Transgender,0,0,0
MASTUNG DISTRICT,60,Male,433,68,501
MASTUNG DISTRICT,60,Female,568,65,633
MASTUNG DISTRICT,60,Transgender,0,0,0
MASTUNG DISTRICT,61,Male,402,67,469
MASTUNG DISTRICT,61,Female,371,67,438
MASTUNG DISTRICT,61,Transgender,0,0,0
MASTUNG DISTRICT,62,Male,360,63,423
MASTUNG DISTRICT,62,Female,322,62,384
MASTUNG DISTRICT,62,Transgender,0,0,0
MASTUNG DISTRICT,63,Male,350,60,410
MASTUNG DISTRICT,63,Female,353,50,403
MASTUNG DISTRICT,63,Transgender,0,0,0
MASTUNG DISTRICT,64,Male,341,49,390
MASTUNG DISTRICT,64,Female,260,57,317
MASTUNG DISTRICT,64,Transgender,0,0,0
MASTUNG DISTRICT,65,Male,276,42,318
MASTUNG DISTRICT,65,Female,293,48,341
MASTUNG DISTRICT,65,Transgender,0,0,0
MASTUNG DISTRICT,66,Male,341,45,386
MASTUNG DISTRICT,66,Female,254,48,302
MASTUNG DISTRICT,66,Transgender,0,0,0
MASTUNG DISTRICT,67,Male,382,66,448
MASTUNG DISTRICT,67,Female,270,46,316
MASTUNG DISTRICT,67,Transgender,0,0,0
MASTUNG DISTRICT,68,Male,218,33,251
MASTUNG DISTRICT,68,Female,186,33,219
MASTUNG DISTRICT,68,Transgender,0,0,0
MASTUNG DISTRICT,69,Male,254,48,302
MASTUNG DISTRICT,69,Female,212,32,244
MASTUNG DISTRICT,69,Transgender,0,0,0
MASTUNG DISTRICT,70,Male,229,23,252
MASTUNG DISTRICT,70,Female,245,34,279
MASTUNG DISTRICT,70,Transgender,0,0,0
MASTUNG DISTRICT,71,Male,269,33,302
MASTUNG DISTRICT,71,Female,186,29,215
MASTUNG DISTRICT,71,Transgender,0,0,0
MASTUNG DISTRICT,72,Male,217,33,250
MASTUNG DISTRICT,72,Female,153,26,179
MASTUNG DISTRICT,72,Transgender,0,0,0
MASTUNG DISTRICT,73,Male,161,24,185
MASTUNG DISTRICT,73,Female,124,27,151
MASTUNG DISTRICT,73,Transgender,0,0,0
MASTUNG DISTRICT,74,Male,150,17,167
MASTUNG DISTRICT,74,Female,118,18,136
MASTUNG DISTRICT,74,Transgender,0,0,0
MASTUNG DISTRICT,>=75,Male,1301,147,1448
MASTUNG DISTRICT,>=75,Female,1167,197,1364
MASTUNG DISTRICT,>=75,Transgender,0,0,0
MATIARI DISTRICT,<1,Male,6543,1852,8395
MATIARI DISTRICT,<1,Female,6130,1685,7815
MATIARI DISTRICT,<1,Transgender,0,0,0
MATIARI DISTRICT,1,Male,7820,2213,10033
MATIARI DISTRICT,1,Female,7522,2250,9772
MATIARI DISTRICT,1,Transgender,0,0,0
MATIARI DISTRICT,2,Male,9028,2442,11470
MATIARI DISTRICT,2,Female,8858,2431,11289
MATIARI DISTRICT,2,Transgender,0,0,0
MATIARI DISTRICT,3,Male,10109,2832,12941
MATIARI DISTRICT,3,Female,9845,2700,12545
MATIARI DISTRICT,3,Transgender,0,0,0
MATIARI DISTRICT,4,Male,10373,2684,13057
MATIARI DISTRICT,4,Female,10027,2644,12671
MATIARI DISTRICT,4,Transgender,0,0,0
MATIARI DISTRICT,5,Male,10456,3048,13504
MATIARI DISTRICT,5,Female,9916,2759,12675
MATIARI DISTRICT,5,Transgender,0,0,0
MATIARI DISTRICT,6,Male,9996,2617,12613
MATIARI DISTRICT,6,Female,9251,2491,11742
MATIARI DISTRICT,6,Transgender,0,0,0
MATIARI DISTRICT,7,Male,9415,2700,12115
MATIARI DISTRICT,7,Female,8484,2461,10945
MATIARI DISTRICT,7,Transgender,0,0,0
MATIARI DISTRICT,8,Male,10831,2741,13572
MATIARI DISTRICT,8,Female,9591,2517,12108
MATIARI DISTRICT,8,Transgender,0,0,0
MATIARI DISTRICT,9,Male,8229,2395,10624
MATIARI DISTRICT,9,Female,7348,2212,9560
MATIARI DISTRICT,9,Transgender,0,0,0
MATIARI DISTRICT,10,Male,9938,2535,12473
MATIARI DISTRICT,10,Female,8685,2235,10920
MATIARI DISTRICT,10,Transgender,0,0,0
MATIARI DISTRICT,11,Male,6987,2212,9199
MATIARI DISTRICT,11,Female,6170,1931,8101
MATIARI DISTRICT,11,Transgender,0,0,0
MATIARI DISTRICT,12,Male,8124,2324,10448
MATIARI DISTRICT,12,Female,6990,1989,8979
MATIARI DISTRICT,12,Transgender,0,0,0
MATIARI DISTRICT,13,Male,6527,2232,8759
MATIARI DISTRICT,13,Female,5307,1808,7115
MATIARI DISTRICT,13,Transgender,0,0,0
MATIARI DISTRICT,14,Male,6844,2090,8934
MATIARI DISTRICT,14,Female,5807,1824,7631
MATIARI DISTRICT,14,Transgender,0,0,0
MATIARI DISTRICT,15,Male,7373,2287,9660
MATIARI DISTRICT,15,Female,5918,2021,7939
MATIARI DISTRICT,15,Transgender,1,0,1
MATIARI DISTRICT,16,Male,6770,2054,8824
MATIARI DISTRICT,16,Female,5641,1852,7493
MATIARI DISTRICT,16,Transgender,2,0,2
MATIARI DISTRICT,17,Male,6229,2157,8386
MATIARI DISTRICT,17,Female,4996,1846,6842
MATIARI DISTRICT,17,Transgender,2,0,2
MATIARI DISTRICT,18,Male,6931,2124,9055
MATIARI DISTRICT,18,Female,6355,1989,8344
MATIARI DISTRICT,18,Transgender,3,0,3
MATIARI DISTRICT,19,Male,5372,1849,7221
MATIARI DISTRICT,19,Female,5470,1848,7318
MATIARI DISTRICT,19,Transgender,0,0,0
MATIARI DISTRICT,20,Male,6717,2065,8782
MATIARI DISTRICT,20,Female,6474,1869,8343
MATIARI DISTRICT,20,Transgender,4,2,6
MATIARI DISTRICT,21,Male,4673,1689,6362
MATIARI DISTRICT,21,Female,4708,1685,6393
MATIARI DISTRICT,21,Transgender,0,2,2
MATIARI DISTRICT,22,Male,5273,1687,6960
MATIARI DISTRICT,22,Female,4727,1598,6325
MATIARI DISTRICT,22,Transgender,3,0,3
MATIARI DISTRICT,23,Male,4293,1536,5829
MATIARI DISTRICT,23,Female,4251,1528,5779
MATIARI DISTRICT,23,Transgender,1,0,1
MATIARI DISTRICT,24,Male,4044,1438,5482
MATIARI DISTRICT,24,Female,4251,1408,5659
MATIARI DISTRICT,24,Transgender,1,1,2
MATIARI DISTRICT,25,Male,5281,1564,6845
MATIARI DISTRICT,25,Female,4854,1549,6403
MATIARI DISTRICT,25,Transgender,3,0,3
MATIARI DISTRICT,26,Male,4156,1386,5542
MATIARI DISTRICT,26,Female,4358,1479,5837
MATIARI DISTRICT,26,Transgender,0,0,0
MATIARI DISTRICT,27,Male,4189,1484,5673
MATIARI DISTRICT,27,Female,4444,1502,5946
MATIARI DISTRICT,27,Transgender,2,0,2
MATIARI DISTRICT,28,Male,4299,1412,5711
MATIARI DISTRICT,28,Female,4641,1514,6155
MATIARI DISTRICT,28,Transgender,0,0,0
MATIARI DISTRICT,29,Male,4052,1379,5431
MATIARI DISTRICT,29,Female,4387,1525,5912
MATIARI DISTRICT,29,Transgender,3,0,3
MATIARI DISTRICT,30,Male,4376,1461,5837
MATIARI DISTRICT,30,Female,4431,1455,5886
MATIARI DISTRICT,30,Transgender,3,1,4
MATIARI DISTRICT,31,Male,3854,1360,5214
MATIARI DISTRICT,31,Female,4170,1392,5562
MATIARI DISTRICT,31,Transgender,0,0,0
MATIARI DISTRICT,32,Male,4175,1374,5549
MATIARI DISTRICT,32,Female,3921,1373,5294
MATIARI DISTRICT,32,Transgender,1,0,1
MATIARI DISTRICT,33,Male,3718,1330,5048
MATIARI DISTRICT,33,Female,3770,1156,4926
MATIARI DISTRICT,33,Transgender,0,0,0
MATIARI DISTRICT,34,Male,3663,1177,4840
MATIARI DISTRICT,34,Female,3566,1165,4731
MATIARI DISTRICT,34,Transgender,1,0,1
MATIARI DISTRICT,35,Male,3807,1251,5058
MATIARI DISTRICT,35,Female,3403,1125,4528
MATIARI DISTRICT,35,Transgender,2,1,3
MATIARI DISTRICT,36,Male,3644,1208,4852
MATIARI DISTRICT,36,Female,3456,1048,4504
MATIARI DISTRICT,36,Transgender,1,1,2
MATIARI DISTRICT,37,Male,4259,1334,5593
MATIARI DISTRICT,37,Female,4273,1220,5493
MATIARI DISTRICT,37,Transgender,1,0,1
MATIARI DISTRICT,38,Male,3580,1168,4748
MATIARI DISTRICT,38,Female,3468,1113,4581
MATIARI DISTRICT,38,Transgender,4,1,5
MATIARI DISTRICT,39,Male,3520,1221,4741
MATIARI DISTRICT,39,Female,3121,1103,4224
MATIARI DISTRICT,39,Transgender,1,1,2
MATIARI DISTRICT,40,Male,3059,1131,4190
MATIARI DISTRICT,40,Female,3008,1007,4015
MATIARI DISTRICT,40,Transgender,2,0,2
MATIARI DISTRICT,41,Male,2839,977,3816
MATIARI DISTRICT,41,Female,3030,962,3992
MATIARI DISTRICT,41,Transgender,1,3,4
MATIARI DISTRICT,42,Male,2624,924,3548
MATIARI DISTRICT,42,Female,2930,906,3836
MATIARI DISTRICT,42,Transgender,1,1,2
MATIARI DISTRICT,43,Male,2478,987,3465
MATIARI DISTRICT,43,Female,2466,845,3311
MATIARI DISTRICT,43,Transgender,0,0,0
MATIARI DISTRICT,44,Male,2441,895,3336
MATIARI DISTRICT,44,Female,2315,730,3045
MATIARI DISTRICT,44,Transgender,0,0,0
MATIARI DISTRICT,45,Male,2494,796,3290
MATIARI DISTRICT,45,Female,2090,663,2753
MATIARI DISTRICT,45,Transgender,1,0,1
MATIARI DISTRICT,46,Male,2428,792,3220
MATIARI DISTRICT,46,Female,2213,692,2905
MATIARI DISTRICT,46,Transgender,2,0,2
MATIARI DISTRICT,47,Male,2321,796,3117
MATIARI DISTRICT,47,Female,2509,794,3303
MATIARI DISTRICT,47,Transgender,0,1,1
MATIARI DISTRICT,48,Male,2204,757,2961
MATIARI DISTRICT,48,Female,1928,611,2539
MATIARI DISTRICT,48,Transgender,2,0,2
MATIARI DISTRICT,49,Male,2297,746,3043
MATIARI DISTRICT,49,Female,1868,691,2559
MATIARI DISTRICT,49,Transgender,2,0,2
MATIARI DISTRICT,50,Male,2175,721,2896
MATIARI DISTRICT,50,Female,1743,611,2354
MATIARI DISTRICT,50,Transgender,0,0,0
MATIARI DISTRICT,51,Male,1915,694,2609
MATIARI DISTRICT,51,Female,1722,595,2317
MATIARI DISTRICT,51,Transgender,1,0,1
MATIARI DISTRICT,52,Male,1668,587,2255
MATIARI DISTRICT,52,Female,1604,573,2177
MATIARI DISTRICT,52,Transgender,1,0,1
MATIARI DISTRICT,53,Male,1491,594,2085
MATIARI DISTRICT,53,Female,1199,447,1646
MATIARI DISTRICT,53,Transgender,0,0,0
MATIARI DISTRICT,54,Male,1325,528,1853
MATIARI DISTRICT,54,Female,1161,383,1544
MATIARI DISTRICT,54,Transgender,0,0,0
MATIARI DISTRICT,55,Male,1271,479,1750
MATIARI DISTRICT,55,Female,1087,360,1447
MATIARI DISTRICT,55,Transgender,0,0,0
MATIARI DISTRICT,56,Male,1094,415,1509
MATIARI DISTRICT,56,Female,1091,359,1450
MATIARI DISTRICT,56,Transgender,0,0,0
MATIARI DISTRICT,57,Male,1187,414,1601
MATIARI DISTRICT,57,Female,1399,453,1852
MATIARI DISTRICT,57,Transgender,0,0,0
MATIARI DISTRICT,58,Male,1050,408,1458
MATIARI DISTRICT,58,Female,1061,349,1410
MATIARI DISTRICT,58,Transgender,0,0,0
MATIARI DISTRICT,59,Male,1123,447,1570
MATIARI DISTRICT,59,Female,1138,395,1533
MATIARI DISTRICT,59,Transgender,1,0,1
MATIARI DISTRICT,60,Male,1159,363,1522
MATIARI DISTRICT,60,Female,1184,349,1533
MATIARI DISTRICT,60,Transgender,0,0,0
MATIARI DISTRICT,61,Male,976,376,1352
MATIARI DISTRICT,61,Female,1109,373,1482
MATIARI DISTRICT,61,Transgender,1,0,1
MATIARI DISTRICT,62,Male,1030,344,1374
MATIARI DISTRICT,62,Female,1180,400,1580
MATIARI DISTRICT,62,Transgender,0,0,0
MATIARI DISTRICT,63,Male,963,355,1318
MATIARI DISTRICT,63,Female,1024,334,1358
MATIARI DISTRICT,63,Transgender,0,0,0
MATIARI DISTRICT,64,Male,1001,308,1309
MATIARI DISTRICT,64,Female,930,317,1247
MATIARI DISTRICT,64,Transgender,0,1,1
MATIARI DISTRICT,65,Male,971,269,1240
MATIARI DISTRICT,65,Female,806,226,1032
MATIARI DISTRICT,65,Transgender,1,1,2
MATIARI DISTRICT,66,Male,803,275,1078
MATIARI DISTRICT,66,Female,799,218,1017
MATIARI DISTRICT,66,Transgender,0,0,0
MATIARI DISTRICT,67,Male,610,247,857
MATIARI DISTRICT,67,Female,696,215,911
MATIARI DISTRICT,67,Transgender,0,0,0
MATIARI DISTRICT,68,Male,651,213,864
MATIARI DISTRICT,68,Female,636,201,837
MATIARI DISTRICT,68,Transgender,0,0,0
MATIARI DISTRICT,69,Male,633,213,846
MATIARI DISTRICT,69,Female,627,202,829
MATIARI DISTRICT,69,Transgender,1,0,1
MATIARI DISTRICT,70,Male,586,197,783
MATIARI DISTRICT,70,Female,570,172,742
MATIARI DISTRICT,70,Transgender,3,0,3
MATIARI DISTRICT,71,Male,529,162,691
MATIARI DISTRICT,71,Female,533,167,700
MATIARI DISTRICT,71,Transgender,0,0,0
MATIARI DISTRICT,72,Male,366,130,496
MATIARI DISTRICT,72,Female,461,151,612
MATIARI DISTRICT,72,Transgender,1,0,1
MATIARI DISTRICT,73,Male,417,121,538
MATIARI DISTRICT,73,Female,412,117,529
MATIARI DISTRICT,73,Transgender,0,0,0
MATIARI DISTRICT,74,Male,367,117,484
MATIARI DISTRICT,74,Female,397,113,510
MATIARI DISTRICT,74,Transgender,0,0,0
MATIARI DISTRICT,>=75,Male,2463,755,3218
MATIARI DISTRICT,>=75,Female,2923,926,3849
MATIARI DISTRICT,>=75,Transgender,0,0,0
MIANWALI DISTRICT,<1,Male,14697,3709,18406
MIANWALI DISTRICT,<1,Female,13893,3353,17246
MIANWALI DISTRICT,<1,Transgender,0,0,0
MIANWALI DISTRICT,1,Male,15911,3652,19563
MIANWALI DISTRICT,1,Female,14895,3433,18328
MIANWALI DISTRICT,1,Transgender,0,0,0
MIANWALI DISTRICT,2,Male,16228,3990,20218
MIANWALI DISTRICT,2,Female,15488,3818,19306
MIANWALI DISTRICT,2,Transgender,0,0,0
MIANWALI DISTRICT,3,Male,17352,4139,21491
MIANWALI DISTRICT,3,Female,16675,4068,20743
MIANWALI DISTRICT,3,Transgender,0,0,0
MIANWALI DISTRICT,4,Male,17326,4093,21419
MIANWALI DISTRICT,4,Female,16130,3935,20065
MIANWALI DISTRICT,4,Transgender,0,0,0
MIANWALI DISTRICT,5,Male,17054,3988,21042
MIANWALI DISTRICT,5,Female,16479,3895,20374
MIANWALI DISTRICT,5,Transgender,0,0,0
MIANWALI DISTRICT,6,Male,15966,3837,19803
MIANWALI DISTRICT,6,Female,15154,3613,18767
MIANWALI DISTRICT,6,Transgender,0,0,0
MIANWALI DISTRICT,7,Male,17234,4115,21349
MIANWALI DISTRICT,7,Female,15849,3795,19644
MIANWALI DISTRICT,7,Transgender,0,0,0
MIANWALI DISTRICT,8,Male,16012,3618,19630
MIANWALI DISTRICT,8,Female,14772,3374,18146
MIANWALI DISTRICT,8,Transgender,0,0,0
MIANWALI DISTRICT,9,Male,17347,4282,21629
MIANWALI DISTRICT,9,Female,15882,3829,19711
MIANWALI DISTRICT,9,Transgender,0,0,0
MIANWALI DISTRICT,10,Male,14613,3322,17935
MIANWALI DISTRICT,10,Female,13405,3054,16459
MIANWALI DISTRICT,10,Transgender,0,0,0
MIANWALI DISTRICT,11,Male,16388,3925,20313
MIANWALI DISTRICT,11,Female,14702,3622,18324
MIANWALI DISTRICT,11,Transgender,0,0,0
MIANWALI DISTRICT,12,Male,13675,3245,16920
MIANWALI DISTRICT,12,Female,12846,3000,15846
MIANWALI DISTRICT,12,Transgender,0,0,0
MIANWALI DISTRICT,13,Male,14878,3678,18556
MIANWALI DISTRICT,13,Female,13324,3375,16699
MIANWALI DISTRICT,13,Transgender,0,0,0
MIANWALI DISTRICT,14,Male,13772,3333,17105
MIANWALI DISTRICT,14,Female,12533,3079,15612
MIANWALI DISTRICT,14,Transgender,0,0,0
MIANWALI DISTRICT,15,Male,13608,3353,16961
MIANWALI DISTRICT,15,Female,13154,3178,16332
MIANWALI DISTRICT,15,Transgender,1,2,3
MIANWALI DISTRICT,16,Male,13543,3445,16988
MIANWALI DISTRICT,16,Female,12874,3203,16077
MIANWALI DISTRICT,16,Transgender,1,1,2
MIANWALI DISTRICT,17,Male,14283,3800,18083
MIANWALI DISTRICT,17,Female,14719,3765,18484
MIANWALI DISTRICT,17,Transgender,2,3,5
MIANWALI DISTRICT,18,Male,11569,2973,14542
MIANWALI DISTRICT,18,Female,11106,2914,14020
MIANWALI DISTRICT,18,Transgender,5,1,6
MIANWALI DISTRICT,19,Male,13289,3427,16716
MIANWALI DISTRICT,19,Female,12473,3368,15841
MIANWALI DISTRICT,19,Transgender,1,3,4
MIANWALI DISTRICT,20,Male,11106,2989,14095
MIANWALI DISTRICT,20,Female,11218,2842,14060
MIANWALI DISTRICT,20,Transgender,1,1,2
MIANWALI DISTRICT,21,Male,11810,3399,15209
MIANWALI DISTRICT,21,Female,12381,3537,15918
MIANWALI DISTRICT,21,Transgender,1,3,4
MIANWALI DISTRICT,22,Male,10237,2950,13187
MIANWALI DISTRICT,22,Female,10894,3000,13894
MIANWALI DISTRICT,22,Transgender,1,1,2
MIANWALI DISTRICT,23,Male,10834,3357,14191
MIANWALI DISTRICT,23,Female,11146,3286,14432
MIANWALI DISTRICT,23,Transgender,2,0,2
MIANWALI DISTRICT,24,Male,9628,2918,12546
MIANWALI DISTRICT,24,Female,10594,3018,13612
MIANWALI DISTRICT,24,Transgender,3,1,4
MIANWALI DISTRICT,25,Male,8715,2622,11337
MIANWALI DISTRICT,25,Female,9590,2564,12154
MIANWALI DISTRICT,25,Transgender,3,2,5
MIANWALI DISTRICT,26,Male,8998,2908,11906
MIANWALI DISTRICT,26,Female,10559,3053,13612
MIANWALI DISTRICT,26,Transgender,1,3,4
MIANWALI DISTRICT,27,Male,8810,2749,11559
MIANWALI DISTRICT,27,Female,10525,3231,13756
MIANWALI DISTRICT,27,Transgender,1,2,3
MIANWALI DISTRICT,28,Male,8550,2651,11201
MIANWALI DISTRICT,28,Female,9770,2782,12552
MIANWALI DISTRICT,28,Transgender,0,0,0
MIANWALI DISTRICT,29,Male,8523,2786,11309
MIANWALI DISTRICT,29,Female,10505,3031,13536
MIANWALI DISTRICT,29,Transgender,1,2,3
MIANWALI DISTRICT,30,Male,7515,2437,9952
MIANWALI DISTRICT,30,Female,8943,2485,11428
MIANWALI DISTRICT,30,Transgender,3,1,4
MIANWALI DISTRICT,31,Male,7734,2641,10375
MIANWALI DISTRICT,31,Female,9380,2690,12070
MIANWALI DISTRICT,31,Transgender,2,1,3
MIANWALI DISTRICT,32,Male,7342,2528,9870
MIANWALI DISTRICT,32,Female,9007,2615,11622
MIANWALI DISTRICT,32,Transgender,1,2,3
MIANWALI DISTRICT,33,Male,7370,2393,9763
MIANWALI DISTRICT,33,Female,8207,2514,10721
MIANWALI DISTRICT,33,Transgender,2,1,3
MIANWALI DISTRICT,34,Male,7239,2331,9570
MIANWALI DISTRICT,34,Female,8167,2360,10527
MIANWALI DISTRICT,34,Transgender,1,1,2
MIANWALI DISTRICT,35,Male,6544,1962,8506
MIANWALI DISTRICT,35,Female,6967,2081,9048
MIANWALI DISTRICT,35,Transgender,4,1,5
MIANWALI DISTRICT,36,Male,6559,2125,8684
MIANWALI DISTRICT,36,Female,7304,2143,9447
MIANWALI DISTRICT,36,Transgender,1,2,3
MIANWALI DISTRICT,37,Male,5818,1967,7785
MIANWALI DISTRICT,37,Female,7025,2113,9138
MIANWALI DISTRICT,37,Transgender,1,0,1
MIANWALI DISTRICT,38,Male,6594,2257,8851
MIANWALI DISTRICT,38,Female,7023,2128,9151
MIANWALI DISTRICT,38,Transgender,2,0,2
MIANWALI DISTRICT,39,Male,6082,2050,8132
MIANWALI DISTRICT,39,Female,6945,2005,8950
MIANWALI DISTRICT,39,Transgender,0,0,0
MIANWALI DISTRICT,40,Male,5673,1801,7474
MIANWALI DISTRICT,40,Female,6228,1723,7951
MIANWALI DISTRICT,40,Transgender,2,1,3
MIANWALI DISTRICT,41,Male,5518,1804,7322
MIANWALI DISTRICT,41,Female,6025,1741,7766
MIANWALI DISTRICT,41,Transgender,0,1,1
MIANWALI DISTRICT,42,Male,4999,1690,6689
MIANWALI DISTRICT,42,Female,5845,1675,7520
MIANWALI DISTRICT,42,Transgender,0,0,0
MIANWALI DISTRICT,43,Male,5156,1719,6875
MIANWALI DISTRICT,43,Female,5702,1600,7302
MIANWALI DISTRICT,43,Transgender,0,0,0
MIANWALI DISTRICT,44,Male,4960,1664,6624
MIANWALI DISTRICT,44,Female,5318,1527,6845
MIANWALI DISTRICT,44,Transgender,0,0,0
MIANWALI DISTRICT,45,Male,4613,1407,6020
MIANWALI DISTRICT,45,Female,5026,1372,6398
MIANWALI DISTRICT,45,Transgender,3,0,3
MIANWALI DISTRICT,46,Male,4856,1454,6310
MIANWALI DISTRICT,46,Female,4975,1399,6374
MIANWALI DISTRICT,46,Transgender,1,1,2
MIANWALI DISTRICT,47,Male,4381,1355,5736
MIANWALI DISTRICT,47,Female,4740,1339,6079
MIANWALI DISTRICT,47,Transgender,0,1,1
MIANWALI DISTRICT,48,Male,4947,1511,6458
MIANWALI DISTRICT,48,Female,5481,1576,7057
MIANWALI DISTRICT,48,Transgender,1,0,1
MIANWALI DISTRICT,49,Male,4799,1515,6314
MIANWALI DISTRICT,49,Female,5294,1533,6827
MIANWALI DISTRICT,49,Transgender,1,1,2
MIANWALI DISTRICT,50,Male,4645,1349,5994
MIANWALI DISTRICT,50,Female,4887,1329,6216
MIANWALI DISTRICT,50,Transgender,2,1,3
MIANWALI DISTRICT,51,Male,4815,1410,6225
MIANWALI DISTRICT,51,Female,5007,1471,6478
MIANWALI DISTRICT,51,Transgender,0,0,0
MIANWALI DISTRICT,52,Male,4848,1347,6195
MIANWALI DISTRICT,52,Female,4628,1332,5960
MIANWALI DISTRICT,52,Transgender,0,0,0
MIANWALI DISTRICT,53,Male,4912,1472,6384
MIANWALI DISTRICT,53,Female,4877,1355,6232
MIANWALI DISTRICT,53,Transgender,2,0,2
MIANWALI DISTRICT,54,Male,4680,1362,6042
MIANWALI DISTRICT,54,Female,4154,1170,5324
MIANWALI DISTRICT,54,Transgender,1,0,1
MIANWALI DISTRICT,55,Male,4041,1175,5216
MIANWALI DISTRICT,55,Female,3556,1005,4561
MIANWALI DISTRICT,55,Transgender,4,1,5
MIANWALI DISTRICT,56,Male,4021,1113,5134
MIANWALI DISTRICT,56,Female,3470,985,4455
MIANWALI DISTRICT,56,Transgender,0,0,0
MIANWALI DISTRICT,57,Male,3457,1063,4520
MIANWALI DISTRICT,57,Female,3005,857,3862
MIANWALI DISTRICT,57,Transgender,1,0,1
MIANWALI DISTRICT,58,Male,3467,1000,4467
MIANWALI DISTRICT,58,Female,3218,966,4184
MIANWALI DISTRICT,58,Transgender,3,0,3
MIANWALI DISTRICT,59,Male,3056,908,3964
MIANWALI DISTRICT,59,Female,3008,936,3944
MIANWALI DISTRICT,59,Transgender,0,1,1
MIANWALI DISTRICT,60,Male,2847,780,3627
MIANWALI DISTRICT,60,Female,2793,761,3554
MIANWALI DISTRICT,60,Transgender,1,2,3
MIANWALI DISTRICT,61,Male,3107,921,4028
MIANWALI DISTRICT,61,Female,2986,961,3947
MIANWALI DISTRICT,61,Transgender,2,0,2
MIANWALI DISTRICT,62,Male,3019,971,3990
MIANWALI DISTRICT,62,Female,2832,914,3746
MIANWALI DISTRICT,62,Transgender,1,0,1
MIANWALI DISTRICT,63,Male,2964,914,3878
MIANWALI DISTRICT,63,Female,2879,958,3837
MIANWALI DISTRICT,63,Transgender,0,0,0
MIANWALI DISTRICT,64,Male,2630,765,3395
MIANWALI DISTRICT,64,Female,2640,765,3405
MIANWALI DISTRICT,64,Transgender,1,0,1
MIANWALI DISTRICT,65,Male,2385,741,3126
MIANWALI DISTRICT,65,Female,2291,579,2870
MIANWALI DISTRICT,65,Transgender,4,0,4
MIANWALI DISTRICT,66,Male,2157,649,2806
MIANWALI DISTRICT,66,Female,2034,590,2624
MIANWALI DISTRICT,66,Transgender,1,0,1
MIANWALI DISTRICT,67,Male,2142,597,2739
MIANWALI DISTRICT,67,Female,2058,549,2607
MIANWALI DISTRICT,67,Transgender,1,0,1
MIANWALI DISTRICT,68,Male,2348,636,2984
MIANWALI DISTRICT,68,Female,2184,653,2837
MIANWALI DISTRICT,68,Transgender,1,0,1
MIANWALI DISTRICT,69,Male,1991,612,2603
MIANWALI DISTRICT,69,Female,1907,524,2431
MIANWALI DISTRICT,69,Transgender,1,0,1
MIANWALI DISTRICT,70,Male,1769,426,2195
MIANWALI DISTRICT,70,Female,1648,433,2081
MIANWALI DISTRICT,70,Transgender,1,0,1
MIANWALI DISTRICT,71,Male,1800,436,2236
MIANWALI DISTRICT,71,Female,1678,444,2122
MIANWALI DISTRICT,71,Transgender,0,1,1
MIANWALI DISTRICT,72,Male,1585,453,2038
MIANWALI DISTRICT,72,Female,1511,425,1936
MIANWALI DISTRICT,72,Transgender,0,1,1
MIANWALI DISTRICT,73,Male,1643,437,2080
MIANWALI DISTRICT,73,Female,1571,442,2013
MIANWALI DISTRICT,73,Transgender,1,0,1
MIANWALI DISTRICT,74,Male,1235,337,1572
MIANWALI DISTRICT,74,Female,1176,309,1485
MIANWALI DISTRICT,74,Transgender,0,0,0
MIANWALI DISTRICT,>=75,Male,9771,2241,12012
MIANWALI DISTRICT,>=75,Female,9583,2437,12020
MIANWALI DISTRICT,>=75,Transgender,4,3,7
MIRPUR KHAS DISTRICT,<1,Male,13832,4670,18502
MIRPUR KHAS DISTRICT,<1,Female,12957,4357,17314
MIRPUR KHAS DISTRICT,<1,Transgender,0,0,0
MIRPUR KHAS DISTRICT,1,Male,16292,5112,21404
MIRPUR KHAS DISTRICT,1,Female,15695,4915,20610
MIRPUR KHAS DISTRICT,1,Transgender,0,0,0
MIRPUR KHAS DISTRICT,2,Male,18598,5568,24166
MIRPUR KHAS DISTRICT,2,Female,17830,5100,22930
MIRPUR KHAS DISTRICT,2,Transgender,0,0,0
MIRPUR KHAS DISTRICT,3,Male,19837,6061,25898
MIRPUR KHAS DISTRICT,3,Female,19343,5772,25115
MIRPUR KHAS DISTRICT,3,Transgender,0,0,0
MIRPUR KHAS DISTRICT,4,Male,20312,5737,26049
MIRPUR KHAS DISTRICT,4,Female,19373,5394,24767
MIRPUR KHAS DISTRICT,4,Transgender,0,0,0
MIRPUR KHAS DISTRICT,5,Male,20393,6069,26462
MIRPUR KHAS DISTRICT,5,Female,19000,5721,24721
MIRPUR KHAS DISTRICT,5,Transgender,0,0,0
MIRPUR KHAS DISTRICT,6,Male,20562,5785,26347
MIRPUR KHAS DISTRICT,6,Female,18909,5307,24216
MIRPUR KHAS DISTRICT,6,Transgender,0,0,0
MIRPUR KHAS DISTRICT,7,Male,18556,5809,24365
MIRPUR KHAS DISTRICT,7,Female,16602,5543,22145
MIRPUR KHAS DISTRICT,7,Transgender,0,0,0
MIRPUR KHAS DISTRICT,8,Male,21445,5703,27148
MIRPUR KHAS DISTRICT,8,Female,19364,5381,24745
MIRPUR KHAS DISTRICT,8,Transgender,0,0,0
MIRPUR KHAS DISTRICT,9,Male,16068,5637,21705
MIRPUR KHAS DISTRICT,9,Female,14150,5094,19244
MIRPUR KHAS DISTRICT,9,Transgender,0,0,0
MIRPUR KHAS DISTRICT,10,Male,18953,5239,24192
MIRPUR KHAS DISTRICT,10,Female,16723,4837,21560
MIRPUR KHAS DISTRICT,10,Transgender,0,0,0
MIRPUR KHAS DISTRICT,11,Male,13132,5414,18546
MIRPUR KHAS DISTRICT,11,Female,11447,4728,16175
MIRPUR KHAS DISTRICT,11,Transgender,0,0,0
MIRPUR KHAS DISTRICT,12,Male,15537,4955,20492
MIRPUR KHAS DISTRICT,12,Female,12970,4458,17428
MIRPUR KHAS DISTRICT,12,Transgender,0,0,0
MIRPUR KHAS DISTRICT,13,Male,11699,4972,16671
MIRPUR KHAS DISTRICT,13,Female,9581,4447,14028
MIRPUR KHAS DISTRICT,13,Transgender,0,0,0
MIRPUR KHAS DISTRICT,14,Male,11686,4637,16323
MIRPUR KHAS DISTRICT,14,Female,9614,4173,13787
MIRPUR KHAS DISTRICT,14,Transgender,0,0,0
MIRPUR KHAS DISTRICT,15,Male,12545,4957,17502
MIRPUR KHAS DISTRICT,15,Female,9849,4585,14434
MIRPUR KHAS DISTRICT,15,Transgender,2,0,2
MIRPUR KHAS DISTRICT,16,Male,11282,4726,16008
MIRPUR KHAS DISTRICT,16,Female,9214,4479,13693
MIRPUR KHAS DISTRICT,16,Transgender,5,1,6
MIRPUR KHAS DISTRICT,17,Male,10308,5038,15346
MIRPUR KHAS DISTRICT,17,Female,8002,4494,12496
MIRPUR KHAS DISTRICT,17,Transgender,0,1,1
MIRPUR KHAS DISTRICT,18,Male,11417,4494,15911
MIRPUR KHAS DISTRICT,18,Female,11529,4293,15822
MIRPUR KHAS DISTRICT,18,Transgender,4,2,6
MIRPUR KHAS DISTRICT,19,Male,8964,4443,13407
MIRPUR KHAS DISTRICT,19,Female,9403,4462,13865
MIRPUR KHAS DISTRICT,19,Transgender,2,0,2
MIRPUR KHAS DISTRICT,20,Male,11681,4356,16037
MIRPUR KHAS DISTRICT,20,Female,10695,4145,14840
MIRPUR KHAS DISTRICT,20,Transgender,9,3,12
MIRPUR KHAS DISTRICT,21,Male,8189,4270,12459
MIRPUR KHAS DISTRICT,21,Female,7903,4319,12222
MIRPUR KHAS DISTRICT,21,Transgender,2,0,2
MIRPUR KHAS DISTRICT,22,Male,8958,3994,12952
MIRPUR KHAS DISTRICT,22,Female,7905,3865,11770
MIRPUR KHAS DISTRICT,22,Transgender,6,0,6
MIRPUR KHAS DISTRICT,23,Male,7356,3923,11279
MIRPUR KHAS DISTRICT,23,Female,7157,3856,11013
MIRPUR KHAS DISTRICT,23,Transgender,1,1,2
MIRPUR KHAS DISTRICT,24,Male,6886,3830,10716
MIRPUR KHAS DISTRICT,24,Female,6684,3680,10364
MIRPUR KHAS DISTRICT,24,Transgender,6,1,7
MIRPUR KHAS DISTRICT,25,Male,8657,3593,12250
MIRPUR KHAS DISTRICT,25,Female,8152,3505,11657
MIRPUR KHAS DISTRICT,25,Transgender,9,3,12
MIRPUR KHAS DISTRICT,26,Male,7282,3658,10940
MIRPUR KHAS DISTRICT,26,Female,7218,3796,11014
MIRPUR KHAS DISTRICT,26,Transgender,10,3,13
MIRPUR KHAS DISTRICT,27,Male,8234,3769,12003
MIRPUR KHAS DISTRICT,27,Female,8601,3826,12427
MIRPUR KHAS DISTRICT,27,Transgender,4,2,6
MIRPUR KHAS DISTRICT,28,Male,6927,3439,10366
MIRPUR KHAS DISTRICT,28,Female,8186,3649,11835
MIRPUR KHAS DISTRICT,28,Transgender,7,1,8
MIRPUR KHAS DISTRICT,29,Male,8157,3778,11935
MIRPUR KHAS DISTRICT,29,Female,8680,3802,12482
MIRPUR KHAS DISTRICT,29,Transgender,4,2,6
MIRPUR KHAS DISTRICT,30,Male,7419,3208,10627
MIRPUR KHAS DISTRICT,30,Female,7196,3343,10539
MIRPUR KHAS DISTRICT,30,Transgender,11,4,15
MIRPUR KHAS DISTRICT,31,Male,7768,3716,11484
MIRPUR KHAS DISTRICT,31,Female,7995,3570,11565
MIRPUR KHAS DISTRICT,31,Transgender,2,0,2
MIRPUR KHAS DISTRICT,32,Male,7509,3542,11051
MIRPUR KHAS DISTRICT,32,Female,7771,3482,11253
MIRPUR KHAS DISTRICT,32,Transgender,7,1,8
MIRPUR KHAS DISTRICT,33,Male,6615,3422,10037
MIRPUR KHAS DISTRICT,33,Female,6585,3212,9797
MIRPUR KHAS DISTRICT,33,Transgender,2,1,3
MIRPUR KHAS DISTRICT,34,Male,5884,3086,8970
MIRPUR KHAS DISTRICT,34,Female,6223,2896,9119
MIRPUR KHAS DISTRICT,34,Transgender,6,0,6
MIRPUR KHAS DISTRICT,35,Male,6323,2679,9002
MIRPUR KHAS DISTRICT,35,Female,6000,2668,8668
MIRPUR KHAS DISTRICT,35,Transgender,5,3,8
MIRPUR KHAS DISTRICT,36,Male,6039,2889,8928
MIRPUR KHAS DISTRICT,36,Female,5772,2478,8250
MIRPUR KHAS DISTRICT,36,Transgender,3,0,3
MIRPUR KHAS DISTRICT,37,Male,8780,3146,11926
MIRPUR KHAS DISTRICT,37,Female,8047,3068,11115
MIRPUR KHAS DISTRICT,37,Transgender,4,1,5
MIRPUR KHAS DISTRICT,38,Male,5247,2842,8089
MIRPUR KHAS DISTRICT,38,Female,5128,2573,7701
MIRPUR KHAS DISTRICT,38,Transgender,3,0,3
MIRPUR KHAS DISTRICT,39,Male,6584,2943,9527
MIRPUR KHAS DISTRICT,39,Female,6293,2702,8995
MIRPUR KHAS DISTRICT,39,Transgender,2,1,3
MIRPUR KHAS DISTRICT,40,Male,4719,2442,7161
MIRPUR KHAS DISTRICT,40,Female,4207,2133,6340
MIRPUR KHAS DISTRICT,40,Transgender,4,3,7
MIRPUR KHAS DISTRICT,41,Male,4974,2462,7436
MIRPUR KHAS DISTRICT,41,Female,4893,2321,7214
MIRPUR KHAS DISTRICT,41,Transgender,2,0,2
MIRPUR KHAS DISTRICT,42,Male,4742,2323,7065
MIRPUR KHAS DISTRICT,42,Female,5292,2400,7692
MIRPUR KHAS DISTRICT,42,Transgender,0,3,3
MIRPUR KHAS DISTRICT,43,Male,4276,2443,6719
MIRPUR KHAS DISTRICT,43,Female,4010,2088,6098
MIRPUR KHAS DISTRICT,43,Transgender,2,1,3
MIRPUR KHAS DISTRICT,44,Male,4057,2271,6328
MIRPUR KHAS DISTRICT,44,Female,3614,2006,5620
MIRPUR KHAS DISTRICT,44,Transgender,1,0,1
MIRPUR KHAS DISTRICT,45,Male,3737,1851,5588
MIRPUR KHAS DISTRICT,45,Female,3279,1634,4913
MIRPUR KHAS DISTRICT,45,Transgender,3,4,7
MIRPUR KHAS DISTRICT,46,Male,3900,2038,5938
MIRPUR KHAS DISTRICT,46,Female,3273,1675,4948
MIRPUR KHAS DISTRICT,46,Transgender,0,0,0
MIRPUR KHAS DISTRICT,47,Male,4589,2117,6706
MIRPUR KHAS DISTRICT,47,Female,4883,2071,6954
MIRPUR KHAS DISTRICT,47,Transgender,1,3,4
MIRPUR KHAS DISTRICT,48,Male,3480,1959,5439
MIRPUR KHAS DISTRICT,48,Female,3084,1775,4859
MIRPUR KHAS DISTRICT,48,Transgender,3,1,4
MIRPUR KHAS DISTRICT,49,Male,3855,2227,6082
MIRPUR KHAS DISTRICT,49,Female,3500,1934,5434
MIRPUR KHAS DISTRICT,49,Transgender,3,0,3
MIRPUR KHAS DISTRICT,50,Male,3146,1724,4870
MIRPUR KHAS DISTRICT,50,Female,2548,1449,3997
MIRPUR KHAS DISTRICT,50,Transgender,5,1,6
MIRPUR KHAS DISTRICT,51,Male,3368,1886,5254
MIRPUR KHAS DISTRICT,51,Female,2809,1672,4481
MIRPUR KHAS DISTRICT,51,Transgender,1,0,1
MIRPUR KHAS DISTRICT,52,Male,3033,1741,4774
MIRPUR KHAS DISTRICT,52,Female,2838,1558,4396
MIRPUR KHAS DISTRICT,52,Transgender,1,1,2
MIRPUR KHAS DISTRICT,53,Male,2680,1763,4443
MIRPUR KHAS DISTRICT,53,Female,2047,1387,3434
MIRPUR KHAS DISTRICT,53,Transgender,0,1,1
MIRPUR KHAS DISTRICT,54,Male,2396,1542,3938
MIRPUR KHAS DISTRICT,54,Female,1829,1192,3021
MIRPUR KHAS DISTRICT,54,Transgender,0,1,1
MIRPUR KHAS DISTRICT,55,Male,2112,1265,3377
MIRPUR KHAS DISTRICT,55,Female,1833,986,2819
MIRPUR KHAS DISTRICT,55,Transgender,0,2,2
MIRPUR KHAS DISTRICT,56,Male,1795,1155,2950
MIRPUR KHAS DISTRICT,56,Female,1585,926,2511
MIRPUR KHAS DISTRICT,56,Transgender,0,1,1
MIRPUR KHAS DISTRICT,57,Male,2247,1237,3484
MIRPUR KHAS DISTRICT,57,Female,2638,1220,3858
MIRPUR KHAS DISTRICT,57,Transgender,1,0,1
MIRPUR KHAS DISTRICT,58,Male,1752,1074,2826
MIRPUR KHAS DISTRICT,58,Female,1890,952,2842
MIRPUR KHAS DISTRICT,58,Transgender,0,0,0
MIRPUR KHAS DISTRICT,59,Male,1973,1081,3054
MIRPUR KHAS DISTRICT,59,Female,2085,1103,3188
MIRPUR KHAS DISTRICT,59,Transgender,0,0,0
MIRPUR KHAS DISTRICT,60,Male,1766,827,2593
MIRPUR KHAS DISTRICT,60,Female,1755,876,2631
MIRPUR KHAS DISTRICT,60,Transgender,3,1,4
MIRPUR KHAS DISTRICT,61,Male,1737,1061,2798
MIRPUR KHAS DISTRICT,61,Female,1918,1103,3021
MIRPUR KHAS DISTRICT,61,Transgender,0,0,0
MIRPUR KHAS DISTRICT,62,Male,1714,953,2667
MIRPUR KHAS DISTRICT,62,Female,2057,991,3048
MIRPUR KHAS DISTRICT,62,Transgender,0,2,2
MIRPUR KHAS DISTRICT,63,Male,1643,909,2552
MIRPUR KHAS DISTRICT,63,Female,1753,882,2635
MIRPUR KHAS DISTRICT,63,Transgender,1,0,1
MIRPUR KHAS DISTRICT,64,Male,1893,779,2672
MIRPUR KHAS DISTRICT,64,Female,1672,751,2423
MIRPUR KHAS DISTRICT,64,Transgender,1,0,1
MIRPUR KHAS DISTRICT,65,Male,1452,659,2111
MIRPUR KHAS DISTRICT,65,Female,1360,615,1975
MIRPUR KHAS DISTRICT,65,Transgender,1,1,2
MIRPUR KHAS DISTRICT,66,Male,1272,611,1883
MIRPUR KHAS DISTRICT,66,Female,1201,582,1783
MIRPUR KHAS DISTRICT,66,Transgender,1,0,1
MIRPUR KHAS DISTRICT,67,Male,1266,552,1818
MIRPUR KHAS DISTRICT,67,Female,1520,602,2122
MIRPUR KHAS DISTRICT,67,Transgender,0,1,1
MIRPUR KHAS DISTRICT,68,Male,1107,571,1678
MIRPUR KHAS DISTRICT,68,Female,1126,661,1787
MIRPUR KHAS DISTRICT,68,Transgender,0,0,0
MIRPUR KHAS DISTRICT,69,Male,1294,526,1820
MIRPUR KHAS DISTRICT,69,Female,1286,598,1884
MIRPUR KHAS DISTRICT,69,Transgender,0,0,0
MIRPUR KHAS DISTRICT,70,Male,1007,429,1436
MIRPUR KHAS DISTRICT,70,Female,974,412,1386
MIRPUR KHAS DISTRICT,70,Transgender,3,0,3
MIRPUR KHAS DISTRICT,71,Male,933,452,1385
MIRPUR KHAS DISTRICT,71,Female,952,481,1433
MIRPUR KHAS DISTRICT,71,Transgender,0,0,0
MIRPUR KHAS DISTRICT,72,Male,748,405,1153
MIRPUR KHAS DISTRICT,72,Female,883,432,1315
MIRPUR KHAS DISTRICT,72,Transgender,1,0,1
MIRPUR KHAS DISTRICT,73,Male,812,401,1213
MIRPUR KHAS DISTRICT,73,Female,812,434,1246
MIRPUR KHAS DISTRICT,73,Transgender,1,0,1
MIRPUR KHAS DISTRICT,74,Male,744,318,1062
MIRPUR KHAS DISTRICT,74,Female,703,292,995
MIRPUR KHAS DISTRICT,74,Transgender,0,0,0
MIRPUR KHAS DISTRICT,>=75,Male,4696,2155,6851
MIRPUR KHAS DISTRICT,>=75,Female,5513,2534,8047
MIRPUR KHAS DISTRICT,>=75,Transgender,8,2,10
MOHMAND AGENCY,<1,Male,6356,0,6356
MOHMAND AGENCY,<1,Female,5915,0,5915
MOHMAND AGENCY,<1,Transgender,0,0,0
MOHMAND AGENCY,1,Male,7418,0,7418
MOHMAND AGENCY,1,Female,6999,0,6999
MOHMAND AGENCY,1,Transgender,0,0,0
MOHMAND AGENCY,2,Male,8714,0,8714
MOHMAND AGENCY,2,Female,8238,0,8238
MOHMAND AGENCY,2,Transgender,0,0,0
MOHMAND AGENCY,3,Male,8658,0,8658
MOHMAND AGENCY,3,Female,8345,0,8345
MOHMAND AGENCY,3,Transgender,0,0,0
MOHMAND AGENCY,4,Male,9170,0,9170
MOHMAND AGENCY,4,Female,8862,0,8862
MOHMAND AGENCY,4,Transgender,0,0,0
MOHMAND AGENCY,5,Male,8666,0,8666
MOHMAND AGENCY,5,Female,8095,0,8095
MOHMAND AGENCY,5,Transgender,0,0,0
MOHMAND AGENCY,6,Male,9784,0,9784
MOHMAND AGENCY,6,Female,9139,0,9139
MOHMAND AGENCY,6,Transgender,0,0,0
MOHMAND AGENCY,7,Male,8611,0,8611
MOHMAND AGENCY,7,Female,7509,0,7509
MOHMAND AGENCY,7,Transgender,0,0,0
MOHMAND AGENCY,8,Male,10029,0,10029
MOHMAND AGENCY,8,Female,8969,0,8969
MOHMAND AGENCY,8,Transgender,0,0,0
MOHMAND AGENCY,9,Male,8181,0,8181
MOHMAND AGENCY,9,Female,7123,0,7123
MOHMAND AGENCY,9,Transgender,0,0,0
MOHMAND AGENCY,10,Male,8788,0,8788
MOHMAND AGENCY,10,Female,7974,0,7974
MOHMAND AGENCY,10,Transgender,0,0,0
MOHMAND AGENCY,11,Male,6740,0,6740
MOHMAND AGENCY,11,Female,5915,0,5915
MOHMAND AGENCY,11,Transgender,0,0,0
MOHMAND AGENCY,12,Male,7307,0,7307
MOHMAND AGENCY,12,Female,6389,0,6389
MOHMAND AGENCY,12,Transgender,0,0,0
MOHMAND AGENCY,13,Male,6201,0,6201
MOHMAND AGENCY,13,Female,5483,0,5483
MOHMAND AGENCY,13,Transgender,0,0,0
MOHMAND AGENCY,14,Male,6159,0,6159
MOHMAND AGENCY,14,Female,5954,0,5954
MOHMAND AGENCY,14,Transgender,0,0,0
MOHMAND AGENCY,15,Male,5497,0,5497
MOHMAND AGENCY,15,Female,5469,0,5469
MOHMAND AGENCY,15,Transgender,1,0,1
MOHMAND AGENCY,16,Male,4940,0,4940
MOHMAND AGENCY,16,Female,5090,0,5090
MOHMAND AGENCY,16,Transgender,0,0,0
MOHMAND AGENCY,17,Male,3742,0,3742
MOHMAND AGENCY,17,Female,4136,0,4136
MOHMAND AGENCY,17,Transgender,1,0,1
MOHMAND AGENCY,18,Male,5253,0,5253
MOHMAND AGENCY,18,Female,5141,0,5141
MOHMAND AGENCY,18,Transgender,1,0,1
MOHMAND AGENCY,19,Male,4441,0,4441
MOHMAND AGENCY,19,Female,3748,0,3748
MOHMAND AGENCY,19,Transgender,0,0,0
MOHMAND AGENCY,20,Male,5073,0,5073
MOHMAND AGENCY,20,Female,5600,0,5600
MOHMAND AGENCY,20,Transgender,3,0,3
MOHMAND AGENCY,21,Male,3781,0,3781
MOHMAND AGENCY,21,Female,3894,0,3894
MOHMAND AGENCY,21,Transgender,1,0,1
MOHMAND AGENCY,22,Male,4106,0,4106
MOHMAND AGENCY,22,Female,3988,0,3988
MOHMAND AGENCY,22,Transgender,2,0,2
MOHMAND AGENCY,23,Male,3856,0,3856
MOHMAND AGENCY,23,Female,3800,0,3800
MOHMAND AGENCY,23,Transgender,0,0,0
MOHMAND AGENCY,24,Male,3415,0,3415
MOHMAND AGENCY,24,Female,3382,0,3382
MOHMAND AGENCY,24,Transgender,0,0,0
MOHMAND AGENCY,25,Male,4321,0,4321
MOHMAND AGENCY,25,Female,4515,0,4515
MOHMAND AGENCY,25,Transgender,0,0,0
MOHMAND AGENCY,26,Male,3346,0,3346
MOHMAND AGENCY,26,Female,3046,0,3046
MOHMAND AGENCY,26,Transgender,0,0,0
MOHMAND AGENCY,27,Male,3068,0,3068
MOHMAND AGENCY,27,Female,3158,0,3158
MOHMAND AGENCY,27,Transgender,3,0,3
MOHMAND AGENCY,28,Male,3268,0,3268
MOHMAND AGENCY,28,Female,3489,0,3489
MOHMAND AGENCY,28,Transgender,0,0,0
MOHMAND AGENCY,29,Male,2448,0,2448
MOHMAND AGENCY,29,Female,2986,0,2986
MOHMAND AGENCY,29,Transgender,1,0,1
MOHMAND AGENCY,30,Male,3488,0,3488
MOHMAND AGENCY,30,Female,3831,0,3831
MOHMAND AGENCY,30,Transgender,2,0,2
MOHMAND AGENCY,31,Male,2557,0,2557
MOHMAND AGENCY,31,Female,2634,0,2634
MOHMAND AGENCY,31,Transgender,0,0,0
MOHMAND AGENCY,32,Male,2403,0,2403
MOHMAND AGENCY,32,Female,2458,0,2458
MOHMAND AGENCY,32,Transgender,0,0,0
MOHMAND AGENCY,33,Male,2533,0,2533
MOHMAND AGENCY,33,Female,2536,0,2536
MOHMAND AGENCY,33,Transgender,1,0,1
MOHMAND AGENCY,34,Male,1961,0,1961
MOHMAND AGENCY,34,Female,1902,0,1902
MOHMAND AGENCY,34,Transgender,2,0,2
MOHMAND AGENCY,35,Male,2618,0,2618
MOHMAND AGENCY,35,Female,2605,0,2605
MOHMAND AGENCY,35,Transgender,2,0,2
MOHMAND AGENCY,36,Male,1691,0,1691
MOHMAND AGENCY,36,Female,1605,0,1605
MOHMAND AGENCY,36,Transgender,0,0,0
MOHMAND AGENCY,37,Male,1980,0,1980
MOHMAND AGENCY,37,Female,1872,0,1872
MOHMAND AGENCY,37,Transgender,0,0,0
MOHMAND AGENCY,38,Male,1950,0,1950
MOHMAND AGENCY,38,Female,2128,0,2128
MOHMAND AGENCY,38,Transgender,0,0,0
MOHMAND AGENCY,39,Male,1812,0,1812
MOHMAND AGENCY,39,Female,1935,0,1935
MOHMAND AGENCY,39,Transgender,0,0,0
MOHMAND AGENCY,40,Male,2401,0,2401
MOHMAND AGENCY,40,Female,2646,0,2646
MOHMAND AGENCY,40,Transgender,2,0,2
MOHMAND AGENCY,41,Male,1575,0,1575
MOHMAND AGENCY,41,Female,1544,0,1544
MOHMAND AGENCY,41,Transgender,0,0,0
MOHMAND AGENCY,42,Male,1488,0,1488
MOHMAND AGENCY,42,Female,1506,0,1506
MOHMAND AGENCY,42,Transgender,0,0,0
MOHMAND AGENCY,43,Male,1449,0,1449
MOHMAND AGENCY,43,Female,1636,0,1636
MOHMAND AGENCY,43,Transgender,0,0,0
MOHMAND AGENCY,44,Male,1256,0,1256
MOHMAND AGENCY,44,Female,1290,0,1290
MOHMAND AGENCY,44,Transgender,0,0,0
MOHMAND AGENCY,45,Male,1733,0,1733
MOHMAND AGENCY,45,Female,1860,0,1860
MOHMAND AGENCY,45,Transgender,3,0,3
MOHMAND AGENCY,46,Male,1078,0,1078
MOHMAND AGENCY,46,Female,964,0,964
MOHMAND AGENCY,46,Transgender,0,0,0
MOHMAND AGENCY,47,Male,1401,0,1401
MOHMAND AGENCY,47,Female,1425,0,1425
MOHMAND AGENCY,47,Transgender,0,0,0
MOHMAND AGENCY,48,Male,1202,0,1202
MOHMAND AGENCY,48,Female,1409,0,1409
MOHMAND AGENCY,48,Transgender,0,0,0
MOHMAND AGENCY,49,Male,1194,0,1194
MOHMAND AGENCY,49,Female,1237,0,1237
MOHMAND AGENCY,49,Transgender,1,0,1
MOHMAND AGENCY,50,Male,1712,0,1712
MOHMAND AGENCY,50,Female,1999,0,1999
MOHMAND AGENCY,50,Transgender,3,0,3
MOHMAND AGENCY,51,Male,1088,0,1088
MOHMAND AGENCY,51,Female,992,0,992
MOHMAND AGENCY,51,Transgender,1,0,1
MOHMAND AGENCY,52,Male,1087,0,1087
MOHMAND AGENCY,52,Female,1158,0,1158
MOHMAND AGENCY,52,Transgender,2,0,2
MOHMAND AGENCY,53,Male,1153,0,1153
MOHMAND AGENCY,53,Female,1042,0,1042
MOHMAND AGENCY,53,Transgender,0,0,0
MOHMAND AGENCY,54,Male,955,0,955
MOHMAND AGENCY,54,Female,966,0,966
MOHMAND AGENCY,54,Transgender,0,0,0
MOHMAND AGENCY,55,Male,1262,0,1262
MOHMAND AGENCY,55,Female,1334,0,1334
MOHMAND AGENCY,55,Transgender,0,0,0
MOHMAND AGENCY,56,Male,977,0,977
MOHMAND AGENCY,56,Female,775,0,775
MOHMAND AGENCY,56,Transgender,0,0,0
MOHMAND AGENCY,57,Male,1108,0,1108
MOHMAND AGENCY,57,Female,914,0,914
MOHMAND AGENCY,57,Transgender,1,0,1
MOHMAND AGENCY,58,Male,849,0,849
MOHMAND AGENCY,58,Female,797,0,797
MOHMAND AGENCY,58,Transgender,0,0,0
MOHMAND AGENCY,59,Male,882,0,882
MOHMAND AGENCY,59,Female,772,0,772
MOHMAND AGENCY,59,Transgender,0,0,0
MOHMAND AGENCY,60,Male,1099,0,1099
MOHMAND AGENCY,60,Female,1171,0,1171
MOHMAND AGENCY,60,Transgender,2,0,2
MOHMAND AGENCY,61,Male,715,0,715
MOHMAND AGENCY,61,Female,659,0,659
MOHMAND AGENCY,61,Transgender,0,0,0
MOHMAND AGENCY,62,Male,727,0,727
MOHMAND AGENCY,62,Female,694,0,694
MOHMAND AGENCY,62,Transgender,0,0,0
MOHMAND AGENCY,63,Male,719,0,719
MOHMAND AGENCY,63,Female,630,0,630
MOHMAND AGENCY,63,Transgender,0,0,0
MOHMAND AGENCY,64,Male,722,0,722
MOHMAND AGENCY,64,Female,583,0,583
MOHMAND AGENCY,64,Transgender,1,0,1
MOHMAND AGENCY,65,Male,752,0,752
MOHMAND AGENCY,65,Female,697,0,697
MOHMAND AGENCY,65,Transgender,1,0,1
MOHMAND AGENCY,66,Male,480,0,480
MOHMAND AGENCY,66,Female,407,0,407
MOHMAND AGENCY,66,Transgender,0,0,0
MOHMAND AGENCY,67,Male,616,0,616
MOHMAND AGENCY,67,Female,531,0,531
MOHMAND AGENCY,67,Transgender,0,0,0
MOHMAND AGENCY,68,Male,458,0,458
MOHMAND AGENCY,68,Female,393,0,393
MOHMAND AGENCY,68,Transgender,0,0,0
MOHMAND AGENCY,69,Male,488,0,488
MOHMAND AGENCY,69,Female,365,0,365
MOHMAND AGENCY,69,Transgender,0,0,0
MOHMAND AGENCY,70,Male,626,0,626
MOHMAND AGENCY,70,Female,601,0,601
MOHMAND AGENCY,70,Transgender,1,0,1
MOHMAND AGENCY,71,Male,310,0,310
MOHMAND AGENCY,71,Female,315,0,315
MOHMAND AGENCY,71,Transgender,0,0,0
MOHMAND AGENCY,72,Male,361,0,361
MOHMAND AGENCY,72,Female,310,0,310
MOHMAND AGENCY,72,Transgender,0,0,0
MOHMAND AGENCY,73,Male,358,0,358
MOHMAND AGENCY,73,Female,319,0,319
MOHMAND AGENCY,73,Transgender,0,0,0
MOHMAND AGENCY,74,Male,333,0,333
MOHMAND AGENCY,74,Female,291,0,291
MOHMAND AGENCY,74,Transgender,0,0,0
MOHMAND AGENCY,>=75,Male,2605,0,2605
MOHMAND AGENCY,>=75,Female,2666,0,2666
MOHMAND AGENCY,>=75,Transgender,3,0,3
MULTAN DISTRICT,<1,Male,32598,21717,54315
MULTAN DISTRICT,<1,Female,30846,20751,51597
MULTAN DISTRICT,<1,Transgender,0,0,0
MULTAN DISTRICT,1,Male,37607,25023,62630
MULTAN DISTRICT,1,Female,35428,23691,59119
MULTAN DISTRICT,1,Transgender,0,0,0
MULTAN DISTRICT,2,Male,39075,25100,64175
MULTAN DISTRICT,2,Female,37144,24128,61272
MULTAN DISTRICT,2,Transgender,0,0,0
MULTAN DISTRICT,3,Male,42810,27016,69826
MULTAN DISTRICT,3,Female,41178,26523,67701
MULTAN DISTRICT,3,Transgender,0,0,0
MULTAN DISTRICT,4,Male,44229,25625,69854
MULTAN DISTRICT,4,Female,41252,24394,65646
MULTAN DISTRICT,4,Transgender,0,0,0
MULTAN DISTRICT,5,Male,42891,26579,69470
MULTAN DISTRICT,5,Female,40385,25098,65483
MULTAN DISTRICT,5,Transgender,0,0,0
MULTAN DISTRICT,6,Male,41393,25515,66908
MULTAN DISTRICT,6,Female,38408,23890,62298
MULTAN DISTRICT,6,Transgender,0,0,0
MULTAN DISTRICT,7,Male,44358,27751,72109
MULTAN DISTRICT,7,Female,41467,25570,67037
MULTAN DISTRICT,7,Transgender,0,0,0
MULTAN DISTRICT,8,Male,43603,24746,68349
MULTAN DISTRICT,8,Female,39842,22996,62838
MULTAN DISTRICT,8,Transgender,0,0,0
MULTAN DISTRICT,9,Male,42067,27365,69432
MULTAN DISTRICT,9,Female,38374,25081,63455
MULTAN DISTRICT,9,Transgender,0,0,0
MULTAN DISTRICT,10,Male,39528,23137,62665
MULTAN DISTRICT,10,Female,35529,21883,57412
MULTAN DISTRICT,10,Transgender,0,0,0
MULTAN DISTRICT,11,Male,35862,26198,62060
MULTAN DISTRICT,11,Female,32020,24141,56161
MULTAN DISTRICT,11,Transgender,0,0,0
MULTAN DISTRICT,12,Male,35269,22900,58169
MULTAN DISTRICT,12,Female,30696,20865,51561
MULTAN DISTRICT,12,Transgender,0,0,0
MULTAN DISTRICT,13,Male,31492,23435,54927
MULTAN DISTRICT,13,Female,27714,21932,49646
MULTAN DISTRICT,13,Transgender,0,0,0
MULTAN DISTRICT,14,Male,30422,21861,52283
MULTAN DISTRICT,14,Female,27335,20177,47512
MULTAN DISTRICT,14,Transgender,0,0,0
MULTAN DISTRICT,15,Male,29244,22069,51313
MULTAN DISTRICT,15,Female,25850,20536,46386
MULTAN DISTRICT,15,Transgender,9,6,15
MULTAN DISTRICT,16,Male,28192,22027,50219
MULTAN DISTRICT,16,Female,25775,20547,46322
MULTAN DISTRICT,16,Transgender,10,7,17
MULTAN DISTRICT,17,Male,27179,23174,50353
MULTAN DISTRICT,17,Female,23484,21121,44605
MULTAN DISTRICT,17,Transgender,8,5,13
MULTAN DISTRICT,18,Male,28274,21776,50050
MULTAN DISTRICT,18,Female,26771,19873,46644
MULTAN DISTRICT,18,Transgender,10,14,24
MULTAN DISTRICT,19,Male,26933,22518,49451
MULTAN DISTRICT,19,Female,25177,21814,46991
MULTAN DISTRICT,19,Transgender,6,5,11
MULTAN DISTRICT,20,Male,27082,20929,48011
MULTAN DISTRICT,20,Female,27081,19332,46413
MULTAN DISTRICT,20,Transgender,7,12,19
MULTAN DISTRICT,21,Male,23810,21641,45451
MULTAN DISTRICT,21,Female,23382,21253,44635
MULTAN DISTRICT,21,Transgender,3,9,12
MULTAN DISTRICT,22,Male,24315,20811,45126
MULTAN DISTRICT,22,Female,23451,20703,44154
MULTAN DISTRICT,22,Transgender,8,12,20
MULTAN DISTRICT,23,Male,21700,19827,41527
MULTAN DISTRICT,23,Female,20449,19734,40183
MULTAN DISTRICT,23,Transgender,6,5,11
MULTAN DISTRICT,24,Male,19914,19324,39238
MULTAN DISTRICT,24,Female,19137,18784,37921
MULTAN DISTRICT,24,Transgender,6,10,16
MULTAN DISTRICT,25,Male,22138,18495,40633
MULTAN DISTRICT,25,Female,23532,18151,41683
MULTAN DISTRICT,25,Transgender,7,15,22
MULTAN DISTRICT,26,Male,19165,18069,37234
MULTAN DISTRICT,26,Female,20301,18597,38898
MULTAN DISTRICT,26,Transgender,4,12,16
MULTAN DISTRICT,27,Male,19526,18007,37533
MULTAN DISTRICT,27,Female,21038,18545,39583
MULTAN DISTRICT,27,Transgender,8,11,19
MULTAN DISTRICT,28,Male,19518,18122,37640
MULTAN DISTRICT,28,Female,20873,18591,39464
MULTAN DISTRICT,28,Transgender,7,11,18
MULTAN DISTRICT,29,Male,20080,17091,37171
MULTAN DISTRICT,29,Female,22088,17705,39793
MULTAN DISTRICT,29,Transgender,7,6,13
MULTAN DISTRICT,30,Male,19786,17580,37366
MULTAN DISTRICT,30,Female,20189,17443,37632
MULTAN DISTRICT,30,Transgender,15,16,31
MULTAN DISTRICT,31,Male,18125,16265,34390
MULTAN DISTRICT,31,Female,19889,16372,36261
MULTAN DISTRICT,31,Transgender,1,4,5
MULTAN DISTRICT,32,Male,16856,16821,33677
MULTAN DISTRICT,32,Female,18722,16480,35202
MULTAN DISTRICT,32,Transgender,9,5,14
MULTAN DISTRICT,33,Male,15525,15438,30963
MULTAN DISTRICT,33,Female,16863,15143,32006
MULTAN DISTRICT,33,Transgender,4,6,10
MULTAN DISTRICT,34,Male,16100,14317,30417
MULTAN DISTRICT,34,Female,16507,13786,30293
MULTAN DISTRICT,34,Transgender,4,5,9
MULTAN DISTRICT,35,Male,17923,14947,32870
MULTAN DISTRICT,35,Female,16701,14380,31081
MULTAN DISTRICT,35,Transgender,11,10,21
MULTAN DISTRICT,36,Male,17208,13560,30768
MULTAN DISTRICT,36,Female,16720,12729,29449
MULTAN DISTRICT,36,Transgender,4,4,8
MULTAN DISTRICT,37,Male,17472,13305,30777
MULTAN DISTRICT,37,Female,17157,11899,29056
MULTAN DISTRICT,37,Transgender,8,2,10
MULTAN DISTRICT,38,Male,15027,14675,29702
MULTAN DISTRICT,38,Female,14591,13922,28513
MULTAN DISTRICT,38,Transgender,6,3,9
MULTAN DISTRICT,39,Male,15638,13255,28893
MULTAN DISTRICT,39,Female,15417,12380,27797
MULTAN DISTRICT,39,Transgender,4,3,7
MULTAN DISTRICT,40,Male,13797,14354,28151
MULTAN DISTRICT,40,Female,12947,12757,25704
MULTAN DISTRICT,40,Transgender,9,10,19
MULTAN DISTRICT,41,Male,13586,11644,25230
MULTAN DISTRICT,41,Female,13921,10733,24654
MULTAN DISTRICT,41,Transgender,0,2,2
MULTAN DISTRICT,42,Male,13059,11750,24809
MULTAN DISTRICT,42,Female,12926,10415,23341
MULTAN DISTRICT,42,Transgender,7,1,8
MULTAN DISTRICT,43,Male,10741,10850,21591
MULTAN DISTRICT,43,Female,10493,10238,20731
MULTAN DISTRICT,43,Transgender,5,2,7
MULTAN DISTRICT,44,Male,10519,9596,20115
MULTAN DISTRICT,44,Female,10037,9034,19071
MULTAN DISTRICT,44,Transgender,1,1,2
MULTAN DISTRICT,45,Male,10564,10726,21290
MULTAN DISTRICT,45,Female,10006,9603,19609
MULTAN DISTRICT,45,Transgender,9,4,13
MULTAN DISTRICT,46,Male,10064,8412,18476
MULTAN DISTRICT,46,Female,9796,7450,17246
MULTAN DISTRICT,46,Transgender,2,0,2
MULTAN DISTRICT,47,Male,10716,8501,19217
MULTAN DISTRICT,47,Female,10755,7165,17920
MULTAN DISTRICT,47,Transgender,4,2,6
MULTAN DISTRICT,48,Male,9651,8911,18562
MULTAN DISTRICT,48,Female,9459,8615,18074
MULTAN DISTRICT,48,Transgender,6,3,9
MULTAN DISTRICT,49,Male,10190,8747,18937
MULTAN DISTRICT,49,Female,9820,8092,17912
MULTAN DISTRICT,49,Transgender,3,0,3
MULTAN DISTRICT,50,Male,9796,9867,19663
MULTAN DISTRICT,50,Female,9069,8857,17926
MULTAN DISTRICT,50,Transgender,15,7,22
MULTAN DISTRICT,51,Male,9791,8019,17810
MULTAN DISTRICT,51,Female,9194,7231,16425
MULTAN DISTRICT,51,Transgender,2,0,2
MULTAN DISTRICT,52,Male,9919,8297,18216
MULTAN DISTRICT,52,Female,8758,7016,15774
MULTAN DISTRICT,52,Transgender,2,0,2
MULTAN DISTRICT,53,Male,8259,7739,15998
MULTAN DISTRICT,53,Female,7165,7086,14251
MULTAN DISTRICT,53,Transgender,3,3,6
MULTAN DISTRICT,54,Male,7417,7044,14461
MULTAN DISTRICT,54,Female,6540,6183,12723
MULTAN DISTRICT,54,Transgender,1,0,1
MULTAN DISTRICT,55,Male,7445,7436,14881
MULTAN DISTRICT,55,Female,6422,6444,12866
MULTAN DISTRICT,55,Transgender,8,5,13
MULTAN DISTRICT,56,Male,6648,5711,12359
MULTAN DISTRICT,56,Female,5747,4554,10301
MULTAN DISTRICT,56,Transgender,2,0,2
MULTAN DISTRICT,57,Male,6742,5337,12079
MULTAN DISTRICT,57,Female,6166,3921,10087
MULTAN DISTRICT,57,Transgender,3,0,3
MULTAN DISTRICT,58,Male,5312,5371,10683
MULTAN DISTRICT,58,Female,5144,4688,9832
MULTAN DISTRICT,58,Transgender,0,3,3
MULTAN DISTRICT,59,Male,5829,4935,10764
MULTAN DISTRICT,59,Female,5622,4617,10239
MULTAN DISTRICT,59,Transgender,1,0,1
MULTAN DISTRICT,60,Male,5840,5332,11172
MULTAN DISTRICT,60,Female,5655,4810,10465
MULTAN DISTRICT,60,Transgender,3,1,4
MULTAN DISTRICT,61,Male,5494,4809,10303
MULTAN DISTRICT,61,Female,5719,4252,9971
MULTAN DISTRICT,61,Transgender,0,0,0
MULTAN DISTRICT,62,Male,5419,4724,10143
MULTAN DISTRICT,62,Female,5565,3893,9458
MULTAN DISTRICT,62,Transgender,0,2,2
MULTAN DISTRICT,63,Male,4860,4647,9507
MULTAN DISTRICT,63,Female,5078,4322,9400
MULTAN DISTRICT,63,Transgender,0,0,0
MULTAN DISTRICT,64,Male,4822,3757,8579
MULTAN DISTRICT,64,Female,4525,3560,8085
MULTAN DISTRICT,64,Transgender,1,2,3
MULTAN DISTRICT,65,Male,4611,4118,8729
MULTAN DISTRICT,65,Female,4367,3429,7796
MULTAN DISTRICT,65,Transgender,5,3,8
MULTAN DISTRICT,66,Male,4112,2827,6939
MULTAN DISTRICT,66,Female,3836,2285,6121
MULTAN DISTRICT,66,Transgender,6,2,8
MULTAN DISTRICT,67,Male,4135,2740,6875
MULTAN DISTRICT,67,Female,3871,2090,5961
MULTAN DISTRICT,67,Transgender,4,0,4
MULTAN DISTRICT,68,Male,3352,2533,5885
MULTAN DISTRICT,68,Female,3194,2365,5559
MULTAN DISTRICT,68,Transgender,1,1,2
MULTAN DISTRICT,69,Male,3350,2229,5579
MULTAN DISTRICT,69,Female,3265,2228,5493
MULTAN DISTRICT,69,Transgender,1,1,2
MULTAN DISTRICT,70,Male,3356,2459,5815
MULTAN DISTRICT,70,Female,3055,2227,5282
MULTAN DISTRICT,70,Transgender,6,6,12
MULTAN DISTRICT,71,Male,2986,2069,5055
MULTAN DISTRICT,71,Female,2748,1805,4553
MULTAN DISTRICT,71,Transgender,0,0,0
MULTAN DISTRICT,72,Male,2760,1999,4759
MULTAN DISTRICT,72,Female,2554,1711,4265
MULTAN DISTRICT,72,Transgender,2,0,2
MULTAN DISTRICT,73,Male,2296,1856,4152
MULTAN DISTRICT,73,Female,2127,1750,3877
MULTAN DISTRICT,73,Transgender,0,1,1
MULTAN DISTRICT,74,Male,2154,1548,3702
MULTAN DISTRICT,74,Female,1923,1343,3266
MULTAN DISTRICT,74,Transgender,1,0,1
MULTAN DISTRICT,>=75,Male,15869,10895,26764
MULTAN DISTRICT,>=75,Female,15321,11146,26467
MULTAN DISTRICT,>=75,Transgender,13,5,18
MUSAKHEL,<1,Male,3588,286,3874
MUSAKHEL,<1,Female,3037,244,3281
MUSAKHEL,<1,Transgender,0,0,0
MUSAKHEL,1,Male,3212,329,3541
MUSAKHEL,1,Female,2679,343,3022
MUSAKHEL,1,Transgender,0,0,0
MUSAKHEL,2,Male,3651,354,4005
MUSAKHEL,2,Female,3137,368,3505
MUSAKHEL,2,Transgender,0,0,0
MUSAKHEL,3,Male,3576,369,3945
MUSAKHEL,3,Female,3099,295,3394
MUSAKHEL,3,Transgender,0,0,0
MUSAKHEL,4,Male,3674,358,4032
MUSAKHEL,4,Female,3120,341,3461
MUSAKHEL,4,Transgender,0,0,0
MUSAKHEL,5,Male,3493,338,3831
MUSAKHEL,5,Female,2912,247,3159
MUSAKHEL,5,Transgender,0,0,0
MUSAKHEL,6,Male,3679,366,4045
MUSAKHEL,6,Female,2805,295,3100
MUSAKHEL,6,Transgender,0,0,0
MUSAKHEL,7,Male,3457,289,3746
MUSAKHEL,7,Female,2673,244,2917
MUSAKHEL,7,Transgender,0,0,0
MUSAKHEL,8,Male,3352,343,3695
MUSAKHEL,8,Female,2534,265,2799
MUSAKHEL,8,Transgender,0,0,0
MUSAKHEL,9,Male,3303,288,3591
MUSAKHEL,9,Female,2518,217,2735
MUSAKHEL,9,Transgender,0,0,0
MUSAKHEL,10,Male,2812,241,3053
MUSAKHEL,10,Female,2067,203,2270
MUSAKHEL,10,Transgender,0,0,0
MUSAKHEL,11,Male,2627,197,2824
MUSAKHEL,11,Female,1862,152,2014
MUSAKHEL,11,Transgender,0,0,0
MUSAKHEL,12,Male,2172,182,2354
MUSAKHEL,12,Female,1446,152,1598
MUSAKHEL,12,Transgender,0,0,0
MUSAKHEL,13,Male,2227,192,2419
MUSAKHEL,13,Female,1341,99,1440
MUSAKHEL,13,Transgender,0,0,0
MUSAKHEL,14,Male,1909,169,2078
MUSAKHEL,14,Female,1129,102,1231
MUSAKHEL,14,Transgender,0,0,0
MUSAKHEL,15,Male,1970,169,2139
MUSAKHEL,15,Female,1020,90,1110
MUSAKHEL,15,Transgender,0,0,0
MUSAKHEL,16,Male,1645,108,1753
MUSAKHEL,16,Female,905,112,1017
MUSAKHEL,16,Transgender,0,0,0
MUSAKHEL,17,Male,1706,131,1837
MUSAKHEL,17,Female,881,128,1009
MUSAKHEL,17,Transgender,2,0,2
MUSAKHEL,18,Male,1374,111,1485
MUSAKHEL,18,Female,1123,110,1233
MUSAKHEL,18,Transgender,0,0,0
MUSAKHEL,19,Male,1245,107,1352
MUSAKHEL,19,Female,1129,120,1249
MUSAKHEL,19,Transgender,0,0,0
MUSAKHEL,20,Male,1003,83,1086
MUSAKHEL,20,Female,1079,101,1180
MUSAKHEL,20,Transgender,0,0,0
MUSAKHEL,21,Male,1036,107,1143
MUSAKHEL,21,Female,1125,94,1219
MUSAKHEL,21,Transgender,0,0,0
MUSAKHEL,22,Male,970,76,1046
MUSAKHEL,22,Female,913,77,990
MUSAKHEL,22,Transgender,0,0,0
MUSAKHEL,23,Male,922,98,1020
MUSAKHEL,23,Female,950,80,1030
MUSAKHEL,23,Transgender,0,0,0
MUSAKHEL,24,Male,881,93,974
MUSAKHEL,24,Female,797,71,868
MUSAKHEL,24,Transgender,0,0,0
MUSAKHEL,25,Male,809,52,861
MUSAKHEL,25,Female,1005,85,1090
MUSAKHEL,25,Transgender,0,0,0
MUSAKHEL,26,Male,892,75,967
MUSAKHEL,26,Female,1143,119,1262
MUSAKHEL,26,Transgender,0,0,0
MUSAKHEL,27,Male,885,62,947
MUSAKHEL,27,Female,1174,105,1279
MUSAKHEL,27,Transgender,0,0,0
MUSAKHEL,28,Male,930,103,1033
MUSAKHEL,28,Female,1002,97,1099
MUSAKHEL,28,Transgender,0,0,0
MUSAKHEL,29,Male,1011,80,1091
MUSAKHEL,29,Female,987,102,1089
MUSAKHEL,29,Transgender,0,0,0
MUSAKHEL,30,Male,781,70,851
MUSAKHEL,30,Female,846,56,902
MUSAKHEL,30,Transgender,1,0,1
MUSAKHEL,31,Male,936,79,1015
MUSAKHEL,31,Female,991,90,1081
MUSAKHEL,31,Transgender,0,0,0
MUSAKHEL,32,Male,750,83,833
MUSAKHEL,32,Female,763,76,839
MUSAKHEL,32,Transgender,0,0,0
MUSAKHEL,33,Male,696,61,757
MUSAKHEL,33,Female,691,60,751
MUSAKHEL,33,Transgender,1,0,1
MUSAKHEL,34,Male,633,66,699
MUSAKHEL,34,Female,625,52,677
MUSAKHEL,34,Transgender,0,0,0
MUSAKHEL,35,Male,591,46,637
MUSAKHEL,35,Female,578,53,631
MUSAKHEL,35,Transgender,0,0,0
MUSAKHEL,36,Male,800,58,858
MUSAKHEL,36,Female,815,61,876
MUSAKHEL,36,Transgender,0,0,0
MUSAKHEL,37,Male,786,59,845
MUSAKHEL,37,Female,720,83,803
MUSAKHEL,37,Transgender,0,0,0
MUSAKHEL,38,Male,722,68,790
MUSAKHEL,38,Female,642,56,698
MUSAKHEL,38,Transgender,0,0,0
MUSAKHEL,39,Male,738,56,794
MUSAKHEL,39,Female,640,55,695
MUSAKHEL,39,Transgender,0,1,1
MUSAKHEL,40,Male,478,28,506
MUSAKHEL,40,Female,621,50,671
MUSAKHEL,40,Transgender,0,0,0
MUSAKHEL,41,Male,654,58,712
MUSAKHEL,41,Female,700,80,780
MUSAKHEL,41,Transgender,0,0,0
MUSAKHEL,42,Male,552,63,615
MUSAKHEL,42,Female,535,53,588
MUSAKHEL,42,Transgender,1,0,1
MUSAKHEL,43,Male,450,42,492
MUSAKHEL,43,Female,444,40,484
MUSAKHEL,43,Transgender,0,0,0
MUSAKHEL,44,Male,508,57,565
MUSAKHEL,44,Female,440,45,485
MUSAKHEL,44,Transgender,0,0,0
MUSAKHEL,45,Male,426,37,463
MUSAKHEL,45,Female,419,28,447
MUSAKHEL,45,Transgender,1,0,1
MUSAKHEL,46,Male,646,50,696
MUSAKHEL,46,Female,557,54,611
MUSAKHEL,46,Transgender,0,0,0
MUSAKHEL,47,Male,667,50,717
MUSAKHEL,47,Female,517,41,558
MUSAKHEL,47,Transgender,0,0,0
MUSAKHEL,48,Male,480,61,541
MUSAKHEL,48,Female,339,36,375
MUSAKHEL,48,Transgender,0,0,0
MUSAKHEL,49,Male,457,43,500
MUSAKHEL,49,Female,348,38,386
MUSAKHEL,49,Transgender,1,0,1
MUSAKHEL,50,Male,322,19,341
MUSAKHEL,50,Female,348,29,377
MUSAKHEL,50,Transgender,0,0,0
MUSAKHEL,51,Male,448,44,492
MUSAKHEL,51,Female,407,28,435
MUSAKHEL,51,Transgender,0,0,0
MUSAKHEL,52,Male,338,27,365
MUSAKHEL,52,Female,293,25,318
MUSAKHEL,52,Transgender,0,0,0
MUSAKHEL,53,Male,319,37,356
MUSAKHEL,53,Female,231,25,256
MUSAKHEL,53,Transgender,0,0,0
MUSAKHEL,54,Male,244,38,282
MUSAKHEL,54,Female,236,24,260
MUSAKHEL,54,Transgender,0,0,0
MUSAKHEL,55,Male,218,14,232
MUSAKHEL,55,Female,234,17,251
MUSAKHEL,55,Transgender,1,0,1
MUSAKHEL,56,Male,278,17,295
MUSAKHEL,56,Female,327,28,355
MUSAKHEL,56,Transgender,0,0,0
MUSAKHEL,57,Male,312,29,341
MUSAKHEL,57,Female,282,36,318
MUSAKHEL,57,Transgender,0,0,0
MUSAKHEL,58,Male,248,26,274
MUSAKHEL,58,Female,230,18,248
MUSAKHEL,58,Transgender,0,0,0
MUSAKHEL,59,Male,286,29,315
MUSAKHEL,59,Female,232,23,255
MUSAKHEL,59,Transgender,0,0,0
MUSAKHEL,60,Male,231,20,251
MUSAKHEL,60,Female,206,18,224
MUSAKHEL,60,Transgender,0,0,0
MUSAKHEL,61,Male,255,18,273
MUSAKHEL,61,Female,246,26,272
MUSAKHEL,61,Transgender,0,0,0
MUSAKHEL,62,Male,228,16,244
MUSAKHEL,62,Female,243,10,253
MUSAKHEL,62,Transgender,0,0,0
MUSAKHEL,63,Male,232,18,250
MUSAKHEL,63,Female,170,14,184
MUSAKHEL,63,Transgender,0,0,0
MUSAKHEL,64,Male,266,16,282
MUSAKHEL,64,Female,192,16,208
MUSAKHEL,64,Transgender,0,0,0
MUSAKHEL,65,Male,164,20,184
MUSAKHEL,65,Female,155,11,166
MUSAKHEL,65,Transgender,0,0,0
MUSAKHEL,66,Male,181,26,207
MUSAKHEL,66,Female,251,25,276
MUSAKHEL,66,Transgender,0,0,0
MUSAKHEL,67,Male,175,12,187
MUSAKHEL,67,Female,210,23,233
MUSAKHEL,67,Transgender,0,0,0
MUSAKHEL,68,Male,177,15,192
MUSAKHEL,68,Female,156,14,170
MUSAKHEL,68,Transgender,0,0,0
MUSAKHEL,69,Male,213,13,226
MUSAKHEL,69,Female,155,11,166
MUSAKHEL,69,Transgender,0,0,0
MUSAKHEL,70,Male,137,13,150
MUSAKHEL,70,Female,105,5,110
MUSAKHEL,70,Transgender,0,0,0
MUSAKHEL,71,Male,134,10,144
MUSAKHEL,71,Female,113,6,119
MUSAKHEL,71,Transgender,0,0,0
MUSAKHEL,72,Male,110,8,118
MUSAKHEL,72,Female,88,10,98
MUSAKHEL,72,Transgender,0,0,0
MUSAKHEL,73,Male,116,10,126
MUSAKHEL,73,Female,83,7,90
MUSAKHEL,73,Transgender,0,0,0
MUSAKHEL,74,Male,129,6,135
MUSAKHEL,74,Female,80,3,83
MUSAKHEL,74,Transgender,0,0,0
MUSAKHEL,>=75,Male,769,49,818
MUSAKHEL,>=75,Female,709,76,785
MUSAKHEL,>=75,Transgender,3,0,3
MUZAFFARGARH DISTRICT,<1,Male,50557,8781,59338
MUZAFFARGARH DISTRICT,<1,Female,47974,8187,56161
MUZAFFARGARH DISTRICT,<1,Transgender,0,0,0
MUZAFFARGARH DISTRICT,1,Male,53145,9520,62665
MUZAFFARGARH DISTRICT,1,Female,50934,9074,60008
MUZAFFARGARH DISTRICT,1,Transgender,0,0,0
MUZAFFARGARH DISTRICT,2,Male,59639,9808,69447
MUZAFFARGARH DISTRICT,2,Female,57258,9383,66641
MUZAFFARGARH DISTRICT,2,Transgender,0,0,0
MUZAFFARGARH DISTRICT,3,Male,64306,10370,74676
MUZAFFARGARH DISTRICT,3,Female,62316,10063,72379
MUZAFFARGARH DISTRICT,3,Transgender,0,0,0
MUZAFFARGARH DISTRICT,4,Male,67871,10419,78290
MUZAFFARGARH DISTRICT,4,Female,64391,9904,74295
MUZAFFARGARH DISTRICT,4,Transgender,0,0,0
MUZAFFARGARH DISTRICT,5,Male,64574,10481,75055
MUZAFFARGARH DISTRICT,5,Female,59895,9927,69822
MUZAFFARGARH DISTRICT,5,Transgender,0,0,0
MUZAFFARGARH DISTRICT,6,Male,63489,9986,73475
MUZAFFARGARH DISTRICT,6,Female,58891,9133,68024
MUZAFFARGARH DISTRICT,6,Transgender,0,0,0
MUZAFFARGARH DISTRICT,7,Male,67952,10893,78845
MUZAFFARGARH DISTRICT,7,Female,62344,10049,72393
MUZAFFARGARH DISTRICT,7,Transgender,0,0,0
MUZAFFARGARH DISTRICT,8,Male,69006,10188,79194
MUZAFFARGARH DISTRICT,8,Female,62011,9301,71312
MUZAFFARGARH DISTRICT,8,Transgender,0,0,0
MUZAFFARGARH DISTRICT,9,Male,61523,10349,71872
MUZAFFARGARH DISTRICT,9,Female,55137,9461,64598
MUZAFFARGARH DISTRICT,9,Transgender,0,0,0
MUZAFFARGARH DISTRICT,10,Male,61460,9569,71029
MUZAFFARGARH DISTRICT,10,Female,54555,8373,62928
MUZAFFARGARH DISTRICT,10,Transgender,0,0,0
MUZAFFARGARH DISTRICT,11,Male,49981,9528,59509
MUZAFFARGARH DISTRICT,11,Female,43812,8683,52495
MUZAFFARGARH DISTRICT,11,Transgender,0,0,0
MUZAFFARGARH DISTRICT,12,Male,52857,8869,61726
MUZAFFARGARH DISTRICT,12,Female,46075,7985,54060
MUZAFFARGARH DISTRICT,12,Transgender,0,0,0
MUZAFFARGARH DISTRICT,13,Male,44367,8826,53193
MUZAFFARGARH DISTRICT,13,Female,37792,7879,45671
MUZAFFARGARH DISTRICT,13,Transgender,0,0,0
MUZAFFARGARH DISTRICT,14,Male,44439,8126,52565
MUZAFFARGARH DISTRICT,14,Female,39584,7307,46891
MUZAFFARGARH DISTRICT,14,Transgender,0,0,0
MUZAFFARGARH DISTRICT,15,Male,40878,8035,48913
MUZAFFARGARH DISTRICT,15,Female,34604,7323,41927
MUZAFFARGARH DISTRICT,15,Transgender,5,0,5
MUZAFFARGARH DISTRICT,16,Male,39294,7765,47059
MUZAFFARGARH DISTRICT,16,Female,35843,7194,43037
MUZAFFARGARH DISTRICT,16,Transgender,8,4,12
MUZAFFARGARH DISTRICT,17,Male,36229,7816,44045
MUZAFFARGARH DISTRICT,17,Female,31831,7368,39199
MUZAFFARGARH DISTRICT,17,Transgender,2,10,12
MUZAFFARGARH DISTRICT,18,Male,40962,7520,48482
MUZAFFARGARH DISTRICT,18,Female,38731,7120,45851
MUZAFFARGARH DISTRICT,18,Transgender,8,5,13
MUZAFFARGARH DISTRICT,19,Male,34298,7408,41706
MUZAFFARGARH DISTRICT,19,Female,32070,7302,39372
MUZAFFARGARH DISTRICT,19,Transgender,2,5,7
MUZAFFARGARH DISTRICT,20,Male,35980,7035,43015
MUZAFFARGARH DISTRICT,20,Female,36527,6880,43407
MUZAFFARGARH DISTRICT,20,Transgender,11,0,11
MUZAFFARGARH DISTRICT,21,Male,27918,6670,34588
MUZAFFARGARH DISTRICT,21,Female,27612,6726,34338
MUZAFFARGARH DISTRICT,21,Transgender,3,1,4
MUZAFFARGARH DISTRICT,22,Male,29425,6231,35656
MUZAFFARGARH DISTRICT,22,Female,28353,6448,34801
MUZAFFARGARH DISTRICT,22,Transgender,6,1,7
MUZAFFARGARH DISTRICT,23,Male,25803,6091,31894
MUZAFFARGARH DISTRICT,23,Female,24897,6185,31082
MUZAFFARGARH DISTRICT,23,Transgender,3,0,3
MUZAFFARGARH DISTRICT,24,Male,25155,5729,30884
MUZAFFARGARH DISTRICT,24,Female,24052,5762,29814
MUZAFFARGARH DISTRICT,24,Transgender,6,2,8
MUZAFFARGARH DISTRICT,25,Male,29008,5975,34983
MUZAFFARGARH DISTRICT,25,Female,29310,5721,35031
MUZAFFARGARH DISTRICT,25,Transgender,14,1,15
MUZAFFARGARH DISTRICT,26,Male,24256,5532,29788
MUZAFFARGARH DISTRICT,26,Female,23727,5700,29427
MUZAFFARGARH DISTRICT,26,Transgender,6,2,8
MUZAFFARGARH DISTRICT,27,Male,24393,5491,29884
MUZAFFARGARH DISTRICT,27,Female,24663,5763,30426
MUZAFFARGARH DISTRICT,27,Transgender,3,1,4
MUZAFFARGARH DISTRICT,28,Male,24593,5445,30038
MUZAFFARGARH DISTRICT,28,Female,25490,5629,31119
MUZAFFARGARH DISTRICT,28,Transgender,1,3,4
MUZAFFARGARH DISTRICT,29,Male,24495,5523,30018
MUZAFFARGARH DISTRICT,29,Female,26027,5538,31565
MUZAFFARGARH DISTRICT,29,Transgender,1,1,2
MUZAFFARGARH DISTRICT,30,Male,24785,5126,29911
MUZAFFARGARH DISTRICT,30,Female,25590,5142,30732
MUZAFFARGARH DISTRICT,30,Transgender,14,4,18
MUZAFFARGARH DISTRICT,31,Male,22774,4893,27667
MUZAFFARGARH DISTRICT,31,Female,24946,5309,30255
MUZAFFARGARH DISTRICT,31,Transgender,2,1,3
MUZAFFARGARH DISTRICT,32,Male,21503,4846,26349
MUZAFFARGARH DISTRICT,32,Female,23502,5008,28510
MUZAFFARGARH DISTRICT,32,Transgender,5,0,5
MUZAFFARGARH DISTRICT,33,Male,19100,4465,23565
MUZAFFARGARH DISTRICT,33,Female,21313,4524,25837
MUZAFFARGARH DISTRICT,33,Transgender,3,1,4
MUZAFFARGARH DISTRICT,34,Male,19389,4474,23863
MUZAFFARGARH DISTRICT,34,Female,21427,4312,25739
MUZAFFARGARH DISTRICT,34,Transgender,3,0,3
MUZAFFARGARH DISTRICT,35,Male,22076,4365,26441
MUZAFFARGARH DISTRICT,35,Female,21443,4116,25559
MUZAFFARGARH DISTRICT,35,Transgender,10,1,11
MUZAFFARGARH DISTRICT,36,Male,22449,4626,27075
MUZAFFARGARH DISTRICT,36,Female,20982,4465,25447
MUZAFFARGARH DISTRICT,36,Transgender,1,1,2
MUZAFFARGARH DISTRICT,37,Male,22463,4164,26627
MUZAFFARGARH DISTRICT,37,Female,21608,4053,25661
MUZAFFARGARH DISTRICT,37,Transgender,5,2,7
MUZAFFARGARH DISTRICT,38,Male,18207,4351,22558
MUZAFFARGARH DISTRICT,38,Female,17858,4048,21906
MUZAFFARGARH DISTRICT,38,Transgender,6,1,7
MUZAFFARGARH DISTRICT,39,Male,18974,3909,22883
MUZAFFARGARH DISTRICT,39,Female,18804,3703,22507
MUZAFFARGARH DISTRICT,39,Transgender,2,0,2
MUZAFFARGARH DISTRICT,40,Male,16130,3620,19750
MUZAFFARGARH DISTRICT,40,Female,16113,3412,19525
MUZAFFARGARH DISTRICT,40,Transgender,8,0,8
MUZAFFARGARH DISTRICT,41,Male,16052,3654,19706
MUZAFFARGARH DISTRICT,41,Female,16543,3574,20117
MUZAFFARGARH DISTRICT,41,Transgender,1,0,1
MUZAFFARGARH DISTRICT,42,Male,15422,3383,18805
MUZAFFARGARH DISTRICT,42,Female,15551,3177,18728
MUZAFFARGARH DISTRICT,42,Transgender,7,0,7
MUZAFFARGARH DISTRICT,43,Male,12517,3128,15645
MUZAFFARGARH DISTRICT,43,Female,12265,2917,15182
MUZAFFARGARH DISTRICT,43,Transgender,2,3,5
MUZAFFARGARH DISTRICT,44,Male,11864,2976,14840
MUZAFFARGARH DISTRICT,44,Female,11631,2845,14476
MUZAFFARGARH DISTRICT,44,Transgender,1,1,2
MUZAFFARGARH DISTRICT,45,Male,12408,2810,15218
MUZAFFARGARH DISTRICT,45,Female,11977,2603,14580
MUZAFFARGARH DISTRICT,45,Transgender,2,3,5
MUZAFFARGARH DISTRICT,46,Male,11900,2889,14789
MUZAFFARGARH DISTRICT,46,Female,11658,2677,14335
MUZAFFARGARH DISTRICT,46,Transgender,5,1,6
MUZAFFARGARH DISTRICT,47,Male,12842,2757,15599
MUZAFFARGARH DISTRICT,47,Female,12419,2376,14795
MUZAFFARGARH DISTRICT,47,Transgender,1,4,5
MUZAFFARGARH DISTRICT,48,Male,11543,2762,14305
MUZAFFARGARH DISTRICT,48,Female,11052,2609,13661
MUZAFFARGARH DISTRICT,48,Transgender,1,3,4
MUZAFFARGARH DISTRICT,49,Male,11792,2754,14546
MUZAFFARGARH DISTRICT,49,Female,11105,2518,13623
MUZAFFARGARH DISTRICT,49,Transgender,2,1,3
MUZAFFARGARH DISTRICT,50,Male,11565,2633,14198
MUZAFFARGARH DISTRICT,50,Female,10683,2438,13121
MUZAFFARGARH DISTRICT,50,Transgender,7,5,12
MUZAFFARGARH DISTRICT,51,Male,11068,2649,13717
MUZAFFARGARH DISTRICT,51,Female,10252,2425,12677
MUZAFFARGARH DISTRICT,51,Transgender,1,0,1
MUZAFFARGARH DISTRICT,52,Male,10853,2439,13292
MUZAFFARGARH DISTRICT,52,Female,10023,2117,12140
MUZAFFARGARH DISTRICT,52,Transgender,7,1,8
MUZAFFARGARH DISTRICT,53,Male,9788,2414,12202
MUZAFFARGARH DISTRICT,53,Female,8246,2074,10320
MUZAFFARGARH DISTRICT,53,Transgender,1,1,2
MUZAFFARGARH DISTRICT,54,Male,9219,2263,11482
MUZAFFARGARH DISTRICT,54,Female,7510,1868,9378
MUZAFFARGARH DISTRICT,54,Transgender,3,3,6
MUZAFFARGARH DISTRICT,55,Male,8431,2008,10439
MUZAFFARGARH DISTRICT,55,Female,7125,1620,8745
MUZAFFARGARH DISTRICT,55,Transgender,5,2,7
MUZAFFARGARH DISTRICT,56,Male,7634,1828,9462
MUZAFFARGARH DISTRICT,56,Female,6306,1467,7773
MUZAFFARGARH DISTRICT,56,Transgender,4,0,4
MUZAFFARGARH DISTRICT,57,Male,7509,1609,9118
MUZAFFARGARH DISTRICT,57,Female,6564,1200,7764
MUZAFFARGARH DISTRICT,57,Transgender,2,0,2
MUZAFFARGARH DISTRICT,58,Male,5923,1511,7434
MUZAFFARGARH DISTRICT,58,Female,6039,1385,7424
MUZAFFARGARH DISTRICT,58,Transgender,2,0,2
MUZAFFARGARH DISTRICT,59,Male,6361,1467,7828
MUZAFFARGARH DISTRICT,59,Female,6262,1323,7585
MUZAFFARGARH DISTRICT,59,Transgender,0,0,0
MUZAFFARGARH DISTRICT,60,Male,6683,1348,8031
MUZAFFARGARH DISTRICT,60,Female,7131,1436,8567
MUZAFFARGARH DISTRICT,60,Transgender,5,1,6
MUZAFFARGARH DISTRICT,61,Male,6046,1352,7398
MUZAFFARGARH DISTRICT,61,Female,6722,1346,8068
MUZAFFARGARH DISTRICT,61,Transgender,0,0,0
MUZAFFARGARH DISTRICT,62,Male,6205,1322,7527
MUZAFFARGARH DISTRICT,62,Female,6657,1322,7979
MUZAFFARGARH DISTRICT,62,Transgender,2,0,2
MUZAFFARGARH DISTRICT,63,Male,5651,1251,6902
MUZAFFARGARH DISTRICT,63,Female,6088,1337,7425
MUZAFFARGARH DISTRICT,63,Transgender,1,5,6
MUZAFFARGARH DISTRICT,64,Male,5675,1188,6863
MUZAFFARGARH DISTRICT,64,Female,5861,1113,6974
MUZAFFARGARH DISTRICT,64,Transgender,2,0,2
MUZAFFARGARH DISTRICT,65,Male,5616,1036,6652
MUZAFFARGARH DISTRICT,65,Female,5675,1028,6703
MUZAFFARGARH DISTRICT,65,Transgender,3,2,5
MUZAFFARGARH DISTRICT,66,Male,4872,875,5747
MUZAFFARGARH DISTRICT,66,Female,4639,895,5534
MUZAFFARGARH DISTRICT,66,Transgender,1,0,1
MUZAFFARGARH DISTRICT,67,Male,5049,875,5924
MUZAFFARGARH DISTRICT,67,Female,4858,819,5677
MUZAFFARGARH DISTRICT,67,Transgender,1,0,1
MUZAFFARGARH DISTRICT,68,Male,4400,850,5250
MUZAFFARGARH DISTRICT,68,Female,4088,817,4905
MUZAFFARGARH DISTRICT,68,Transgender,0,0,0
MUZAFFARGARH DISTRICT,69,Male,4233,730,4963
MUZAFFARGARH DISTRICT,69,Female,3948,708,4656
MUZAFFARGARH DISTRICT,69,Transgender,3,0,3
MUZAFFARGARH DISTRICT,70,Male,4482,721,5203
MUZAFFARGARH DISTRICT,70,Female,4079,681,4760
MUZAFFARGARH DISTRICT,70,Transgender,2,0,2
MUZAFFARGARH DISTRICT,71,Male,3896,636,4532
MUZAFFARGARH DISTRICT,71,Female,3514,692,4206
MUZAFFARGARH DISTRICT,71,Transgender,0,1,1
MUZAFFARGARH DISTRICT,72,Male,3694,672,4366
MUZAFFARGARH DISTRICT,72,Female,3121,602,3723
MUZAFFARGARH DISTRICT,72,Transgender,2,0,2
MUZAFFARGARH DISTRICT,73,Male,3254,590,3844
MUZAFFARGARH DISTRICT,73,Female,2781,596,3377
MUZAFFARGARH DISTRICT,73,Transgender,0,0,0
MUZAFFARGARH DISTRICT,74,Male,2761,496,3257
MUZAFFARGARH DISTRICT,74,Female,2396,456,2852
MUZAFFARGARH DISTRICT,74,Transgender,0,0,0
MUZAFFARGARH DISTRICT,>=75,Male,21982,3498,25480
MUZAFFARGARH DISTRICT,>=75,Female,19950,3613,23563
MUZAFFARGARH DISTRICT,>=75,Transgender,20,1,21
NANKANA SAHIB DISTRICT,<1,Male,13057,2771,15828
NANKANA SAHIB DISTRICT,<1,Female,12369,2626,14995
NANKANA SAHIB DISTRICT,<1,Transgender,0,0,0
NANKANA SAHIB DISTRICT,1,Male,14200,2986,17186
NANKANA SAHIB DISTRICT,1,Female,13856,2847,16703
NANKANA SAHIB DISTRICT,1,Transgender,0,0,0
NANKANA SAHIB DISTRICT,2,Male,14677,2935,17612
NANKANA SAHIB DISTRICT,2,Female,14325,2799,17124
NANKANA SAHIB DISTRICT,2,Transgender,0,0,0
NANKANA SAHIB DISTRICT,3,Male,15754,3186,18940
NANKANA SAHIB DISTRICT,3,Female,15207,3030,18237
NANKANA SAHIB DISTRICT,3,Transgender,0,0,0
NANKANA SAHIB DISTRICT,4,Male,15582,3023,18605
NANKANA SAHIB DISTRICT,4,Female,14953,2894,17847
NANKANA SAHIB DISTRICT,4,Transgender,0,0,0
NANKANA SAHIB DISTRICT,5,Male,15300,3137,18437
NANKANA SAHIB DISTRICT,5,Female,14542,2987,17529
NANKANA SAHIB DISTRICT,5,Transgender,0,0,0
NANKANA SAHIB DISTRICT,6,Male,15346,3048,18394
NANKANA SAHIB DISTRICT,6,Female,14538,2877,17415
NANKANA SAHIB DISTRICT,6,Transgender,0,0,0
NANKANA SAHIB DISTRICT,7,Male,16058,3315,19373
NANKANA SAHIB DISTRICT,7,Female,15127,3168,18295
NANKANA SAHIB DISTRICT,7,Transgender,0,0,0
NANKANA SAHIB DISTRICT,8,Male,15311,2930,18241
NANKANA SAHIB DISTRICT,8,Female,14454,2789,17243
NANKANA SAHIB DISTRICT,8,Transgender,0,0,0
NANKANA SAHIB DISTRICT,9,Male,15024,3239,18263
NANKANA SAHIB DISTRICT,9,Female,14073,3046,17119
NANKANA SAHIB DISTRICT,9,Transgender,0,0,0
NANKANA SAHIB DISTRICT,10,Male,14126,2741,16867
NANKANA SAHIB DISTRICT,10,Female,13643,2614,16257
NANKANA SAHIB DISTRICT,10,Transgender,0,0,0
NANKANA SAHIB DISTRICT,11,Male,13655,3177,16832
NANKANA SAHIB DISTRICT,11,Female,12985,2925,15910
NANKANA SAHIB DISTRICT,11,Transgender,0,0,0
NANKANA SAHIB DISTRICT,12,Male,13053,2596,15649
NANKANA SAHIB DISTRICT,12,Female,12218,2435,14653
NANKANA SAHIB DISTRICT,12,Transgender,0,0,0
NANKANA SAHIB DISTRICT,13,Male,12539,2866,15405
NANKANA SAHIB DISTRICT,13,Female,11567,2730,14297
NANKANA SAHIB DISTRICT,13,Transgender,0,0,0
NANKANA SAHIB DISTRICT,14,Male,12583,2615,15198
NANKANA SAHIB DISTRICT,14,Female,11529,2475,14004
NANKANA SAHIB DISTRICT,14,Transgender,0,0,0
NANKANA SAHIB DISTRICT,15,Male,11799,2588,14387
NANKANA SAHIB DISTRICT,15,Female,11259,2532,13791
NANKANA SAHIB DISTRICT,15,Transgender,2,1,3
NANKANA SAHIB DISTRICT,16,Male,12219,2613,14832
NANKANA SAHIB DISTRICT,16,Female,11924,2558,14482
NANKANA SAHIB DISTRICT,16,Transgender,2,1,3
NANKANA SAHIB DISTRICT,17,Male,11775,2828,14603
NANKANA SAHIB DISTRICT,17,Female,11152,2652,13804
NANKANA SAHIB DISTRICT,17,Transgender,0,1,1
NANKANA SAHIB DISTRICT,18,Male,11562,2326,13888
NANKANA SAHIB DISTRICT,18,Female,10882,2152,13034
NANKANA SAHIB DISTRICT,18,Transgender,3,0,3
NANKANA SAHIB DISTRICT,19,Male,11409,2671,14080
NANKANA SAHIB DISTRICT,19,Female,10817,2644,13461
NANKANA SAHIB DISTRICT,19,Transgender,3,1,4
NANKANA SAHIB DISTRICT,20,Male,11408,2307,13715
NANKANA SAHIB DISTRICT,20,Female,10936,2283,13219
NANKANA SAHIB DISTRICT,20,Transgender,4,1,5
NANKANA SAHIB DISTRICT,21,Male,10055,2503,12558
NANKANA SAHIB DISTRICT,21,Female,10471,2746,13217
NANKANA SAHIB DISTRICT,21,Transgender,2,1,3
NANKANA SAHIB DISTRICT,22,Male,10357,2282,12639
NANKANA SAHIB DISTRICT,22,Female,10646,2447,13093
NANKANA SAHIB DISTRICT,22,Transgender,3,0,3
NANKANA SAHIB DISTRICT,23,Male,9424,2323,11747
NANKANA SAHIB DISTRICT,23,Female,9341,2373,11714
NANKANA SAHIB DISTRICT,23,Transgender,2,1,3
NANKANA SAHIB DISTRICT,24,Male,8912,2180,11092
NANKANA SAHIB DISTRICT,24,Female,8976,2280,11256
NANKANA SAHIB DISTRICT,24,Transgender,3,1,4
NANKANA SAHIB DISTRICT,25,Male,9123,1896,11019
NANKANA SAHIB DISTRICT,25,Female,9835,2043,11878
NANKANA SAHIB DISTRICT,25,Transgender,2,1,3
NANKANA SAHIB DISTRICT,26,Male,8214,2037,10251
NANKANA SAHIB DISTRICT,26,Female,8814,2285,11099
NANKANA SAHIB DISTRICT,26,Transgender,4,3,7
NANKANA SAHIB DISTRICT,27,Male,7721,2015,9736
NANKANA SAHIB DISTRICT,27,Female,8228,2305,10533
NANKANA SAHIB DISTRICT,27,Transgender,2,1,3
NANKANA SAHIB DISTRICT,28,Male,8092,1893,9985
NANKANA SAHIB DISTRICT,28,Female,8928,2118,11046
NANKANA SAHIB DISTRICT,28,Transgender,3,5,8
NANKANA SAHIB DISTRICT,29,Male,7527,1908,9435
NANKANA SAHIB DISTRICT,29,Female,8085,2178,10263
NANKANA SAHIB DISTRICT,29,Transgender,0,0,0
NANKANA SAHIB DISTRICT,30,Male,8571,1823,10394
NANKANA SAHIB DISTRICT,30,Female,9462,1967,11429
NANKANA SAHIB DISTRICT,30,Transgender,4,3,7
NANKANA SAHIB DISTRICT,31,Male,7048,1774,8822
NANKANA SAHIB DISTRICT,31,Female,7406,1831,9237
NANKANA SAHIB DISTRICT,31,Transgender,1,0,1
NANKANA SAHIB DISTRICT,32,Male,7598,1826,9424
NANKANA SAHIB DISTRICT,32,Female,7834,1907,9741
NANKANA SAHIB DISTRICT,32,Transgender,4,1,5
NANKANA SAHIB DISTRICT,33,Male,6789,1790,8579
NANKANA SAHIB DISTRICT,33,Female,6903,1736,8639
NANKANA SAHIB DISTRICT,33,Transgender,1,1,2
NANKANA SAHIB DISTRICT,34,Male,6465,1576,8041
NANKANA SAHIB DISTRICT,34,Female,6479,1604,8083
NANKANA SAHIB DISTRICT,34,Transgender,1,2,3
NANKANA SAHIB DISTRICT,35,Male,7787,1551,9338
NANKANA SAHIB DISTRICT,35,Female,7688,1663,9351
NANKANA SAHIB DISTRICT,35,Transgender,5,1,6
NANKANA SAHIB DISTRICT,36,Male,6503,1513,8016
NANKANA SAHIB DISTRICT,36,Female,6110,1546,7656
NANKANA SAHIB DISTRICT,36,Transgender,1,0,1
NANKANA SAHIB DISTRICT,37,Male,6648,1584,8232
NANKANA SAHIB DISTRICT,37,Female,6319,1620,7939
NANKANA SAHIB DISTRICT,37,Transgender,3,2,5
NANKANA SAHIB DISTRICT,38,Male,6458,1645,8103
NANKANA SAHIB DISTRICT,38,Female,6615,1591,8206
NANKANA SAHIB DISTRICT,38,Transgender,0,0,0
NANKANA SAHIB DISTRICT,39,Male,6765,1518,8283
NANKANA SAHIB DISTRICT,39,Female,6690,1516,8206
NANKANA SAHIB DISTRICT,39,Transgender,1,1,2
NANKANA SAHIB DISTRICT,40,Male,6905,1561,8466
NANKANA SAHIB DISTRICT,40,Female,6522,1365,7887
NANKANA SAHIB DISTRICT,40,Transgender,4,4,8
NANKANA SAHIB DISTRICT,41,Male,5823,1317,7140
NANKANA SAHIB DISTRICT,41,Female,5547,1379,6926
NANKANA SAHIB DISTRICT,41,Transgender,1,0,1
NANKANA SAHIB DISTRICT,42,Male,5626,1415,7041
NANKANA SAHIB DISTRICT,42,Female,5365,1323,6688
NANKANA SAHIB DISTRICT,42,Transgender,2,1,3
NANKANA SAHIB DISTRICT,43,Male,4870,1257,6127
NANKANA SAHIB DISTRICT,43,Female,4823,1210,6033
NANKANA SAHIB DISTRICT,43,Transgender,1,1,2
NANKANA SAHIB DISTRICT,44,Male,4408,1130,5538
NANKANA SAHIB DISTRICT,44,Female,4382,1121,5503
NANKANA SAHIB DISTRICT,44,Transgender,1,0,1
NANKANA SAHIB DISTRICT,45,Male,5310,1169,6479
NANKANA SAHIB DISTRICT,45,Female,4950,1074,6024
NANKANA SAHIB DISTRICT,45,Transgender,3,2,5
NANKANA SAHIB DISTRICT,46,Male,4069,1038,5107
NANKANA SAHIB DISTRICT,46,Female,3940,984,4924
NANKANA SAHIB DISTRICT,46,Transgender,0,1,1
NANKANA SAHIB DISTRICT,47,Male,4498,1098,5596
NANKANA SAHIB DISTRICT,47,Female,4280,1038,5318
NANKANA SAHIB DISTRICT,47,Transgender,0,4,4
NANKANA SAHIB DISTRICT,48,Male,4518,1081,5599
NANKANA SAHIB DISTRICT,48,Female,4244,1021,5265
NANKANA SAHIB DISTRICT,48,Transgender,0,1,1
NANKANA SAHIB DISTRICT,49,Male,4548,1153,5701
NANKANA SAHIB DISTRICT,49,Female,4360,1055,5415
NANKANA SAHIB DISTRICT,49,Transgender,2,0,2
NANKANA SAHIB DISTRICT,50,Male,5322,1084,6406
NANKANA SAHIB DISTRICT,50,Female,4752,942,5694
NANKANA SAHIB DISTRICT,50,Transgender,4,0,4
NANKANA SAHIB DISTRICT,51,Male,4380,1083,5463
NANKANA SAHIB DISTRICT,51,Female,3871,1037,4908
NANKANA SAHIB DISTRICT,51,Transgender,1,1,2
NANKANA SAHIB DISTRICT,52,Male,4499,1086,5585
NANKANA SAHIB DISTRICT,52,Female,3938,921,4859
NANKANA SAHIB DISTRICT,52,Transgender,1,1,2
NANKANA SAHIB DISTRICT,53,Male,4042,1037,5079
NANKANA SAHIB DISTRICT,53,Female,3361,891,4252
NANKANA SAHIB DISTRICT,53,Transgender,0,0,0
NANKANA SAHIB DISTRICT,54,Male,3793,933,4726
NANKANA SAHIB DISTRICT,54,Female,3171,794,3965
NANKANA SAHIB DISTRICT,54,Transgender,1,0,1
NANKANA SAHIB DISTRICT,55,Male,4088,964,5052
NANKANA SAHIB DISTRICT,55,Female,3368,689,4057
NANKANA SAHIB DISTRICT,55,Transgender,2,1,3
NANKANA SAHIB DISTRICT,56,Male,3190,779,3969
NANKANA SAHIB DISTRICT,56,Female,2559,573,3132
NANKANA SAHIB DISTRICT,56,Transgender,0,1,1
NANKANA SAHIB DISTRICT,57,Male,2972,633,3605
NANKANA SAHIB DISTRICT,57,Female,2687,539,3226
NANKANA SAHIB DISTRICT,57,Transgender,1,0,1
NANKANA SAHIB DISTRICT,58,Male,2744,653,3397
NANKANA SAHIB DISTRICT,58,Female,2467,561,3028
NANKANA SAHIB DISTRICT,58,Transgender,3,0,3
NANKANA SAHIB DISTRICT,59,Male,2771,662,3433
NANKANA SAHIB DISTRICT,59,Female,2432,559,2991
NANKANA SAHIB DISTRICT,59,Transgender,0,0,0
NANKANA SAHIB DISTRICT,60,Male,3435,649,4084
NANKANA SAHIB DISTRICT,60,Female,2892,552,3444
NANKANA SAHIB DISTRICT,60,Transgender,2,1,3
NANKANA SAHIB DISTRICT,61,Male,2495,646,3141
NANKANA SAHIB DISTRICT,61,Female,2219,482,2701
NANKANA SAHIB DISTRICT,61,Transgender,3,0,3
NANKANA SAHIB DISTRICT,62,Male,2712,559,3271
NANKANA SAHIB DISTRICT,62,Female,2340,473,2813
NANKANA SAHIB DISTRICT,62,Transgender,1,0,1
NANKANA SAHIB DISTRICT,63,Male,2301,585,2886
NANKANA SAHIB DISTRICT,63,Female,2146,445,2591
NANKANA SAHIB DISTRICT,63,Transgender,0,1,1
NANKANA SAHIB DISTRICT,64,Male,2228,426,2654
NANKANA SAHIB DISTRICT,64,Female,1973,365,2338
NANKANA SAHIB DISTRICT,64,Transgender,0,0,0
NANKANA SAHIB DISTRICT,65,Male,2621,404,3025
NANKANA SAHIB DISTRICT,65,Female,2235,410,2645
NANKANA SAHIB DISTRICT,65,Transgender,1,0,1
NANKANA SAHIB DISTRICT,66,Male,1548,325,1873
NANKANA SAHIB DISTRICT,66,Female,1416,322,1738
NANKANA SAHIB DISTRICT,66,Transgender,2,0,2
NANKANA SAHIB DISTRICT,67,Male,1687,310,1997
NANKANA SAHIB DISTRICT,67,Female,1519,264,1783
NANKANA SAHIB DISTRICT,67,Transgender,0,0,0
NANKANA SAHIB DISTRICT,68,Male,1603,315,1918
NANKANA SAHIB DISTRICT,68,Female,1550,311,1861
NANKANA SAHIB DISTRICT,68,Transgender,1,0,1
NANKANA SAHIB DISTRICT,69,Male,1668,271,1939
NANKANA SAHIB DISTRICT,69,Female,1620,272,1892
NANKANA SAHIB DISTRICT,69,Transgender,0,0,0
NANKANA SAHIB DISTRICT,70,Male,2351,326,2677
NANKANA SAHIB DISTRICT,70,Female,1948,318,2266
NANKANA SAHIB DISTRICT,70,Transgender,3,1,4
NANKANA SAHIB DISTRICT,71,Male,1483,295,1778
NANKANA SAHIB DISTRICT,71,Female,1300,278,1578
NANKANA SAHIB DISTRICT,71,Transgender,0,0,0
NANKANA SAHIB DISTRICT,72,Male,1677,254,1931
NANKANA SAHIB DISTRICT,72,Female,1341,253,1594
NANKANA SAHIB DISTRICT,72,Transgender,0,0,0
NANKANA SAHIB DISTRICT,73,Male,1349,253,1602
NANKANA SAHIB DISTRICT,73,Female,1237,215,1452
NANKANA SAHIB DISTRICT,73,Transgender,0,0,0
NANKANA SAHIB DISTRICT,74,Male,1413,196,1609
NANKANA SAHIB DISTRICT,74,Female,1096,191,1287
NANKANA SAHIB DISTRICT,74,Transgender,1,0,1
NANKANA SAHIB DISTRICT,>=75,Male,10489,1862,12351
NANKANA SAHIB DISTRICT,>=75,Female,8794,1681,10475
NANKANA SAHIB DISTRICT,>=75,Transgender,4,3,7
NAROWAL DISTRICT,<1,Male,20717,3092,23809
NAROWAL DISTRICT,<1,Female,19382,3036,22418
NAROWAL DISTRICT,<1,Transgender,0,0,0
NAROWAL DISTRICT,1,Male,20722,3092,23814
NAROWAL DISTRICT,1,Female,19842,2873,22715
NAROWAL DISTRICT,1,Transgender,0,0,0
NAROWAL DISTRICT,2,Male,19670,3016,22686
NAROWAL DISTRICT,2,Female,18932,2948,21880
NAROWAL DISTRICT,2,Transgender,0,0,0
NAROWAL DISTRICT,3,Male,20685,3320,24005
NAROWAL DISTRICT,3,Female,19997,3188,23185
NAROWAL DISTRICT,3,Transgender,0,0,0
NAROWAL DISTRICT,4,Male,20569,3159,23728
NAROWAL DISTRICT,4,Female,19688,3096,22784
NAROWAL DISTRICT,4,Transgender,0,0,0
NAROWAL DISTRICT,5,Male,20295,3191,23486
NAROWAL DISTRICT,5,Female,19880,3100,22980
NAROWAL DISTRICT,5,Transgender,0,0,0
NAROWAL DISTRICT,6,Male,20382,3307,23689
NAROWAL DISTRICT,6,Female,19363,3041,22404
NAROWAL DISTRICT,6,Transgender,0,0,0
NAROWAL DISTRICT,7,Male,20818,3531,24349
NAROWAL DISTRICT,7,Female,20206,3315,23521
NAROWAL DISTRICT,7,Transgender,0,0,0
NAROWAL DISTRICT,8,Male,19538,3255,22793
NAROWAL DISTRICT,8,Female,18332,3014,21346
NAROWAL DISTRICT,8,Transgender,0,0,0
NAROWAL DISTRICT,9,Male,20427,3594,24021
NAROWAL DISTRICT,9,Female,19000,3263,22263
NAROWAL DISTRICT,9,Transgender,0,0,0
NAROWAL DISTRICT,10,Male,18277,3128,21405
NAROWAL DISTRICT,10,Female,17347,2949,20296
NAROWAL DISTRICT,10,Transgender,0,0,0
NAROWAL DISTRICT,11,Male,20035,3637,23672
NAROWAL DISTRICT,11,Female,19537,3344,22881
NAROWAL DISTRICT,11,Transgender,0,0,0
NAROWAL DISTRICT,12,Male,17808,3083,20891
NAROWAL DISTRICT,12,Female,16651,2956,19607
NAROWAL DISTRICT,12,Transgender,0,0,0
NAROWAL DISTRICT,13,Male,18658,3364,22022
NAROWAL DISTRICT,13,Female,17836,3236,21072
NAROWAL DISTRICT,13,Transgender,0,0,0
NAROWAL DISTRICT,14,Male,17690,3220,20910
NAROWAL DISTRICT,14,Female,16709,2954,19663
NAROWAL DISTRICT,14,Transgender,0,0,0
NAROWAL DISTRICT,15,Male,16696,2955,19651
NAROWAL DISTRICT,15,Female,17012,3108,20120
NAROWAL DISTRICT,15,Transgender,6,0,6
NAROWAL DISTRICT,16,Male,16984,3167,20151
NAROWAL DISTRICT,16,Female,17409,3104,20513
NAROWAL DISTRICT,16,Transgender,1,0,1
NAROWAL DISTRICT,17,Male,16254,3068,19322
NAROWAL DISTRICT,17,Female,16992,3193,20185
NAROWAL DISTRICT,17,Transgender,4,0,4
NAROWAL DISTRICT,18,Male,15308,2695,18003
NAROWAL DISTRICT,18,Female,14862,2545,17407
NAROWAL DISTRICT,18,Transgender,3,3,6
NAROWAL DISTRICT,19,Male,15772,2773,18545
NAROWAL DISTRICT,19,Female,15968,2886,18854
NAROWAL DISTRICT,19,Transgender,3,0,3
NAROWAL DISTRICT,20,Male,13389,2374,15763
NAROWAL DISTRICT,20,Female,14306,2324,16630
NAROWAL DISTRICT,20,Transgender,1,2,3
NAROWAL DISTRICT,21,Male,13460,2577,16037
NAROWAL DISTRICT,21,Female,15923,2834,18757
NAROWAL DISTRICT,21,Transgender,2,0,2
NAROWAL DISTRICT,22,Male,11897,2164,14061
NAROWAL DISTRICT,22,Female,14755,2633,17388
NAROWAL DISTRICT,22,Transgender,3,4,7
NAROWAL DISTRICT,23,Male,10821,2119,12940
NAROWAL DISTRICT,23,Female,14509,2607,17116
NAROWAL DISTRICT,23,Transgender,1,3,4
NAROWAL DISTRICT,24,Male,10584,2035,12619
NAROWAL DISTRICT,24,Female,13304,2551,15855
NAROWAL DISTRICT,24,Transgender,1,3,4
NAROWAL DISTRICT,25,Male,9207,1781,10988
NAROWAL DISTRICT,25,Female,12032,2036,14068
NAROWAL DISTRICT,25,Transgender,5,1,6
NAROWAL DISTRICT,26,Male,9783,2021,11804
NAROWAL DISTRICT,26,Female,12269,2351,14620
NAROWAL DISTRICT,26,Transgender,2,1,3
NAROWAL DISTRICT,27,Male,8264,1631,9895
NAROWAL DISTRICT,27,Female,10842,2144,12986
NAROWAL DISTRICT,27,Transgender,2,0,2
NAROWAL DISTRICT,28,Male,8937,1723,10660
NAROWAL DISTRICT,28,Female,11505,2183,13688
NAROWAL DISTRICT,28,Transgender,4,2,6
NAROWAL DISTRICT,29,Male,7703,1561,9264
NAROWAL DISTRICT,29,Female,10181,1938,12119
NAROWAL DISTRICT,29,Transgender,2,1,3
NAROWAL DISTRICT,30,Male,8757,1671,10428
NAROWAL DISTRICT,30,Female,11104,2062,13166
NAROWAL DISTRICT,30,Transgender,6,6,12
NAROWAL DISTRICT,31,Male,7802,1431,9233
NAROWAL DISTRICT,31,Female,9899,1938,11837
NAROWAL DISTRICT,31,Transgender,1,2,3
NAROWAL DISTRICT,32,Male,7981,1635,9616
NAROWAL DISTRICT,32,Female,9972,1971,11943
NAROWAL DISTRICT,32,Transgender,2,1,3
NAROWAL DISTRICT,33,Male,7701,1487,9188
NAROWAL DISTRICT,33,Female,9228,1787,11015
NAROWAL DISTRICT,33,Transgender,0,2,2
NAROWAL DISTRICT,34,Male,7286,1410,8696
NAROWAL DISTRICT,34,Female,9015,1669,10684
NAROWAL DISTRICT,34,Transgender,2,2,4
NAROWAL DISTRICT,35,Male,7522,1453,8975
NAROWAL DISTRICT,35,Female,8484,1751,10235
NAROWAL DISTRICT,35,Transgender,8,1,9
NAROWAL DISTRICT,36,Male,7622,1480,9102
NAROWAL DISTRICT,36,Female,8404,1639,10043
NAROWAL DISTRICT,36,Transgender,1,2,3
NAROWAL DISTRICT,37,Male,6301,1174,7475
NAROWAL DISTRICT,37,Female,7395,1396,8791
NAROWAL DISTRICT,37,Transgender,0,1,1
NAROWAL DISTRICT,38,Male,7369,1485,8854
NAROWAL DISTRICT,38,Female,8133,1837,9970
NAROWAL DISTRICT,38,Transgender,3,1,4
NAROWAL DISTRICT,39,Male,6642,1249,7891
NAROWAL DISTRICT,39,Female,7471,1512,8983
NAROWAL DISTRICT,39,Transgender,1,1,2
NAROWAL DISTRICT,40,Male,6983,1550,8533
NAROWAL DISTRICT,40,Female,7248,1551,8799
NAROWAL DISTRICT,40,Transgender,4,4,8
NAROWAL DISTRICT,41,Male,6128,1218,7346
NAROWAL DISTRICT,41,Female,7192,1419,8611
NAROWAL DISTRICT,41,Transgender,0,0,0
NAROWAL DISTRICT,42,Male,5544,1259,6803
NAROWAL DISTRICT,42,Female,6481,1311,7792
NAROWAL DISTRICT,42,Transgender,1,2,3
NAROWAL DISTRICT,43,Male,5449,1191,6640
NAROWAL DISTRICT,43,Female,6053,1365,7418
NAROWAL DISTRICT,43,Transgender,0,0,0
NAROWAL DISTRICT,44,Male,5610,1057,6667
NAROWAL DISTRICT,44,Female,5857,1239,7096
NAROWAL DISTRICT,44,Transgender,1,0,1
NAROWAL DISTRICT,45,Male,5566,1253,6819
NAROWAL DISTRICT,45,Female,5455,1254,6709
NAROWAL DISTRICT,45,Transgender,5,4,9
NAROWAL DISTRICT,46,Male,5423,1072,6495
NAROWAL DISTRICT,46,Female,5820,1127,6947
NAROWAL DISTRICT,46,Transgender,2,1,3
NAROWAL DISTRICT,47,Male,4919,1005,5924
NAROWAL DISTRICT,47,Female,5016,901,5917
NAROWAL DISTRICT,47,Transgender,2,0,2
NAROWAL DISTRICT,48,Male,5513,1156,6669
NAROWAL DISTRICT,48,Female,5728,1186,6914
NAROWAL DISTRICT,48,Transgender,2,2,4
NAROWAL DISTRICT,49,Male,5352,1036,6388
NAROWAL DISTRICT,49,Female,5264,1021,6285
NAROWAL DISTRICT,49,Transgender,1,0,1
NAROWAL DISTRICT,50,Male,5561,1188,6749
NAROWAL DISTRICT,50,Female,5283,1175,6458
NAROWAL DISTRICT,50,Transgender,3,1,4
NAROWAL DISTRICT,51,Male,5382,996,6378
NAROWAL DISTRICT,51,Female,5520,1006,6526
NAROWAL DISTRICT,51,Transgender,2,0,2
NAROWAL DISTRICT,52,Male,5284,1012,6296
NAROWAL DISTRICT,52,Female,5062,905,5967
NAROWAL DISTRICT,52,Transgender,2,0,2
NAROWAL DISTRICT,53,Male,5098,967,6065
NAROWAL DISTRICT,53,Female,4634,950,5584
NAROWAL DISTRICT,53,Transgender,0,0,0
NAROWAL DISTRICT,54,Male,4825,906,5731
NAROWAL DISTRICT,54,Female,4117,904,5021
NAROWAL DISTRICT,54,Transgender,0,0,0
NAROWAL DISTRICT,55,Male,4476,947,5423
NAROWAL DISTRICT,55,Female,3762,791,4553
NAROWAL DISTRICT,55,Transgender,2,2,4
NAROWAL DISTRICT,56,Male,4328,766,5094
NAROWAL DISTRICT,56,Female,3748,651,4399
NAROWAL DISTRICT,56,Transgender,0,0,0
NAROWAL DISTRICT,57,Male,3593,575,4168
NAROWAL DISTRICT,57,Female,3038,419,3457
NAROWAL DISTRICT,57,Transgender,0,0,0
NAROWAL DISTRICT,58,Male,3725,640,4365
NAROWAL DISTRICT,58,Female,3553,615,4168
NAROWAL DISTRICT,58,Transgender,0,0,0
NAROWAL DISTRICT,59,Male,3350,587,3937
NAROWAL DISTRICT,59,Female,3191,557,3748
NAROWAL DISTRICT,59,Transgender,1,0,1
NAROWAL DISTRICT,60,Male,3512,678,4190
NAROWAL DISTRICT,60,Female,3513,600,4113
NAROWAL DISTRICT,60,Transgender,4,1,5
NAROWAL DISTRICT,61,Male,3242,566,3808
NAROWAL DISTRICT,61,Female,3274,497,3771
NAROWAL DISTRICT,61,Transgender,1,0,1
NAROWAL DISTRICT,62,Male,3214,537,3751
NAROWAL DISTRICT,62,Female,2980,477,3457
NAROWAL DISTRICT,62,Transgender,0,0,0
NAROWAL DISTRICT,63,Male,3214,569,3783
NAROWAL DISTRICT,63,Female,2904,502,3406
NAROWAL DISTRICT,63,Transgender,3,0,3
NAROWAL DISTRICT,64,Male,2945,472,3417
NAROWAL DISTRICT,64,Female,2723,444,3167
NAROWAL DISTRICT,64,Transgender,0,0,0
NAROWAL DISTRICT,65,Male,2890,483,3373
NAROWAL DISTRICT,65,Female,3136,445,3581
NAROWAL DISTRICT,65,Transgender,0,1,1
NAROWAL DISTRICT,66,Male,2602,379,2981
NAROWAL DISTRICT,66,Female,2588,335,2923
NAROWAL DISTRICT,66,Transgender,1,0,1
NAROWAL DISTRICT,67,Male,2106,287,2393
NAROWAL DISTRICT,67,Female,2021,246,2267
NAROWAL DISTRICT,67,Transgender,1,0,1
NAROWAL DISTRICT,68,Male,2406,350,2756
NAROWAL DISTRICT,68,Female,2445,363,2808
NAROWAL DISTRICT,68,Transgender,0,0,0
NAROWAL DISTRICT,69,Male,2418,322,2740
NAROWAL DISTRICT,69,Female,2242,248,2490
NAROWAL DISTRICT,69,Transgender,0,0,0
NAROWAL DISTRICT,70,Male,2737,400,3137
NAROWAL DISTRICT,70,Female,2607,367,2974
NAROWAL DISTRICT,70,Transgender,1,1,2
NAROWAL DISTRICT,71,Male,2386,318,2704
NAROWAL DISTRICT,71,Female,2097,270,2367
NAROWAL DISTRICT,71,Transgender,0,0,0
NAROWAL DISTRICT,72,Male,2178,321,2499
NAROWAL DISTRICT,72,Female,2016,269,2285
NAROWAL DISTRICT,72,Transgender,1,0,1
NAROWAL DISTRICT,73,Male,2034,264,2298
NAROWAL DISTRICT,73,Female,1823,243,2066
NAROWAL DISTRICT,73,Transgender,0,0,0
NAROWAL DISTRICT,74,Male,1979,239,2218
NAROWAL DISTRICT,74,Female,1648,217,1865
NAROWAL DISTRICT,74,Transgender,0,0,0
NAROWAL DISTRICT,>=75,Male,14991,1964,16955
NAROWAL DISTRICT,>=75,Female,13798,1777,15575
NAROWAL DISTRICT,>=75,Transgender,5,2,7
NASIRABAD DISTRICT,<1,Male,5518,1468,6986
NASIRABAD DISTRICT,<1,Female,5143,1256,6399
NASIRABAD DISTRICT,<1,Transgender,0,0,0
NASIRABAD DISTRICT,1,Male,7430,1752,9182
NASIRABAD DISTRICT,1,Female,7393,1716,9109
NASIRABAD DISTRICT,1,Transgender,0,0,0
NASIRABAD DISTRICT,2,Male,8621,1802,10423
NASIRABAD DISTRICT,2,Female,8357,1831,10188
NASIRABAD DISTRICT,2,Transgender,0,0,0
NASIRABAD DISTRICT,3,Male,8757,2028,10785
NASIRABAD DISTRICT,3,Female,8580,1953,10533
NASIRABAD DISTRICT,3,Transgender,0,0,0
NASIRABAD DISTRICT,4,Male,9315,1935,11250
NASIRABAD DISTRICT,4,Female,8825,1844,10669
NASIRABAD DISTRICT,4,Transgender,0,0,0
NASIRABAD DISTRICT,5,Male,8553,2064,10617
NASIRABAD DISTRICT,5,Female,7818,1859,9677
NASIRABAD DISTRICT,5,Transgender,0,0,0
NASIRABAD DISTRICT,6,Male,9171,1780,10951
NASIRABAD DISTRICT,6,Female,7839,1556,9395
NASIRABAD DISTRICT,6,Transgender,0,0,0
NASIRABAD DISTRICT,7,Male,8711,1970,10681
NASIRABAD DISTRICT,7,Female,7213,1808,9021
NASIRABAD DISTRICT,7,Transgender,0,0,0
NASIRABAD DISTRICT,8,Male,9431,1739,11170
NASIRABAD DISTRICT,8,Female,7557,1640,9197
NASIRABAD DISTRICT,8,Transgender,0,0,0
NASIRABAD DISTRICT,9,Male,6984,1655,8639
NASIRABAD DISTRICT,9,Female,5849,1474,7323
NASIRABAD DISTRICT,9,Transgender,0,0,0
NASIRABAD DISTRICT,10,Male,7977,1552,9529
NASIRABAD DISTRICT,10,Female,6238,1351,7589
NASIRABAD DISTRICT,10,Transgender,0,0,0
NASIRABAD DISTRICT,11,Male,5086,1381,6467
NASIRABAD DISTRICT,11,Female,3897,1145,5042
NASIRABAD DISTRICT,11,Transgender,0,0,0
NASIRABAD DISTRICT,12,Male,5653,1359,7012
NASIRABAD DISTRICT,12,Female,4506,1102,5608
NASIRABAD DISTRICT,12,Transgender,0,0,0
NASIRABAD DISTRICT,13,Male,4009,1200,5209
NASIRABAD DISTRICT,13,Female,3155,992,4147
NASIRABAD DISTRICT,13,Transgender,0,0,0
NASIRABAD DISTRICT,14,Male,4284,1208,5492
NASIRABAD DISTRICT,14,Female,3278,983,4261
NASIRABAD DISTRICT,14,Transgender,0,0,0
NASIRABAD DISTRICT,15,Male,3837,1104,4941
NASIRABAD DISTRICT,15,Female,2879,944,3823
NASIRABAD DISTRICT,15,Transgender,0,0,0
NASIRABAD DISTRICT,16,Male,3928,1051,4979
NASIRABAD DISTRICT,16,Female,2985,862,3847
NASIRABAD DISTRICT,16,Transgender,0,0,0
NASIRABAD DISTRICT,17,Male,2909,1035,3944
NASIRABAD DISTRICT,17,Female,2442,812,3254
NASIRABAD DISTRICT,17,Transgender,0,0,0
NASIRABAD DISTRICT,18,Male,4249,997,5246
NASIRABAD DISTRICT,18,Female,3705,944,4649
NASIRABAD DISTRICT,18,Transgender,1,0,1
NASIRABAD DISTRICT,19,Male,2974,886,3860
NASIRABAD DISTRICT,19,Female,3012,900,3912
NASIRABAD DISTRICT,19,Transgender,0,0,0
NASIRABAD DISTRICT,20,Male,3578,739,4317
NASIRABAD DISTRICT,20,Female,3347,734,4081
NASIRABAD DISTRICT,20,Transgender,0,0,0
NASIRABAD DISTRICT,21,Male,2584,738,3322
NASIRABAD DISTRICT,21,Female,2558,751,3309
NASIRABAD DISTRICT,21,Transgender,0,0,0
NASIRABAD DISTRICT,22,Male,2324,646,2970
NASIRABAD DISTRICT,22,Female,2156,622,2778
NASIRABAD DISTRICT,22,Transgender,0,0,0
NASIRABAD DISTRICT,23,Male,2041,681,2722
NASIRABAD DISTRICT,23,Female,2134,573,2707
NASIRABAD DISTRICT,23,Transgender,0,0,0
NASIRABAD DISTRICT,24,Male,1822,534,2356
NASIRABAD DISTRICT,24,Female,2036,540,2576
NASIRABAD DISTRICT,24,Transgender,0,0,0
NASIRABAD DISTRICT,25,Male,2621,595,3216
NASIRABAD DISTRICT,25,Female,3091,671,3762
NASIRABAD DISTRICT,25,Transgender,0,0,0
NASIRABAD DISTRICT,26,Male,1922,579,2501
NASIRABAD DISTRICT,26,Female,1857,649,2506
NASIRABAD DISTRICT,26,Transgender,0,0,0
NASIRABAD DISTRICT,27,Male,2486,750,3236
NASIRABAD DISTRICT,27,Female,2670,905,3575
NASIRABAD DISTRICT,27,Transgender,0,0,0
NASIRABAD DISTRICT,28,Male,2018,594,2612
NASIRABAD DISTRICT,28,Female,2542,680,3222
NASIRABAD DISTRICT,28,Transgender,0,0,0
NASIRABAD DISTRICT,29,Male,2554,673,3227
NASIRABAD DISTRICT,29,Female,2835,874,3709
NASIRABAD DISTRICT,29,Transgender,0,0,0
NASIRABAD DISTRICT,30,Male,2363,535,2898
NASIRABAD DISTRICT,30,Female,3189,544,3733
NASIRABAD DISTRICT,30,Transgender,0,0,0
NASIRABAD DISTRICT,31,Male,2212,625,2837
NASIRABAD DISTRICT,31,Female,2496,676,3172
NASIRABAD DISTRICT,31,Transgender,0,0,0
NASIRABAD DISTRICT,32,Male,2242,569,2811
NASIRABAD DISTRICT,32,Female,2577,699,3276
NASIRABAD DISTRICT,32,Transgender,0,0,0
NASIRABAD DISTRICT,33,Male,1974,533,2507
NASIRABAD DISTRICT,33,Female,2352,566,2918
NASIRABAD DISTRICT,33,Transgender,0,0,0
NASIRABAD DISTRICT,34,Male,1855,496,2351
NASIRABAD DISTRICT,34,Female,2063,508,2571
NASIRABAD DISTRICT,34,Transgender,0,0,0
NASIRABAD DISTRICT,35,Male,2248,501,2749
NASIRABAD DISTRICT,35,Female,2533,519,3052
NASIRABAD DISTRICT,35,Transgender,0,0,0
NASIRABAD DISTRICT,36,Male,2034,514,2548
NASIRABAD DISTRICT,36,Female,1708,419,2127
NASIRABAD DISTRICT,36,Transgender,0,0,0
NASIRABAD DISTRICT,37,Male,3307,702,4009
NASIRABAD DISTRICT,37,Female,2476,704,3180
NASIRABAD DISTRICT,37,Transgender,0,0,0
NASIRABAD DISTRICT,38,Male,1805,424,2229
NASIRABAD DISTRICT,38,Female,1893,403,2296
NASIRABAD DISTRICT,38,Transgender,0,0,0
NASIRABAD DISTRICT,39,Male,2384,568,2952
NASIRABAD DISTRICT,39,Female,2023,540,2563
NASIRABAD DISTRICT,39,Transgender,0,0,0
NASIRABAD DISTRICT,40,Male,1573,348,1921
NASIRABAD DISTRICT,40,Female,2172,398,2570
NASIRABAD DISTRICT,40,Transgender,0,0,0
NASIRABAD DISTRICT,41,Male,1461,399,1860
NASIRABAD DISTRICT,41,Female,1484,392,1876
NASIRABAD DISTRICT,41,Transgender,0,0,0
NASIRABAD DISTRICT,42,Male,1534,349,1883
NASIRABAD DISTRICT,42,Female,1389,431,1820
NASIRABAD DISTRICT,42,Transgender,0,0,0
NASIRABAD DISTRICT,43,Male,1121,278,1399
NASIRABAD DISTRICT,43,Female,1386,308,1694
NASIRABAD DISTRICT,43,Transgender,0,0,0
NASIRABAD DISTRICT,44,Male,1057,311,1368
NASIRABAD DISTRICT,44,Female,1199,315,1514
NASIRABAD DISTRICT,44,Transgender,0,0,0
NASIRABAD DISTRICT,45,Male,1148,275,1423
NASIRABAD DISTRICT,45,Female,1451,299,1750
NASIRABAD DISTRICT,45,Transgender,0,0,0
NASIRABAD DISTRICT,46,Male,1036,313,1349
NASIRABAD DISTRICT,46,Female,845,285,1130
NASIRABAD DISTRICT,46,Transgender,0,0,0
NASIRABAD DISTRICT,47,Male,1529,377,1906
NASIRABAD DISTRICT,47,Female,1260,423,1683
NASIRABAD DISTRICT,47,Transgender,0,0,0
NASIRABAD DISTRICT,48,Male,941,318,1259
NASIRABAD DISTRICT,48,Female,1067,284,1351
NASIRABAD DISTRICT,48,Transgender,0,0,0
NASIRABAD DISTRICT,49,Male,1146,375,1521
NASIRABAD DISTRICT,49,Female,1155,312,1467
NASIRABAD DISTRICT,49,Transgender,0,0,0
NASIRABAD DISTRICT,50,Male,1047,235,1282
NASIRABAD DISTRICT,50,Female,1291,259,1550
NASIRABAD DISTRICT,50,Transgender,0,0,0
NASIRABAD DISTRICT,51,Male,942,262,1204
NASIRABAD DISTRICT,51,Female,885,276,1161
NASIRABAD DISTRICT,51,Transgender,0,0,0
NASIRABAD DISTRICT,52,Male,1111,265,1376
NASIRABAD DISTRICT,52,Female,884,266,1150
NASIRABAD DISTRICT,52,Transgender,0,0,0
NASIRABAD DISTRICT,53,Male,777,216,993
NASIRABAD DISTRICT,53,Female,806,171,977
NASIRABAD DISTRICT,53,Transgender,0,0,0
NASIRABAD DISTRICT,54,Male,736,221,957
NASIRABAD DISTRICT,54,Female,713,184,897
NASIRABAD DISTRICT,54,Transgender,0,0,0
NASIRABAD DISTRICT,55,Male,616,178,794
NASIRABAD DISTRICT,55,Female,832,141,973
NASIRABAD DISTRICT,55,Transgender,0,0,0
NASIRABAD DISTRICT,56,Male,603,160,763
NASIRABAD DISTRICT,56,Female,572,154,726
NASIRABAD DISTRICT,56,Transgender,0,0,0
NASIRABAD DISTRICT,57,Male,1011,226,1237
NASIRABAD DISTRICT,57,Female,907,253,1160
NASIRABAD DISTRICT,57,Transgender,0,0,0
NASIRABAD DISTRICT,58,Male,512,136,648
NASIRABAD DISTRICT,58,Female,642,132,774
NASIRABAD DISTRICT,58,Transgender,0,0,0
NASIRABAD DISTRICT,59,Male,721,163,884
NASIRABAD DISTRICT,59,Female,594,166,760
NASIRABAD DISTRICT,59,Transgender,0,0,0
NASIRABAD DISTRICT,60,Male,555,111,666
NASIRABAD DISTRICT,60,Female,766,137,903
NASIRABAD DISTRICT,60,Transgender,0,0,0
NASIRABAD DISTRICT,61,Male,520,141,661
NASIRABAD DISTRICT,61,Female,535,166,701
NASIRABAD DISTRICT,61,Transgender,0,0,0
NASIRABAD DISTRICT,62,Male,624,131,755
NASIRABAD DISTRICT,62,Female,654,155,809
NASIRABAD DISTRICT,62,Transgender,0,0,0
NASIRABAD DISTRICT,63,Male,511,134,645
NASIRABAD DISTRICT,63,Female,537,126,663
NASIRABAD DISTRICT,63,Transgender,0,0,0
NASIRABAD DISTRICT,64,Male,520,98,618
NASIRABAD DISTRICT,64,Female,479,119,598
NASIRABAD DISTRICT,64,Transgender,0,0,0
NASIRABAD DISTRICT,65,Male,421,80,501
NASIRABAD DISTRICT,65,Female,541,102,643
NASIRABAD DISTRICT,65,Transgender,0,0,0
NASIRABAD DISTRICT,66,Male,438,136,574
NASIRABAD DISTRICT,66,Female,357,135,492
NASIRABAD DISTRICT,66,Transgender,0,0,0
NASIRABAD DISTRICT,67,Male,504,74,578
NASIRABAD DISTRICT,67,Female,518,146,664
NASIRABAD DISTRICT,67,Transgender,0,0,0
NASIRABAD DISTRICT,68,Male,330,85,415
NASIRABAD DISTRICT,68,Female,359,85,444
NASIRABAD DISTRICT,68,Transgender,0,0,0
NASIRABAD DISTRICT,69,Male,407,94,501
NASIRABAD DISTRICT,69,Female,316,89,405
NASIRABAD DISTRICT,69,Transgender,0,0,0
NASIRABAD DISTRICT,70,Male,335,53,388
NASIRABAD DISTRICT,70,Female,411,82,493
NASIRABAD DISTRICT,70,Transgender,0,0,0
NASIRABAD DISTRICT,71,Male,357,81,438
NASIRABAD DISTRICT,71,Female,291,85,376
NASIRABAD DISTRICT,71,Transgender,0,0,0
NASIRABAD DISTRICT,72,Male,235,49,284
NASIRABAD DISTRICT,72,Female,313,65,378
NASIRABAD DISTRICT,72,Transgender,0,0,0
NASIRABAD DISTRICT,73,Male,238,57,295
NASIRABAD DISTRICT,73,Female,207,63,270
NASIRABAD DISTRICT,73,Transgender,0,0,0
NASIRABAD DISTRICT,74,Male,239,44,283
NASIRABAD DISTRICT,74,Female,219,73,292
NASIRABAD DISTRICT,74,Transgender,0,0,0
NASIRABAD DISTRICT,>=75,Male,1776,426,2202
NASIRABAD DISTRICT,>=75,Female,1883,529,2412
NASIRABAD DISTRICT,>=75,Transgender,0,0,0
NAUSHAHRO FEROZE DISTRICT,<1,Male,13085,3815,16900
NAUSHAHRO FEROZE DISTRICT,<1,Female,12034,3651,15685
NAUSHAHRO FEROZE DISTRICT,<1,Transgender,0,0,0
NAUSHAHRO FEROZE DISTRICT,1,Male,17013,4878,21891
NAUSHAHRO FEROZE DISTRICT,1,Female,16495,4678,21173
NAUSHAHRO FEROZE DISTRICT,1,Transgender,0,0,0
NAUSHAHRO FEROZE DISTRICT,2,Male,19717,5253,24970
NAUSHAHRO FEROZE DISTRICT,2,Female,19782,5071,24853
NAUSHAHRO FEROZE DISTRICT,2,Transgender,0,0,0
NAUSHAHRO FEROZE DISTRICT,3,Male,22859,6083,28942
NAUSHAHRO FEROZE DISTRICT,3,Female,22265,5987,28252
NAUSHAHRO FEROZE DISTRICT,3,Transgender,0,0,0
NAUSHAHRO FEROZE DISTRICT,4,Male,23936,6010,29946
NAUSHAHRO FEROZE DISTRICT,4,Female,22624,5793,28417
NAUSHAHRO FEROZE DISTRICT,4,Transgender,0,0,0
NAUSHAHRO FEROZE DISTRICT,5,Male,24890,6529,31419
NAUSHAHRO FEROZE DISTRICT,5,Female,22161,6094,28255
NAUSHAHRO FEROZE DISTRICT,5,Transgender,0,0,0
NAUSHAHRO FEROZE DISTRICT,6,Male,22106,5698,27804
NAUSHAHRO FEROZE DISTRICT,6,Female,19940,5327,25267
NAUSHAHRO FEROZE DISTRICT,6,Transgender,0,0,0
NAUSHAHRO FEROZE DISTRICT,7,Male,20482,5927,26409
NAUSHAHRO FEROZE DISTRICT,7,Female,18036,5326,23362
NAUSHAHRO FEROZE DISTRICT,7,Transgender,0,0,0
NAUSHAHRO FEROZE DISTRICT,8,Male,22535,5770,28305
NAUSHAHRO FEROZE DISTRICT,8,Female,19540,5135,24675
NAUSHAHRO FEROZE DISTRICT,8,Transgender,0,0,0
NAUSHAHRO FEROZE DISTRICT,9,Male,18189,5357,23546
NAUSHAHRO FEROZE DISTRICT,9,Female,15553,4749,20302
NAUSHAHRO FEROZE DISTRICT,9,Transgender,0,0,0
NAUSHAHRO FEROZE DISTRICT,10,Male,19689,5338,25027
NAUSHAHRO FEROZE DISTRICT,10,Female,17150,4680,21830
NAUSHAHRO FEROZE DISTRICT,10,Transgender,0,0,0
NAUSHAHRO FEROZE DISTRICT,11,Male,14743,4594,19337
NAUSHAHRO FEROZE DISTRICT,11,Female,12368,4243,16611
NAUSHAHRO FEROZE DISTRICT,11,Transgender,0,0,0
NAUSHAHRO FEROZE DISTRICT,12,Male,16412,4927,21339
NAUSHAHRO FEROZE DISTRICT,12,Female,14197,4293,18490
NAUSHAHRO FEROZE DISTRICT,12,Transgender,0,0,0
NAUSHAHRO FEROZE DISTRICT,13,Male,13760,4531,18291
NAUSHAHRO FEROZE DISTRICT,13,Female,11655,4035,15690
NAUSHAHRO FEROZE DISTRICT,13,Transgender,0,0,0
NAUSHAHRO FEROZE DISTRICT,14,Male,14467,4407,18874
NAUSHAHRO FEROZE DISTRICT,14,Female,12280,4051,16331
NAUSHAHRO FEROZE DISTRICT,14,Transgender,0,0,0
NAUSHAHRO FEROZE DISTRICT,15,Male,15308,4873,20181
NAUSHAHRO FEROZE DISTRICT,15,Female,12786,4333,17119
NAUSHAHRO FEROZE DISTRICT,15,Transgender,4,2,6
NAUSHAHRO FEROZE DISTRICT,16,Male,14626,4588,19214
NAUSHAHRO FEROZE DISTRICT,16,Female,12276,4287,16563
NAUSHAHRO FEROZE DISTRICT,16,Transgender,1,2,3
NAUSHAHRO FEROZE DISTRICT,17,Male,14112,4865,18977
NAUSHAHRO FEROZE DISTRICT,17,Female,11445,4177,15622
NAUSHAHRO FEROZE DISTRICT,17,Transgender,0,3,3
NAUSHAHRO FEROZE DISTRICT,18,Male,14910,4577,19487
NAUSHAHRO FEROZE DISTRICT,18,Female,14073,4398,18471
NAUSHAHRO FEROZE DISTRICT,18,Transgender,3,2,5
NAUSHAHRO FEROZE DISTRICT,19,Male,11911,4160,16071
NAUSHAHRO FEROZE DISTRICT,19,Female,11597,4186,15783
NAUSHAHRO FEROZE DISTRICT,19,Transgender,1,0,1
NAUSHAHRO FEROZE DISTRICT,20,Male,12997,4091,17088
NAUSHAHRO FEROZE DISTRICT,20,Female,12914,4072,16986
NAUSHAHRO FEROZE DISTRICT,20,Transgender,5,4,9
NAUSHAHRO FEROZE DISTRICT,21,Male,9533,3520,13053
NAUSHAHRO FEROZE DISTRICT,21,Female,9693,3550,13243
NAUSHAHRO FEROZE DISTRICT,21,Transgender,1,0,1
NAUSHAHRO FEROZE DISTRICT,22,Male,10800,3582,14382
NAUSHAHRO FEROZE DISTRICT,22,Female,10199,3728,13927
NAUSHAHRO FEROZE DISTRICT,22,Transgender,5,2,7
NAUSHAHRO FEROZE DISTRICT,23,Male,9319,3400,12719
NAUSHAHRO FEROZE DISTRICT,23,Female,8883,3177,12060
NAUSHAHRO FEROZE DISTRICT,23,Transgender,2,3,5
NAUSHAHRO FEROZE DISTRICT,24,Male,8460,3067,11527
NAUSHAHRO FEROZE DISTRICT,24,Female,8529,3036,11565
NAUSHAHRO FEROZE DISTRICT,24,Transgender,1,3,4
NAUSHAHRO FEROZE DISTRICT,25,Male,10775,3425,14200
NAUSHAHRO FEROZE DISTRICT,25,Female,10848,3468,14316
NAUSHAHRO FEROZE DISTRICT,25,Transgender,5,5,10
NAUSHAHRO FEROZE DISTRICT,26,Male,8700,2912,11612
NAUSHAHRO FEROZE DISTRICT,26,Female,8724,2939,11663
NAUSHAHRO FEROZE DISTRICT,26,Transgender,1,1,2
NAUSHAHRO FEROZE DISTRICT,27,Male,8781,3060,11841
NAUSHAHRO FEROZE DISTRICT,27,Female,9100,3020,12120
NAUSHAHRO FEROZE DISTRICT,27,Transgender,3,4,7
NAUSHAHRO FEROZE DISTRICT,28,Male,9563,3108,12671
NAUSHAHRO FEROZE DISTRICT,28,Female,9900,3246,13146
NAUSHAHRO FEROZE DISTRICT,28,Transgender,4,1,5
NAUSHAHRO FEROZE DISTRICT,29,Male,8685,2696,11381
NAUSHAHRO FEROZE DISTRICT,29,Female,9392,2934,12326
NAUSHAHRO FEROZE DISTRICT,29,Transgender,2,0,2
NAUSHAHRO FEROZE DISTRICT,30,Male,9833,3122,12955
NAUSHAHRO FEROZE DISTRICT,30,Female,9685,3230,12915
NAUSHAHRO FEROZE DISTRICT,30,Transgender,8,5,13
NAUSHAHRO FEROZE DISTRICT,31,Male,8126,2562,10688
NAUSHAHRO FEROZE DISTRICT,31,Female,8556,2690,11246
NAUSHAHRO FEROZE DISTRICT,31,Transgender,3,0,3
NAUSHAHRO FEROZE DISTRICT,32,Male,8474,2834,11308
NAUSHAHRO FEROZE DISTRICT,32,Female,8147,2566,10713
NAUSHAHRO FEROZE DISTRICT,32,Transgender,5,2,7
NAUSHAHRO FEROZE DISTRICT,33,Male,7241,2476,9717
NAUSHAHRO FEROZE DISTRICT,33,Female,7127,2413,9540
NAUSHAHRO FEROZE DISTRICT,33,Transgender,1,1,2
NAUSHAHRO FEROZE DISTRICT,34,Male,6193,2118,8311
NAUSHAHRO FEROZE DISTRICT,34,Female,6385,2036,8421
NAUSHAHRO FEROZE DISTRICT,34,Transgender,2,4,6
NAUSHAHRO FEROZE DISTRICT,35,Male,8213,2655,10868
NAUSHAHRO FEROZE DISTRICT,35,Female,7377,2503,9880
NAUSHAHRO FEROZE DISTRICT,35,Transgender,9,4,13
NAUSHAHRO FEROZE DISTRICT,36,Male,6297,1984,8281
NAUSHAHRO FEROZE DISTRICT,36,Female,5942,1839,7781
NAUSHAHRO FEROZE DISTRICT,36,Transgender,1,1,2
NAUSHAHRO FEROZE DISTRICT,37,Male,6707,2069,8776
NAUSHAHRO FEROZE DISTRICT,37,Female,6856,2074,8930
NAUSHAHRO FEROZE DISTRICT,37,Transgender,2,2,4
NAUSHAHRO FEROZE DISTRICT,38,Male,6190,2237,8427
NAUSHAHRO FEROZE DISTRICT,38,Female,6218,2108,8326
NAUSHAHRO FEROZE DISTRICT,38,Transgender,2,2,4
NAUSHAHRO FEROZE DISTRICT,39,Male,6140,1969,8109
NAUSHAHRO FEROZE DISTRICT,39,Female,6009,1880,7889
NAUSHAHRO FEROZE DISTRICT,39,Transgender,1,0,1
NAUSHAHRO FEROZE DISTRICT,40,Male,6668,2272,8940
NAUSHAHRO FEROZE DISTRICT,40,Female,6814,2348,9162
NAUSHAHRO FEROZE DISTRICT,40,Transgender,9,3,12
NAUSHAHRO FEROZE DISTRICT,41,Male,4909,1851,6760
NAUSHAHRO FEROZE DISTRICT,41,Female,5113,1690,6803
NAUSHAHRO FEROZE DISTRICT,41,Transgender,1,0,1
NAUSHAHRO FEROZE DISTRICT,42,Male,5193,1864,7057
NAUSHAHRO FEROZE DISTRICT,42,Female,5415,1744,7159
NAUSHAHRO FEROZE DISTRICT,42,Transgender,1,0,1
NAUSHAHRO FEROZE DISTRICT,43,Male,4515,1750,6265
NAUSHAHRO FEROZE DISTRICT,43,Female,4588,1596,6184
NAUSHAHRO FEROZE DISTRICT,43,Transgender,1,0,1
NAUSHAHRO FEROZE DISTRICT,44,Male,4562,1624,6186
NAUSHAHRO FEROZE DISTRICT,44,Female,4419,1425,5844
NAUSHAHRO FEROZE DISTRICT,44,Transgender,1,1,2
NAUSHAHRO FEROZE DISTRICT,45,Male,5478,1765,7243
NAUSHAHRO FEROZE DISTRICT,45,Female,5028,1695,6723
NAUSHAHRO FEROZE DISTRICT,45,Transgender,7,5,12
NAUSHAHRO FEROZE DISTRICT,46,Male,4513,1477,5990
NAUSHAHRO FEROZE DISTRICT,46,Female,4199,1298,5497
NAUSHAHRO FEROZE DISTRICT,46,Transgender,1,0,1
NAUSHAHRO FEROZE DISTRICT,47,Male,4988,1482,6470
NAUSHAHRO FEROZE DISTRICT,47,Female,5268,1463,6731
NAUSHAHRO FEROZE DISTRICT,47,Transgender,2,0,2
NAUSHAHRO FEROZE DISTRICT,48,Male,4623,1542,6165
NAUSHAHRO FEROZE DISTRICT,48,Female,4315,1305,5620
NAUSHAHRO FEROZE DISTRICT,48,Transgender,1,0,1
NAUSHAHRO FEROZE DISTRICT,49,Male,4364,1472,5836
NAUSHAHRO FEROZE DISTRICT,49,Female,4102,1277,5379
NAUSHAHRO FEROZE DISTRICT,49,Transgender,0,0,0
NAUSHAHRO FEROZE DISTRICT,50,Male,4830,1627,6457
NAUSHAHRO FEROZE DISTRICT,50,Female,4252,1417,5669
NAUSHAHRO FEROZE DISTRICT,50,Transgender,6,1,7
NAUSHAHRO FEROZE DISTRICT,51,Male,3929,1255,5184
NAUSHAHRO FEROZE DISTRICT,51,Female,3429,990,4419
NAUSHAHRO FEROZE DISTRICT,51,Transgender,1,0,1
NAUSHAHRO FEROZE DISTRICT,52,Male,3647,1197,4844
NAUSHAHRO FEROZE DISTRICT,52,Female,3189,1034,4223
NAUSHAHRO FEROZE DISTRICT,52,Transgender,2,2,4
NAUSHAHRO FEROZE DISTRICT,53,Male,3287,1116,4403
NAUSHAHRO FEROZE DISTRICT,53,Female,2760,896,3656
NAUSHAHRO FEROZE DISTRICT,53,Transgender,2,2,4
NAUSHAHRO FEROZE DISTRICT,54,Male,2824,1048,3872
NAUSHAHRO FEROZE DISTRICT,54,Female,2432,834,3266
NAUSHAHRO FEROZE DISTRICT,54,Transgender,0,1,1
NAUSHAHRO FEROZE DISTRICT,55,Male,3399,1197,4596
NAUSHAHRO FEROZE DISTRICT,55,Female,2912,1001,3913
NAUSHAHRO FEROZE DISTRICT,55,Transgender,1,1,2
NAUSHAHRO FEROZE DISTRICT,56,Male,2472,812,3284
NAUSHAHRO FEROZE DISTRICT,56,Female,2041,585,2626
NAUSHAHRO FEROZE DISTRICT,56,Transgender,0,0,0
NAUSHAHRO FEROZE DISTRICT,57,Male,2440,802,3242
NAUSHAHRO FEROZE DISTRICT,57,Female,2351,654,3005
NAUSHAHRO FEROZE DISTRICT,57,Transgender,0,1,1
NAUSHAHRO FEROZE DISTRICT,58,Male,2162,732,2894
NAUSHAHRO FEROZE DISTRICT,58,Female,2134,643,2777
NAUSHAHRO FEROZE DISTRICT,58,Transgender,1,0,1
NAUSHAHRO FEROZE DISTRICT,59,Male,2176,704,2880
NAUSHAHRO FEROZE DISTRICT,59,Female,2349,694,3043
NAUSHAHRO FEROZE DISTRICT,59,Transgender,1,1,2
NAUSHAHRO FEROZE DISTRICT,60,Male,2691,777,3468
NAUSHAHRO FEROZE DISTRICT,60,Female,2715,822,3537
NAUSHAHRO FEROZE DISTRICT,60,Transgender,4,0,4
NAUSHAHRO FEROZE DISTRICT,61,Male,2102,633,2735
NAUSHAHRO FEROZE DISTRICT,61,Female,2338,671,3009
NAUSHAHRO FEROZE DISTRICT,61,Transgender,0,0,0
NAUSHAHRO FEROZE DISTRICT,62,Male,2088,606,2694
NAUSHAHRO FEROZE DISTRICT,62,Female,2264,626,2890
NAUSHAHRO FEROZE DISTRICT,62,Transgender,1,0,1
NAUSHAHRO FEROZE DISTRICT,63,Male,2178,587,2765
NAUSHAHRO FEROZE DISTRICT,63,Female,2189,660,2849
NAUSHAHRO FEROZE DISTRICT,63,Transgender,0,1,1
NAUSHAHRO FEROZE DISTRICT,64,Male,1850,539,2389
NAUSHAHRO FEROZE DISTRICT,64,Female,1908,518,2426
NAUSHAHRO FEROZE DISTRICT,64,Transgender,0,1,1
NAUSHAHRO FEROZE DISTRICT,65,Male,2110,603,2713
NAUSHAHRO FEROZE DISTRICT,65,Female,1854,565,2419
NAUSHAHRO FEROZE DISTRICT,65,Transgender,2,2,4
NAUSHAHRO FEROZE DISTRICT,66,Male,1669,446,2115
NAUSHAHRO FEROZE DISTRICT,66,Female,1614,415,2029
NAUSHAHRO FEROZE DISTRICT,66,Transgender,0,0,0
NAUSHAHRO FEROZE DISTRICT,67,Male,1485,363,1848
NAUSHAHRO FEROZE DISTRICT,67,Female,1496,351,1847
NAUSHAHRO FEROZE DISTRICT,67,Transgender,0,1,1
NAUSHAHRO FEROZE DISTRICT,68,Male,1369,371,1740
NAUSHAHRO FEROZE DISTRICT,68,Female,1281,393,1674
NAUSHAHRO FEROZE DISTRICT,68,Transgender,2,0,2
NAUSHAHRO FEROZE DISTRICT,69,Male,1248,305,1553
NAUSHAHRO FEROZE DISTRICT,69,Female,1288,342,1630
NAUSHAHRO FEROZE DISTRICT,69,Transgender,1,0,1
NAUSHAHRO FEROZE DISTRICT,70,Male,1405,338,1743
NAUSHAHRO FEROZE DISTRICT,70,Female,1306,422,1728
NAUSHAHRO FEROZE DISTRICT,70,Transgender,5,1,6
NAUSHAHRO FEROZE DISTRICT,71,Male,1127,297,1424
NAUSHAHRO FEROZE DISTRICT,71,Female,1156,300,1456
NAUSHAHRO FEROZE DISTRICT,71,Transgender,0,1,1
NAUSHAHRO FEROZE DISTRICT,72,Male,883,255,1138
NAUSHAHRO FEROZE DISTRICT,72,Female,868,256,1124
NAUSHAHRO FEROZE DISTRICT,72,Transgender,0,0,0
NAUSHAHRO FEROZE DISTRICT,73,Male,881,233,1114
NAUSHAHRO FEROZE DISTRICT,73,Female,875,272,1147
NAUSHAHRO FEROZE DISTRICT,73,Transgender,0,0,0
NAUSHAHRO FEROZE DISTRICT,74,Male,713,205,918
NAUSHAHRO FEROZE DISTRICT,74,Female,736,205,941
NAUSHAHRO FEROZE DISTRICT,74,Transgender,0,0,0
NAUSHAHRO FEROZE DISTRICT,>=75,Male,6002,1621,7623
NAUSHAHRO FEROZE DISTRICT,>=75,Female,6389,1908,8297
NAUSHAHRO FEROZE DISTRICT,>=75,Transgender,4,2,6
NORTH WAZIRISTAN AGENCY,<1,Male,8343,16,8359
NORTH WAZIRISTAN AGENCY,<1,Female,8009,21,8030
NORTH WAZIRISTAN AGENCY,<1,Transgender,0,0,0
NORTH WAZIRISTAN AGENCY,1,Male,9132,25,9157
NORTH WAZIRISTAN AGENCY,1,Female,8609,33,8642
NORTH WAZIRISTAN AGENCY,1,Transgender,0,0,0
NORTH WAZIRISTAN AGENCY,2,Male,10683,33,10716
NORTH WAZIRISTAN AGENCY,2,Female,10335,27,10362
NORTH WAZIRISTAN AGENCY,2,Transgender,0,0,0
NORTH WAZIRISTAN AGENCY,3,Male,11162,31,11193
NORTH WAZIRISTAN AGENCY,3,Female,10660,33,10693
NORTH WAZIRISTAN AGENCY,3,Transgender,0,0,0
NORTH WAZIRISTAN AGENCY,4,Male,11236,30,11266
NORTH WAZIRISTAN AGENCY,4,Female,10839,34,10873
NORTH WAZIRISTAN AGENCY,4,Transgender,0,0,0
NORTH WAZIRISTAN AGENCY,5,Male,10899,30,10929
NORTH WAZIRISTAN AGENCY,5,Female,10044,36,10080
NORTH WAZIRISTAN AGENCY,5,Transgender,0,0,0
NORTH WAZIRISTAN AGENCY,6,Male,11132,39,11171
NORTH WAZIRISTAN AGENCY,6,Female,10079,31,10110
NORTH WAZIRISTAN AGENCY,6,Transgender,0,0,0
NORTH WAZIRISTAN AGENCY,7,Male,10796,49,10845
NORTH WAZIRISTAN AGENCY,7,Female,8819,34,8853
NORTH WAZIRISTAN AGENCY,7,Transgender,0,0,0
NORTH WAZIRISTAN AGENCY,8,Male,11446,33,11479
NORTH WAZIRISTAN AGENCY,8,Female,9365,35,9400
NORTH WAZIRISTAN AGENCY,8,Transgender,0,0,0
NORTH WAZIRISTAN AGENCY,9,Male,9404,33,9437
NORTH WAZIRISTAN AGENCY,9,Female,7824,41,7865
NORTH WAZIRISTAN AGENCY,9,Transgender,0,0,0
NORTH WAZIRISTAN AGENCY,10,Male,9486,28,9514
NORTH WAZIRISTAN AGENCY,10,Female,7603,26,7629
NORTH WAZIRISTAN AGENCY,10,Transgender,0,0,0
NORTH WAZIRISTAN AGENCY,11,Male,7662,39,7701
NORTH WAZIRISTAN AGENCY,11,Female,6400,35,6435
NORTH WAZIRISTAN AGENCY,11,Transgender,0,0,0
NORTH WAZIRISTAN AGENCY,12,Male,7576,33,7609
NORTH WAZIRISTAN AGENCY,12,Female,6189,37,6226
NORTH WAZIRISTAN AGENCY,12,Transgender,0,0,0
NORTH WAZIRISTAN AGENCY,13,Male,6725,44,6769
NORTH WAZIRISTAN AGENCY,13,Female,5307,33,5340
NORTH WAZIRISTAN AGENCY,13,Transgender,0,0,0
NORTH WAZIRISTAN AGENCY,14,Male,6050,46,6096
NORTH WAZIRISTAN AGENCY,14,Female,4990,24,5014
NORTH WAZIRISTAN AGENCY,14,Transgender,0,0,0
NORTH WAZIRISTAN AGENCY,15,Male,5651,33,5684
NORTH WAZIRISTAN AGENCY,15,Female,4905,36,4941
NORTH WAZIRISTAN AGENCY,15,Transgender,1,0,1
NORTH WAZIRISTAN AGENCY,16,Male,4550,40,4590
NORTH WAZIRISTAN AGENCY,16,Female,4641,20,4661
NORTH WAZIRISTAN AGENCY,16,Transgender,1,0,1
NORTH WAZIRISTAN AGENCY,17,Male,3848,25,3873
NORTH WAZIRISTAN AGENCY,17,Female,4841,29,4870
NORTH WAZIRISTAN AGENCY,17,Transgender,0,0,0
NORTH WAZIRISTAN AGENCY,18,Male,4536,27,4563
NORTH WAZIRISTAN AGENCY,18,Female,5602,26,5628
NORTH WAZIRISTAN AGENCY,18,Transgender,1,0,1
NORTH WAZIRISTAN AGENCY,19,Male,4450,43,4493
NORTH WAZIRISTAN AGENCY,19,Female,5352,24,5376
NORTH WAZIRISTAN AGENCY,19,Transgender,2,0,2
NORTH WAZIRISTAN AGENCY,20,Male,5223,65,5288
NORTH WAZIRISTAN AGENCY,20,Female,6206,22,6228
NORTH WAZIRISTAN AGENCY,20,Transgender,2,0,2
NORTH WAZIRISTAN AGENCY,21,Male,5784,95,5879
NORTH WAZIRISTAN AGENCY,21,Female,5368,27,5395
NORTH WAZIRISTAN AGENCY,21,Transgender,1,0,1
NORTH WAZIRISTAN AGENCY,22,Male,4241,83,4324
NORTH WAZIRISTAN AGENCY,22,Female,5166,27,5193
NORTH WAZIRISTAN AGENCY,22,Transgender,2,0,2
NORTH WAZIRISTAN AGENCY,23,Male,4375,123,4498
NORTH WAZIRISTAN AGENCY,23,Female,4626,23,4649
NORTH WAZIRISTAN AGENCY,23,Transgender,1,0,1
NORTH WAZIRISTAN AGENCY,24,Male,4108,113,4221
NORTH WAZIRISTAN AGENCY,24,Female,3999,18,4017
NORTH WAZIRISTAN AGENCY,24,Transgender,0,0,0
NORTH WAZIRISTAN AGENCY,25,Male,5061,117,5178
NORTH WAZIRISTAN AGENCY,25,Female,5198,16,5214
NORTH WAZIRISTAN AGENCY,25,Transgender,0,0,0
NORTH WAZIRISTAN AGENCY,26,Male,4351,156,4507
NORTH WAZIRISTAN AGENCY,26,Female,4022,22,4044
NORTH WAZIRISTAN AGENCY,26,Transgender,1,0,1
NORTH WAZIRISTAN AGENCY,27,Male,4766,152,4918
NORTH WAZIRISTAN AGENCY,27,Female,4879,21,4900
NORTH WAZIRISTAN AGENCY,27,Transgender,1,0,1
NORTH WAZIRISTAN AGENCY,28,Male,3994,139,4133
NORTH WAZIRISTAN AGENCY,28,Female,3774,17,3791
NORTH WAZIRISTAN AGENCY,28,Transgender,2,0,2
NORTH WAZIRISTAN AGENCY,29,Male,4212,199,4411
NORTH WAZIRISTAN AGENCY,29,Female,3775,19,3794
NORTH WAZIRISTAN AGENCY,29,Transgender,0,0,0
NORTH WAZIRISTAN AGENCY,30,Male,3752,150,3902
NORTH WAZIRISTAN AGENCY,30,Female,4104,21,4125
NORTH WAZIRISTAN AGENCY,30,Transgender,1,0,1
NORTH WAZIRISTAN AGENCY,31,Male,3555,147,3702
NORTH WAZIRISTAN AGENCY,31,Female,3245,21,3266
NORTH WAZIRISTAN AGENCY,31,Transgender,0,0,0
NORTH WAZIRISTAN AGENCY,32,Male,2955,103,3058
NORTH WAZIRISTAN AGENCY,32,Female,2880,13,2893
NORTH WAZIRISTAN AGENCY,32,Transgender,0,0,0
NORTH WAZIRISTAN AGENCY,33,Male,3180,118,3298
NORTH WAZIRISTAN AGENCY,33,Female,2739,18,2757
NORTH WAZIRISTAN AGENCY,33,Transgender,1,0,1
NORTH WAZIRISTAN AGENCY,34,Male,2568,103,2671
NORTH WAZIRISTAN AGENCY,34,Female,2061,18,2079
NORTH WAZIRISTAN AGENCY,34,Transgender,0,0,0
NORTH WAZIRISTAN AGENCY,35,Male,2390,76,2466
NORTH WAZIRISTAN AGENCY,35,Female,2807,8,2815
NORTH WAZIRISTAN AGENCY,35,Transgender,2,0,2
NORTH WAZIRISTAN AGENCY,36,Male,2205,85,2290
NORTH WAZIRISTAN AGENCY,36,Female,1953,8,1961
NORTH WAZIRISTAN AGENCY,36,Transgender,0,0,0
NORTH WAZIRISTAN AGENCY,37,Male,2312,66,2378
NORTH WAZIRISTAN AGENCY,37,Female,2468,11,2479
NORTH WAZIRISTAN AGENCY,37,Transgender,0,0,0
NORTH WAZIRISTAN AGENCY,38,Male,2272,63,2335
NORTH WAZIRISTAN AGENCY,38,Female,2154,12,2166
NORTH WAZIRISTAN AGENCY,38,Transgender,2,0,2
NORTH WAZIRISTAN AGENCY,39,Male,2242,83,2325
NORTH WAZIRISTAN AGENCY,39,Female,1989,8,1997
NORTH WAZIRISTAN AGENCY,39,Transgender,0,0,0
NORTH WAZIRISTAN AGENCY,40,Male,2200,32,2232
NORTH WAZIRISTAN AGENCY,40,Female,2956,11,2967
NORTH WAZIRISTAN AGENCY,40,Transgender,2,0,2
NORTH WAZIRISTAN AGENCY,41,Male,2040,45,2085
NORTH WAZIRISTAN AGENCY,41,Female,1785,5,1790
NORTH WAZIRISTAN AGENCY,41,Transgender,0,0,0
NORTH WAZIRISTAN AGENCY,42,Male,1503,31,1534
NORTH WAZIRISTAN AGENCY,42,Female,1797,12,1809
NORTH WAZIRISTAN AGENCY,42,Transgender,2,0,2
NORTH WAZIRISTAN AGENCY,43,Male,1598,41,1639
NORTH WAZIRISTAN AGENCY,43,Female,1696,11,1707
NORTH WAZIRISTAN AGENCY,43,Transgender,1,0,1
NORTH WAZIRISTAN AGENCY,44,Male,1295,22,1317
NORTH WAZIRISTAN AGENCY,44,Female,1416,9,1425
NORTH WAZIRISTAN AGENCY,44,Transgender,0,0,0
NORTH WAZIRISTAN AGENCY,45,Male,1392,28,1420
NORTH WAZIRISTAN AGENCY,45,Female,2028,8,2036
NORTH WAZIRISTAN AGENCY,45,Transgender,0,0,0
NORTH WAZIRISTAN AGENCY,46,Male,1107,18,1125
NORTH WAZIRISTAN AGENCY,46,Female,1214,9,1223
NORTH WAZIRISTAN AGENCY,46,Transgender,0,0,0
NORTH WAZIRISTAN AGENCY,47,Male,1272,21,1293
NORTH WAZIRISTAN AGENCY,47,Female,1623,5,1628
NORTH WAZIRISTAN AGENCY,47,Transgender,2,0,2
NORTH WAZIRISTAN AGENCY,48,Male,1118,11,1129
NORTH WAZIRISTAN AGENCY,48,Female,1233,8,1241
NORTH WAZIRISTAN AGENCY,48,Transgender,0,0,0
NORTH WAZIRISTAN AGENCY,49,Male,1261,11,1272
NORTH WAZIRISTAN AGENCY,49,Female,1279,7,1286
NORTH WAZIRISTAN AGENCY,49,Transgender,0,0,0
NORTH WAZIRISTAN AGENCY,50,Male,1399,10,1409
NORTH WAZIRISTAN AGENCY,50,Female,2044,8,2052
NORTH WAZIRISTAN AGENCY,50,Transgender,0,0,0
NORTH WAZIRISTAN AGENCY,51,Male,1195,9,1204
NORTH WAZIRISTAN AGENCY,51,Female,1217,3,1220
NORTH WAZIRISTAN AGENCY,51,Transgender,0,0,0
NORTH WAZIRISTAN AGENCY,52,Male,994,6,1000
NORTH WAZIRISTAN AGENCY,52,Female,1203,4,1207
NORTH WAZIRISTAN AGENCY,52,Transgender,0,0,0
NORTH WAZIRISTAN AGENCY,53,Male,1076,7,1083
NORTH WAZIRISTAN AGENCY,53,Female,1137,1,1138
NORTH WAZIRISTAN AGENCY,53,Transgender,0,0,0
NORTH WAZIRISTAN AGENCY,54,Male,1017,10,1027
NORTH WAZIRISTAN AGENCY,54,Female,995,1,996
NORTH WAZIRISTAN AGENCY,54,Transgender,0,0,0
NORTH WAZIRISTAN AGENCY,55,Male,1118,11,1129
NORTH WAZIRISTAN AGENCY,55,Female,1319,1,1320
NORTH WAZIRISTAN AGENCY,55,Transgender,1,0,1
NORTH WAZIRISTAN AGENCY,56,Male,900,3,903
NORTH WAZIRISTAN AGENCY,56,Female,895,0,895
NORTH WAZIRISTAN AGENCY,56,Transgender,1,0,1
NORTH WAZIRISTAN AGENCY,57,Male,1159,8,1167
NORTH WAZIRISTAN AGENCY,57,Female,1062,1,1063
NORTH WAZIRISTAN AGENCY,57,Transgender,0,0,0
NORTH WAZIRISTAN AGENCY,58,Male,814,6,820
NORTH WAZIRISTAN AGENCY,58,Female,747,2,749
NORTH WAZIRISTAN AGENCY,58,Transgender,0,0,0
NORTH WAZIRISTAN AGENCY,59,Male,926,0,926
NORTH WAZIRISTAN AGENCY,59,Female,745,2,747
NORTH WAZIRISTAN AGENCY,59,Transgender,0,0,0
NORTH WAZIRISTAN AGENCY,60,Male,1116,3,1119
NORTH WAZIRISTAN AGENCY,60,Female,1052,1,1053
NORTH WAZIRISTAN AGENCY,60,Transgender,2,0,2
NORTH WAZIRISTAN AGENCY,61,Male,1000,2,1002
NORTH WAZIRISTAN AGENCY,61,Female,639,2,641
NORTH WAZIRISTAN AGENCY,61,Transgender,0,0,0
NORTH WAZIRISTAN AGENCY,62,Male,991,2,993
NORTH WAZIRISTAN AGENCY,62,Female,809,1,810
NORTH WAZIRISTAN AGENCY,62,Transgender,0,0,0
NORTH WAZIRISTAN AGENCY,63,Male,872,0,872
NORTH WAZIRISTAN AGENCY,63,Female,644,0,644
NORTH WAZIRISTAN AGENCY,63,Transgender,0,0,0
NORTH WAZIRISTAN AGENCY,64,Male,750,1,751
NORTH WAZIRISTAN AGENCY,64,Female,586,0,586
NORTH WAZIRISTAN AGENCY,64,Transgender,0,0,0
NORTH WAZIRISTAN AGENCY,65,Male,717,2,719
NORTH WAZIRISTAN AGENCY,65,Female,542,4,546
NORTH WAZIRISTAN AGENCY,65,Transgender,0,0,0
NORTH WAZIRISTAN AGENCY,66,Male,661,2,663
NORTH WAZIRISTAN AGENCY,66,Female,375,0,375
NORTH WAZIRISTAN AGENCY,66,Transgender,0,0,0
NORTH WAZIRISTAN AGENCY,67,Male,715,0,715
NORTH WAZIRISTAN AGENCY,67,Female,496,1,497
NORTH WAZIRISTAN AGENCY,67,Transgender,1,0,1
NORTH WAZIRISTAN AGENCY,68,Male,430,0,430
NORTH WAZIRISTAN AGENCY,68,Female,341,0,341
NORTH WAZIRISTAN AGENCY,68,Transgender,0,0,0
NORTH WAZIRISTAN AGENCY,69,Male,444,2,446
NORTH WAZIRISTAN AGENCY,69,Female,311,0,311
NORTH WAZIRISTAN AGENCY,69,Transgender,0,0,0
NORTH WAZIRISTAN AGENCY,70,Male,386,1,387
NORTH WAZIRISTAN AGENCY,70,Female,416,1,417
NORTH WAZIRISTAN AGENCY,70,Transgender,0,0,0
NORTH WAZIRISTAN AGENCY,71,Male,394,1,395
NORTH WAZIRISTAN AGENCY,71,Female,267,1,268
NORTH WAZIRISTAN AGENCY,71,Transgender,0,0,0
NORTH WAZIRISTAN AGENCY,72,Male,287,1,288
NORTH WAZIRISTAN AGENCY,72,Female,281,1,282
NORTH WAZIRISTAN AGENCY,72,Transgender,0,0,0
NORTH WAZIRISTAN AGENCY,73,Male,245,0,245
NORTH WAZIRISTAN AGENCY,73,Female,231,0,231
NORTH WAZIRISTAN AGENCY,73,Transgender,0,0,0
NORTH WAZIRISTAN AGENCY,74,Male,194,1,195
NORTH WAZIRISTAN AGENCY,74,Female,221,0,221
NORTH WAZIRISTAN AGENCY,74,Transgender,0,0,0
NORTH WAZIRISTAN AGENCY,>=75,Male,1583,6,1589
NORTH WAZIRISTAN AGENCY,>=75,Female,2239,12,2251
NORTH WAZIRISTAN AGENCY,>=75,Transgender,0,0,0
NOWSHERA DISTRICT,<1,Male,16909,4255,21164
NOWSHERA DISTRICT,<1,Female,15913,4041,19954
NOWSHERA DISTRICT,<1,Transgender,0,0,0
NOWSHERA DISTRICT,1,Male,17417,4357,21774
NOWSHERA DISTRICT,1,Female,16390,4031,20421
NOWSHERA DISTRICT,1,Transgender,0,0,0
NOWSHERA DISTRICT,2,Male,18072,4478,22550
NOWSHERA DISTRICT,2,Female,17217,4240,21457
NOWSHERA DISTRICT,2,Transgender,0,0,0
NOWSHERA DISTRICT,3,Male,19069,4895,23964
NOWSHERA DISTRICT,3,Female,18439,4655,23094
NOWSHERA DISTRICT,3,Transgender,0,0,0
NOWSHERA DISTRICT,4,Male,18922,4600,23522
NOWSHERA DISTRICT,4,Female,17790,4389,22179
NOWSHERA DISTRICT,4,Transgender,0,0,0
NOWSHERA DISTRICT,5,Male,18714,4844,23558
NOWSHERA DISTRICT,5,Female,17805,4484,22289
NOWSHERA DISTRICT,5,Transgender,0,0,0
NOWSHERA DISTRICT,6,Male,18260,4575,22835
NOWSHERA DISTRICT,6,Female,17189,4308,21497
NOWSHERA DISTRICT,6,Transgender,0,0,0
NOWSHERA DISTRICT,7,Male,18622,4755,23377
NOWSHERA DISTRICT,7,Female,17843,4441,22284
NOWSHERA DISTRICT,7,Transgender,0,0,0
NOWSHERA DISTRICT,8,Male,17684,4330,22014
NOWSHERA DISTRICT,8,Female,16411,4081,20492
NOWSHERA DISTRICT,8,Transgender,0,0,0
NOWSHERA DISTRICT,9,Male,17945,4597,22542
NOWSHERA DISTRICT,9,Female,16583,4270,20853
NOWSHERA DISTRICT,9,Transgender,0,0,0
NOWSHERA DISTRICT,10,Male,16016,3929,19945
NOWSHERA DISTRICT,10,Female,14767,3822,18589
NOWSHERA DISTRICT,10,Transgender,0,0,0
NOWSHERA DISTRICT,11,Male,16626,4528,21154
NOWSHERA DISTRICT,11,Female,14665,3883,18548
NOWSHERA DISTRICT,11,Transgender,0,0,0
NOWSHERA DISTRICT,12,Male,14783,3949,18732
NOWSHERA DISTRICT,12,Female,13334,3558,16892
NOWSHERA DISTRICT,12,Transgender,0,0,0
NOWSHERA DISTRICT,13,Male,15437,4118,19555
NOWSHERA DISTRICT,13,Female,13891,3749,17640
NOWSHERA DISTRICT,13,Transgender,0,0,0
NOWSHERA DISTRICT,14,Male,14408,3848,18256
NOWSHERA DISTRICT,14,Female,13148,3481,16629
NOWSHERA DISTRICT,14,Transgender,0,0,0
NOWSHERA DISTRICT,15,Male,13994,3784,17778
NOWSHERA DISTRICT,15,Female,13203,3574,16777
NOWSHERA DISTRICT,15,Transgender,4,1,5
NOWSHERA DISTRICT,16,Male,13470,3642,17112
NOWSHERA DISTRICT,16,Female,12605,3477,16082
NOWSHERA DISTRICT,16,Transgender,1,1,2
NOWSHERA DISTRICT,17,Male,13454,3733,17187
NOWSHERA DISTRICT,17,Female,13504,3582,17086
NOWSHERA DISTRICT,17,Transgender,0,0,0
NOWSHERA DISTRICT,18,Male,12200,3687,15887
NOWSHERA DISTRICT,18,Female,12021,3236,15257
NOWSHERA DISTRICT,18,Transgender,4,1,5
NOWSHERA DISTRICT,19,Male,12366,4351,16717
NOWSHERA DISTRICT,19,Female,11705,3302,15007
NOWSHERA DISTRICT,19,Transgender,4,1,5
NOWSHERA DISTRICT,20,Male,11169,4273,15442
NOWSHERA DISTRICT,20,Female,11822,3016,14838
NOWSHERA DISTRICT,20,Transgender,4,0,4
NOWSHERA DISTRICT,21,Male,11354,5428,16782
NOWSHERA DISTRICT,21,Female,11118,3080,14198
NOWSHERA DISTRICT,21,Transgender,0,2,2
NOWSHERA DISTRICT,22,Male,9923,4450,14373
NOWSHERA DISTRICT,22,Female,10233,2893,13126
NOWSHERA DISTRICT,22,Transgender,1,2,3
NOWSHERA DISTRICT,23,Male,9888,4472,14360
NOWSHERA DISTRICT,23,Female,10279,2759,13038
NOWSHERA DISTRICT,23,Transgender,2,7,9
NOWSHERA DISTRICT,24,Male,9207,3706,12913
NOWSHERA DISTRICT,24,Female,10406,2668,13074
NOWSHERA DISTRICT,24,Transgender,4,3,7
NOWSHERA DISTRICT,25,Male,8767,3127,11894
NOWSHERA DISTRICT,25,Female,10464,2871,13335
NOWSHERA DISTRICT,25,Transgender,1,3,4
NOWSHERA DISTRICT,26,Male,9455,3490,12945
NOWSHERA DISTRICT,26,Female,10683,2852,13535
NOWSHERA DISTRICT,26,Transgender,2,2,4
NOWSHERA DISTRICT,27,Male,9344,3640,12984
NOWSHERA DISTRICT,27,Female,10729,2921,13650
NOWSHERA DISTRICT,27,Transgender,1,2,3
NOWSHERA DISTRICT,28,Male,8729,3187,11916
NOWSHERA DISTRICT,28,Female,9001,2641,11642
NOWSHERA DISTRICT,28,Transgender,4,1,5
NOWSHERA DISTRICT,29,Male,8279,3340,11619
NOWSHERA DISTRICT,29,Female,9667,2615,12282
NOWSHERA DISTRICT,29,Transgender,6,0,6
NOWSHERA DISTRICT,30,Male,7942,2949,10891
NOWSHERA DISTRICT,30,Female,8871,2624,11495
NOWSHERA DISTRICT,30,Transgender,1,5,6
NOWSHERA DISTRICT,31,Male,8151,3127,11278
NOWSHERA DISTRICT,31,Female,8854,2568,11422
NOWSHERA DISTRICT,31,Transgender,1,3,4
NOWSHERA DISTRICT,32,Male,7275,2803,10078
NOWSHERA DISTRICT,32,Female,7367,2136,9503
NOWSHERA DISTRICT,32,Transgender,0,1,1
NOWSHERA DISTRICT,33,Male,7198,2860,10058
NOWSHERA DISTRICT,33,Female,7496,2192,9688
NOWSHERA DISTRICT,33,Transgender,1,1,2
NOWSHERA DISTRICT,34,Male,7043,2624,9667
NOWSHERA DISTRICT,34,Female,6842,2052,8894
NOWSHERA DISTRICT,34,Transgender,0,1,1
NOWSHERA DISTRICT,35,Male,6078,2174,8252
NOWSHERA DISTRICT,35,Female,6173,1862,8035
NOWSHERA DISTRICT,35,Transgender,0,3,3
NOWSHERA DISTRICT,36,Male,6111,2327,8438
NOWSHERA DISTRICT,36,Female,6167,1910,8077
NOWSHERA DISTRICT,36,Transgender,0,0,0
NOWSHERA DISTRICT,37,Male,5723,2115,7838
NOWSHERA DISTRICT,37,Female,6003,1693,7696
NOWSHERA DISTRICT,37,Transgender,0,1,1
NOWSHERA DISTRICT,38,Male,5945,2387,8332
NOWSHERA DISTRICT,38,Female,5688,1779,7467
NOWSHERA DISTRICT,38,Transgender,0,2,2
NOWSHERA DISTRICT,39,Male,5950,2232,8182
NOWSHERA DISTRICT,39,Female,6142,1763,7905
NOWSHERA DISTRICT,39,Transgender,0,1,1
NOWSHERA DISTRICT,40,Male,5423,1925,7348
NOWSHERA DISTRICT,40,Female,5736,1804,7540
NOWSHERA DISTRICT,40,Transgender,1,2,3
NOWSHERA DISTRICT,41,Male,5534,1943,7477
NOWSHERA DISTRICT,41,Female,5867,1584,7451
NOWSHERA DISTRICT,41,Transgender,0,0,0
NOWSHERA DISTRICT,42,Male,4904,1748,6652
NOWSHERA DISTRICT,42,Female,4925,1413,6338
NOWSHERA DISTRICT,42,Transgender,1,0,1
NOWSHERA DISTRICT,43,Male,5031,1762,6793
NOWSHERA DISTRICT,43,Female,4809,1430,6239
NOWSHERA DISTRICT,43,Transgender,0,0,0
NOWSHERA DISTRICT,44,Male,4725,1623,6348
NOWSHERA DISTRICT,44,Female,4555,1284,5839
NOWSHERA DISTRICT,44,Transgender,1,2,3
NOWSHERA DISTRICT,45,Male,3793,1296,5089
NOWSHERA DISTRICT,45,Female,4053,1165,5218
NOWSHERA DISTRICT,45,Transgender,2,1,3
NOWSHERA DISTRICT,46,Male,4367,1450,5817
NOWSHERA DISTRICT,46,Female,4389,1118,5507
NOWSHERA DISTRICT,46,Transgender,1,2,3
NOWSHERA DISTRICT,47,Male,4001,1323,5324
NOWSHERA DISTRICT,47,Female,3910,1025,4935
NOWSHERA DISTRICT,47,Transgender,2,0,2
NOWSHERA DISTRICT,48,Male,4129,1318,5447
NOWSHERA DISTRICT,48,Female,3810,1133,4943
NOWSHERA DISTRICT,48,Transgender,1,1,2
NOWSHERA DISTRICT,49,Male,3981,1281,5262
NOWSHERA DISTRICT,49,Female,3936,1073,5009
NOWSHERA DISTRICT,49,Transgender,1,1,2
NOWSHERA DISTRICT,50,Male,3665,1156,4821
NOWSHERA DISTRICT,50,Female,4032,1036,5068
NOWSHERA DISTRICT,50,Transgender,3,1,4
NOWSHERA DISTRICT,51,Male,3955,1154,5109
NOWSHERA DISTRICT,51,Female,3648,996,4644
NOWSHERA DISTRICT,51,Transgender,1,0,1
NOWSHERA DISTRICT,52,Male,3500,1106,4606
NOWSHERA DISTRICT,52,Female,3171,859,4030
NOWSHERA DISTRICT,52,Transgender,1,0,1
NOWSHERA DISTRICT,53,Male,3507,1123,4630
NOWSHERA DISTRICT,53,Female,2909,834,3743
NOWSHERA DISTRICT,53,Transgender,0,0,0
NOWSHERA DISTRICT,54,Male,3242,963,4205
NOWSHERA DISTRICT,54,Female,2733,802,3535
NOWSHERA DISTRICT,54,Transgender,0,0,0
NOWSHERA DISTRICT,55,Male,2764,875,3639
NOWSHERA DISTRICT,55,Female,2512,678,3190
NOWSHERA DISTRICT,55,Transgender,3,1,4
NOWSHERA DISTRICT,56,Male,2918,854,3772
NOWSHERA DISTRICT,56,Female,2580,668,3248
NOWSHERA DISTRICT,56,Transgender,0,0,0
NOWSHERA DISTRICT,57,Male,2710,742,3452
NOWSHERA DISTRICT,57,Female,2475,557,3032
NOWSHERA DISTRICT,57,Transgender,0,0,0
NOWSHERA DISTRICT,58,Male,2941,843,3784
NOWSHERA DISTRICT,58,Female,2639,629,3268
NOWSHERA DISTRICT,58,Transgender,1,0,1
NOWSHERA DISTRICT,59,Male,2908,762,3670
NOWSHERA DISTRICT,59,Female,2650,635,3285
NOWSHERA DISTRICT,59,Transgender,1,0,1
NOWSHERA DISTRICT,60,Male,2635,747,3382
NOWSHERA DISTRICT,60,Female,2462,606,3068
NOWSHERA DISTRICT,60,Transgender,1,1,2
NOWSHERA DISTRICT,61,Male,2647,807,3454
NOWSHERA DISTRICT,61,Female,2328,605,2933
NOWSHERA DISTRICT,61,Transgender,0,0,0
NOWSHERA DISTRICT,62,Male,2376,719,3095
NOWSHERA DISTRICT,62,Female,2006,558,2564
NOWSHERA DISTRICT,62,Transgender,2,0,2
NOWSHERA DISTRICT,63,Male,2479,631,3110
NOWSHERA DISTRICT,63,Female,1993,555,2548
NOWSHERA DISTRICT,63,Transgender,1,0,1
NOWSHERA DISTRICT,64,Male,2440,652,3092
NOWSHERA DISTRICT,64,Female,2017,488,2505
NOWSHERA DISTRICT,64,Transgender,0,0,0
NOWSHERA DISTRICT,65,Male,1741,485,2226
NOWSHERA DISTRICT,65,Female,1535,383,1918
NOWSHERA DISTRICT,65,Transgender,1,0,1
NOWSHERA DISTRICT,66,Male,1761,491,2252
NOWSHERA DISTRICT,66,Female,1459,381,1840
NOWSHERA DISTRICT,66,Transgender,0,0,0
NOWSHERA DISTRICT,67,Male,1724,477,2201
NOWSHERA DISTRICT,67,Female,1309,356,1665
NOWSHERA DISTRICT,67,Transgender,0,0,0
NOWSHERA DISTRICT,68,Male,1650,437,2087
NOWSHERA DISTRICT,68,Female,1222,309,1531
NOWSHERA DISTRICT,68,Transgender,0,0,0
NOWSHERA DISTRICT,69,Male,1579,384,1963
NOWSHERA DISTRICT,69,Female,1349,277,1626
NOWSHERA DISTRICT,69,Transgender,1,0,1
NOWSHERA DISTRICT,70,Male,1222,321,1543
NOWSHERA DISTRICT,70,Female,1123,268,1391
NOWSHERA DISTRICT,70,Transgender,1,0,1
NOWSHERA DISTRICT,71,Male,1201,344,1545
NOWSHERA DISTRICT,71,Female,1026,256,1282
NOWSHERA DISTRICT,71,Transgender,0,0,0
NOWSHERA DISTRICT,72,Male,1167,328,1495
NOWSHERA DISTRICT,72,Female,891,256,1147
NOWSHERA DISTRICT,72,Transgender,0,0,0
NOWSHERA DISTRICT,73,Male,1037,275,1312
NOWSHERA DISTRICT,73,Female,842,222,1064
NOWSHERA DISTRICT,73,Transgender,1,0,1
NOWSHERA DISTRICT,74,Male,1007,223,1230
NOWSHERA DISTRICT,74,Female,807,184,991
NOWSHERA DISTRICT,74,Transgender,0,0,0
NOWSHERA DISTRICT,>=75,Male,6401,1537,7938
NOWSHERA DISTRICT,>=75,Female,6290,1482,7772
NOWSHERA DISTRICT,>=75,Transgender,1,0,1
NUSHKI,<1,Male,1732,612,2344
NUSHKI,<1,Female,1634,517,2151
NUSHKI,<1,Transgender,0,0,0
NUSHKI,1,Male,2358,767,3125
NUSHKI,1,Female,2344,698,3042
NUSHKI,1,Transgender,0,0,0
NUSHKI,2,Male,2540,763,3303
NUSHKI,2,Female,2385,757,3142
NUSHKI,2,Transgender,0,0,0
NUSHKI,3,Male,2522,796,3318
NUSHKI,3,Female,2326,721,3047
NUSHKI,3,Transgender,0,0,0
NUSHKI,4,Male,2383,760,3143
NUSHKI,4,Female,2337,695,3032
NUSHKI,4,Transgender,0,0,0
NUSHKI,5,Male,2283,706,2989
NUSHKI,5,Female,2112,701,2813
NUSHKI,5,Transgender,0,0,0
NUSHKI,6,Male,2188,748,2936
NUSHKI,6,Female,2050,698,2748
NUSHKI,6,Transgender,0,0,0
NUSHKI,7,Male,2371,784,3155
NUSHKI,7,Female,2215,719,2934
NUSHKI,7,Transgender,0,0,0
NUSHKI,8,Male,2256,720,2976
NUSHKI,8,Female,2035,682,2717
NUSHKI,8,Transgender,0,0,0
NUSHKI,9,Male,2188,743,2931
NUSHKI,9,Female,1970,662,2632
NUSHKI,9,Transgender,0,0,0
NUSHKI,10,Male,2040,659,2699
NUSHKI,10,Female,1881,569,2450
NUSHKI,10,Transgender,0,0,0
NUSHKI,11,Male,1904,737,2641
NUSHKI,11,Female,1708,639,2347
NUSHKI,11,Transgender,0,0,0
NUSHKI,12,Male,1782,573,2355
NUSHKI,12,Female,1581,595,2176
NUSHKI,12,Transgender,0,0,0
NUSHKI,13,Male,1716,638,2354
NUSHKI,13,Female,1519,590,2109
NUSHKI,13,Transgender,0,0,0
NUSHKI,14,Male,1607,595,2202
NUSHKI,14,Female,1559,552,2111
NUSHKI,14,Transgender,0,0,0
NUSHKI,15,Male,1455,559,2014
NUSHKI,15,Female,1514,522,2036
NUSHKI,15,Transgender,0,0,0
NUSHKI,16,Male,1446,571,2017
NUSHKI,16,Female,1346,504,1850
NUSHKI,16,Transgender,0,0,0
NUSHKI,17,Male,1327,575,1902
NUSHKI,17,Female,1236,480,1716
NUSHKI,17,Transgender,0,0,0
NUSHKI,18,Male,1561,504,2065
NUSHKI,18,Female,1387,427,1814
NUSHKI,18,Transgender,2,0,2
NUSHKI,19,Male,1488,575,2063
NUSHKI,19,Female,1237,495,1732
NUSHKI,19,Transgender,0,0,0
NUSHKI,20,Male,1294,452,1746
NUSHKI,20,Female,1264,451,1715
NUSHKI,20,Transgender,0,0,0
NUSHKI,21,Male,1242,475,1717
NUSHKI,21,Female,1237,468,1705
NUSHKI,21,Transgender,0,0,0
NUSHKI,22,Male,1122,371,1493
NUSHKI,22,Female,1065,347,1412
NUSHKI,22,Transgender,0,0,0
NUSHKI,23,Male,1058,439,1497
NUSHKI,23,Female,1027,402,1429
NUSHKI,23,Transgender,0,0,0
NUSHKI,24,Male,1080,412,1492
NUSHKI,24,Female,953,383,1336
NUSHKI,24,Transgender,0,0,0
NUSHKI,25,Male,1033,416,1449
NUSHKI,25,Female,1103,425,1528
NUSHKI,25,Transgender,0,0,0
NUSHKI,26,Male,969,426,1395
NUSHKI,26,Female,996,468,1464
NUSHKI,26,Transgender,0,0,0
NUSHKI,27,Male,1076,434,1510
NUSHKI,27,Female,1222,354,1576
NUSHKI,27,Transgender,0,0,0
NUSHKI,28,Male,1113,387,1500
NUSHKI,28,Female,1033,382,1415
NUSHKI,28,Transgender,0,0,0
NUSHKI,29,Male,976,394,1370
NUSHKI,29,Female,1010,383,1393
NUSHKI,29,Transgender,0,0,0
NUSHKI,30,Male,827,372,1199
NUSHKI,30,Female,908,319,1227
NUSHKI,30,Transgender,0,0,0
NUSHKI,31,Male,863,368,1231
NUSHKI,31,Female,932,342,1274
NUSHKI,31,Transgender,0,0,0
NUSHKI,32,Male,731,304,1035
NUSHKI,32,Female,732,240,972
NUSHKI,32,Transgender,0,0,0
NUSHKI,33,Male,776,305,1081
NUSHKI,33,Female,783,266,1049
NUSHKI,33,Transgender,0,0,0
NUSHKI,34,Male,796,317,1113
NUSHKI,34,Female,715,259,974
NUSHKI,34,Transgender,0,0,0
NUSHKI,35,Male,735,264,999
NUSHKI,35,Female,717,238,955
NUSHKI,35,Transgender,1,0,1
NUSHKI,36,Male,682,286,968
NUSHKI,36,Female,585,224,809
NUSHKI,36,Transgender,0,0,0
NUSHKI,37,Male,797,229,1026
NUSHKI,37,Female,746,189,935
NUSHKI,37,Transgender,0,0,0
NUSHKI,38,Male,699,255,954
NUSHKI,38,Female,563,213,776
NUSHKI,38,Transgender,0,0,0
NUSHKI,39,Male,646,243,889
NUSHKI,39,Female,594,219,813
NUSHKI,39,Transgender,0,0,0
NUSHKI,40,Male,547,223,770
NUSHKI,40,Female,466,189,655
NUSHKI,40,Transgender,0,0,0
NUSHKI,41,Male,574,200,774
NUSHKI,41,Female,478,184,662
NUSHKI,41,Transgender,0,0,0
NUSHKI,42,Male,396,145,541
NUSHKI,42,Female,439,130,569
NUSHKI,42,Transgender,0,0,0
NUSHKI,43,Male,457,186,643
NUSHKI,43,Female,424,161,585
NUSHKI,43,Transgender,0,0,0
NUSHKI,44,Male,417,153,570
NUSHKI,44,Female,385,129,514
NUSHKI,44,Transgender,0,0,0
NUSHKI,45,Male,391,161,552
NUSHKI,45,Female,389,178,567
NUSHKI,45,Transgender,0,0,0
NUSHKI,46,Male,347,157,504
NUSHKI,46,Female,384,144,528
NUSHKI,46,Transgender,0,0,0
NUSHKI,47,Male,462,133,595
NUSHKI,47,Female,448,113,561
NUSHKI,47,Transgender,0,0,0
NUSHKI,48,Male,388,159,547
NUSHKI,48,Female,399,161,560
NUSHKI,48,Transgender,0,0,0
NUSHKI,49,Male,471,156,627
NUSHKI,49,Female,444,145,589
NUSHKI,49,Transgender,0,0,0
NUSHKI,50,Male,381,168,549
NUSHKI,50,Female,349,143,492
NUSHKI,50,Transgender,0,0,0
NUSHKI,51,Male,448,134,582
NUSHKI,51,Female,344,108,452
NUSHKI,51,Transgender,0,0,0
NUSHKI,52,Male,348,114,462
NUSHKI,52,Female,277,76,353
NUSHKI,52,Transgender,0,0,0
NUSHKI,53,Male,366,132,498
NUSHKI,53,Female,287,114,401
NUSHKI,53,Transgender,0,0,0
NUSHKI,54,Male,337,110,447
NUSHKI,54,Female,234,84,318
NUSHKI,54,Transgender,0,0,0
NUSHKI,55,Male,230,101,331
NUSHKI,55,Female,232,79,311
NUSHKI,55,Transgender,0,0,0
NUSHKI,56,Male,244,104,348
NUSHKI,56,Female,194,82,276
NUSHKI,56,Transgender,0,0,0
NUSHKI,57,Male,245,84,329
NUSHKI,57,Female,241,63,304
NUSHKI,57,Transgender,0,0,0
NUSHKI,58,Male,260,82,342
NUSHKI,58,Female,210,80,290
NUSHKI,58,Transgender,0,0,0
NUSHKI,59,Male,252,97,349
NUSHKI,59,Female,284,65,349
NUSHKI,59,Transgender,0,0,0
NUSHKI,60,Male,192,63,255
NUSHKI,60,Female,196,79,275
NUSHKI,60,Transgender,0,0,0
NUSHKI,61,Male,251,87,338
NUSHKI,61,Female,239,84,323
NUSHKI,61,Transgender,0,0,0
NUSHKI,62,Male,231,58,289
NUSHKI,62,Female,235,60,295
NUSHKI,62,Transgender,0,0,0
NUSHKI,63,Male,191,67,258
NUSHKI,63,Female,182,70,252
NUSHKI,63,Transgender,0,0,0
NUSHKI,64,Male,235,66,301
NUSHKI,64,Female,202,39,241
NUSHKI,64,Transgender,0,0,0
NUSHKI,65,Male,133,60,193
NUSHKI,65,Female,117,52,169
NUSHKI,65,Transgender,0,0,0
NUSHKI,66,Male,179,51,230
NUSHKI,66,Female,158,70,228
NUSHKI,66,Transgender,0,0,0
NUSHKI,67,Male,169,44,213
NUSHKI,67,Female,193,38,231
NUSHKI,67,Transgender,0,0,0
NUSHKI,68,Male,111,45,156
NUSHKI,68,Female,122,47,169
NUSHKI,68,Transgender,0,0,0
NUSHKI,69,Male,150,50,200
NUSHKI,69,Female,118,36,154
NUSHKI,69,Transgender,0,0,0
NUSHKI,70,Male,107,41,148
NUSHKI,70,Female,121,36,157
NUSHKI,70,Transgender,0,0,0
NUSHKI,71,Male,126,48,174
NUSHKI,71,Female,124,45,169
NUSHKI,71,Transgender,0,0,0
NUSHKI,72,Male,124,29,153
NUSHKI,72,Female,121,24,145
NUSHKI,72,Transgender,0,0,0
NUSHKI,73,Male,79,33,112
NUSHKI,73,Female,75,28,103
NUSHKI,73,Transgender,0,0,0
NUSHKI,74,Male,91,21,112
NUSHKI,74,Female,74,20,94
NUSHKI,74,Transgender,0,0,0
NUSHKI,>=75,Male,698,185,883
NUSHKI,>=75,Female,512,164,676
NUSHKI,>=75,Transgender,0,0,0
OKARA DISTRICT,<1,Male,27431,9017,36448
OKARA DISTRICT,<1,Female,26421,8677,35098
OKARA DISTRICT,<1,Transgender,0,0,0
OKARA DISTRICT,1,Male,30071,10840,40911
OKARA DISTRICT,1,Female,28515,10303,38818
OKARA DISTRICT,1,Transgender,0,0,0
OKARA DISTRICT,2,Male,31295,10630,41925
OKARA DISTRICT,2,Female,29676,10059,39735
OKARA DISTRICT,2,Transgender,0,0,0
OKARA DISTRICT,3,Male,33541,11528,45069
OKARA DISTRICT,3,Female,32359,11078,43437
OKARA DISTRICT,3,Transgender,0,0,0
OKARA DISTRICT,4,Male,33651,10965,44616
OKARA DISTRICT,4,Female,32054,10446,42500
OKARA DISTRICT,4,Transgender,0,0,0
OKARA DISTRICT,5,Male,32516,11261,43777
OKARA DISTRICT,5,Female,30700,10569,41269
OKARA DISTRICT,5,Transgender,0,0,0
OKARA DISTRICT,6,Male,31452,10836,42288
OKARA DISTRICT,6,Female,29890,10208,40098
OKARA DISTRICT,6,Transgender,0,0,0
OKARA DISTRICT,7,Male,33845,11588,45433
OKARA DISTRICT,7,Female,32153,10998,43151
OKARA DISTRICT,7,Transgender,0,0,0
OKARA DISTRICT,8,Male,32985,10531,43516
OKARA DISTRICT,8,Female,30856,10082,40938
OKARA DISTRICT,8,Transgender,0,0,0
OKARA DISTRICT,9,Male,31106,11295,42401
OKARA DISTRICT,9,Female,28720,10473,39193
OKARA DISTRICT,9,Transgender,0,0,0
OKARA DISTRICT,10,Male,29839,10046,39885
OKARA DISTRICT,10,Female,28028,9398,37426
OKARA DISTRICT,10,Transgender,0,0,0
OKARA DISTRICT,11,Male,27456,10715,38171
OKARA DISTRICT,11,Female,25230,9850,35080
OKARA DISTRICT,11,Transgender,0,0,0
OKARA DISTRICT,12,Male,26898,9787,36685
OKARA DISTRICT,12,Female,24482,8632,33114
OKARA DISTRICT,12,Transgender,0,0,0
OKARA DISTRICT,13,Male,24705,9593,34298
OKARA DISTRICT,13,Female,22011,8948,30959
OKARA DISTRICT,13,Transgender,0,0,0
OKARA DISTRICT,14,Male,24108,8967,33075
OKARA DISTRICT,14,Female,22416,8413,30829
OKARA DISTRICT,14,Transgender,0,0,0
OKARA DISTRICT,15,Male,23016,8945,31961
OKARA DISTRICT,15,Female,21783,8500,30283
OKARA DISTRICT,15,Transgender,0,0,0
OKARA DISTRICT,16,Male,23054,8883,31937
OKARA DISTRICT,16,Female,21882,8298,30180
OKARA DISTRICT,16,Transgender,3,1,4
OKARA DISTRICT,17,Male,22392,8971,31363
OKARA DISTRICT,17,Female,20445,8570,29015
OKARA DISTRICT,17,Transgender,1,0,1
OKARA DISTRICT,18,Male,22884,8171,31055
OKARA DISTRICT,18,Female,21839,7804,29643
OKARA DISTRICT,18,Transgender,9,7,16
OKARA DISTRICT,19,Male,21433,8727,30160
OKARA DISTRICT,19,Female,20673,8564,29237
OKARA DISTRICT,19,Transgender,2,4,6
OKARA DISTRICT,20,Male,22318,8141,30459
OKARA DISTRICT,20,Female,21870,7692,29562
OKARA DISTRICT,20,Transgender,4,5,9
OKARA DISTRICT,21,Male,19828,8369,28197
OKARA DISTRICT,21,Female,19835,8576,28411
OKARA DISTRICT,21,Transgender,2,4,6
OKARA DISTRICT,22,Male,20171,8203,28374
OKARA DISTRICT,22,Female,20204,8409,28613
OKARA DISTRICT,22,Transgender,4,4,8
OKARA DISTRICT,23,Male,17878,8068,25946
OKARA DISTRICT,23,Female,17462,7946,25408
OKARA DISTRICT,23,Transgender,2,4,6
OKARA DISTRICT,24,Male,16958,8029,24987
OKARA DISTRICT,24,Female,16507,7473,23980
OKARA DISTRICT,24,Transgender,1,3,4
OKARA DISTRICT,25,Male,18541,7646,26187
OKARA DISTRICT,25,Female,19685,7259,26944
OKARA DISTRICT,25,Transgender,4,12,16
OKARA DISTRICT,26,Male,15753,8114,23867
OKARA DISTRICT,26,Female,16040,7274,23314
OKARA DISTRICT,26,Transgender,3,4,7
OKARA DISTRICT,27,Male,15630,7835,23465
OKARA DISTRICT,27,Female,15808,7378,23186
OKARA DISTRICT,27,Transgender,2,5,7
OKARA DISTRICT,28,Male,15262,7435,22697
OKARA DISTRICT,28,Female,15794,7049,22843
OKARA DISTRICT,28,Transgender,4,9,13
OKARA DISTRICT,29,Male,15027,7305,22332
OKARA DISTRICT,29,Female,15876,6745,22621
OKARA DISTRICT,29,Transgender,0,3,3
OKARA DISTRICT,30,Male,15715,7147,22862
OKARA DISTRICT,30,Female,17328,7064,24392
OKARA DISTRICT,30,Transgender,6,6,12
OKARA DISTRICT,31,Male,14070,6627,20697
OKARA DISTRICT,31,Female,14667,5977,20644
OKARA DISTRICT,31,Transgender,1,1,2
OKARA DISTRICT,32,Male,13783,6848,20631
OKARA DISTRICT,32,Female,14007,6358,20365
OKARA DISTRICT,32,Transgender,0,3,3
OKARA DISTRICT,33,Male,12878,6596,19474
OKARA DISTRICT,33,Female,13395,5820,19215
OKARA DISTRICT,33,Transgender,2,3,5
OKARA DISTRICT,34,Male,12680,6090,18770
OKARA DISTRICT,34,Female,12478,5104,17582
OKARA DISTRICT,34,Transgender,1,3,4
OKARA DISTRICT,35,Male,15111,6337,21448
OKARA DISTRICT,35,Female,14422,5757,20179
OKARA DISTRICT,35,Transgender,4,9,13
OKARA DISTRICT,36,Male,12874,5622,18496
OKARA DISTRICT,36,Female,11823,4745,16568
OKARA DISTRICT,36,Transgender,1,4,5
OKARA DISTRICT,37,Male,14015,5614,19629
OKARA DISTRICT,37,Female,13034,4977,18011
OKARA DISTRICT,37,Transgender,2,3,5
OKARA DISTRICT,38,Male,12263,5932,18195
OKARA DISTRICT,38,Female,11343,5046,16389
OKARA DISTRICT,38,Transgender,3,0,3
OKARA DISTRICT,39,Male,13136,5603,18739
OKARA DISTRICT,39,Female,12771,5176,17947
OKARA DISTRICT,39,Transgender,1,2,3
OKARA DISTRICT,40,Male,11926,5502,17428
OKARA DISTRICT,40,Female,11712,4787,16499
OKARA DISTRICT,40,Transgender,6,5,11
OKARA DISTRICT,41,Male,11706,4887,16593
OKARA DISTRICT,41,Female,11322,4185,15507
OKARA DISTRICT,41,Transgender,1,2,3
OKARA DISTRICT,42,Male,11167,4651,15818
OKARA DISTRICT,42,Female,10757,4183,14940
OKARA DISTRICT,42,Transgender,3,4,7
OKARA DISTRICT,43,Male,9397,4097,13494
OKARA DISTRICT,43,Female,9083,3824,12907
OKARA DISTRICT,43,Transgender,0,0,0
OKARA DISTRICT,44,Male,8780,3664,12444
OKARA DISTRICT,44,Female,8394,3337,11731
OKARA DISTRICT,44,Transgender,2,1,3
OKARA DISTRICT,45,Male,9585,4142,13727
OKARA DISTRICT,45,Female,9167,3823,12990
OKARA DISTRICT,45,Transgender,8,6,14
OKARA DISTRICT,46,Male,8305,3236,11541
OKARA DISTRICT,46,Female,7534,2809,10343
OKARA DISTRICT,46,Transgender,2,4,6
OKARA DISTRICT,47,Male,9623,3518,13141
OKARA DISTRICT,47,Female,9006,3175,12181
OKARA DISTRICT,47,Transgender,1,4,5
OKARA DISTRICT,48,Male,8255,3542,11797
OKARA DISTRICT,48,Female,7800,3315,11115
OKARA DISTRICT,48,Transgender,3,3,6
OKARA DISTRICT,49,Male,9385,3653,13038
OKARA DISTRICT,49,Female,8725,3439,12164
OKARA DISTRICT,49,Transgender,0,0,0
OKARA DISTRICT,50,Male,9122,3866,12988
OKARA DISTRICT,50,Female,8427,3490,11917
OKARA DISTRICT,50,Transgender,5,6,11
OKARA DISTRICT,51,Male,9078,3454,12532
OKARA DISTRICT,51,Female,8181,3083,11264
OKARA DISTRICT,51,Transgender,0,0,0
OKARA DISTRICT,52,Male,9173,3449,12622
OKARA DISTRICT,52,Female,8355,2937,11292
OKARA DISTRICT,52,Transgender,0,0,0
OKARA DISTRICT,53,Male,7771,3271,11042
OKARA DISTRICT,53,Female,6823,2887,9710
OKARA DISTRICT,53,Transgender,3,1,4
OKARA DISTRICT,54,Male,7276,2810,10086
OKARA DISTRICT,54,Female,6129,2464,8593
OKARA DISTRICT,54,Transgender,1,0,1
OKARA DISTRICT,55,Male,7281,3059,10340
OKARA DISTRICT,55,Female,5791,2351,8142
OKARA DISTRICT,55,Transgender,0,4,4
OKARA DISTRICT,56,Male,6075,2248,8323
OKARA DISTRICT,56,Female,4918,1861,6779
OKARA DISTRICT,56,Transgender,0,0,0
OKARA DISTRICT,57,Male,6640,2279,8919
OKARA DISTRICT,57,Female,5732,1774,7506
OKARA DISTRICT,57,Transgender,0,2,2
OKARA DISTRICT,58,Male,5151,1999,7150
OKARA DISTRICT,58,Female,4550,1698,6248
OKARA DISTRICT,58,Transgender,3,3,6
OKARA DISTRICT,59,Male,5286,1912,7198
OKARA DISTRICT,59,Female,4886,1727,6613
OKARA DISTRICT,59,Transgender,0,0,0
OKARA DISTRICT,60,Male,5476,2071,7547
OKARA DISTRICT,60,Female,5108,1840,6948
OKARA DISTRICT,60,Transgender,2,7,9
OKARA DISTRICT,61,Male,4989,1855,6844
OKARA DISTRICT,61,Female,4671,1573,6244
OKARA DISTRICT,61,Transgender,2,0,2
OKARA DISTRICT,62,Male,5111,1852,6963
OKARA DISTRICT,62,Female,4737,1524,6261
OKARA DISTRICT,62,Transgender,2,2,4
OKARA DISTRICT,63,Male,4604,1866,6470
OKARA DISTRICT,63,Female,4246,1551,5797
OKARA DISTRICT,63,Transgender,1,0,1
OKARA DISTRICT,64,Male,4470,1456,5926
OKARA DISTRICT,64,Female,4225,1454,5679
OKARA DISTRICT,64,Transgender,0,0,0
OKARA DISTRICT,65,Male,4511,1657,6168
OKARA DISTRICT,65,Female,4185,1440,5625
OKARA DISTRICT,65,Transgender,3,0,3
OKARA DISTRICT,66,Male,3387,1090,4477
OKARA DISTRICT,66,Female,3029,898,3927
OKARA DISTRICT,66,Transgender,1,0,1
OKARA DISTRICT,67,Male,3841,1085,4926
OKARA DISTRICT,67,Female,3403,999,4402
OKARA DISTRICT,67,Transgender,1,0,1
OKARA DISTRICT,68,Male,3379,1064,4443
OKARA DISTRICT,68,Female,2978,966,3944
OKARA DISTRICT,68,Transgender,1,0,1
OKARA DISTRICT,69,Male,3628,1071,4699
OKARA DISTRICT,69,Female,3246,973,4219
OKARA DISTRICT,69,Transgender,0,0,0
OKARA DISTRICT,70,Male,3898,1158,5056
OKARA DISTRICT,70,Female,3348,1024,4372
OKARA DISTRICT,70,Transgender,0,1,1
OKARA DISTRICT,71,Male,3335,960,4295
OKARA DISTRICT,71,Female,2715,899,3614
OKARA DISTRICT,71,Transgender,1,1,2
OKARA DISTRICT,72,Male,3178,945,4123
OKARA DISTRICT,72,Female,2601,843,3444
OKARA DISTRICT,72,Transgender,1,1,2
OKARA DISTRICT,73,Male,2947,869,3816
OKARA DISTRICT,73,Female,2444,740,3184
OKARA DISTRICT,73,Transgender,0,1,1
OKARA DISTRICT,74,Male,2760,759,3519
OKARA DISTRICT,74,Female,2194,593,2787
OKARA DISTRICT,74,Transgender,1,0,1
OKARA DISTRICT,>=75,Male,19093,5458,24551
OKARA DISTRICT,>=75,Female,16075,4931,21006
OKARA DISTRICT,>=75,Transgender,9,3,12
ORAKZAI AGENCY,<1,Male,3899,0,3899
ORAKZAI AGENCY,<1,Female,3630,0,3630
ORAKZAI AGENCY,<1,Transgender,0,0,0
ORAKZAI AGENCY,1,Male,4607,0,4607
ORAKZAI AGENCY,1,Female,4335,0,4335
ORAKZAI AGENCY,1,Transgender,0,0,0
ORAKZAI AGENCY,2,Male,5200,0,5200
ORAKZAI AGENCY,2,Female,4977,0,4977
ORAKZAI AGENCY,2,Transgender,0,0,0
ORAKZAI AGENCY,3,Male,5301,0,5301
ORAKZAI AGENCY,3,Female,4854,0,4854
ORAKZAI AGENCY,3,Transgender,0,0,0
ORAKZAI AGENCY,4,Male,5043,0,5043
ORAKZAI AGENCY,4,Female,4947,0,4947
ORAKZAI AGENCY,4,Transgender,0,0,0
ORAKZAI AGENCY,5,Male,4955,0,4955
ORAKZAI AGENCY,5,Female,4517,0,4517
ORAKZAI AGENCY,5,Transgender,0,0,0
ORAKZAI AGENCY,6,Male,5023,0,5023
ORAKZAI AGENCY,6,Female,4642,0,4642
ORAKZAI AGENCY,6,Transgender,0,0,0
ORAKZAI AGENCY,7,Male,4690,0,4690
ORAKZAI AGENCY,7,Female,4189,0,4189
ORAKZAI AGENCY,7,Transgender,0,0,0
ORAKZAI AGENCY,8,Male,5009,0,5009
ORAKZAI AGENCY,8,Female,4536,0,4536
ORAKZAI AGENCY,8,Transgender,0,0,0
ORAKZAI AGENCY,9,Male,4437,0,4437
ORAKZAI AGENCY,9,Female,3907,0,3907
ORAKZAI AGENCY,9,Transgender,0,0,0
ORAKZAI AGENCY,10,Male,4501,0,4501
ORAKZAI AGENCY,10,Female,3960,0,3960
ORAKZAI AGENCY,10,Transgender,0,0,0
ORAKZAI AGENCY,11,Male,3578,0,3578
ORAKZAI AGENCY,11,Female,3288,0,3288
ORAKZAI AGENCY,11,Transgender,0,0,0
ORAKZAI AGENCY,12,Male,3535,0,3535
ORAKZAI AGENCY,12,Female,3212,0,3212
ORAKZAI AGENCY,12,Transgender,0,0,0
ORAKZAI AGENCY,13,Male,3337,0,3337
ORAKZAI AGENCY,13,Female,3185,0,3185
ORAKZAI AGENCY,13,Transgender,0,0,0
ORAKZAI AGENCY,14,Male,3010,0,3010
ORAKZAI AGENCY,14,Female,2778,0,2778
ORAKZAI AGENCY,14,Transgender,0,0,0
ORAKZAI AGENCY,15,Male,2864,0,2864
ORAKZAI AGENCY,15,Female,2851,0,2851
ORAKZAI AGENCY,15,Transgender,0,0,0
ORAKZAI AGENCY,16,Male,2539,0,2539
ORAKZAI AGENCY,16,Female,2431,0,2431
ORAKZAI AGENCY,16,Transgender,0,0,0
ORAKZAI AGENCY,17,Male,2190,0,2190
ORAKZAI AGENCY,17,Female,2288,0,2288
ORAKZAI AGENCY,17,Transgender,0,0,0
ORAKZAI AGENCY,18,Male,2177,0,2177
ORAKZAI AGENCY,18,Female,2250,0,2250
ORAKZAI AGENCY,18,Transgender,0,0,0
ORAKZAI AGENCY,19,Male,2215,0,2215
ORAKZAI AGENCY,19,Female,2171,0,2171
ORAKZAI AGENCY,19,Transgender,0,0,0
ORAKZAI AGENCY,20,Male,2165,0,2165
ORAKZAI AGENCY,20,Female,2271,0,2271
ORAKZAI AGENCY,20,Transgender,2,0,2
ORAKZAI AGENCY,21,Male,2006,0,2006
ORAKZAI AGENCY,21,Female,2053,0,2053
ORAKZAI AGENCY,21,Transgender,0,0,0
ORAKZAI AGENCY,22,Male,1676,0,1676
ORAKZAI AGENCY,22,Female,1590,0,1590
ORAKZAI AGENCY,22,Transgender,0,0,0
ORAKZAI AGENCY,23,Male,1896,0,1896
ORAKZAI AGENCY,23,Female,2030,0,2030
ORAKZAI AGENCY,23,Transgender,0,0,0
ORAKZAI AGENCY,24,Male,1852,0,1852
ORAKZAI AGENCY,24,Female,1990,0,1990
ORAKZAI AGENCY,24,Transgender,0,0,0
ORAKZAI AGENCY,25,Male,1942,0,1942
ORAKZAI AGENCY,25,Female,2146,0,2146
ORAKZAI AGENCY,25,Transgender,0,0,0
ORAKZAI AGENCY,26,Male,2006,0,2006
ORAKZAI AGENCY,26,Female,2265,0,2265
ORAKZAI AGENCY,26,Transgender,0,0,0
ORAKZAI AGENCY,27,Male,1863,0,1863
ORAKZAI AGENCY,27,Female,2186,0,2186
ORAKZAI AGENCY,27,Transgender,0,0,0
ORAKZAI AGENCY,28,Male,1633,0,1633
ORAKZAI AGENCY,28,Female,1917,0,1917
ORAKZAI AGENCY,28,Transgender,2,0,2
ORAKZAI AGENCY,29,Male,1674,0,1674
ORAKZAI AGENCY,29,Female,2106,0,2106
ORAKZAI AGENCY,29,Transgender,0,0,0
ORAKZAI AGENCY,30,Male,1476,0,1476
ORAKZAI AGENCY,30,Female,1665,0,1665
ORAKZAI AGENCY,30,Transgender,0,0,0
ORAKZAI AGENCY,31,Male,1663,0,1663
ORAKZAI AGENCY,31,Female,1965,0,1965
ORAKZAI AGENCY,31,Transgender,0,0,0
ORAKZAI AGENCY,32,Male,1341,0,1341
ORAKZAI AGENCY,32,Female,1471,0,1471
ORAKZAI AGENCY,32,Transgender,0,0,0
ORAKZAI AGENCY,33,Male,1387,0,1387
ORAKZAI AGENCY,33,Female,1440,0,1440
ORAKZAI AGENCY,33,Transgender,0,0,0
ORAKZAI AGENCY,34,Male,1300,0,1300
ORAKZAI AGENCY,34,Female,1220,0,1220
ORAKZAI AGENCY,34,Transgender,0,0,0
ORAKZAI AGENCY,35,Male,1048,0,1048
ORAKZAI AGENCY,35,Female,1201,0,1201
ORAKZAI AGENCY,35,Transgender,1,0,1
ORAKZAI AGENCY,36,Male,987,0,987
ORAKZAI AGENCY,36,Female,1206,0,1206
ORAKZAI AGENCY,36,Transgender,1,0,1
ORAKZAI AGENCY,37,Male,1072,0,1072
ORAKZAI AGENCY,37,Female,1130,0,1130
ORAKZAI AGENCY,37,Transgender,0,0,0
ORAKZAI AGENCY,38,Male,993,0,993
ORAKZAI AGENCY,38,Female,968,0,968
ORAKZAI AGENCY,38,Transgender,0,0,0
ORAKZAI AGENCY,39,Male,905,0,905
ORAKZAI AGENCY,39,Female,983,0,983
ORAKZAI AGENCY,39,Transgender,0,0,0
ORAKZAI AGENCY,40,Male,889,0,889
ORAKZAI AGENCY,40,Female,1213,0,1213
ORAKZAI AGENCY,40,Transgender,0,0,0
ORAKZAI AGENCY,41,Male,965,0,965
ORAKZAI AGENCY,41,Female,1067,0,1067
ORAKZAI AGENCY,41,Transgender,0,0,0
ORAKZAI AGENCY,42,Male,740,0,740
ORAKZAI AGENCY,42,Female,790,0,790
ORAKZAI AGENCY,42,Transgender,0,0,0
ORAKZAI AGENCY,43,Male,750,0,750
ORAKZAI AGENCY,43,Female,849,0,849
ORAKZAI AGENCY,43,Transgender,0,0,0
ORAKZAI AGENCY,44,Male,731,0,731
ORAKZAI AGENCY,44,Female,806,0,806
ORAKZAI AGENCY,44,Transgender,0,0,0
ORAKZAI AGENCY,45,Male,631,0,631
ORAKZAI AGENCY,45,Female,808,0,808
ORAKZAI AGENCY,45,Transgender,0,0,0
ORAKZAI AGENCY,46,Male,738,0,738
ORAKZAI AGENCY,46,Female,964,0,964
ORAKZAI AGENCY,46,Transgender,1,0,1
ORAKZAI AGENCY,47,Male,694,0,694
ORAKZAI AGENCY,47,Female,844,0,844
ORAKZAI AGENCY,47,Transgender,1,0,1
ORAKZAI AGENCY,48,Male,626,0,626
ORAKZAI AGENCY,48,Female,695,0,695
ORAKZAI AGENCY,48,Transgender,0,0,0
ORAKZAI AGENCY,49,Male,603,0,603
ORAKZAI AGENCY,49,Female,666,0,666
ORAKZAI AGENCY,49,Transgender,0,0,0
ORAKZAI AGENCY,50,Male,659,0,659
ORAKZAI AGENCY,50,Female,877,0,877
ORAKZAI AGENCY,50,Transgender,0,0,0
ORAKZAI AGENCY,51,Male,635,0,635
ORAKZAI AGENCY,51,Female,792,0,792
ORAKZAI AGENCY,51,Transgender,1,0,1
ORAKZAI AGENCY,52,Male,546,0,546
ORAKZAI AGENCY,52,Female,644,0,644
ORAKZAI AGENCY,52,Transgender,0,0,0
ORAKZAI AGENCY,53,Male,567,0,567
ORAKZAI AGENCY,53,Female,646,0,646
ORAKZAI AGENCY,53,Transgender,0,0,0
ORAKZAI AGENCY,54,Male,530,0,530
ORAKZAI AGENCY,54,Female,541,0,541
ORAKZAI AGENCY,54,Transgender,1,0,1
ORAKZAI AGENCY,55,Male,545,0,545
ORAKZAI AGENCY,55,Female,597,0,597
ORAKZAI AGENCY,55,Transgender,0,0,0
ORAKZAI AGENCY,56,Male,558,0,558
ORAKZAI AGENCY,56,Female,656,0,656
ORAKZAI AGENCY,56,Transgender,0,0,0
ORAKZAI AGENCY,57,Male,528,0,528
ORAKZAI AGENCY,57,Female,574,0,574
ORAKZAI AGENCY,57,Transgender,0,0,0
ORAKZAI AGENCY,58,Male,479,0,479
ORAKZAI AGENCY,58,Female,379,0,379
ORAKZAI AGENCY,58,Transgender,0,0,0
ORAKZAI AGENCY,59,Male,469,0,469
ORAKZAI AGENCY,59,Female,379,0,379
ORAKZAI AGENCY,59,Transgender,0,0,0
ORAKZAI AGENCY,60,Male,458,0,458
ORAKZAI AGENCY,60,Female,529,0,529
ORAKZAI AGENCY,60,Transgender,0,0,0
ORAKZAI AGENCY,61,Male,461,0,461
ORAKZAI AGENCY,61,Female,509,0,509
ORAKZAI AGENCY,61,Transgender,0,0,0
ORAKZAI AGENCY,62,Male,404,0,404
ORAKZAI AGENCY,62,Female,389,0,389
ORAKZAI AGENCY,62,Transgender,0,0,0
ORAKZAI AGENCY,63,Male,432,0,432
ORAKZAI AGENCY,63,Female,327,0,327
ORAKZAI AGENCY,63,Transgender,0,0,0
ORAKZAI AGENCY,64,Male,409,0,409
ORAKZAI AGENCY,64,Female,335,0,335
ORAKZAI AGENCY,64,Transgender,0,0,0
ORAKZAI AGENCY,65,Male,324,0,324
ORAKZAI AGENCY,65,Female,317,0,317
ORAKZAI AGENCY,65,Transgender,0,0,0
ORAKZAI AGENCY,66,Male,349,0,349
ORAKZAI AGENCY,66,Female,342,0,342
ORAKZAI AGENCY,66,Transgender,0,0,0
ORAKZAI AGENCY,67,Male,333,0,333
ORAKZAI AGENCY,67,Female,280,0,280
ORAKZAI AGENCY,67,Transgender,0,0,0
ORAKZAI AGENCY,68,Male,284,0,284
ORAKZAI AGENCY,68,Female,216,0,216
ORAKZAI AGENCY,68,Transgender,0,0,0
ORAKZAI AGENCY,69,Male,292,0,292
ORAKZAI AGENCY,69,Female,187,0,187
ORAKZAI AGENCY,69,Transgender,0,0,0
ORAKZAI AGENCY,70,Male,227,0,227
ORAKZAI AGENCY,70,Female,184,0,184
ORAKZAI AGENCY,70,Transgender,0,0,0
ORAKZAI AGENCY,71,Male,224,0,224
ORAKZAI AGENCY,71,Female,162,0,162
ORAKZAI AGENCY,71,Transgender,0,0,0
ORAKZAI AGENCY,72,Male,166,0,166
ORAKZAI AGENCY,72,Female,134,0,134
ORAKZAI AGENCY,72,Transgender,0,0,0
ORAKZAI AGENCY,73,Male,180,0,180
ORAKZAI AGENCY,73,Female,126,0,126
ORAKZAI AGENCY,73,Transgender,0,0,0
ORAKZAI AGENCY,74,Male,155,0,155
ORAKZAI AGENCY,74,Female,101,0,101
ORAKZAI AGENCY,74,Transgender,0,0,0
ORAKZAI AGENCY,>=75,Male,988,0,988
ORAKZAI AGENCY,>=75,Female,1052,0,1052
ORAKZAI AGENCY,>=75,Transgender,1,0,1
PAKPATTAN DISTRICT,<1,Male,21244,3634,24878
PAKPATTAN DISTRICT,<1,Female,20099,3416,23515
PAKPATTAN DISTRICT,<1,Transgender,0,0,0
PAKPATTAN DISTRICT,1,Male,21884,3772,25656
PAKPATTAN DISTRICT,1,Female,21054,3657,24711
PAKPATTAN DISTRICT,1,Transgender,0,0,0
PAKPATTAN DISTRICT,2,Male,21602,3790,25392
PAKPATTAN DISTRICT,2,Female,20635,3550,24185
PAKPATTAN DISTRICT,2,Transgender,0,0,0
PAKPATTAN DISTRICT,3,Male,23231,3986,27217
PAKPATTAN DISTRICT,3,Female,22279,3870,26149
PAKPATTAN DISTRICT,3,Transgender,0,0,0
PAKPATTAN DISTRICT,4,Male,24111,4008,28119
PAKPATTAN DISTRICT,4,Female,22761,3798,26559
PAKPATTAN DISTRICT,4,Transgender,0,0,0
PAKPATTAN DISTRICT,5,Male,22280,3657,25937
PAKPATTAN DISTRICT,5,Female,21070,3460,24530
PAKPATTAN DISTRICT,5,Transgender,0,0,0
PAKPATTAN DISTRICT,6,Male,22772,3792,26564
PAKPATTAN DISTRICT,6,Female,21113,3534,24647
PAKPATTAN DISTRICT,6,Transgender,0,0,0
PAKPATTAN DISTRICT,7,Male,24214,4048,28262
PAKPATTAN DISTRICT,7,Female,22951,3820,26771
PAKPATTAN DISTRICT,7,Transgender,0,0,0
PAKPATTAN DISTRICT,8,Male,22908,3593,26501
PAKPATTAN DISTRICT,8,Female,21593,3357,24950
PAKPATTAN DISTRICT,8,Transgender,0,0,0
PAKPATTAN DISTRICT,9,Male,22420,3965,26385
PAKPATTAN DISTRICT,9,Female,20932,3673,24605
PAKPATTAN DISTRICT,9,Transgender,0,0,0
PAKPATTAN DISTRICT,10,Male,20527,3242,23769
PAKPATTAN DISTRICT,10,Female,18782,3007,21789
PAKPATTAN DISTRICT,10,Transgender,0,0,0
PAKPATTAN DISTRICT,11,Male,19194,3682,22876
PAKPATTAN DISTRICT,11,Female,17855,3503,21358
PAKPATTAN DISTRICT,11,Transgender,0,0,0
PAKPATTAN DISTRICT,12,Male,18008,3156,21164
PAKPATTAN DISTRICT,12,Female,16531,2921,19452
PAKPATTAN DISTRICT,12,Transgender,0,0,0
PAKPATTAN DISTRICT,13,Male,16899,3348,20247
PAKPATTAN DISTRICT,13,Female,15149,3083,18232
PAKPATTAN DISTRICT,13,Transgender,0,0,0
PAKPATTAN DISTRICT,14,Male,16303,3095,19398
PAKPATTAN DISTRICT,14,Female,15058,2820,17878
PAKPATTAN DISTRICT,14,Transgender,0,0,0
PAKPATTAN DISTRICT,15,Male,15735,3111,18846
PAKPATTAN DISTRICT,15,Female,14476,2815,17291
PAKPATTAN DISTRICT,15,Transgender,1,0,1
PAKPATTAN DISTRICT,16,Male,16036,3160,19196
PAKPATTAN DISTRICT,16,Female,14368,2869,17237
PAKPATTAN DISTRICT,16,Transgender,3,5,8
PAKPATTAN DISTRICT,17,Male,15780,3183,18963
PAKPATTAN DISTRICT,17,Female,13524,3070,16594
PAKPATTAN DISTRICT,17,Transgender,5,0,5
PAKPATTAN DISTRICT,18,Male,14612,2677,17289
PAKPATTAN DISTRICT,18,Female,14415,2565,16980
PAKPATTAN DISTRICT,18,Transgender,4,2,6
PAKPATTAN DISTRICT,19,Male,14141,2994,17135
PAKPATTAN DISTRICT,19,Female,14731,3108,17839
PAKPATTAN DISTRICT,19,Transgender,2,1,3
PAKPATTAN DISTRICT,20,Male,13408,2464,15872
PAKPATTAN DISTRICT,20,Female,13709,2538,16247
PAKPATTAN DISTRICT,20,Transgender,4,1,5
PAKPATTAN DISTRICT,21,Male,13760,2932,16692
PAKPATTAN DISTRICT,21,Female,14090,3081,17171
PAKPATTAN DISTRICT,21,Transgender,1,0,1
PAKPATTAN DISTRICT,22,Male,12736,2548,15284
PAKPATTAN DISTRICT,22,Female,13455,2782,16237
PAKPATTAN DISTRICT,22,Transgender,9,6,15
PAKPATTAN DISTRICT,23,Male,12067,2590,14657
PAKPATTAN DISTRICT,23,Female,12153,2799,14952
PAKPATTAN DISTRICT,23,Transgender,1,4,5
PAKPATTAN DISTRICT,24,Male,11434,2426,13860
PAKPATTAN DISTRICT,24,Female,12112,2660,14772
PAKPATTAN DISTRICT,24,Transgender,4,3,7
PAKPATTAN DISTRICT,25,Male,10564,2135,12699
PAKPATTAN DISTRICT,25,Female,11696,2061,13757
PAKPATTAN DISTRICT,25,Transgender,3,7,10
PAKPATTAN DISTRICT,26,Male,10955,2365,13320
PAKPATTAN DISTRICT,26,Female,12603,2726,15329
PAKPATTAN DISTRICT,26,Transgender,3,0,3
PAKPATTAN DISTRICT,27,Male,11251,2410,13661
PAKPATTAN DISTRICT,27,Female,12156,2558,14714
PAKPATTAN DISTRICT,27,Transgender,3,4,7
PAKPATTAN DISTRICT,28,Male,10847,2164,13011
PAKPATTAN DISTRICT,28,Female,11358,2415,13773
PAKPATTAN DISTRICT,28,Transgender,6,5,11
PAKPATTAN DISTRICT,29,Male,12204,2408,14612
PAKPATTAN DISTRICT,29,Female,12560,2654,15214
PAKPATTAN DISTRICT,29,Transgender,1,2,3
PAKPATTAN DISTRICT,30,Male,9225,1956,11181
PAKPATTAN DISTRICT,30,Female,9817,1814,11631
PAKPATTAN DISTRICT,30,Transgender,2,5,7
PAKPATTAN DISTRICT,31,Male,11219,2302,13521
PAKPATTAN DISTRICT,31,Female,11935,2467,14402
PAKPATTAN DISTRICT,31,Transgender,1,0,1
PAKPATTAN DISTRICT,32,Male,9410,2003,11413
PAKPATTAN DISTRICT,32,Female,10405,2238,12643
PAKPATTAN DISTRICT,32,Transgender,0,3,3
PAKPATTAN DISTRICT,33,Male,9165,2012,11177
PAKPATTAN DISTRICT,33,Female,9077,1956,11033
PAKPATTAN DISTRICT,33,Transgender,1,1,2
PAKPATTAN DISTRICT,34,Male,10157,2101,12258
PAKPATTAN DISTRICT,34,Female,9786,2005,11791
PAKPATTAN DISTRICT,34,Transgender,1,3,4
PAKPATTAN DISTRICT,35,Male,8694,1720,10414
PAKPATTAN DISTRICT,35,Female,8321,1528,9849
PAKPATTAN DISTRICT,35,Transgender,7,3,10
PAKPATTAN DISTRICT,36,Male,10720,1887,12607
PAKPATTAN DISTRICT,36,Female,10195,1971,12166
PAKPATTAN DISTRICT,36,Transgender,1,0,1
PAKPATTAN DISTRICT,37,Male,10370,1852,12222
PAKPATTAN DISTRICT,37,Female,10416,2001,12417
PAKPATTAN DISTRICT,37,Transgender,2,1,3
PAKPATTAN DISTRICT,38,Male,8729,1843,10572
PAKPATTAN DISTRICT,38,Female,7946,1752,9698
PAKPATTAN DISTRICT,38,Transgender,2,3,5
PAKPATTAN DISTRICT,39,Male,9686,1898,11584
PAKPATTAN DISTRICT,39,Female,9783,2028,11811
PAKPATTAN DISTRICT,39,Transgender,3,1,4
PAKPATTAN DISTRICT,40,Male,6334,1423,7757
PAKPATTAN DISTRICT,40,Female,6207,1243,7450
PAKPATTAN DISTRICT,40,Transgender,5,5,10
PAKPATTAN DISTRICT,41,Male,8863,1715,10578
PAKPATTAN DISTRICT,41,Female,9413,1725,11138
PAKPATTAN DISTRICT,41,Transgender,2,0,2
PAKPATTAN DISTRICT,42,Male,7559,1495,9054
PAKPATTAN DISTRICT,42,Female,8144,1511,9655
PAKPATTAN DISTRICT,42,Transgender,3,1,4
PAKPATTAN DISTRICT,43,Male,6396,1478,7874
PAKPATTAN DISTRICT,43,Female,6056,1367,7423
PAKPATTAN DISTRICT,43,Transgender,3,0,3
PAKPATTAN DISTRICT,44,Male,6686,1392,8078
PAKPATTAN DISTRICT,44,Female,6286,1273,7559
PAKPATTAN DISTRICT,44,Transgender,0,1,1
PAKPATTAN DISTRICT,45,Male,5131,1090,6221
PAKPATTAN DISTRICT,45,Female,4749,1009,5758
PAKPATTAN DISTRICT,45,Transgender,6,2,8
PAKPATTAN DISTRICT,46,Male,7001,1364,8365
PAKPATTAN DISTRICT,46,Female,6980,1375,8355
PAKPATTAN DISTRICT,46,Transgender,5,1,6
PAKPATTAN DISTRICT,47,Male,7237,1326,8563
PAKPATTAN DISTRICT,47,Female,7279,1417,8696
PAKPATTAN DISTRICT,47,Transgender,2,2,4
PAKPATTAN DISTRICT,48,Male,6168,1337,7505
PAKPATTAN DISTRICT,48,Female,5158,1174,6332
PAKPATTAN DISTRICT,48,Transgender,1,0,1
PAKPATTAN DISTRICT,49,Male,6680,1426,8106
PAKPATTAN DISTRICT,49,Female,6193,1254,7447
PAKPATTAN DISTRICT,49,Transgender,1,1,2
PAKPATTAN DISTRICT,50,Male,4693,1068,5761
PAKPATTAN DISTRICT,50,Female,4270,868,5138
PAKPATTAN DISTRICT,50,Transgender,2,0,2
PAKPATTAN DISTRICT,51,Male,6992,1417,8409
PAKPATTAN DISTRICT,51,Female,6891,1277,8168
PAKPATTAN DISTRICT,51,Transgender,0,2,2
PAKPATTAN DISTRICT,52,Male,6585,1256,7841
PAKPATTAN DISTRICT,52,Female,6166,1229,7395
PAKPATTAN DISTRICT,52,Transgender,2,2,4
PAKPATTAN DISTRICT,53,Male,5779,1157,6936
PAKPATTAN DISTRICT,53,Female,4439,998,5437
PAKPATTAN DISTRICT,53,Transgender,0,0,0
PAKPATTAN DISTRICT,54,Male,5308,1139,6447
PAKPATTAN DISTRICT,54,Female,4185,903,5088
PAKPATTAN DISTRICT,54,Transgender,1,2,3
PAKPATTAN DISTRICT,55,Male,3871,843,4714
PAKPATTAN DISTRICT,55,Female,3093,639,3732
PAKPATTAN DISTRICT,55,Transgender,4,1,5
PAKPATTAN DISTRICT,56,Male,5017,941,5958
PAKPATTAN DISTRICT,56,Female,4491,809,5300
PAKPATTAN DISTRICT,56,Transgender,0,0,0
PAKPATTAN DISTRICT,57,Male,4691,805,5496
PAKPATTAN DISTRICT,57,Female,4738,728,5466
PAKPATTAN DISTRICT,57,Transgender,2,0,2
PAKPATTAN DISTRICT,58,Male,3750,710,4460
PAKPATTAN DISTRICT,58,Female,3072,586,3658
PAKPATTAN DISTRICT,58,Transgender,1,0,1
PAKPATTAN DISTRICT,59,Male,4043,784,4827
PAKPATTAN DISTRICT,59,Female,3732,682,4414
PAKPATTAN DISTRICT,59,Transgender,2,0,2
PAKPATTAN DISTRICT,60,Male,2632,552,3184
PAKPATTAN DISTRICT,60,Female,2497,460,2957
PAKPATTAN DISTRICT,60,Transgender,3,2,5
PAKPATTAN DISTRICT,61,Male,3780,701,4481
PAKPATTAN DISTRICT,61,Female,3829,751,4580
PAKPATTAN DISTRICT,61,Transgender,0,0,0
PAKPATTAN DISTRICT,62,Male,3414,666,4080
PAKPATTAN DISTRICT,62,Female,3499,619,4118
PAKPATTAN DISTRICT,62,Transgender,2,0,2
PAKPATTAN DISTRICT,63,Male,3186,616,3802
PAKPATTAN DISTRICT,63,Female,2980,582,3562
PAKPATTAN DISTRICT,63,Transgender,1,0,1
PAKPATTAN DISTRICT,64,Male,3204,525,3729
PAKPATTAN DISTRICT,64,Female,3110,591,3701
PAKPATTAN DISTRICT,64,Transgender,2,1,3
PAKPATTAN DISTRICT,65,Male,2247,403,2650
PAKPATTAN DISTRICT,65,Female,2294,402,2696
PAKPATTAN DISTRICT,65,Transgender,1,0,1
PAKPATTAN DISTRICT,66,Male,2851,445,3296
PAKPATTAN DISTRICT,66,Female,3001,513,3514
PAKPATTAN DISTRICT,66,Transgender,1,0,1
PAKPATTAN DISTRICT,67,Male,2734,395,3129
PAKPATTAN DISTRICT,67,Female,2801,448,3249
PAKPATTAN DISTRICT,67,Transgender,1,0,1
PAKPATTAN DISTRICT,68,Male,2459,387,2846
PAKPATTAN DISTRICT,68,Female,2279,361,2640
PAKPATTAN DISTRICT,68,Transgender,1,0,1
PAKPATTAN DISTRICT,69,Male,2902,364,3266
PAKPATTAN DISTRICT,69,Female,2463,393,2856
PAKPATTAN DISTRICT,69,Transgender,1,1,2
PAKPATTAN DISTRICT,70,Male,1826,293,2119
PAKPATTAN DISTRICT,70,Female,1709,291,2000
PAKPATTAN DISTRICT,70,Transgender,3,0,3
PAKPATTAN DISTRICT,71,Male,2526,416,2942
PAKPATTAN DISTRICT,71,Female,2272,359,2631
PAKPATTAN DISTRICT,71,Transgender,0,0,0
PAKPATTAN DISTRICT,72,Male,2108,313,2421
PAKPATTAN DISTRICT,72,Female,1928,321,2249
PAKPATTAN DISTRICT,72,Transgender,0,0,0
PAKPATTAN DISTRICT,73,Male,2010,303,2313
PAKPATTAN DISTRICT,73,Female,1687,310,1997
PAKPATTAN DISTRICT,73,Transgender,0,1,1
PAKPATTAN DISTRICT,74,Male,1860,268,2128
PAKPATTAN DISTRICT,74,Female,1544,226,1770
PAKPATTAN DISTRICT,74,Transgender,0,0,0
PAKPATTAN DISTRICT,>=75,Male,12561,1802,14363
PAKPATTAN DISTRICT,>=75,Female,11133,1758,12891
PAKPATTAN DISTRICT,>=75,Transgender,5,1,6
PANJGUR DISTRICT,<1,Male,5115,1682,6797
PANJGUR DISTRICT,<1,Female,4487,1247,5734
PANJGUR DISTRICT,<1,Transgender,0,0,0
PANJGUR DISTRICT,1,Male,4306,1621,5927
PANJGUR DISTRICT,1,Female,3716,1304,5020
PANJGUR DISTRICT,1,Transgender,0,0,0
PANJGUR DISTRICT,2,Male,5358,1923,7281
PANJGUR DISTRICT,2,Female,4876,1501,6377
PANJGUR DISTRICT,2,Transgender,0,0,0
PANJGUR DISTRICT,3,Male,4663,1734,6397
PANJGUR DISTRICT,3,Female,3948,1352,5300
PANJGUR DISTRICT,3,Transgender,0,0,0
PANJGUR DISTRICT,4,Male,5474,1824,7298
PANJGUR DISTRICT,4,Female,4743,1461,6204
PANJGUR DISTRICT,4,Transgender,0,0,0
PANJGUR DISTRICT,5,Male,4752,1651,6403
PANJGUR DISTRICT,5,Female,3906,1361,5267
PANJGUR DISTRICT,5,Transgender,0,0,0
PANJGUR DISTRICT,6,Male,5203,1781,6984
PANJGUR DISTRICT,6,Female,4369,1346,5715
PANJGUR DISTRICT,6,Transgender,0,0,0
PANJGUR DISTRICT,7,Male,4289,1611,5900
PANJGUR DISTRICT,7,Female,3538,1291,4829
PANJGUR DISTRICT,7,Transgender,0,0,0
PANJGUR DISTRICT,8,Male,5510,1679,7189
PANJGUR DISTRICT,8,Female,4568,1419,5987
PANJGUR DISTRICT,8,Transgender,0,0,0
PANJGUR DISTRICT,9,Male,4839,1610,6449
PANJGUR DISTRICT,9,Female,3898,1348,5246
PANJGUR DISTRICT,9,Transgender,0,0,0
PANJGUR DISTRICT,10,Male,5104,1640,6744
PANJGUR DISTRICT,10,Female,4451,1326,5777
PANJGUR DISTRICT,10,Transgender,0,0,0
PANJGUR DISTRICT,11,Male,3935,1356,5291
PANJGUR DISTRICT,11,Female,3289,1119,4408
PANJGUR DISTRICT,11,Transgender,0,0,0
PANJGUR DISTRICT,12,Male,4029,1324,5353
PANJGUR DISTRICT,12,Female,3393,970,4363
PANJGUR DISTRICT,12,Transgender,0,0,0
PANJGUR DISTRICT,13,Male,3559,1209,4768
PANJGUR DISTRICT,13,Female,2768,973,3741
PANJGUR DISTRICT,13,Transgender,0,0,0
PANJGUR DISTRICT,14,Male,3916,1251,5167
PANJGUR DISTRICT,14,Female,2989,961,3950
PANJGUR DISTRICT,14,Transgender,0,0,0
PANJGUR DISTRICT,15,Male,3485,1132,4617
PANJGUR DISTRICT,15,Female,2543,924,3467
PANJGUR DISTRICT,15,Transgender,0,0,0
PANJGUR DISTRICT,16,Male,3218,1083,4301
PANJGUR DISTRICT,16,Female,2457,871,3328
PANJGUR DISTRICT,16,Transgender,0,0,0
PANJGUR DISTRICT,17,Male,2802,1086,3888
PANJGUR DISTRICT,17,Female,2324,903,3227
PANJGUR DISTRICT,17,Transgender,0,0,0
PANJGUR DISTRICT,18,Male,2460,939,3399
PANJGUR DISTRICT,18,Female,2284,829,3113
PANJGUR DISTRICT,18,Transgender,1,0,1
PANJGUR DISTRICT,19,Male,1931,646,2577
PANJGUR DISTRICT,19,Female,2001,745,2746
PANJGUR DISTRICT,19,Transgender,0,0,0
PANJGUR DISTRICT,20,Male,2102,747,2849
PANJGUR DISTRICT,20,Female,2277,838,3115
PANJGUR DISTRICT,20,Transgender,1,0,1
PANJGUR DISTRICT,21,Male,1795,626,2421
PANJGUR DISTRICT,21,Female,1945,665,2610
PANJGUR DISTRICT,21,Transgender,1,0,1
PANJGUR DISTRICT,22,Male,1452,575,2027
PANJGUR DISTRICT,22,Female,1621,591,2212
PANJGUR DISTRICT,22,Transgender,0,1,1
PANJGUR DISTRICT,23,Male,1304,523,1827
PANJGUR DISTRICT,23,Female,1443,570,2013
PANJGUR DISTRICT,23,Transgender,0,0,0
PANJGUR DISTRICT,24,Male,1096,451,1547
PANJGUR DISTRICT,24,Female,1354,545,1899
PANJGUR DISTRICT,24,Transgender,0,0,0
PANJGUR DISTRICT,25,Male,1515,618,2133
PANJGUR DISTRICT,25,Female,1593,607,2200
PANJGUR DISTRICT,25,Transgender,1,0,1
PANJGUR DISTRICT,26,Male,1058,428,1486
PANJGUR DISTRICT,26,Female,1328,495,1823
PANJGUR DISTRICT,26,Transgender,1,0,1
PANJGUR DISTRICT,27,Male,1309,519,1828
PANJGUR DISTRICT,27,Female,1299,588,1887
PANJGUR DISTRICT,27,Transgender,1,0,1
PANJGUR DISTRICT,28,Male,1417,523,1940
PANJGUR DISTRICT,28,Female,1561,606,2167
PANJGUR DISTRICT,28,Transgender,1,0,1
PANJGUR DISTRICT,29,Male,1305,543,1848
PANJGUR DISTRICT,29,Female,1601,574,2175
PANJGUR DISTRICT,29,Transgender,1,0,1
PANJGUR DISTRICT,30,Male,1457,556,2013
PANJGUR DISTRICT,30,Female,1556,558,2114
PANJGUR DISTRICT,30,Transgender,0,0,0
PANJGUR DISTRICT,31,Male,1093,421,1514
PANJGUR DISTRICT,31,Female,1246,422,1668
PANJGUR DISTRICT,31,Transgender,0,0,0
PANJGUR DISTRICT,32,Male,946,359,1305
PANJGUR DISTRICT,32,Female,1022,378,1400
PANJGUR DISTRICT,32,Transgender,2,0,2
PANJGUR DISTRICT,33,Male,884,331,1215
PANJGUR DISTRICT,33,Female,1062,375,1437
PANJGUR DISTRICT,33,Transgender,0,0,0
PANJGUR DISTRICT,34,Male,686,283,969
PANJGUR DISTRICT,34,Female,927,287,1214
PANJGUR DISTRICT,34,Transgender,0,0,0
PANJGUR DISTRICT,35,Male,1064,391,1455
PANJGUR DISTRICT,35,Female,1157,379,1536
PANJGUR DISTRICT,35,Transgender,1,0,1
PANJGUR DISTRICT,36,Male,746,266,1012
PANJGUR DISTRICT,36,Female,819,263,1082
PANJGUR DISTRICT,36,Transgender,1,1,2
PANJGUR DISTRICT,37,Male,834,340,1174
PANJGUR DISTRICT,37,Female,876,307,1183
PANJGUR DISTRICT,37,Transgender,0,0,0
PANJGUR DISTRICT,38,Male,1144,325,1469
PANJGUR DISTRICT,38,Female,1277,354,1631
PANJGUR DISTRICT,38,Transgender,1,1,2
PANJGUR DISTRICT,39,Male,1165,372,1537
PANJGUR DISTRICT,39,Female,1087,373,1460
PANJGUR DISTRICT,39,Transgender,2,0,2
PANJGUR DISTRICT,40,Male,1176,405,1581
PANJGUR DISTRICT,40,Female,1318,382,1700
PANJGUR DISTRICT,40,Transgender,1,0,1
PANJGUR DISTRICT,41,Male,802,323,1125
PANJGUR DISTRICT,41,Female,804,223,1027
PANJGUR DISTRICT,41,Transgender,0,0,0
PANJGUR DISTRICT,42,Male,760,203,963
PANJGUR DISTRICT,42,Female,720,233,953
PANJGUR DISTRICT,42,Transgender,0,0,0
PANJGUR DISTRICT,43,Male,708,200,908
PANJGUR DISTRICT,43,Female,814,206,1020
PANJGUR DISTRICT,43,Transgender,0,0,0
PANJGUR DISTRICT,44,Male,542,187,729
PANJGUR DISTRICT,44,Female,618,165,783
PANJGUR DISTRICT,44,Transgender,0,0,0
PANJGUR DISTRICT,45,Male,781,209,990
PANJGUR DISTRICT,45,Female,745,220,965
PANJGUR DISTRICT,45,Transgender,0,0,0
PANJGUR DISTRICT,46,Male,402,125,527
PANJGUR DISTRICT,46,Female,383,124,507
PANJGUR DISTRICT,46,Transgender,0,0,0
PANJGUR DISTRICT,47,Male,514,187,701
PANJGUR DISTRICT,47,Female,456,144,600
PANJGUR DISTRICT,47,Transgender,0,0,0
PANJGUR DISTRICT,48,Male,674,173,847
PANJGUR DISTRICT,48,Female,700,198,898
PANJGUR DISTRICT,48,Transgender,0,0,0
PANJGUR DISTRICT,49,Male,655,201,856
PANJGUR DISTRICT,49,Female,595,225,820
PANJGUR DISTRICT,49,Transgender,1,0,1
PANJGUR DISTRICT,50,Male,687,190,877
PANJGUR DISTRICT,50,Female,705,227,932
PANJGUR DISTRICT,50,Transgender,0,0,0
PANJGUR DISTRICT,51,Male,391,152,543
PANJGUR DISTRICT,51,Female,401,131,532
PANJGUR DISTRICT,51,Transgender,0,0,0
PANJGUR DISTRICT,52,Male,519,192,711
PANJGUR DISTRICT,52,Female,408,102,510
PANJGUR DISTRICT,52,Transgender,0,0,0
PANJGUR DISTRICT,53,Male,509,161,670
PANJGUR DISTRICT,53,Female,440,142,582
PANJGUR DISTRICT,53,Transgender,1,0,1
PANJGUR DISTRICT,54,Male,445,151,596
PANJGUR DISTRICT,54,Female,400,132,532
PANJGUR DISTRICT,54,Transgender,0,0,0
PANJGUR DISTRICT,55,Male,472,146,618
PANJGUR DISTRICT,55,Female,375,117,492
PANJGUR DISTRICT,55,Transgender,0,0,0
PANJGUR DISTRICT,56,Male,302,134,436
PANJGUR DISTRICT,56,Female,251,84,335
PANJGUR DISTRICT,56,Transgender,0,0,0
PANJGUR DISTRICT,57,Male,318,111,429
PANJGUR DISTRICT,57,Female,190,71,261
PANJGUR DISTRICT,57,Transgender,0,0,0
PANJGUR DISTRICT,58,Male,342,112,454
PANJGUR DISTRICT,58,Female,314,120,434
PANJGUR DISTRICT,58,Transgender,0,0,0
PANJGUR DISTRICT,59,Male,400,104,504
PANJGUR DISTRICT,59,Female,299,107,406
PANJGUR DISTRICT,59,Transgender,0,0,0
PANJGUR DISTRICT,60,Male,425,106,531
PANJGUR DISTRICT,60,Female,353,139,492
PANJGUR DISTRICT,60,Transgender,0,0,0
PANJGUR DISTRICT,61,Male,251,80,331
PANJGUR DISTRICT,61,Female,206,61,267
PANJGUR DISTRICT,61,Transgender,0,0,0
PANJGUR DISTRICT,62,Male,240,89,329
PANJGUR DISTRICT,62,Female,227,105,332
PANJGUR DISTRICT,62,Transgender,0,0,0
PANJGUR DISTRICT,63,Male,223,81,304
PANJGUR DISTRICT,63,Female,218,83,301
PANJGUR DISTRICT,63,Transgender,0,0,0
PANJGUR DISTRICT,64,Male,302,79,381
PANJGUR DISTRICT,64,Female,248,62,310
PANJGUR DISTRICT,64,Transgender,0,0,0
PANJGUR DISTRICT,65,Male,303,94,397
PANJGUR DISTRICT,65,Female,202,72,274
PANJGUR DISTRICT,65,Transgender,0,0,0
PANJGUR DISTRICT,66,Male,112,42,154
PANJGUR DISTRICT,66,Female,96,36,132
PANJGUR DISTRICT,66,Transgender,0,0,0
PANJGUR DISTRICT,67,Male,167,70,237
PANJGUR DISTRICT,67,Female,115,49,164
PANJGUR DISTRICT,67,Transgender,0,0,0
PANJGUR DISTRICT,68,Male,183,69,252
PANJGUR DISTRICT,68,Female,140,45,185
PANJGUR DISTRICT,68,Transgender,0,0,0
PANJGUR DISTRICT,69,Male,234,69,303
PANJGUR DISTRICT,69,Female,151,53,204
PANJGUR DISTRICT,69,Transgender,0,0,0
PANJGUR DISTRICT,70,Male,212,54,266
PANJGUR DISTRICT,70,Female,101,58,159
PANJGUR DISTRICT,70,Transgender,0,0,0
PANJGUR DISTRICT,71,Male,98,32,130
PANJGUR DISTRICT,71,Female,93,29,122
PANJGUR DISTRICT,71,Transgender,0,0,0
PANJGUR DISTRICT,72,Male,105,34,139
PANJGUR DISTRICT,72,Female,63,40,103
PANJGUR DISTRICT,72,Transgender,0,0,0
PANJGUR DISTRICT,73,Male,112,45,157
PANJGUR DISTRICT,73,Female,69,38,107
PANJGUR DISTRICT,73,Transgender,0,0,0
PANJGUR DISTRICT,74,Male,133,42,175
PANJGUR DISTRICT,74,Female,85,38,123
PANJGUR DISTRICT,74,Transgender,0,0,0
PANJGUR DISTRICT,>=75,Male,693,236,929
PANJGUR DISTRICT,>=75,Female,509,254,763
PANJGUR DISTRICT,>=75,Transgender,1,0,1
PESHAWAR DISTRICT,<1,Male,33834,25378,59212
PESHAWAR DISTRICT,<1,Female,31761,23928,55689
PESHAWAR DISTRICT,<1,Transgender,0,0,0
PESHAWAR DISTRICT,1,Male,35428,26831,62259
PESHAWAR DISTRICT,1,Female,33400,25336,58736
PESHAWAR DISTRICT,1,Transgender,0,0,0
PESHAWAR DISTRICT,2,Male,39020,28739,67759
PESHAWAR DISTRICT,2,Female,37056,27045,64101
PESHAWAR DISTRICT,2,Transgender,0,0,0
PESHAWAR DISTRICT,3,Male,40620,30569,71189
PESHAWAR DISTRICT,3,Female,39077,29053,68130
PESHAWAR DISTRICT,3,Transgender,0,0,0
PESHAWAR DISTRICT,4,Male,39962,28707,68669
PESHAWAR DISTRICT,4,Female,37756,27271,65027
PESHAWAR DISTRICT,4,Transgender,0,0,0
PESHAWAR DISTRICT,5,Male,39425,28794,68219
PESHAWAR DISTRICT,5,Female,36598,27185,63783
PESHAWAR DISTRICT,5,Transgender,0,0,0
PESHAWAR DISTRICT,6,Male,37913,27650,65563
PESHAWAR DISTRICT,6,Female,35561,25612,61173
PESHAWAR DISTRICT,6,Transgender,0,0,0
PESHAWAR DISTRICT,7,Male,38668,28794,67462
PESHAWAR DISTRICT,7,Female,35485,27254,62739
PESHAWAR DISTRICT,7,Transgender,0,0,0
PESHAWAR DISTRICT,8,Male,38086,26386,64472
PESHAWAR DISTRICT,8,Female,34935,24243,59178
PESHAWAR DISTRICT,8,Transgender,0,0,0
PESHAWAR DISTRICT,9,Male,36411,28125,64536
PESHAWAR DISTRICT,9,Female,32619,25669,58288
PESHAWAR DISTRICT,9,Transgender,0,0,0
PESHAWAR DISTRICT,10,Male,34779,24437,59216
PESHAWAR DISTRICT,10,Female,31555,22439,53994
PESHAWAR DISTRICT,10,Transgender,0,0,0
PESHAWAR DISTRICT,11,Male,33103,26810,59913
PESHAWAR DISTRICT,11,Female,29328,24029,53357
PESHAWAR DISTRICT,11,Transgender,0,0,0
PESHAWAR DISTRICT,12,Male,31460,23406,54866
PESHAWAR DISTRICT,12,Female,27720,21809,49529
PESHAWAR DISTRICT,12,Transgender,0,0,0
PESHAWAR DISTRICT,13,Male,31046,24958,56004
PESHAWAR DISTRICT,13,Female,28424,22954,51378
PESHAWAR DISTRICT,13,Transgender,0,0,0
PESHAWAR DISTRICT,14,Male,29351,22947,52298
PESHAWAR DISTRICT,14,Female,26920,21116,48036
PESHAWAR DISTRICT,14,Transgender,0,0,0
PESHAWAR DISTRICT,15,Male,29425,23644,53069
PESHAWAR DISTRICT,15,Female,26854,21909,48763
PESHAWAR DISTRICT,15,Transgender,7,10,17
PESHAWAR DISTRICT,16,Male,27585,23495,51080
PESHAWAR DISTRICT,16,Female,25706,21600,47306
PESHAWAR DISTRICT,16,Transgender,4,10,14
PESHAWAR DISTRICT,17,Male,26030,24467,50497
PESHAWAR DISTRICT,17,Female,25345,22058,47403
PESHAWAR DISTRICT,17,Transgender,9,13,22
PESHAWAR DISTRICT,18,Male,25321,23158,48479
PESHAWAR DISTRICT,18,Female,25004,20356,45360
PESHAWAR DISTRICT,18,Transgender,2,21,23
PESHAWAR DISTRICT,19,Male,24113,23307,47420
PESHAWAR DISTRICT,19,Female,22909,21361,44270
PESHAWAR DISTRICT,19,Transgender,5,9,14
PESHAWAR DISTRICT,20,Male,22544,20880,43424
PESHAWAR DISTRICT,20,Female,24857,19627,44484
PESHAWAR DISTRICT,20,Transgender,10,18,28
PESHAWAR DISTRICT,21,Male,21865,23223,45088
PESHAWAR DISTRICT,21,Female,21813,20804,42617
PESHAWAR DISTRICT,21,Transgender,4,6,10
PESHAWAR DISTRICT,22,Male,19415,20439,39854
PESHAWAR DISTRICT,22,Female,20144,19175,39319
PESHAWAR DISTRICT,22,Transgender,8,32,40
PESHAWAR DISTRICT,23,Male,19202,20410,39612
PESHAWAR DISTRICT,23,Female,19572,18405,37977
PESHAWAR DISTRICT,23,Transgender,5,18,23
PESHAWAR DISTRICT,24,Male,17801,19220,37021
PESHAWAR DISTRICT,24,Female,18537,17472,36009
PESHAWAR DISTRICT,24,Transgender,3,20,23
PESHAWAR DISTRICT,25,Male,18512,17529,36041
PESHAWAR DISTRICT,25,Female,21810,17659,39469
PESHAWAR DISTRICT,25,Transgender,8,24,32
PESHAWAR DISTRICT,26,Male,17391,17493,34884
PESHAWAR DISTRICT,26,Female,18489,16776,35265
PESHAWAR DISTRICT,26,Transgender,9,21,30
PESHAWAR DISTRICT,27,Male,17762,17452,35214
PESHAWAR DISTRICT,27,Female,19267,16933,36200
PESHAWAR DISTRICT,27,Transgender,4,17,21
PESHAWAR DISTRICT,28,Male,17273,16800,34073
PESHAWAR DISTRICT,28,Female,17859,16201,34060
PESHAWAR DISTRICT,28,Transgender,8,10,18
PESHAWAR DISTRICT,29,Male,16230,15914,32144
PESHAWAR DISTRICT,29,Female,17777,15692,33469
PESHAWAR DISTRICT,29,Transgender,4,7,11
PESHAWAR DISTRICT,30,Male,16077,15477,31554
PESHAWAR DISTRICT,30,Female,17794,15642,33436
PESHAWAR DISTRICT,30,Transgender,10,22,32
PESHAWAR DISTRICT,31,Male,15142,14675,29817
PESHAWAR DISTRICT,31,Female,15806,14094,29900
PESHAWAR DISTRICT,31,Transgender,5,5,10
PESHAWAR DISTRICT,32,Male,13373,13901,27274
PESHAWAR DISTRICT,32,Female,12900,12465,25365
PESHAWAR DISTRICT,32,Transgender,5,13,18
PESHAWAR DISTRICT,33,Male,13726,13956,27682
PESHAWAR DISTRICT,33,Female,13800,13044,26844
PESHAWAR DISTRICT,33,Transgender,4,10,14
PESHAWAR DISTRICT,34,Male,12234,12256,24490
PESHAWAR DISTRICT,34,Female,11432,11151,22583
PESHAWAR DISTRICT,34,Transgender,1,2,3
PESHAWAR DISTRICT,35,Male,11855,11147,23002
PESHAWAR DISTRICT,35,Female,12359,11801,24160
PESHAWAR DISTRICT,35,Transgender,8,11,19
PESHAWAR DISTRICT,36,Male,10499,10700,21199
PESHAWAR DISTRICT,36,Female,9792,9716,19508
PESHAWAR DISTRICT,36,Transgender,3,10,13
PESHAWAR DISTRICT,37,Male,10060,10389,20449
PESHAWAR DISTRICT,37,Female,10068,9320,19388
PESHAWAR DISTRICT,37,Transgender,3,6,9
PESHAWAR DISTRICT,38,Male,10844,11651,22495
PESHAWAR DISTRICT,38,Female,10245,10813,21058
PESHAWAR DISTRICT,38,Transgender,4,6,10
PESHAWAR DISTRICT,39,Male,10136,10515,20651
PESHAWAR DISTRICT,39,Female,10071,9679,19750
PESHAWAR DISTRICT,39,Transgender,1,6,7
PESHAWAR DISTRICT,40,Male,10798,11228,22026
PESHAWAR DISTRICT,40,Female,12137,11248,23385
PESHAWAR DISTRICT,40,Transgender,11,13,24
PESHAWAR DISTRICT,41,Male,9399,9441,18840
PESHAWAR DISTRICT,41,Female,9880,8582,18462
PESHAWAR DISTRICT,41,Transgender,0,2,2
PESHAWAR DISTRICT,42,Male,8031,8604,16635
PESHAWAR DISTRICT,42,Female,8227,7851,16078
PESHAWAR DISTRICT,42,Transgender,1,1,2
PESHAWAR DISTRICT,43,Male,8611,9203,17814
PESHAWAR DISTRICT,43,Female,8470,8558,17028
PESHAWAR DISTRICT,43,Transgender,3,4,7
PESHAWAR DISTRICT,44,Male,7562,7721,15283
PESHAWAR DISTRICT,44,Female,7544,7043,14587
PESHAWAR DISTRICT,44,Transgender,1,2,3
PESHAWAR DISTRICT,45,Male,7544,7734,15278
PESHAWAR DISTRICT,45,Female,8027,7842,15869
PESHAWAR DISTRICT,45,Transgender,7,5,12
PESHAWAR DISTRICT,46,Male,7206,6980,14186
PESHAWAR DISTRICT,46,Female,6739,6154,12893
PESHAWAR DISTRICT,46,Transgender,6,2,8
PESHAWAR DISTRICT,47,Male,7047,6805,13852
PESHAWAR DISTRICT,47,Female,6961,5872,12833
PESHAWAR DISTRICT,47,Transgender,2,3,5
PESHAWAR DISTRICT,48,Male,6791,7010,13801
PESHAWAR DISTRICT,48,Female,6594,6685,13279
PESHAWAR DISTRICT,48,Transgender,1,1,2
PESHAWAR DISTRICT,49,Male,6766,6745,13511
PESHAWAR DISTRICT,49,Female,6654,6648,13302
PESHAWAR DISTRICT,49,Transgender,0,3,3
PESHAWAR DISTRICT,50,Male,7128,7362,14490
PESHAWAR DISTRICT,50,Female,7685,7310,14995
PESHAWAR DISTRICT,50,Transgender,4,5,9
PESHAWAR DISTRICT,51,Male,6378,6448,12826
PESHAWAR DISTRICT,51,Female,6006,5598,11604
PESHAWAR DISTRICT,51,Transgender,2,3,5
PESHAWAR DISTRICT,52,Male,5863,6332,12195
PESHAWAR DISTRICT,52,Female,5031,5394,10425
PESHAWAR DISTRICT,52,Transgender,0,1,1
PESHAWAR DISTRICT,53,Male,5814,6528,12342
PESHAWAR DISTRICT,53,Female,5069,5495,10564
PESHAWAR DISTRICT,53,Transgender,0,0,0
PESHAWAR DISTRICT,54,Male,5218,5614,10832
PESHAWAR DISTRICT,54,Female,4555,4796,9351
PESHAWAR DISTRICT,54,Transgender,5,0,5
PESHAWAR DISTRICT,55,Male,5245,5928,11173
PESHAWAR DISTRICT,55,Female,5096,4924,10020
PESHAWAR DISTRICT,55,Transgender,4,6,10
PESHAWAR DISTRICT,56,Male,4742,4914,9656
PESHAWAR DISTRICT,56,Female,3997,3718,7715
PESHAWAR DISTRICT,56,Transgender,3,1,4
PESHAWAR DISTRICT,57,Male,4896,4680,9576
PESHAWAR DISTRICT,57,Female,4187,3418,7605
PESHAWAR DISTRICT,57,Transgender,0,1,1
PESHAWAR DISTRICT,58,Male,5120,4894,10014
PESHAWAR DISTRICT,58,Female,3994,3822,7816
PESHAWAR DISTRICT,58,Transgender,0,0,0
PESHAWAR DISTRICT,59,Male,4959,4614,9573
PESHAWAR DISTRICT,59,Female,4061,3632,7693
PESHAWAR DISTRICT,59,Transgender,2,1,3
PESHAWAR DISTRICT,60,Male,4850,4623,9473
PESHAWAR DISTRICT,60,Female,4324,3782,8106
PESHAWAR DISTRICT,60,Transgender,11,3,14
PESHAWAR DISTRICT,61,Male,4309,4415,8724
PESHAWAR DISTRICT,61,Female,3515,3303,6818
PESHAWAR DISTRICT,61,Transgender,0,2,2
PESHAWAR DISTRICT,62,Male,3838,4263,8101
PESHAWAR DISTRICT,62,Female,3113,3106,6219
PESHAWAR DISTRICT,62,Transgender,0,2,2
PESHAWAR DISTRICT,63,Male,4025,4145,8170
PESHAWAR DISTRICT,63,Female,3349,3265,6614
PESHAWAR DISTRICT,63,Transgender,2,1,3
PESHAWAR DISTRICT,64,Male,3894,3532,7426
PESHAWAR DISTRICT,64,Female,3041,2728,5769
PESHAWAR DISTRICT,64,Transgender,3,0,3
PESHAWAR DISTRICT,65,Male,3265,3110,6375
PESHAWAR DISTRICT,65,Female,2487,2357,4844
PESHAWAR DISTRICT,65,Transgender,0,6,6
PESHAWAR DISTRICT,66,Male,2738,2533,5271
PESHAWAR DISTRICT,66,Female,2053,1757,3810
PESHAWAR DISTRICT,66,Transgender,1,2,3
PESHAWAR DISTRICT,67,Male,2769,2642,5411
PESHAWAR DISTRICT,67,Female,2001,1773,3774
PESHAWAR DISTRICT,67,Transgender,0,2,2
PESHAWAR DISTRICT,68,Male,2603,2522,5125
PESHAWAR DISTRICT,68,Female,1955,1934,3889
PESHAWAR DISTRICT,68,Transgender,0,1,1
PESHAWAR DISTRICT,69,Male,2707,2058,4765
PESHAWAR DISTRICT,69,Female,1982,1697,3679
PESHAWAR DISTRICT,69,Transgender,0,2,2
PESHAWAR DISTRICT,70,Male,2304,1965,4269
PESHAWAR DISTRICT,70,Female,1813,1638,3451
PESHAWAR DISTRICT,70,Transgender,3,3,6
PESHAWAR DISTRICT,71,Male,1808,1785,3593
PESHAWAR DISTRICT,71,Female,1448,1305,2753
PESHAWAR DISTRICT,71,Transgender,0,0,0
PESHAWAR DISTRICT,72,Male,1557,1663,3220
PESHAWAR DISTRICT,72,Female,1247,1130,2377
PESHAWAR DISTRICT,72,Transgender,0,1,1
PESHAWAR DISTRICT,73,Male,1697,1701,3398
PESHAWAR DISTRICT,73,Female,1341,1279,2620
PESHAWAR DISTRICT,73,Transgender,1,0,1
PESHAWAR DISTRICT,74,Male,1508,1283,2791
PESHAWAR DISTRICT,74,Female,1147,1004,2151
PESHAWAR DISTRICT,74,Transgender,0,0,0
PESHAWAR DISTRICT,>=75,Male,10484,9356,19840
PESHAWAR DISTRICT,>=75,Female,10032,9057,19089
PESHAWAR DISTRICT,>=75,Transgender,6,6,12
PISHIN DISTRICT,<1,Male,11552,2347,13899
PISHIN DISTRICT,<1,Female,10007,1995,12002
PISHIN DISTRICT,<1,Transgender,0,0,0
PISHIN DISTRICT,1,Male,12057,2848,14905
PISHIN DISTRICT,1,Female,10743,2571,13314
PISHIN DISTRICT,1,Transgender,0,0,0
PISHIN DISTRICT,2,Male,12251,2767,15018
PISHIN DISTRICT,2,Female,11138,2437,13575
PISHIN DISTRICT,2,Transgender,0,0,0
PISHIN DISTRICT,3,Male,11954,2839,14793
PISHIN DISTRICT,3,Female,10717,2571,13288
PISHIN DISTRICT,3,Transgender,0,0,0
PISHIN DISTRICT,4,Male,11224,2558,13782
PISHIN DISTRICT,4,Female,10378,2431,12809
PISHIN DISTRICT,4,Transgender,0,0,0
PISHIN DISTRICT,5,Male,10853,2491,13344
PISHIN DISTRICT,5,Female,10087,2220,12307
PISHIN DISTRICT,5,Transgender,0,0,0
PISHIN DISTRICT,6,Male,10770,2499,13269
PISHIN DISTRICT,6,Female,9813,2287,12100
PISHIN DISTRICT,6,Transgender,0,0,0
PISHIN DISTRICT,7,Male,10561,2412,12973
PISHIN DISTRICT,7,Female,9544,2076,11620
PISHIN DISTRICT,7,Transgender,0,0,0
PISHIN DISTRICT,8,Male,10207,2355,12562
PISHIN DISTRICT,8,Female,8922,2120,11042
PISHIN DISTRICT,8,Transgender,0,0,0
PISHIN DISTRICT,9,Male,10370,2485,12855
PISHIN DISTRICT,9,Female,9250,2201,11451
PISHIN DISTRICT,9,Transgender,0,0,0
PISHIN DISTRICT,10,Male,9182,2109,11291
PISHIN DISTRICT,10,Female,8296,1912,10208
PISHIN DISTRICT,10,Transgender,0,0,0
PISHIN DISTRICT,11,Male,9188,2163,11351
PISHIN DISTRICT,11,Female,8119,1881,10000
PISHIN DISTRICT,11,Transgender,0,0,0
PISHIN DISTRICT,12,Male,8111,1911,10022
PISHIN DISTRICT,12,Female,6818,1706,8524
PISHIN DISTRICT,12,Transgender,0,0,0
PISHIN DISTRICT,13,Male,8286,1988,10274
PISHIN DISTRICT,13,Female,7117,1706,8823
PISHIN DISTRICT,13,Transgender,0,0,0
PISHIN DISTRICT,14,Male,7756,1842,9598
PISHIN DISTRICT,14,Female,6703,1626,8329
PISHIN DISTRICT,14,Transgender,0,0,0
PISHIN DISTRICT,15,Male,7441,1803,9244
PISHIN DISTRICT,15,Female,6370,1651,8021
PISHIN DISTRICT,15,Transgender,0,1,1
PISHIN DISTRICT,16,Male,6824,1642,8466
PISHIN DISTRICT,16,Female,6557,1626,8183
PISHIN DISTRICT,16,Transgender,2,0,2
PISHIN DISTRICT,17,Male,6348,1518,7866
PISHIN DISTRICT,17,Female,7345,1747,9092
PISHIN DISTRICT,17,Transgender,5,0,5
PISHIN DISTRICT,18,Male,6758,1537,8295
PISHIN DISTRICT,18,Female,7040,1730,8770
PISHIN DISTRICT,18,Transgender,1,1,2
PISHIN DISTRICT,19,Male,6678,1454,8132
PISHIN DISTRICT,19,Female,7321,1823,9144
PISHIN DISTRICT,19,Transgender,2,1,3
PISHIN DISTRICT,20,Male,6030,1385,7415
PISHIN DISTRICT,20,Female,6592,1781,8373
PISHIN DISTRICT,20,Transgender,2,1,3
PISHIN DISTRICT,21,Male,5610,1272,6882
PISHIN DISTRICT,21,Female,6260,1701,7961
PISHIN DISTRICT,21,Transgender,0,0,0
PISHIN DISTRICT,22,Male,4710,1135,5845
PISHIN DISTRICT,22,Female,4736,1271,6007
PISHIN DISTRICT,22,Transgender,0,0,0
PISHIN DISTRICT,23,Male,4523,1133,5656
PISHIN DISTRICT,23,Female,4997,1356,6353
PISHIN DISTRICT,23,Transgender,0,0,0
PISHIN DISTRICT,24,Male,4296,946,5242
PISHIN DISTRICT,24,Female,4686,1179,5865
PISHIN DISTRICT,24,Transgender,2,2,4
PISHIN DISTRICT,25,Male,4492,1119,5611
PISHIN DISTRICT,25,Female,5027,1339,6366
PISHIN DISTRICT,25,Transgender,1,1,2
PISHIN DISTRICT,26,Male,3996,981,4977
PISHIN DISTRICT,26,Female,4240,1035,5275
PISHIN DISTRICT,26,Transgender,0,1,1
PISHIN DISTRICT,27,Male,4247,1010,5257
PISHIN DISTRICT,27,Female,4550,1103,5653
PISHIN DISTRICT,27,Transgender,0,0,0
PISHIN DISTRICT,28,Male,4160,1028,5188
PISHIN DISTRICT,28,Female,4269,1094,5363
PISHIN DISTRICT,28,Transgender,1,1,2
PISHIN DISTRICT,29,Male,4149,947,5096
PISHIN DISTRICT,29,Female,4453,1102,5555
PISHIN DISTRICT,29,Transgender,0,1,1
PISHIN DISTRICT,30,Male,4002,1035,5037
PISHIN DISTRICT,30,Female,3955,1031,4986
PISHIN DISTRICT,30,Transgender,2,3,5
PISHIN DISTRICT,31,Male,3909,799,4708
PISHIN DISTRICT,31,Female,3917,990,4907
PISHIN DISTRICT,31,Transgender,1,2,3
PISHIN DISTRICT,32,Male,3220,738,3958
PISHIN DISTRICT,32,Female,3040,781,3821
PISHIN DISTRICT,32,Transgender,1,0,1
PISHIN DISTRICT,33,Male,3338,830,4168
PISHIN DISTRICT,33,Female,3033,919,3952
PISHIN DISTRICT,33,Transgender,0,1,1
PISHIN DISTRICT,34,Male,2964,722,3686
PISHIN DISTRICT,34,Female,2627,703,3330
PISHIN DISTRICT,34,Transgender,0,0,0
PISHIN DISTRICT,35,Male,2906,775,3681
PISHIN DISTRICT,35,Female,2520,765,3285
PISHIN DISTRICT,35,Transgender,0,0,0
PISHIN DISTRICT,36,Male,2649,665,3314
PISHIN DISTRICT,36,Female,2246,560,2806
PISHIN DISTRICT,36,Transgender,0,0,0
PISHIN DISTRICT,37,Male,3201,702,3903
PISHIN DISTRICT,37,Female,2737,590,3327
PISHIN DISTRICT,37,Transgender,0,0,0
PISHIN DISTRICT,38,Male,2738,826,3564
PISHIN DISTRICT,38,Female,2391,668,3059
PISHIN DISTRICT,38,Transgender,1,1,2
PISHIN DISTRICT,39,Male,2772,675,3447
PISHIN DISTRICT,39,Female,2176,617,2793
PISHIN DISTRICT,39,Transgender,0,0,0
PISHIN DISTRICT,40,Male,2442,765,3207
PISHIN DISTRICT,40,Female,2303,631,2934
PISHIN DISTRICT,40,Transgender,1,1,2
PISHIN DISTRICT,41,Male,2033,556,2589
PISHIN DISTRICT,41,Female,1865,460,2325
PISHIN DISTRICT,41,Transgender,0,0,0
PISHIN DISTRICT,42,Male,1757,418,2175
PISHIN DISTRICT,42,Female,1703,477,2180
PISHIN DISTRICT,42,Transgender,1,1,2
PISHIN DISTRICT,43,Male,1816,466,2282
PISHIN DISTRICT,43,Female,1558,466,2024
PISHIN DISTRICT,43,Transgender,0,1,1
PISHIN DISTRICT,44,Male,1502,429,1931
PISHIN DISTRICT,44,Female,1474,402,1876
PISHIN DISTRICT,44,Transgender,0,1,1
PISHIN DISTRICT,45,Male,1562,475,2037
PISHIN DISTRICT,45,Female,1506,419,1925
PISHIN DISTRICT,45,Transgender,2,4,6
PISHIN DISTRICT,46,Male,1295,309,1604
PISHIN DISTRICT,46,Female,1404,252,1656
PISHIN DISTRICT,46,Transgender,0,0,0
PISHIN DISTRICT,47,Male,1600,369,1969
PISHIN DISTRICT,47,Female,1702,369,2071
PISHIN DISTRICT,47,Transgender,0,0,0
PISHIN DISTRICT,48,Male,1540,402,1942
PISHIN DISTRICT,48,Female,1392,380,1772
PISHIN DISTRICT,48,Transgender,0,2,2
PISHIN DISTRICT,49,Male,1543,365,1908
PISHIN DISTRICT,49,Female,1388,296,1684
PISHIN DISTRICT,49,Transgender,0,0,0
PISHIN DISTRICT,50,Male,1714,434,2148
PISHIN DISTRICT,50,Female,1438,426,1864
PISHIN DISTRICT,50,Transgender,0,0,0
PISHIN DISTRICT,51,Male,1641,371,2012
PISHIN DISTRICT,51,Female,1350,310,1660
PISHIN DISTRICT,51,Transgender,0,0,0
PISHIN DISTRICT,52,Male,1398,348,1746
PISHIN DISTRICT,52,Female,1114,264,1378
PISHIN DISTRICT,52,Transgender,0,0,0
PISHIN DISTRICT,53,Male,1428,333,1761
PISHIN DISTRICT,53,Female,1052,281,1333
PISHIN DISTRICT,53,Transgender,0,0,0
PISHIN DISTRICT,54,Male,1303,281,1584
PISHIN DISTRICT,54,Female,934,255,1189
PISHIN DISTRICT,54,Transgender,0,0,0
PISHIN DISTRICT,55,Male,1184,345,1529
PISHIN DISTRICT,55,Female,883,315,1198
PISHIN DISTRICT,55,Transgender,0,1,1
PISHIN DISTRICT,56,Male,952,221,1173
PISHIN DISTRICT,56,Female,738,178,916
PISHIN DISTRICT,56,Transgender,0,0,0
PISHIN DISTRICT,57,Male,993,231,1224
PISHIN DISTRICT,57,Female,1059,226,1285
PISHIN DISTRICT,57,Transgender,0,0,0
PISHIN DISTRICT,58,Male,911,237,1148
PISHIN DISTRICT,58,Female,764,207,971
PISHIN DISTRICT,58,Transgender,0,0,0
PISHIN DISTRICT,59,Male,903,251,1154
PISHIN DISTRICT,59,Female,791,198,989
PISHIN DISTRICT,59,Transgender,0,1,1
PISHIN DISTRICT,60,Male,929,277,1206
PISHIN DISTRICT,60,Female,740,243,983
PISHIN DISTRICT,60,Transgender,0,0,0
PISHIN DISTRICT,61,Male,815,212,1027
PISHIN DISTRICT,61,Female,791,205,996
PISHIN DISTRICT,61,Transgender,0,1,1
PISHIN DISTRICT,62,Male,683,173,856
PISHIN DISTRICT,62,Female,719,162,881
PISHIN DISTRICT,62,Transgender,0,0,0
PISHIN DISTRICT,63,Male,878,228,1106
PISHIN DISTRICT,63,Female,716,178,894
PISHIN DISTRICT,63,Transgender,1,0,1
PISHIN DISTRICT,64,Male,767,212,979
PISHIN DISTRICT,64,Female,687,140,827
PISHIN DISTRICT,64,Transgender,0,1,1
PISHIN DISTRICT,65,Male,714,211,925
PISHIN DISTRICT,65,Female,566,143,709
PISHIN DISTRICT,65,Transgender,1,0,1
PISHIN DISTRICT,66,Male,564,140,704
PISHIN DISTRICT,66,Female,528,98,626
PISHIN DISTRICT,66,Transgender,0,0,0
PISHIN DISTRICT,67,Male,644,124,768
PISHIN DISTRICT,67,Female,606,111,717
PISHIN DISTRICT,67,Transgender,0,0,0
PISHIN DISTRICT,68,Male,631,145,776
PISHIN DISTRICT,68,Female,438,113,551
PISHIN DISTRICT,68,Transgender,0,0,0
PISHIN DISTRICT,69,Male,609,129,738
PISHIN DISTRICT,69,Female,442,107,549
PISHIN DISTRICT,69,Transgender,0,0,0
PISHIN DISTRICT,70,Male,535,148,683
PISHIN DISTRICT,70,Female,307,108,415
PISHIN DISTRICT,70,Transgender,1,0,1
PISHIN DISTRICT,71,Male,509,90,599
PISHIN DISTRICT,71,Female,356,81,437
PISHIN DISTRICT,71,Transgender,0,0,0
PISHIN DISTRICT,72,Male,400,78,478
PISHIN DISTRICT,72,Female,301,58,359
PISHIN DISTRICT,72,Transgender,0,0,0
PISHIN DISTRICT,73,Male,440,105,545
PISHIN DISTRICT,73,Female,270,61,331
PISHIN DISTRICT,73,Transgender,1,0,1
PISHIN DISTRICT,74,Male,406,87,493
PISHIN DISTRICT,74,Female,221,54,275
PISHIN DISTRICT,74,Transgender,0,0,0
PISHIN DISTRICT,>=75,Male,2483,552,3035
PISHIN DISTRICT,>=75,Female,1427,381,1808
PISHIN DISTRICT,>=75,Transgender,1,0,1
QUETTA DISTRICT,<1,Male,17880,13134,31014
QUETTA DISTRICT,<1,Female,16396,11711,28107
QUETTA DISTRICT,<1,Transgender,0,0,0
QUETTA DISTRICT,1,Male,24736,15198,39934
QUETTA DISTRICT,1,Female,22946,13911,36857
QUETTA DISTRICT,1,Transgender,0,0,0
QUETTA DISTRICT,2,Male,23886,15127,39013
QUETTA DISTRICT,2,Female,22266,14235,36501
QUETTA DISTRICT,2,Transgender,0,0,0
QUETTA DISTRICT,3,Male,24543,16268,40811
QUETTA DISTRICT,3,Female,23101,15122,38223
QUETTA DISTRICT,3,Transgender,0,0,0
QUETTA DISTRICT,4,Male,22655,14672,37327
QUETTA DISTRICT,4,Female,21522,13901,35423
QUETTA DISTRICT,4,Transgender,0,0,0
QUETTA DISTRICT,5,Male,22914,14925,37839
QUETTA DISTRICT,5,Female,21154,13993,35147
QUETTA DISTRICT,5,Transgender,0,0,0
QUETTA DISTRICT,6,Male,21834,14137,35971
QUETTA DISTRICT,6,Female,19860,13199,33059
QUETTA DISTRICT,6,Transgender,0,0,0
QUETTA DISTRICT,7,Male,23503,15134,38637
QUETTA DISTRICT,7,Female,21569,14182,35751
QUETTA DISTRICT,7,Transgender,0,0,0
QUETTA DISTRICT,8,Male,21028,13551,34579
QUETTA DISTRICT,8,Female,18851,12575,31426
QUETTA DISTRICT,8,Transgender,0,0,0
QUETTA DISTRICT,9,Male,22383,14871,37254
QUETTA DISTRICT,9,Female,20368,13630,33998
QUETTA DISTRICT,9,Transgender,0,0,0
QUETTA DISTRICT,10,Male,18515,12301,30816
QUETTA DISTRICT,10,Female,16703,11345,28048
QUETTA DISTRICT,10,Transgender,0,0,0
QUETTA DISTRICT,11,Male,20462,14271,34733
QUETTA DISTRICT,11,Female,17628,12768,30396
QUETTA DISTRICT,11,Transgender,0,0,0
QUETTA DISTRICT,12,Male,16592,11739,28331
QUETTA DISTRICT,12,Female,14750,10317,25067
QUETTA DISTRICT,12,Transgender,0,0,0
QUETTA DISTRICT,13,Male,18022,12838,30860
QUETTA DISTRICT,13,Female,15842,11384,27226
QUETTA DISTRICT,13,Transgender,0,0,0
QUETTA DISTRICT,14,Male,16294,11707,28001
QUETTA DISTRICT,14,Female,14420,10327,24747
QUETTA DISTRICT,14,Transgender,0,0,0
QUETTA DISTRICT,15,Male,16515,11996,28511
QUETTA DISTRICT,15,Female,14527,10773,25300
QUETTA DISTRICT,15,Transgender,1,3,4
QUETTA DISTRICT,16,Male,15897,11930,27827
QUETTA DISTRICT,16,Female,13446,10462,23908
QUETTA DISTRICT,16,Transgender,4,2,6
QUETTA DISTRICT,17,Male,15519,12304,27823
QUETTA DISTRICT,17,Female,13622,10846,24468
QUETTA DISTRICT,17,Transgender,2,4,6
QUETTA DISTRICT,18,Male,15049,11395,26444
QUETTA DISTRICT,18,Female,13029,9604,22633
QUETTA DISTRICT,18,Transgender,5,4,9
QUETTA DISTRICT,19,Male,15151,12105,27256
QUETTA DISTRICT,19,Female,13969,11174,25143
QUETTA DISTRICT,19,Transgender,1,3,4
QUETTA DISTRICT,20,Male,12668,10015,22683
QUETTA DISTRICT,20,Female,11819,8954,20773
QUETTA DISTRICT,20,Transgender,6,6,12
QUETTA DISTRICT,21,Male,13863,11509,25372
QUETTA DISTRICT,21,Female,12731,10653,23384
QUETTA DISTRICT,21,Transgender,1,3,4
QUETTA DISTRICT,22,Male,10977,9698,20675
QUETTA DISTRICT,22,Female,10098,8573,18671
QUETTA DISTRICT,22,Transgender,4,2,6
QUETTA DISTRICT,23,Male,11337,10607,21944
QUETTA DISTRICT,23,Female,10608,9159,19767
QUETTA DISTRICT,23,Transgender,3,1,4
QUETTA DISTRICT,24,Male,9991,9932,19923
QUETTA DISTRICT,24,Female,8868,8397,17265
QUETTA DISTRICT,24,Transgender,5,3,8
QUETTA DISTRICT,25,Male,9917,9094,19011
QUETTA DISTRICT,25,Female,10600,8058,18658
QUETTA DISTRICT,25,Transgender,4,9,13
QUETTA DISTRICT,26,Male,9078,9339,18417
QUETTA DISTRICT,26,Female,8789,8173,16962
QUETTA DISTRICT,26,Transgender,5,4,9
QUETTA DISTRICT,27,Male,9827,9352,19179
QUETTA DISTRICT,27,Female,9826,8610,18436
QUETTA DISTRICT,27,Transgender,3,4,7
QUETTA DISTRICT,28,Male,8479,8653,17132
QUETTA DISTRICT,28,Female,8557,7959,16516
QUETTA DISTRICT,28,Transgender,4,4,8
QUETTA DISTRICT,29,Male,9134,9012,18146
QUETTA DISTRICT,29,Female,9438,8215,17653
QUETTA DISTRICT,29,Transgender,6,2,8
QUETTA DISTRICT,30,Male,7637,7607,15244
QUETTA DISTRICT,30,Female,8620,7006,15626
QUETTA DISTRICT,30,Transgender,7,6,13
QUETTA DISTRICT,31,Male,8575,8552,17127
QUETTA DISTRICT,31,Female,8508,7599,16107
QUETTA DISTRICT,31,Transgender,2,1,3
QUETTA DISTRICT,32,Male,7232,7694,14926
QUETTA DISTRICT,32,Female,6884,6551,13435
QUETTA DISTRICT,32,Transgender,4,6,10
QUETTA DISTRICT,33,Male,7275,7633,14908
QUETTA DISTRICT,33,Female,7374,6525,13899
QUETTA DISTRICT,33,Transgender,3,6,9
QUETTA DISTRICT,34,Male,6487,6786,13273
QUETTA DISTRICT,34,Female,5794,5877,11671
QUETTA DISTRICT,34,Transgender,2,1,3
QUETTA DISTRICT,35,Male,6134,5985,12119
QUETTA DISTRICT,35,Female,6484,5214,11698
QUETTA DISTRICT,35,Transgender,4,3,7
QUETTA DISTRICT,36,Male,5958,6169,12127
QUETTA DISTRICT,36,Female,5317,5067,10384
QUETTA DISTRICT,36,Transgender,2,4,6
QUETTA DISTRICT,37,Male,6850,6307,13157
QUETTA DISTRICT,37,Female,6135,5336,11471
QUETTA DISTRICT,37,Transgender,3,3,6
QUETTA DISTRICT,38,Male,6084,6676,12760
QUETTA DISTRICT,38,Female,5319,5396,10715
QUETTA DISTRICT,38,Transgender,2,2,4
QUETTA DISTRICT,39,Male,6238,6200,12438
QUETTA DISTRICT,39,Female,5573,5162,10735
QUETTA DISTRICT,39,Transgender,1,1,2
QUETTA DISTRICT,40,Male,5187,5048,10235
QUETTA DISTRICT,40,Female,5205,4521,9726
QUETTA DISTRICT,40,Transgender,1,4,5
QUETTA DISTRICT,41,Male,5213,5193,10406
QUETTA DISTRICT,41,Female,4945,4557,9502
QUETTA DISTRICT,41,Transgender,1,0,1
QUETTA DISTRICT,42,Male,4027,4372,8399
QUETTA DISTRICT,42,Female,4123,3820,7943
QUETTA DISTRICT,42,Transgender,1,4,5
QUETTA DISTRICT,43,Male,4144,4376,8520
QUETTA DISTRICT,43,Female,4079,3866,7945
QUETTA DISTRICT,43,Transgender,1,0,1
QUETTA DISTRICT,44,Male,3663,3778,7441
QUETTA DISTRICT,44,Female,3337,3327,6664
QUETTA DISTRICT,44,Transgender,3,0,3
QUETTA DISTRICT,45,Male,3558,3454,7012
QUETTA DISTRICT,45,Female,3499,3349,6848
QUETTA DISTRICT,45,Transgender,2,6,8
QUETTA DISTRICT,46,Male,3578,3480,7058
QUETTA DISTRICT,46,Female,3441,3132,6573
QUETTA DISTRICT,46,Transgender,1,0,1
QUETTA DISTRICT,47,Male,4013,3591,7604
QUETTA DISTRICT,47,Female,3928,3118,7046
QUETTA DISTRICT,47,Transgender,5,2,7
QUETTA DISTRICT,48,Male,3467,3588,7055
QUETTA DISTRICT,48,Female,2980,3143,6123
QUETTA DISTRICT,48,Transgender,1,3,4
QUETTA DISTRICT,49,Male,3791,3599,7390
QUETTA DISTRICT,49,Female,3449,3250,6699
QUETTA DISTRICT,49,Transgender,0,0,0
QUETTA DISTRICT,50,Male,3457,3220,6677
QUETTA DISTRICT,50,Female,3225,2955,6180
QUETTA DISTRICT,50,Transgender,4,2,6
QUETTA DISTRICT,51,Male,3894,3524,7418
QUETTA DISTRICT,51,Female,3331,3021,6352
QUETTA DISTRICT,51,Transgender,1,1,2
QUETTA DISTRICT,52,Male,2967,3099,6066
QUETTA DISTRICT,52,Female,2613,2570,5183
QUETTA DISTRICT,52,Transgender,1,1,2
QUETTA DISTRICT,53,Male,3078,2990,6068
QUETTA DISTRICT,53,Female,2448,2483,4931
QUETTA DISTRICT,53,Transgender,1,1,2
QUETTA DISTRICT,54,Male,2677,2784,5461
QUETTA DISTRICT,54,Female,2202,2281,4483
QUETTA DISTRICT,54,Transgender,0,0,0
QUETTA DISTRICT,55,Male,2398,2589,4987
QUETTA DISTRICT,55,Female,2031,2025,4056
QUETTA DISTRICT,55,Transgender,2,3,5
QUETTA DISTRICT,56,Male,2466,2371,4837
QUETTA DISTRICT,56,Female,1868,1907,3775
QUETTA DISTRICT,56,Transgender,1,0,1
QUETTA DISTRICT,57,Male,2412,2279,4691
QUETTA DISTRICT,57,Female,2115,1853,3968
QUETTA DISTRICT,57,Transgender,2,9,11
QUETTA DISTRICT,58,Male,2009,2223,4232
QUETTA DISTRICT,58,Female,1647,1780,3427
QUETTA DISTRICT,58,Transgender,5,1,6
QUETTA DISTRICT,59,Male,2129,1993,4122
QUETTA DISTRICT,59,Female,1827,1734,3561
QUETTA DISTRICT,59,Transgender,3,1,4
QUETTA DISTRICT,60,Male,2111,1773,3884
QUETTA DISTRICT,60,Female,1789,1556,3345
QUETTA DISTRICT,60,Transgender,2,4,6
QUETTA DISTRICT,61,Male,2253,2175,4428
QUETTA DISTRICT,61,Female,2052,1854,3906
QUETTA DISTRICT,61,Transgender,0,1,1
QUETTA DISTRICT,62,Male,1873,1867,3740
QUETTA DISTRICT,62,Female,1718,1768,3486
QUETTA DISTRICT,62,Transgender,0,1,1
QUETTA DISTRICT,63,Male,2039,1925,3964
QUETTA DISTRICT,63,Female,1668,1692,3360
QUETTA DISTRICT,63,Transgender,0,3,3
QUETTA DISTRICT,64,Male,1757,1684,3441
QUETTA DISTRICT,64,Female,1382,1387,2769
QUETTA DISTRICT,64,Transgender,0,0,0
QUETTA DISTRICT,65,Male,1452,1365,2817
QUETTA DISTRICT,65,Female,1146,1066,2212
QUETTA DISTRICT,65,Transgender,0,1,1
QUETTA DISTRICT,66,Male,1579,1327,2906
QUETTA DISTRICT,66,Female,1165,996,2161
QUETTA DISTRICT,66,Transgender,0,0,0
QUETTA DISTRICT,67,Male,1529,1316,2845
QUETTA DISTRICT,67,Female,1177,963,2140
QUETTA DISTRICT,67,Transgender,1,2,3
QUETTA DISTRICT,68,Male,1275,1321,2596
QUETTA DISTRICT,68,Female,996,1088,2084
QUETTA DISTRICT,68,Transgender,1,0,1
QUETTA DISTRICT,69,Male,1182,1053,2235
QUETTA DISTRICT,69,Female,1002,925,1927
QUETTA DISTRICT,69,Transgender,0,0,0
QUETTA DISTRICT,70,Male,1021,790,1811
QUETTA DISTRICT,70,Female,677,653,1330
QUETTA DISTRICT,70,Transgender,2,1,3
QUETTA DISTRICT,71,Male,1196,1002,2198
QUETTA DISTRICT,71,Female,813,756,1569
QUETTA DISTRICT,71,Transgender,5,0,5
QUETTA DISTRICT,72,Male,904,773,1677
QUETTA DISTRICT,72,Female,720,659,1379
QUETTA DISTRICT,72,Transgender,0,0,0
QUETTA DISTRICT,73,Male,882,836,1718
QUETTA DISTRICT,73,Female,608,674,1282
QUETTA DISTRICT,73,Transgender,0,0,0
QUETTA DISTRICT,74,Male,667,600,1267
QUETTA DISTRICT,74,Female,497,496,993
QUETTA DISTRICT,74,Transgender,1,0,1
QUETTA DISTRICT,>=75,Male,5490,4238,9728
QUETTA DISTRICT,>=75,Female,4480,4056,8536
QUETTA DISTRICT,>=75,Transgender,5,4,9
RAHIM YAR KHAN DISTRICT,<1,Male,42901,11819,54720
RAHIM YAR KHAN DISTRICT,<1,Female,40348,10923,51271
RAHIM YAR KHAN DISTRICT,<1,Transgender,0,0,0
RAHIM YAR KHAN DISTRICT,1,Male,56084,13538,69622
RAHIM YAR KHAN DISTRICT,1,Female,53865,12589,66454
RAHIM YAR KHAN DISTRICT,1,Transgender,0,0,0
RAHIM YAR KHAN DISTRICT,2,Male,59318,13799,73117
RAHIM YAR KHAN DISTRICT,2,Female,57300,12678,69978
RAHIM YAR KHAN DISTRICT,2,Transgender,0,0,0
RAHIM YAR KHAN DISTRICT,3,Male,63511,14719,78230
RAHIM YAR KHAN DISTRICT,3,Female,60662,14205,74867
RAHIM YAR KHAN DISTRICT,3,Transgender,0,0,0
RAHIM YAR KHAN DISTRICT,4,Male,66347,14323,80670
RAHIM YAR KHAN DISTRICT,4,Female,63129,13348,76477
RAHIM YAR KHAN DISTRICT,4,Transgender,0,0,0
RAHIM YAR KHAN DISTRICT,5,Male,64124,14582,78706
RAHIM YAR KHAN DISTRICT,5,Female,60012,13577,73589
RAHIM YAR KHAN DISTRICT,5,Transgender,0,0,0
RAHIM YAR KHAN DISTRICT,6,Male,63072,13819,76891
RAHIM YAR KHAN DISTRICT,6,Female,58586,12887,71473
RAHIM YAR KHAN DISTRICT,6,Transgender,0,0,0
RAHIM YAR KHAN DISTRICT,7,Male,66487,15346,81833
RAHIM YAR KHAN DISTRICT,7,Female,60561,14249,74810
RAHIM YAR KHAN DISTRICT,7,Transgender,0,0,0
RAHIM YAR KHAN DISTRICT,8,Male,68409,13590,81999
RAHIM YAR KHAN DISTRICT,8,Female,60570,12509,73079
RAHIM YAR KHAN DISTRICT,8,Transgender,0,0,0
RAHIM YAR KHAN DISTRICT,9,Male,60229,14745,74974
RAHIM YAR KHAN DISTRICT,9,Female,53433,13620,67053
RAHIM YAR KHAN DISTRICT,9,Transgender,0,0,0
RAHIM YAR KHAN DISTRICT,10,Male,61055,12897,73952
RAHIM YAR KHAN DISTRICT,10,Female,52745,11481,64226
RAHIM YAR KHAN DISTRICT,10,Transgender,0,0,0
RAHIM YAR KHAN DISTRICT,11,Male,48495,13763,62258
RAHIM YAR KHAN DISTRICT,11,Female,42775,12620,55395
RAHIM YAR KHAN DISTRICT,11,Transgender,0,0,0
RAHIM YAR KHAN DISTRICT,12,Male,52100,12445,64545
RAHIM YAR KHAN DISTRICT,12,Female,44908,10975,55883
RAHIM YAR KHAN DISTRICT,12,Transgender,0,0,0
RAHIM YAR KHAN DISTRICT,13,Male,43914,12649,56563
RAHIM YAR KHAN DISTRICT,13,Female,38125,11499,49624
RAHIM YAR KHAN DISTRICT,13,Transgender,0,0,0
RAHIM YAR KHAN DISTRICT,14,Male,43441,11636,55077
RAHIM YAR KHAN DISTRICT,14,Female,38962,10973,49935
RAHIM YAR KHAN DISTRICT,14,Transgender,0,0,0
RAHIM YAR KHAN DISTRICT,15,Male,42910,11939,54849
RAHIM YAR KHAN DISTRICT,15,Female,38617,11148,49765
RAHIM YAR KHAN DISTRICT,15,Transgender,12,2,14
RAHIM YAR KHAN DISTRICT,16,Male,39558,11427,50985
RAHIM YAR KHAN DISTRICT,16,Female,37602,10722,48324
RAHIM YAR KHAN DISTRICT,16,Transgender,10,1,11
RAHIM YAR KHAN DISTRICT,17,Male,41350,12760,54110
RAHIM YAR KHAN DISTRICT,17,Female,39368,12445,51813
RAHIM YAR KHAN DISTRICT,17,Transgender,6,2,8
RAHIM YAR KHAN DISTRICT,18,Male,37364,9943,47307
RAHIM YAR KHAN DISTRICT,18,Female,36063,9356,45419
RAHIM YAR KHAN DISTRICT,18,Transgender,16,1,17
RAHIM YAR KHAN DISTRICT,19,Male,35607,11144,46751
RAHIM YAR KHAN DISTRICT,19,Female,33642,10955,44597
RAHIM YAR KHAN DISTRICT,19,Transgender,6,4,10
RAHIM YAR KHAN DISTRICT,20,Male,39550,10294,49844
RAHIM YAR KHAN DISTRICT,20,Female,38921,9932,48853
RAHIM YAR KHAN DISTRICT,20,Transgender,17,11,28
RAHIM YAR KHAN DISTRICT,21,Male,31491,10631,42122
RAHIM YAR KHAN DISTRICT,21,Female,30335,10722,41057
RAHIM YAR KHAN DISTRICT,21,Transgender,9,6,15
RAHIM YAR KHAN DISTRICT,22,Male,34106,9926,44032
RAHIM YAR KHAN DISTRICT,22,Female,33172,10016,43188
RAHIM YAR KHAN DISTRICT,22,Transgender,16,9,25
RAHIM YAR KHAN DISTRICT,23,Male,27931,9121,37052
RAHIM YAR KHAN DISTRICT,23,Female,27865,9490,37355
RAHIM YAR KHAN DISTRICT,23,Transgender,8,6,14
RAHIM YAR KHAN DISTRICT,24,Male,26522,8872,35394
RAHIM YAR KHAN DISTRICT,24,Female,27217,9427,36644
RAHIM YAR KHAN DISTRICT,24,Transgender,6,6,12
RAHIM YAR KHAN DISTRICT,25,Male,32014,8320,40334
RAHIM YAR KHAN DISTRICT,25,Female,32898,8855,41753
RAHIM YAR KHAN DISTRICT,25,Transgender,13,12,25
RAHIM YAR KHAN DISTRICT,26,Male,24771,8235,33006
RAHIM YAR KHAN DISTRICT,26,Female,25700,9076,34776
RAHIM YAR KHAN DISTRICT,26,Transgender,7,6,13
RAHIM YAR KHAN DISTRICT,27,Male,25767,8130,33897
RAHIM YAR KHAN DISTRICT,27,Female,25635,8797,34432
RAHIM YAR KHAN DISTRICT,27,Transgender,5,5,10
RAHIM YAR KHAN DISTRICT,28,Male,26268,8065,34333
RAHIM YAR KHAN DISTRICT,28,Female,28365,8739,37104
RAHIM YAR KHAN DISTRICT,28,Transgender,6,7,13
RAHIM YAR KHAN DISTRICT,29,Male,24418,7584,32002
RAHIM YAR KHAN DISTRICT,29,Female,26596,8425,35021
RAHIM YAR KHAN DISTRICT,29,Transgender,7,6,13
RAHIM YAR KHAN DISTRICT,30,Male,27784,7822,35606
RAHIM YAR KHAN DISTRICT,30,Female,29958,8034,37992
RAHIM YAR KHAN DISTRICT,30,Transgender,15,10,25
RAHIM YAR KHAN DISTRICT,31,Male,24185,7468,31653
RAHIM YAR KHAN DISTRICT,31,Female,24819,7815,32634
RAHIM YAR KHAN DISTRICT,31,Transgender,2,3,5
RAHIM YAR KHAN DISTRICT,32,Male,23292,7233,30525
RAHIM YAR KHAN DISTRICT,32,Female,23709,7484,31193
RAHIM YAR KHAN DISTRICT,32,Transgender,11,2,13
RAHIM YAR KHAN DISTRICT,33,Male,20410,6760,27170
RAHIM YAR KHAN DISTRICT,33,Female,21885,7111,28996
RAHIM YAR KHAN DISTRICT,33,Transgender,5,3,8
RAHIM YAR KHAN DISTRICT,34,Male,19215,6120,25335
RAHIM YAR KHAN DISTRICT,34,Female,20046,6289,26335
RAHIM YAR KHAN DISTRICT,34,Transgender,7,2,9
RAHIM YAR KHAN DISTRICT,35,Male,24910,6663,31573
RAHIM YAR KHAN DISTRICT,35,Female,23921,6718,30639
RAHIM YAR KHAN DISTRICT,35,Transgender,18,11,29
RAHIM YAR KHAN DISTRICT,36,Male,20631,5920,26551
RAHIM YAR KHAN DISTRICT,36,Female,19378,5758,25136
RAHIM YAR KHAN DISTRICT,36,Transgender,5,2,7
RAHIM YAR KHAN DISTRICT,37,Male,22779,5943,28722
RAHIM YAR KHAN DISTRICT,37,Female,19897,5630,25527
RAHIM YAR KHAN DISTRICT,37,Transgender,5,4,9
RAHIM YAR KHAN DISTRICT,38,Male,19677,6198,25875
RAHIM YAR KHAN DISTRICT,38,Female,20097,6268,26365
RAHIM YAR KHAN DISTRICT,38,Transgender,6,3,9
RAHIM YAR KHAN DISTRICT,39,Male,19942,5833,25775
RAHIM YAR KHAN DISTRICT,39,Female,19247,5871,25118
RAHIM YAR KHAN DISTRICT,39,Transgender,4,6,10
RAHIM YAR KHAN DISTRICT,40,Male,19742,6127,25869
RAHIM YAR KHAN DISTRICT,40,Female,20182,5811,25993
RAHIM YAR KHAN DISTRICT,40,Transgender,20,8,28
RAHIM YAR KHAN DISTRICT,41,Male,17036,5217,22253
RAHIM YAR KHAN DISTRICT,41,Female,17563,5229,22792
RAHIM YAR KHAN DISTRICT,41,Transgender,4,3,7
RAHIM YAR KHAN DISTRICT,42,Male,16636,5081,21717
RAHIM YAR KHAN DISTRICT,42,Female,16699,4946,21645
RAHIM YAR KHAN DISTRICT,42,Transgender,4,4,8
RAHIM YAR KHAN DISTRICT,43,Male,14299,4905,19204
RAHIM YAR KHAN DISTRICT,43,Female,14456,4801,19257
RAHIM YAR KHAN DISTRICT,43,Transgender,3,3,6
RAHIM YAR KHAN DISTRICT,44,Male,14001,4616,18617
RAHIM YAR KHAN DISTRICT,44,Female,13848,4401,18249
RAHIM YAR KHAN DISTRICT,44,Transgender,2,2,4
RAHIM YAR KHAN DISTRICT,45,Male,15692,4847,20539
RAHIM YAR KHAN DISTRICT,45,Female,15376,4600,19976
RAHIM YAR KHAN DISTRICT,45,Transgender,11,3,14
RAHIM YAR KHAN DISTRICT,46,Male,13191,4157,17348
RAHIM YAR KHAN DISTRICT,46,Female,12723,3887,16610
RAHIM YAR KHAN DISTRICT,46,Transgender,8,3,11
RAHIM YAR KHAN DISTRICT,47,Male,14632,4188,18820
RAHIM YAR KHAN DISTRICT,47,Female,13227,3778,17005
RAHIM YAR KHAN DISTRICT,47,Transgender,2,3,5
RAHIM YAR KHAN DISTRICT,48,Male,13592,4510,18102
RAHIM YAR KHAN DISTRICT,48,Female,13420,4383,17803
RAHIM YAR KHAN DISTRICT,48,Transgender,1,0,1
RAHIM YAR KHAN DISTRICT,49,Male,13338,4371,17709
RAHIM YAR KHAN DISTRICT,49,Female,13018,4282,17300
RAHIM YAR KHAN DISTRICT,49,Transgender,1,2,3
RAHIM YAR KHAN DISTRICT,50,Male,15015,4572,19587
RAHIM YAR KHAN DISTRICT,50,Female,13868,4163,18031
RAHIM YAR KHAN DISTRICT,50,Transgender,8,6,14
RAHIM YAR KHAN DISTRICT,51,Male,12560,3845,16405
RAHIM YAR KHAN DISTRICT,51,Female,11385,3699,15084
RAHIM YAR KHAN DISTRICT,51,Transgender,4,1,5
RAHIM YAR KHAN DISTRICT,52,Male,11877,3757,15634
RAHIM YAR KHAN DISTRICT,52,Female,10748,3372,14120
RAHIM YAR KHAN DISTRICT,52,Transgender,6,0,6
RAHIM YAR KHAN DISTRICT,53,Male,10759,3622,14381
RAHIM YAR KHAN DISTRICT,53,Female,9536,3281,12817
RAHIM YAR KHAN DISTRICT,53,Transgender,2,1,3
RAHIM YAR KHAN DISTRICT,54,Male,9736,3305,13041
RAHIM YAR KHAN DISTRICT,54,Female,8318,2912,11230
RAHIM YAR KHAN DISTRICT,54,Transgender,1,1,2
RAHIM YAR KHAN DISTRICT,55,Male,10889,3474,14363
RAHIM YAR KHAN DISTRICT,55,Female,9531,2947,12478
RAHIM YAR KHAN DISTRICT,55,Transgender,10,4,14
RAHIM YAR KHAN DISTRICT,56,Male,8324,2795,11119
RAHIM YAR KHAN DISTRICT,56,Female,7154,2351,9505
RAHIM YAR KHAN DISTRICT,56,Transgender,1,1,2
RAHIM YAR KHAN DISTRICT,57,Male,8491,2600,11091
RAHIM YAR KHAN DISTRICT,57,Female,7360,2061,9421
RAHIM YAR KHAN DISTRICT,57,Transgender,4,3,7
RAHIM YAR KHAN DISTRICT,58,Male,7047,2292,9339
RAHIM YAR KHAN DISTRICT,58,Female,6906,2275,9181
RAHIM YAR KHAN DISTRICT,58,Transgender,3,1,4
RAHIM YAR KHAN DISTRICT,59,Male,7022,2286,9308
RAHIM YAR KHAN DISTRICT,59,Female,7247,2192,9439
RAHIM YAR KHAN DISTRICT,59,Transgender,1,0,1
RAHIM YAR KHAN DISTRICT,60,Male,9334,2509,11843
RAHIM YAR KHAN DISTRICT,60,Female,9122,2352,11474
RAHIM YAR KHAN DISTRICT,60,Transgender,9,3,12
RAHIM YAR KHAN DISTRICT,61,Male,7595,2381,9976
RAHIM YAR KHAN DISTRICT,61,Female,7690,2151,9841
RAHIM YAR KHAN DISTRICT,61,Transgender,4,0,4
RAHIM YAR KHAN DISTRICT,62,Male,7429,2202,9631
RAHIM YAR KHAN DISTRICT,62,Female,7524,1986,9510
RAHIM YAR KHAN DISTRICT,62,Transgender,6,0,6
RAHIM YAR KHAN DISTRICT,63,Male,6957,2097,9054
RAHIM YAR KHAN DISTRICT,63,Female,6900,2068,8968
RAHIM YAR KHAN DISTRICT,63,Transgender,0,0,0
RAHIM YAR KHAN DISTRICT,64,Male,6076,1787,7863
RAHIM YAR KHAN DISTRICT,64,Female,6234,1775,8009
RAHIM YAR KHAN DISTRICT,64,Transgender,5,0,5
RAHIM YAR KHAN DISTRICT,65,Male,7131,1925,9056
RAHIM YAR KHAN DISTRICT,65,Female,6727,1723,8450
RAHIM YAR KHAN DISTRICT,65,Transgender,5,4,9
RAHIM YAR KHAN DISTRICT,66,Male,5810,1432,7242
RAHIM YAR KHAN DISTRICT,66,Female,5399,1332,6731
RAHIM YAR KHAN DISTRICT,66,Transgender,1,1,2
RAHIM YAR KHAN DISTRICT,67,Male,6262,1302,7564
RAHIM YAR KHAN DISTRICT,67,Female,5222,1216,6438
RAHIM YAR KHAN DISTRICT,67,Transgender,1,1,2
RAHIM YAR KHAN DISTRICT,68,Male,4827,1283,6110
RAHIM YAR KHAN DISTRICT,68,Female,4723,1192,5915
RAHIM YAR KHAN DISTRICT,68,Transgender,1,1,2
RAHIM YAR KHAN DISTRICT,69,Male,4209,1062,5271
RAHIM YAR KHAN DISTRICT,69,Female,4217,1053,5270
RAHIM YAR KHAN DISTRICT,69,Transgender,2,1,3
RAHIM YAR KHAN DISTRICT,70,Male,5454,1209,6663
RAHIM YAR KHAN DISTRICT,70,Female,4980,1115,6095
RAHIM YAR KHAN DISTRICT,70,Transgender,1,5,6
RAHIM YAR KHAN DISTRICT,71,Male,4621,1088,5709
RAHIM YAR KHAN DISTRICT,71,Female,4007,985,4992
RAHIM YAR KHAN DISTRICT,71,Transgender,2,1,3
RAHIM YAR KHAN DISTRICT,72,Male,4292,1012,5304
RAHIM YAR KHAN DISTRICT,72,Female,3874,859,4733
RAHIM YAR KHAN DISTRICT,72,Transgender,2,0,2
RAHIM YAR KHAN DISTRICT,73,Male,3569,1001,4570
RAHIM YAR KHAN DISTRICT,73,Female,3266,869,4135
RAHIM YAR KHAN DISTRICT,73,Transgender,0,0,0
RAHIM YAR KHAN DISTRICT,74,Male,2693,730,3423
RAHIM YAR KHAN DISTRICT,74,Female,2630,608,3238
RAHIM YAR KHAN DISTRICT,74,Transgender,1,0,1
RAHIM YAR KHAN DISTRICT,>=75,Male,24420,5675,30095
RAHIM YAR KHAN DISTRICT,>=75,Female,23897,5631,29528
RAHIM YAR KHAN DISTRICT,>=75,Transgender,13,2,15
RAJANPUR DISTRICT,<1,Male,22207,4095,26302
RAJANPUR DISTRICT,<1,Female,21191,3829,25020
RAJANPUR DISTRICT,<1,Transgender,0,0,0
RAJANPUR DISTRICT,1,Male,25083,4494,29577
RAJANPUR DISTRICT,1,Female,24871,4403,29274
RAJANPUR DISTRICT,1,Transgender,0,0,0
RAJANPUR DISTRICT,2,Male,30023,4961,34984
RAJANPUR DISTRICT,2,Female,30445,4803,35248
RAJANPUR DISTRICT,2,Transgender,0,0,0
RAJANPUR DISTRICT,3,Male,32331,5530,37861
RAJANPUR DISTRICT,3,Female,31937,5247,37184
RAJANPUR DISTRICT,3,Transgender,0,0,0
RAJANPUR DISTRICT,4,Male,34072,5138,39210
RAJANPUR DISTRICT,4,Female,32865,4916,37781
RAJANPUR DISTRICT,4,Transgender,0,0,0
RAJANPUR DISTRICT,5,Male,32318,5560,37878
RAJANPUR DISTRICT,5,Female,30286,4929,35215
RAJANPUR DISTRICT,5,Transgender,0,0,0
RAJANPUR DISTRICT,6,Male,32706,5001,37707
RAJANPUR DISTRICT,6,Female,30527,4575,35102
RAJANPUR DISTRICT,6,Transgender,0,0,0
RAJANPUR DISTRICT,7,Male,33748,5695,39443
RAJANPUR DISTRICT,7,Female,29913,5178,35091
RAJANPUR DISTRICT,7,Transgender,0,0,0
RAJANPUR DISTRICT,8,Male,35918,5227,41145
RAJANPUR DISTRICT,8,Female,31387,4732,36119
RAJANPUR DISTRICT,8,Transgender,0,0,0
RAJANPUR DISTRICT,9,Male,29742,5302,35044
RAJANPUR DISTRICT,9,Female,25416,4776,30192
RAJANPUR DISTRICT,9,Transgender,0,0,0
RAJANPUR DISTRICT,10,Male,31811,4785,36596
RAJANPUR DISTRICT,10,Female,26660,4280,30940
RAJANPUR DISTRICT,10,Transgender,0,0,0
RAJANPUR DISTRICT,11,Male,21763,4641,26404
RAJANPUR DISTRICT,11,Female,18574,4319,22893
RAJANPUR DISTRICT,11,Transgender,0,0,0
RAJANPUR DISTRICT,12,Male,25205,4610,29815
RAJANPUR DISTRICT,12,Female,21084,4104,25188
RAJANPUR DISTRICT,12,Transgender,0,0,0
RAJANPUR DISTRICT,13,Male,19513,4458,23971
RAJANPUR DISTRICT,13,Female,15553,3913,19466
RAJANPUR DISTRICT,13,Transgender,0,0,0
RAJANPUR DISTRICT,14,Male,20027,4230,24257
RAJANPUR DISTRICT,14,Female,16860,3789,20649
RAJANPUR DISTRICT,14,Transgender,0,0,0
RAJANPUR DISTRICT,15,Male,17728,4001,21729
RAJANPUR DISTRICT,15,Female,14052,3639,17691
RAJANPUR DISTRICT,15,Transgender,5,3,8
RAJANPUR DISTRICT,16,Male,17371,3865,21236
RAJANPUR DISTRICT,16,Female,14713,3574,18287
RAJANPUR DISTRICT,16,Transgender,10,0,10
RAJANPUR DISTRICT,17,Male,14017,3672,17689
RAJANPUR DISTRICT,17,Female,11417,3475,14892
RAJANPUR DISTRICT,17,Transgender,5,3,8
RAJANPUR DISTRICT,18,Male,18778,3680,22458
RAJANPUR DISTRICT,18,Female,16978,3530,20508
RAJANPUR DISTRICT,18,Transgender,8,2,10
RAJANPUR DISTRICT,19,Male,14779,3627,18406
RAJANPUR DISTRICT,19,Female,13008,3584,16592
RAJANPUR DISTRICT,19,Transgender,2,3,5
RAJANPUR DISTRICT,20,Male,16368,3327,19695
RAJANPUR DISTRICT,20,Female,15332,3138,18470
RAJANPUR DISTRICT,20,Transgender,8,2,10
RAJANPUR DISTRICT,21,Male,11713,3253,14966
RAJANPUR DISTRICT,21,Female,11111,3139,14250
RAJANPUR DISTRICT,21,Transgender,2,0,2
RAJANPUR DISTRICT,22,Male,11898,2778,14676
RAJANPUR DISTRICT,22,Female,11047,2911,13958
RAJANPUR DISTRICT,22,Transgender,4,0,4
RAJANPUR DISTRICT,23,Male,10155,2864,13019
RAJANPUR DISTRICT,23,Female,9864,2919,12783
RAJANPUR DISTRICT,23,Transgender,3,1,4
RAJANPUR DISTRICT,24,Male,9755,2562,12317
RAJANPUR DISTRICT,24,Female,9263,2606,11869
RAJANPUR DISTRICT,24,Transgender,5,0,5
RAJANPUR DISTRICT,25,Male,12010,2595,14605
RAJANPUR DISTRICT,25,Female,12290,2611,14901
RAJANPUR DISTRICT,25,Transgender,6,0,6
RAJANPUR DISTRICT,26,Male,9439,2430,11869
RAJANPUR DISTRICT,26,Female,9805,2555,12360
RAJANPUR DISTRICT,26,Transgender,4,0,4
RAJANPUR DISTRICT,27,Male,10446,2652,13098
RAJANPUR DISTRICT,27,Female,11578,2855,14433
RAJANPUR DISTRICT,27,Transgender,4,1,5
RAJANPUR DISTRICT,28,Male,9878,2346,12224
RAJANPUR DISTRICT,28,Female,10960,2446,13406
RAJANPUR DISTRICT,28,Transgender,2,3,5
RAJANPUR DISTRICT,29,Male,10955,2607,13562
RAJANPUR DISTRICT,29,Female,12132,2764,14896
RAJANPUR DISTRICT,29,Transgender,3,2,5
RAJANPUR DISTRICT,30,Male,10256,2125,12381
RAJANPUR DISTRICT,30,Female,11221,2141,13362
RAJANPUR DISTRICT,30,Transgender,7,6,13
RAJANPUR DISTRICT,31,Male,9875,2374,12249
RAJANPUR DISTRICT,31,Female,10733,2526,13259
RAJANPUR DISTRICT,31,Transgender,1,2,3
RAJANPUR DISTRICT,32,Male,9848,2212,12060
RAJANPUR DISTRICT,32,Female,11105,2345,13450
RAJANPUR DISTRICT,32,Transgender,3,2,5
RAJANPUR DISTRICT,33,Male,8138,2033,10171
RAJANPUR DISTRICT,33,Female,8810,1994,10804
RAJANPUR DISTRICT,33,Transgender,1,0,1
RAJANPUR DISTRICT,34,Male,7571,1964,9535
RAJANPUR DISTRICT,34,Female,8229,1864,10093
RAJANPUR DISTRICT,34,Transgender,5,2,7
RAJANPUR DISTRICT,35,Male,9251,1962,11213
RAJANPUR DISTRICT,35,Female,9322,1912,11234
RAJANPUR DISTRICT,35,Transgender,6,5,11
RAJANPUR DISTRICT,36,Male,8659,2040,10699
RAJANPUR DISTRICT,36,Female,8147,1891,10038
RAJANPUR DISTRICT,36,Transgender,1,0,1
RAJANPUR DISTRICT,37,Male,12614,2340,14954
RAJANPUR DISTRICT,37,Female,11716,2496,14212
RAJANPUR DISTRICT,37,Transgender,7,1,8
RAJANPUR DISTRICT,38,Male,7469,1772,9241
RAJANPUR DISTRICT,38,Female,7323,1663,8986
RAJANPUR DISTRICT,38,Transgender,2,1,3
RAJANPUR DISTRICT,39,Male,9212,2079,11291
RAJANPUR DISTRICT,39,Female,8349,1946,10295
RAJANPUR DISTRICT,39,Transgender,2,0,2
RAJANPUR DISTRICT,40,Male,6559,1455,8014
RAJANPUR DISTRICT,40,Female,7413,1303,8716
RAJANPUR DISTRICT,40,Transgender,3,4,7
RAJANPUR DISTRICT,41,Male,6967,1642,8609
RAJANPUR DISTRICT,41,Female,7233,1650,8883
RAJANPUR DISTRICT,41,Transgender,1,0,1
RAJANPUR DISTRICT,42,Male,7756,1661,9417
RAJANPUR DISTRICT,42,Female,7788,1750,9538
RAJANPUR DISTRICT,42,Transgender,2,2,4
RAJANPUR DISTRICT,43,Male,5173,1388,6561
RAJANPUR DISTRICT,43,Female,5125,1287,6412
RAJANPUR DISTRICT,43,Transgender,1,0,1
RAJANPUR DISTRICT,44,Male,5071,1331,6402
RAJANPUR DISTRICT,44,Female,4778,1093,5871
RAJANPUR DISTRICT,44,Transgender,2,0,2
RAJANPUR DISTRICT,45,Male,5096,1132,6228
RAJANPUR DISTRICT,45,Female,5064,1143,6207
RAJANPUR DISTRICT,45,Transgender,2,0,2
RAJANPUR DISTRICT,46,Male,5215,1241,6456
RAJANPUR DISTRICT,46,Female,4844,1180,6024
RAJANPUR DISTRICT,46,Transgender,2,0,2
RAJANPUR DISTRICT,47,Male,7008,1430,8438
RAJANPUR DISTRICT,47,Female,7107,1501,8608
RAJANPUR DISTRICT,47,Transgender,2,0,2
RAJANPUR DISTRICT,48,Male,4772,1269,6041
RAJANPUR DISTRICT,48,Female,4220,1105,5325
RAJANPUR DISTRICT,48,Transgender,2,1,3
RAJANPUR DISTRICT,49,Male,5712,1361,7073
RAJANPUR DISTRICT,49,Female,4779,1207,5986
RAJANPUR DISTRICT,49,Transgender,1,1,2
RAJANPUR DISTRICT,50,Male,4694,1078,5772
RAJANPUR DISTRICT,50,Female,4502,926,5428
RAJANPUR DISTRICT,50,Transgender,3,0,3
RAJANPUR DISTRICT,51,Male,5080,1304,6384
RAJANPUR DISTRICT,51,Female,4382,1136,5518
RAJANPUR DISTRICT,51,Transgender,0,2,2
RAJANPUR DISTRICT,52,Male,4787,1152,5939
RAJANPUR DISTRICT,52,Female,5006,1135,6141
RAJANPUR DISTRICT,52,Transgender,3,2,5
RAJANPUR DISTRICT,53,Male,3986,1150,5136
RAJANPUR DISTRICT,53,Female,3166,871,4037
RAJANPUR DISTRICT,53,Transgender,0,0,0
RAJANPUR DISTRICT,54,Male,3649,977,4626
RAJANPUR DISTRICT,54,Female,2868,774,3642
RAJANPUR DISTRICT,54,Transgender,0,0,0
RAJANPUR DISTRICT,55,Male,3205,833,4038
RAJANPUR DISTRICT,55,Female,2863,607,3470
RAJANPUR DISTRICT,55,Transgender,2,1,3
RAJANPUR DISTRICT,56,Male,3239,838,4077
RAJANPUR DISTRICT,56,Female,2712,669,3381
RAJANPUR DISTRICT,56,Transgender,0,0,0
RAJANPUR DISTRICT,57,Male,4178,818,4996
RAJANPUR DISTRICT,57,Female,4212,788,5000
RAJANPUR DISTRICT,57,Transgender,0,0,0
RAJANPUR DISTRICT,58,Male,2306,650,2956
RAJANPUR DISTRICT,58,Female,2132,518,2650
RAJANPUR DISTRICT,58,Transgender,0,0,0
RAJANPUR DISTRICT,59,Male,2715,672,3387
RAJANPUR DISTRICT,59,Female,2449,637,3086
RAJANPUR DISTRICT,59,Transgender,0,0,0
RAJANPUR DISTRICT,60,Male,2562,511,3073
RAJANPUR DISTRICT,60,Female,3029,582,3611
RAJANPUR DISTRICT,60,Transgender,3,0,3
RAJANPUR DISTRICT,61,Male,2720,681,3401
RAJANPUR DISTRICT,61,Female,2885,638,3523
RAJANPUR DISTRICT,61,Transgender,0,0,0
RAJANPUR DISTRICT,62,Male,2887,602,3489
RAJANPUR DISTRICT,62,Female,3391,753,4144
RAJANPUR DISTRICT,62,Transgender,0,0,0
RAJANPUR DISTRICT,63,Male,2292,541,2833
RAJANPUR DISTRICT,63,Female,2440,623,3063
RAJANPUR DISTRICT,63,Transgender,0,0,0
RAJANPUR DISTRICT,64,Male,2235,490,2725
RAJANPUR DISTRICT,64,Female,2302,519,2821
RAJANPUR DISTRICT,64,Transgender,0,0,0
RAJANPUR DISTRICT,65,Male,2114,453,2567
RAJANPUR DISTRICT,65,Female,2292,456,2748
RAJANPUR DISTRICT,65,Transgender,1,0,1
RAJANPUR DISTRICT,66,Male,2663,490,3153
RAJANPUR DISTRICT,66,Female,2531,487,3018
RAJANPUR DISTRICT,66,Transgender,1,0,1
RAJANPUR DISTRICT,67,Male,3068,525,3593
RAJANPUR DISTRICT,67,Female,3316,579,3895
RAJANPUR DISTRICT,67,Transgender,1,0,1
RAJANPUR DISTRICT,68,Male,1809,418,2227
RAJANPUR DISTRICT,68,Female,1702,431,2133
RAJANPUR DISTRICT,68,Transgender,0,0,0
RAJANPUR DISTRICT,69,Male,2047,395,2442
RAJANPUR DISTRICT,69,Female,1755,367,2122
RAJANPUR DISTRICT,69,Transgender,1,0,1
RAJANPUR DISTRICT,70,Male,1774,323,2097
RAJANPUR DISTRICT,70,Female,1755,300,2055
RAJANPUR DISTRICT,70,Transgender,2,2,4
RAJANPUR DISTRICT,71,Male,2161,368,2529
RAJANPUR DISTRICT,71,Female,1846,375,2221
RAJANPUR DISTRICT,71,Transgender,1,1,2
RAJANPUR DISTRICT,72,Male,1750,300,2050
RAJANPUR DISTRICT,72,Female,1922,346,2268
RAJANPUR DISTRICT,72,Transgender,0,0,0
RAJANPUR DISTRICT,73,Male,1339,260,1599
RAJANPUR DISTRICT,73,Female,1206,288,1494
RAJANPUR DISTRICT,73,Transgender,2,1,3
RAJANPUR DISTRICT,74,Male,1201,191,1392
RAJANPUR DISTRICT,74,Female,1079,199,1278
RAJANPUR DISTRICT,74,Transgender,0,0,0
RAJANPUR DISTRICT,>=75,Male,11056,1851,12907
RAJANPUR DISTRICT,>=75,Female,10929,2031,12960
RAJANPUR DISTRICT,>=75,Transgender,6,1,7
RAWALPINDI DISTRICT,<1,Male,26976,31443,58419
RAWALPINDI DISTRICT,<1,Female,25686,29936,55622
RAWALPINDI DISTRICT,<1,Transgender,0,0,0
RAWALPINDI DISTRICT,1,Male,29043,35075,64118
RAWALPINDI DISTRICT,1,Female,27933,33068,61001
RAWALPINDI DISTRICT,1,Transgender,0,0,0
RAWALPINDI DISTRICT,2,Male,29111,35159,64270
RAWALPINDI DISTRICT,2,Female,27239,33265,60504
RAWALPINDI DISTRICT,2,Transgender,0,0,0
RAWALPINDI DISTRICT,3,Male,30276,37466,67742
RAWALPINDI DISTRICT,3,Female,29017,35923,64940
RAWALPINDI DISTRICT,3,Transgender,0,0,0
RAWALPINDI DISTRICT,4,Male,28008,34809,62817
RAWALPINDI DISTRICT,4,Female,26263,32906,59169
RAWALPINDI DISTRICT,4,Transgender,0,0,0
RAWALPINDI DISTRICT,5,Male,28002,35302,63304
RAWALPINDI DISTRICT,5,Female,26970,33529,60499
RAWALPINDI DISTRICT,5,Transgender,0,0,0
RAWALPINDI DISTRICT,6,Male,28383,35045,63428
RAWALPINDI DISTRICT,6,Female,26641,33073,59714
RAWALPINDI DISTRICT,6,Transgender,0,0,0
RAWALPINDI DISTRICT,7,Male,30117,37290,67407
RAWALPINDI DISTRICT,7,Female,28076,35358,63434
RAWALPINDI DISTRICT,7,Transgender,0,0,0
RAWALPINDI DISTRICT,8,Male,25877,32205,58082
RAWALPINDI DISTRICT,8,Female,24573,30380,54953
RAWALPINDI DISTRICT,8,Transgender,0,0,0
RAWALPINDI DISTRICT,9,Male,30511,38611,69122
RAWALPINDI DISTRICT,9,Female,28943,35733,64676
RAWALPINDI DISTRICT,9,Transgender,0,0,0
RAWALPINDI DISTRICT,10,Male,23876,30279,54155
RAWALPINDI DISTRICT,10,Female,22562,28153,50715
RAWALPINDI DISTRICT,10,Transgender,0,0,0
RAWALPINDI DISTRICT,11,Male,30063,37185,67248
RAWALPINDI DISTRICT,11,Female,28016,35105,63121
RAWALPINDI DISTRICT,11,Transgender,0,0,0
RAWALPINDI DISTRICT,12,Male,23152,29967,53119
RAWALPINDI DISTRICT,12,Female,21834,27469,49303
RAWALPINDI DISTRICT,12,Transgender,0,0,0
RAWALPINDI DISTRICT,13,Male,26963,33881,60844
RAWALPINDI DISTRICT,13,Female,24734,30978,55712
RAWALPINDI DISTRICT,13,Transgender,0,0,0
RAWALPINDI DISTRICT,14,Male,23868,30372,54240
RAWALPINDI DISTRICT,14,Female,21439,27010,48449
RAWALPINDI DISTRICT,14,Transgender,0,0,0
RAWALPINDI DISTRICT,15,Male,24190,30070,54260
RAWALPINDI DISTRICT,15,Female,22620,28056,50676
RAWALPINDI DISTRICT,15,Transgender,3,8,11
RAWALPINDI DISTRICT,16,Male,24758,30749,55507
RAWALPINDI DISTRICT,16,Female,23098,27707,50805
RAWALPINDI DISTRICT,16,Transgender,5,10,15
RAWALPINDI DISTRICT,17,Male,25566,33286,58852
RAWALPINDI DISTRICT,17,Female,24289,30243,54532
RAWALPINDI DISTRICT,17,Transgender,5,11,16
RAWALPINDI DISTRICT,18,Male,20417,27117,47534
RAWALPINDI DISTRICT,18,Female,18667,23899,42566
RAWALPINDI DISTRICT,18,Transgender,4,10,14
RAWALPINDI DISTRICT,19,Male,25277,32331,57608
RAWALPINDI DISTRICT,19,Female,24876,30174,55050
RAWALPINDI DISTRICT,19,Transgender,2,10,12
RAWALPINDI DISTRICT,20,Male,20072,26609,46681
RAWALPINDI DISTRICT,20,Female,17908,22248,40156
RAWALPINDI DISTRICT,20,Transgender,7,19,26
RAWALPINDI DISTRICT,21,Male,24708,32971,57679
RAWALPINDI DISTRICT,21,Female,25644,31456,57100
RAWALPINDI DISTRICT,21,Transgender,3,11,14
RAWALPINDI DISTRICT,22,Male,20084,27867,47951
RAWALPINDI DISTRICT,22,Female,20691,26734,47425
RAWALPINDI DISTRICT,22,Transgender,8,24,32
RAWALPINDI DISTRICT,23,Male,22343,29661,52004
RAWALPINDI DISTRICT,23,Female,24172,29816,53988
RAWALPINDI DISTRICT,23,Transgender,8,13,21
RAWALPINDI DISTRICT,24,Male,21047,28586,49633
RAWALPINDI DISTRICT,24,Female,23675,28982,52657
RAWALPINDI DISTRICT,24,Transgender,6,30,36
RAWALPINDI DISTRICT,25,Male,16833,23742,40575
RAWALPINDI DISTRICT,25,Female,17870,22180,40050
RAWALPINDI DISTRICT,25,Transgender,6,45,51
RAWALPINDI DISTRICT,26,Male,19492,26741,46233
RAWALPINDI DISTRICT,26,Female,23925,28525,52450
RAWALPINDI DISTRICT,26,Transgender,5,25,30
RAWALPINDI DISTRICT,27,Male,19158,26605,45763
RAWALPINDI DISTRICT,27,Female,23562,29027,52589
RAWALPINDI DISTRICT,27,Transgender,5,20,25
RAWALPINDI DISTRICT,28,Male,17635,24916,42551
RAWALPINDI DISTRICT,28,Female,21000,26834,47834
RAWALPINDI DISTRICT,28,Transgender,2,41,43
RAWALPINDI DISTRICT,29,Male,19048,25538,44586
RAWALPINDI DISTRICT,29,Female,23444,27867,51311
RAWALPINDI DISTRICT,29,Transgender,7,28,35
RAWALPINDI DISTRICT,30,Male,16115,22972,39087
RAWALPINDI DISTRICT,30,Female,17435,23075,40510
RAWALPINDI DISTRICT,30,Transgender,7,63,70
RAWALPINDI DISTRICT,31,Male,18711,25145,43856
RAWALPINDI DISTRICT,31,Female,22392,26903,49295
RAWALPINDI DISTRICT,31,Transgender,3,19,22
RAWALPINDI DISTRICT,32,Male,17542,24703,42245
RAWALPINDI DISTRICT,32,Female,19763,25668,45431
RAWALPINDI DISTRICT,32,Transgender,7,31,38
RAWALPINDI DISTRICT,33,Male,17481,24074,41555
RAWALPINDI DISTRICT,33,Female,20057,24932,44989
RAWALPINDI DISTRICT,33,Transgender,4,20,24
RAWALPINDI DISTRICT,34,Male,16133,22316,38449
RAWALPINDI DISTRICT,34,Female,18767,23623,42390
RAWALPINDI DISTRICT,34,Transgender,11,17,28
RAWALPINDI DISTRICT,35,Male,13237,19479,32716
RAWALPINDI DISTRICT,35,Female,13938,19049,32987
RAWALPINDI DISTRICT,35,Transgender,9,50,59
RAWALPINDI DISTRICT,36,Male,15021,21106,36127
RAWALPINDI DISTRICT,36,Female,16898,21704,38602
RAWALPINDI DISTRICT,36,Transgender,7,19,26
RAWALPINDI DISTRICT,37,Male,14224,20480,34704
RAWALPINDI DISTRICT,37,Female,15442,19643,35085
RAWALPINDI DISTRICT,37,Transgender,9,17,26
RAWALPINDI DISTRICT,38,Male,15240,22669,37909
RAWALPINDI DISTRICT,38,Female,16623,22282,38905
RAWALPINDI DISTRICT,38,Transgender,9,30,39
RAWALPINDI DISTRICT,39,Male,14501,20667,35168
RAWALPINDI DISTRICT,39,Female,15896,19841,35737
RAWALPINDI DISTRICT,39,Transgender,0,12,12
RAWALPINDI DISTRICT,40,Male,12477,19826,32303
RAWALPINDI DISTRICT,40,Female,12217,17475,29692
RAWALPINDI DISTRICT,40,Transgender,10,35,45
RAWALPINDI DISTRICT,41,Male,13061,19182,32243
RAWALPINDI DISTRICT,41,Female,13913,17428,31341
RAWALPINDI DISTRICT,41,Transgender,3,13,16
RAWALPINDI DISTRICT,42,Male,12006,18335,30341
RAWALPINDI DISTRICT,42,Female,12435,16478,28913
RAWALPINDI DISTRICT,42,Transgender,1,26,27
RAWALPINDI DISTRICT,43,Male,12129,17592,29721
RAWALPINDI DISTRICT,43,Female,13327,17087,30414
RAWALPINDI DISTRICT,43,Transgender,4,12,16
RAWALPINDI DISTRICT,44,Male,10949,15902,26851
RAWALPINDI DISTRICT,44,Female,12098,15210,27308
RAWALPINDI DISTRICT,44,Transgender,2,16,18
RAWALPINDI DISTRICT,45,Male,9294,14513,23807
RAWALPINDI DISTRICT,45,Female,9355,13193,22548
RAWALPINDI DISTRICT,45,Transgender,6,22,28
RAWALPINDI DISTRICT,46,Male,10444,14166,24610
RAWALPINDI DISTRICT,46,Female,11325,12998,24323
RAWALPINDI DISTRICT,46,Transgender,4,10,14
RAWALPINDI DISTRICT,47,Male,9964,13730,23694
RAWALPINDI DISTRICT,47,Female,9714,11517,21231
RAWALPINDI DISTRICT,47,Transgender,3,7,10
RAWALPINDI DISTRICT,48,Male,10916,14972,25888
RAWALPINDI DISTRICT,48,Female,11773,14408,26181
RAWALPINDI DISTRICT,48,Transgender,3,9,12
RAWALPINDI DISTRICT,49,Male,10256,13915,24171
RAWALPINDI DISTRICT,49,Female,11605,13479,25084
RAWALPINDI DISTRICT,49,Transgender,2,7,9
RAWALPINDI DISTRICT,50,Male,9504,13725,23229
RAWALPINDI DISTRICT,50,Female,9454,12710,22164
RAWALPINDI DISTRICT,50,Transgender,10,22,32
RAWALPINDI DISTRICT,51,Male,10129,12909,23038
RAWALPINDI DISTRICT,51,Female,10792,11977,22769
RAWALPINDI DISTRICT,51,Transgender,1,9,10
RAWALPINDI DISTRICT,52,Male,9812,13482,23294
RAWALPINDI DISTRICT,52,Female,10200,11760,21960
RAWALPINDI DISTRICT,52,Transgender,4,6,10
RAWALPINDI DISTRICT,53,Male,9904,12977,22881
RAWALPINDI DISTRICT,53,Female,10665,12310,22975
RAWALPINDI DISTRICT,53,Transgender,3,6,9
RAWALPINDI DISTRICT,54,Male,9638,12082,21720
RAWALPINDI DISTRICT,54,Female,9803,10901,20704
RAWALPINDI DISTRICT,54,Transgender,2,4,6
RAWALPINDI DISTRICT,55,Male,7874,11142,19016
RAWALPINDI DISTRICT,55,Female,7361,9337,16698
RAWALPINDI DISTRICT,55,Transgender,3,9,12
RAWALPINDI DISTRICT,56,Male,8287,10252,18539
RAWALPINDI DISTRICT,56,Female,7773,8317,16090
RAWALPINDI DISTRICT,56,Transgender,2,7,9
RAWALPINDI DISTRICT,57,Male,7465,9267,16732
RAWALPINDI DISTRICT,57,Female,6520,6789,13309
RAWALPINDI DISTRICT,57,Transgender,1,3,4
RAWALPINDI DISTRICT,58,Male,7888,9516,17404
RAWALPINDI DISTRICT,58,Female,7424,8030,15454
RAWALPINDI DISTRICT,58,Transgender,1,5,6
RAWALPINDI DISTRICT,59,Male,7357,8790,16147
RAWALPINDI DISTRICT,59,Female,7461,7754,15215
RAWALPINDI DISTRICT,59,Transgender,0,0,0
RAWALPINDI DISTRICT,60,Male,6127,7893,14020
RAWALPINDI DISTRICT,60,Female,5905,6744,12649
RAWALPINDI DISTRICT,60,Transgender,3,7,10
RAWALPINDI DISTRICT,61,Male,7458,8172,15630
RAWALPINDI DISTRICT,61,Female,7473,7092,14565
RAWALPINDI DISTRICT,61,Transgender,6,2,8
RAWALPINDI DISTRICT,62,Male,7583,8402,15985
RAWALPINDI DISTRICT,62,Female,7012,7172,14184
RAWALPINDI DISTRICT,62,Transgender,0,2,2
RAWALPINDI DISTRICT,63,Male,7584,8303,15887
RAWALPINDI DISTRICT,63,Female,6907,7283,14190
RAWALPINDI DISTRICT,63,Transgender,1,6,7
RAWALPINDI DISTRICT,64,Male,6737,6861,13598
RAWALPINDI DISTRICT,64,Female,6060,6010,12070
RAWALPINDI DISTRICT,64,Transgender,1,3,4
RAWALPINDI DISTRICT,65,Male,5288,6347,11635
RAWALPINDI DISTRICT,65,Female,4747,5330,10077
RAWALPINDI DISTRICT,65,Transgender,2,3,5
RAWALPINDI DISTRICT,66,Male,5259,4918,10177
RAWALPINDI DISTRICT,66,Female,4930,4224,9154
RAWALPINDI DISTRICT,66,Transgender,4,3,7
RAWALPINDI DISTRICT,67,Male,4964,5023,9987
RAWALPINDI DISTRICT,67,Female,4656,3958,8614
RAWALPINDI DISTRICT,67,Transgender,0,2,2
RAWALPINDI DISTRICT,68,Male,5245,5241,10486
RAWALPINDI DISTRICT,68,Female,5085,4594,9679
RAWALPINDI DISTRICT,68,Transgender,2,1,3
RAWALPINDI DISTRICT,69,Male,4707,4500,9207
RAWALPINDI DISTRICT,69,Female,4288,4000,8288
RAWALPINDI DISTRICT,69,Transgender,0,2,2
RAWALPINDI DISTRICT,70,Male,3713,3795,7508
RAWALPINDI DISTRICT,70,Female,3252,3288,6540
RAWALPINDI DISTRICT,70,Transgender,3,3,6
RAWALPINDI DISTRICT,71,Male,3851,3735,7586
RAWALPINDI DISTRICT,71,Female,3665,3303,6968
RAWALPINDI DISTRICT,71,Transgender,5,2,7
RAWALPINDI DISTRICT,72,Male,3898,3900,7798
RAWALPINDI DISTRICT,72,Female,3562,3144,6706
RAWALPINDI DISTRICT,72,Transgender,1,3,4
RAWALPINDI DISTRICT,73,Male,3562,3437,6999
RAWALPINDI DISTRICT,73,Female,3533,3160,6693
RAWALPINDI DISTRICT,73,Transgender,1,1,2
RAWALPINDI DISTRICT,74,Male,2902,2699,5601
RAWALPINDI DISTRICT,74,Female,2595,2410,5005
RAWALPINDI DISTRICT,74,Transgender,0,1,1
RAWALPINDI DISTRICT,>=75,Male,21659,19240,40899
RAWALPINDI DISTRICT,>=75,Female,22010,18392,40402
RAWALPINDI DISTRICT,>=75,Transgender,13,10,23
SAHIWAL DISTRICT,<1,Male,22754,5631,28385
SAHIWAL DISTRICT,<1,Female,21770,5492,27262
SAHIWAL DISTRICT,<1,Transgender,0,0,0
SAHIWAL DISTRICT,1,Male,25271,5943,31214
SAHIWAL DISTRICT,1,Female,24153,5773,29926
SAHIWAL DISTRICT,1,Transgender,0,0,0
SAHIWAL DISTRICT,2,Male,25955,6115,32070
SAHIWAL DISTRICT,2,Female,25055,5764,30819
SAHIWAL DISTRICT,2,Transgender,0,0,0
SAHIWAL DISTRICT,3,Male,28078,6385,34463
SAHIWAL DISTRICT,3,Female,27175,6266,33441
SAHIWAL DISTRICT,3,Transgender,0,0,0
SAHIWAL DISTRICT,4,Male,28269,6264,34533
SAHIWAL DISTRICT,4,Female,27170,5941,33111
SAHIWAL DISTRICT,4,Transgender,0,0,0
SAHIWAL DISTRICT,5,Male,28031,6140,34171
SAHIWAL DISTRICT,5,Female,26613,5894,32507
SAHIWAL DISTRICT,5,Transgender,0,0,0
SAHIWAL DISTRICT,6,Male,26764,5999,32763
SAHIWAL DISTRICT,6,Female,25526,5848,31374
SAHIWAL DISTRICT,6,Transgender,0,0,0
SAHIWAL DISTRICT,7,Male,29012,6522,35534
SAHIWAL DISTRICT,7,Female,27606,6154,33760
SAHIWAL DISTRICT,7,Transgender,0,0,0
SAHIWAL DISTRICT,8,Male,26847,5801,32648
SAHIWAL DISTRICT,8,Female,25616,5501,31117
SAHIWAL DISTRICT,8,Transgender,0,0,0
SAHIWAL DISTRICT,9,Male,27060,6348,33408
SAHIWAL DISTRICT,9,Female,25042,5968,31010
SAHIWAL DISTRICT,9,Transgender,0,0,0
SAHIWAL DISTRICT,10,Male,24605,5502,30107
SAHIWAL DISTRICT,10,Female,23670,5194,28864
SAHIWAL DISTRICT,10,Transgender,0,0,0
SAHIWAL DISTRICT,11,Male,24305,6271,30576
SAHIWAL DISTRICT,11,Female,22188,5917,28105
SAHIWAL DISTRICT,11,Transgender,0,0,0
SAHIWAL DISTRICT,12,Male,22694,5394,28088
SAHIWAL DISTRICT,12,Female,20848,5019,25867
SAHIWAL DISTRICT,12,Transgender,0,0,0
SAHIWAL DISTRICT,13,Male,21789,5770,27559
SAHIWAL DISTRICT,13,Female,19792,5301,25093
SAHIWAL DISTRICT,13,Transgender,0,0,0
SAHIWAL DISTRICT,14,Male,21050,5319,26369
SAHIWAL DISTRICT,14,Female,19364,4990,24354
SAHIWAL DISTRICT,14,Transgender,0,0,0
SAHIWAL DISTRICT,15,Male,20810,5373,26183
SAHIWAL DISTRICT,15,Female,19784,5139,24923
SAHIWAL DISTRICT,15,Transgender,2,0,2
SAHIWAL DISTRICT,16,Male,21045,5340,26385
SAHIWAL DISTRICT,16,Female,19428,5132,24560
SAHIWAL DISTRICT,16,Transgender,1,0,1
SAHIWAL DISTRICT,17,Male,21087,5857,26944
SAHIWAL DISTRICT,17,Female,19202,5533,24735
SAHIWAL DISTRICT,17,Transgender,4,1,5
SAHIWAL DISTRICT,18,Male,19806,4882,24688
SAHIWAL DISTRICT,18,Female,18874,4515,23389
SAHIWAL DISTRICT,18,Transgender,9,0,9
SAHIWAL DISTRICT,19,Male,19678,5460,25138
SAHIWAL DISTRICT,19,Female,18983,5239,24222
SAHIWAL DISTRICT,19,Transgender,3,2,5
SAHIWAL DISTRICT,20,Male,19419,4802,24221
SAHIWAL DISTRICT,20,Female,19002,4639,23641
SAHIWAL DISTRICT,20,Transgender,11,0,11
SAHIWAL DISTRICT,21,Male,18093,5398,23491
SAHIWAL DISTRICT,21,Female,18631,5635,24266
SAHIWAL DISTRICT,21,Transgender,2,1,3
SAHIWAL DISTRICT,22,Male,18171,4868,23039
SAHIWAL DISTRICT,22,Female,18862,5158,24020
SAHIWAL DISTRICT,22,Transgender,9,1,10
SAHIWAL DISTRICT,23,Male,17106,4988,22094
SAHIWAL DISTRICT,23,Female,17493,5340,22833
SAHIWAL DISTRICT,23,Transgender,2,3,5
SAHIWAL DISTRICT,24,Male,16127,4832,20959
SAHIWAL DISTRICT,24,Female,16641,5047,21688
SAHIWAL DISTRICT,24,Transgender,7,3,10
SAHIWAL DISTRICT,25,Male,16509,4253,20762
SAHIWAL DISTRICT,25,Female,17535,4298,21833
SAHIWAL DISTRICT,25,Transgender,10,2,12
SAHIWAL DISTRICT,26,Male,14969,4589,19558
SAHIWAL DISTRICT,26,Female,16350,4954,21304
SAHIWAL DISTRICT,26,Transgender,8,1,9
SAHIWAL DISTRICT,27,Male,14536,4486,19022
SAHIWAL DISTRICT,27,Female,15887,5010,20897
SAHIWAL DISTRICT,27,Transgender,4,2,6
SAHIWAL DISTRICT,28,Male,14782,4374,19156
SAHIWAL DISTRICT,28,Female,15888,4636,20524
SAHIWAL DISTRICT,28,Transgender,4,4,8
SAHIWAL DISTRICT,29,Male,14277,4066,18343
SAHIWAL DISTRICT,29,Female,15900,4596,20496
SAHIWAL DISTRICT,29,Transgender,2,2,4
SAHIWAL DISTRICT,30,Male,14939,4214,19153
SAHIWAL DISTRICT,30,Female,16597,4232,20829
SAHIWAL DISTRICT,30,Transgender,7,2,9
SAHIWAL DISTRICT,31,Male,13426,3835,17261
SAHIWAL DISTRICT,31,Female,14798,4225,19023
SAHIWAL DISTRICT,31,Transgender,2,2,4
SAHIWAL DISTRICT,32,Male,13208,4103,17311
SAHIWAL DISTRICT,32,Female,14438,4263,18701
SAHIWAL DISTRICT,32,Transgender,6,2,8
SAHIWAL DISTRICT,33,Male,12348,3823,16171
SAHIWAL DISTRICT,33,Female,12934,3863,16797
SAHIWAL DISTRICT,33,Transgender,1,0,1
SAHIWAL DISTRICT,34,Male,12343,3544,15887
SAHIWAL DISTRICT,34,Female,12080,3590,15670
SAHIWAL DISTRICT,34,Transgender,5,1,6
SAHIWAL DISTRICT,35,Male,13160,3418,16578
SAHIWAL DISTRICT,35,Female,13410,3463,16873
SAHIWAL DISTRICT,35,Transgender,6,2,8
SAHIWAL DISTRICT,36,Male,12411,3373,15784
SAHIWAL DISTRICT,36,Female,11841,3387,15228
SAHIWAL DISTRICT,36,Transgender,2,3,5
SAHIWAL DISTRICT,37,Male,11941,3065,15006
SAHIWAL DISTRICT,37,Female,11882,3004,14886
SAHIWAL DISTRICT,37,Transgender,2,0,2
SAHIWAL DISTRICT,38,Male,12053,3620,15673
SAHIWAL DISTRICT,38,Female,11247,3541,14788
SAHIWAL DISTRICT,38,Transgender,4,2,6
SAHIWAL DISTRICT,39,Male,12009,3208,15217
SAHIWAL DISTRICT,39,Female,12085,3186,15271
SAHIWAL DISTRICT,39,Transgender,1,0,1
SAHIWAL DISTRICT,40,Male,11469,3508,14977
SAHIWAL DISTRICT,40,Female,11454,3201,14655
SAHIWAL DISTRICT,40,Transgender,3,5,8
SAHIWAL DISTRICT,41,Male,10631,2884,13515
SAHIWAL DISTRICT,41,Female,10566,2715,13281
SAHIWAL DISTRICT,41,Transgender,1,0,1
SAHIWAL DISTRICT,42,Male,10025,2871,12896
SAHIWAL DISTRICT,42,Female,10147,2756,12903
SAHIWAL DISTRICT,42,Transgender,5,0,5
SAHIWAL DISTRICT,43,Male,8823,2648,11471
SAHIWAL DISTRICT,43,Female,8884,2741,11625
SAHIWAL DISTRICT,43,Transgender,1,0,1
SAHIWAL DISTRICT,44,Male,8391,2437,10828
SAHIWAL DISTRICT,44,Female,8215,2462,10677
SAHIWAL DISTRICT,44,Transgender,2,1,3
SAHIWAL DISTRICT,45,Male,8962,2634,11596
SAHIWAL DISTRICT,45,Female,8902,2502,11404
SAHIWAL DISTRICT,45,Transgender,7,3,10
SAHIWAL DISTRICT,46,Male,7955,2242,10197
SAHIWAL DISTRICT,46,Female,7625,2092,9717
SAHIWAL DISTRICT,46,Transgender,4,1,5
SAHIWAL DISTRICT,47,Male,8510,2190,10700
SAHIWAL DISTRICT,47,Female,8220,1932,10152
SAHIWAL DISTRICT,47,Transgender,2,0,2
SAHIWAL DISTRICT,48,Male,8053,2448,10501
SAHIWAL DISTRICT,48,Female,7832,2373,10205
SAHIWAL DISTRICT,48,Transgender,1,1,2
SAHIWAL DISTRICT,49,Male,8646,2372,11018
SAHIWAL DISTRICT,49,Female,8339,2334,10673
SAHIWAL DISTRICT,49,Transgender,1,0,1
SAHIWAL DISTRICT,50,Male,8710,2605,11315
SAHIWAL DISTRICT,50,Female,8369,2260,10629
SAHIWAL DISTRICT,50,Transgender,10,3,13
SAHIWAL DISTRICT,51,Male,8674,2223,10897
SAHIWAL DISTRICT,51,Female,7941,2126,10067
SAHIWAL DISTRICT,51,Transgender,0,2,2
SAHIWAL DISTRICT,52,Male,8346,2397,10743
SAHIWAL DISTRICT,52,Female,7930,2088,10018
SAHIWAL DISTRICT,52,Transgender,1,0,1
SAHIWAL DISTRICT,53,Male,8010,2161,10171
SAHIWAL DISTRICT,53,Female,6880,2101,8981
SAHIWAL DISTRICT,53,Transgender,1,0,1
SAHIWAL DISTRICT,54,Male,7502,2060,9562
SAHIWAL DISTRICT,54,Female,6138,1846,7984
SAHIWAL DISTRICT,54,Transgender,0,0,0
SAHIWAL DISTRICT,55,Male,7368,2027,9395
SAHIWAL DISTRICT,55,Female,6112,1636,7748
SAHIWAL DISTRICT,55,Transgender,5,1,6
SAHIWAL DISTRICT,56,Male,6476,1649,8125
SAHIWAL DISTRICT,56,Female,5466,1441,6907
SAHIWAL DISTRICT,56,Transgender,0,0,0
SAHIWAL DISTRICT,57,Male,6202,1534,7736
SAHIWAL DISTRICT,57,Female,5627,1207,6834
SAHIWAL DISTRICT,57,Transgender,0,0,0
SAHIWAL DISTRICT,58,Male,5739,1477,7216
SAHIWAL DISTRICT,58,Female,4748,1350,6098
SAHIWAL DISTRICT,58,Transgender,3,0,3
SAHIWAL DISTRICT,59,Male,5753,1470,7223
SAHIWAL DISTRICT,59,Female,5016,1324,6340
SAHIWAL DISTRICT,59,Transgender,2,0,2
SAHIWAL DISTRICT,60,Male,5376,1464,6840
SAHIWAL DISTRICT,60,Female,4947,1244,6191
SAHIWAL DISTRICT,60,Transgender,2,3,5
SAHIWAL DISTRICT,61,Male,5172,1262,6434
SAHIWAL DISTRICT,61,Female,4688,1129,5817
SAHIWAL DISTRICT,61,Transgender,0,0,0
SAHIWAL DISTRICT,62,Male,4960,1296,6256
SAHIWAL DISTRICT,62,Female,4659,1127,5786
SAHIWAL DISTRICT,62,Transgender,1,0,1
SAHIWAL DISTRICT,63,Male,4790,1284,6074
SAHIWAL DISTRICT,63,Female,4362,1123,5485
SAHIWAL DISTRICT,63,Transgender,4,0,4
SAHIWAL DISTRICT,64,Male,4401,1032,5433
SAHIWAL DISTRICT,64,Female,4129,954,5083
SAHIWAL DISTRICT,64,Transgender,0,0,0
SAHIWAL DISTRICT,65,Male,4209,1071,5280
SAHIWAL DISTRICT,65,Female,3942,896,4838
SAHIWAL DISTRICT,65,Transgender,5,0,5
SAHIWAL DISTRICT,66,Male,3415,801,4216
SAHIWAL DISTRICT,66,Female,3023,668,3691
SAHIWAL DISTRICT,66,Transgender,0,0,0
SAHIWAL DISTRICT,67,Male,3390,690,4080
SAHIWAL DISTRICT,67,Female,3043,597,3640
SAHIWAL DISTRICT,67,Transgender,1,0,1
SAHIWAL DISTRICT,68,Male,3266,746,4012
SAHIWAL DISTRICT,68,Female,2889,639,3528
SAHIWAL DISTRICT,68,Transgender,1,0,1
SAHIWAL DISTRICT,69,Male,3515,629,4144
SAHIWAL DISTRICT,69,Female,3018,653,3671
SAHIWAL DISTRICT,69,Transgender,0,0,0
SAHIWAL DISTRICT,70,Male,3319,691,4010
SAHIWAL DISTRICT,70,Female,3082,604,3686
SAHIWAL DISTRICT,70,Transgender,0,1,1
SAHIWAL DISTRICT,71,Male,2883,562,3445
SAHIWAL DISTRICT,71,Female,2612,524,3136
SAHIWAL DISTRICT,71,Transgender,2,0,2
SAHIWAL DISTRICT,72,Male,2820,625,3445
SAHIWAL DISTRICT,72,Female,2316,534,2850
SAHIWAL DISTRICT,72,Transgender,0,0,0
SAHIWAL DISTRICT,73,Male,2627,580,3207
SAHIWAL DISTRICT,73,Female,2152,531,2683
SAHIWAL DISTRICT,73,Transgender,0,0,0
SAHIWAL DISTRICT,74,Male,2539,461,3000
SAHIWAL DISTRICT,74,Female,2111,409,2520
SAHIWAL DISTRICT,74,Transgender,0,0,0
SAHIWAL DISTRICT,>=75,Male,17337,3439,20776
SAHIWAL DISTRICT,>=75,Female,15396,3213,18609
SAHIWAL DISTRICT,>=75,Transgender,7,3,10
SANGHAR DISTRICT,<1,Male,17068,6272,23340
SANGHAR DISTRICT,<1,Female,15919,5817,21736
SANGHAR DISTRICT,<1,Transgender,0,0,0
SANGHAR DISTRICT,1,Male,21945,6839,28784
SANGHAR DISTRICT,1,Female,21147,6579,27726
SANGHAR DISTRICT,1,Transgender,0,0,0
SANGHAR DISTRICT,2,Male,25184,7573,32757
SANGHAR DISTRICT,2,Female,24682,7208,31890
SANGHAR DISTRICT,2,Transgender,0,0,0
SANGHAR DISTRICT,3,Male,26389,8528,34917
SANGHAR DISTRICT,3,Female,26087,8139,34226
SANGHAR DISTRICT,3,Transgender,0,0,0
SANGHAR DISTRICT,4,Male,27590,8230,35820
SANGHAR DISTRICT,4,Female,27112,8079,35191
SANGHAR DISTRICT,4,Transgender,0,0,0
SANGHAR DISTRICT,5,Male,27938,8806,36744
SANGHAR DISTRICT,5,Female,25611,8035,33646
SANGHAR DISTRICT,5,Transgender,0,0,0
SANGHAR DISTRICT,6,Male,28554,8314,36868
SANGHAR DISTRICT,6,Female,26223,7716,33939
SANGHAR DISTRICT,6,Transgender,0,0,0
SANGHAR DISTRICT,7,Male,24342,8366,32708
SANGHAR DISTRICT,7,Female,21823,7867,29690
SANGHAR DISTRICT,7,Transgender,0,0,0
SANGHAR DISTRICT,8,Male,30121,8434,38555
SANGHAR DISTRICT,8,Female,26590,7649,34239
SANGHAR DISTRICT,8,Transgender,0,0,0
SANGHAR DISTRICT,9,Male,22382,7850,30232
SANGHAR DISTRICT,9,Female,19567,7270,26837
SANGHAR DISTRICT,9,Transgender,0,0,0
SANGHAR DISTRICT,10,Male,26696,7846,34542
SANGHAR DISTRICT,10,Female,23136,7069,30205
SANGHAR DISTRICT,10,Transgender,0,0,0
SANGHAR DISTRICT,11,Male,18561,7349,25910
SANGHAR DISTRICT,11,Female,15725,6848,22573
SANGHAR DISTRICT,11,Transgender,0,0,0
SANGHAR DISTRICT,12,Male,22026,7376,29402
SANGHAR DISTRICT,12,Female,18469,6567,25036
SANGHAR DISTRICT,12,Transgender,0,0,0
SANGHAR DISTRICT,13,Male,16930,6898,23828
SANGHAR DISTRICT,13,Female,13893,6272,20165
SANGHAR DISTRICT,13,Transgender,0,0,0
SANGHAR DISTRICT,14,Male,17587,6649,24236
SANGHAR DISTRICT,14,Female,14735,5942,20677
SANGHAR DISTRICT,14,Transgender,0,0,0
SANGHAR DISTRICT,15,Male,18075,7048,25123
SANGHAR DISTRICT,15,Female,14334,6385,20719
SANGHAR DISTRICT,15,Transgender,6,2,8
SANGHAR DISTRICT,16,Male,17151,6598,23749
SANGHAR DISTRICT,16,Female,13895,6026,19921
SANGHAR DISTRICT,16,Transgender,2,3,5
SANGHAR DISTRICT,17,Male,14260,6871,21131
SANGHAR DISTRICT,17,Female,11506,6282,17788
SANGHAR DISTRICT,17,Transgender,2,2,4
SANGHAR DISTRICT,18,Male,17203,6649,23852
SANGHAR DISTRICT,18,Female,15824,6131,21955
SANGHAR DISTRICT,18,Transgender,5,1,6
SANGHAR DISTRICT,19,Male,13072,6164,19236
SANGHAR DISTRICT,19,Female,12523,5932,18455
SANGHAR DISTRICT,19,Transgender,3,1,4
SANGHAR DISTRICT,20,Male,15678,6007,21685
SANGHAR DISTRICT,20,Female,14813,5767,20580
SANGHAR DISTRICT,20,Transgender,3,3,6
SANGHAR DISTRICT,21,Male,11207,5685,16892
SANGHAR DISTRICT,21,Female,10812,5550,16362
SANGHAR DISTRICT,21,Transgender,3,1,4
SANGHAR DISTRICT,22,Male,12042,5289,17331
SANGHAR DISTRICT,22,Female,10568,5122,15690
SANGHAR DISTRICT,22,Transgender,5,2,7
SANGHAR DISTRICT,23,Male,10508,5115,15623
SANGHAR DISTRICT,23,Female,9341,4724,14065
SANGHAR DISTRICT,23,Transgender,0,2,2
SANGHAR DISTRICT,24,Male,9587,4615,14202
SANGHAR DISTRICT,24,Female,8997,4481,13478
SANGHAR DISTRICT,24,Transgender,4,1,5
SANGHAR DISTRICT,25,Male,11640,4794,16434
SANGHAR DISTRICT,25,Female,11061,4604,15665
SANGHAR DISTRICT,25,Transgender,10,2,12
SANGHAR DISTRICT,26,Male,9214,4416,13630
SANGHAR DISTRICT,26,Female,9013,4364,13377
SANGHAR DISTRICT,26,Transgender,1,4,5
SANGHAR DISTRICT,27,Male,10305,4687,14992
SANGHAR DISTRICT,27,Female,10370,4701,15071
SANGHAR DISTRICT,27,Transgender,1,5,6
SANGHAR DISTRICT,28,Male,9818,4382,14200
SANGHAR DISTRICT,28,Female,10823,4550,15373
SANGHAR DISTRICT,28,Transgender,3,3,6
SANGHAR DISTRICT,29,Male,10681,4637,15318
SANGHAR DISTRICT,29,Female,10968,4594,15562
SANGHAR DISTRICT,29,Transgender,5,1,6
SANGHAR DISTRICT,30,Male,10286,4330,14616
SANGHAR DISTRICT,30,Female,10632,4267,14899
SANGHAR DISTRICT,30,Transgender,6,8,14
SANGHAR DISTRICT,31,Male,9975,4528,14503
SANGHAR DISTRICT,31,Female,10204,4200,14404
SANGHAR DISTRICT,31,Transgender,0,1,1
SANGHAR DISTRICT,32,Male,9918,4391,14309
SANGHAR DISTRICT,32,Female,9816,4158,13974
SANGHAR DISTRICT,32,Transgender,6,2,8
SANGHAR DISTRICT,33,Male,8946,4116,13062
SANGHAR DISTRICT,33,Female,9306,3887,13193
SANGHAR DISTRICT,33,Transgender,0,0,0
SANGHAR DISTRICT,34,Male,8412,3824,12236
SANGHAR DISTRICT,34,Female,9143,3670,12813
SANGHAR DISTRICT,34,Transgender,2,1,3
SANGHAR DISTRICT,35,Male,9407,3709,13116
SANGHAR DISTRICT,35,Female,8935,3625,12560
SANGHAR DISTRICT,35,Transgender,6,3,9
SANGHAR DISTRICT,36,Male,8930,3492,12422
SANGHAR DISTRICT,36,Female,8705,3156,11861
SANGHAR DISTRICT,36,Transgender,5,1,6
SANGHAR DISTRICT,37,Male,12165,4148,16313
SANGHAR DISTRICT,37,Female,11440,4138,15578
SANGHAR DISTRICT,37,Transgender,4,1,5
SANGHAR DISTRICT,38,Male,7960,3367,11327
SANGHAR DISTRICT,38,Female,7565,3186,10751
SANGHAR DISTRICT,38,Transgender,4,1,5
SANGHAR DISTRICT,39,Male,8905,3764,12669
SANGHAR DISTRICT,39,Female,8799,3672,12471
SANGHAR DISTRICT,39,Transgender,2,1,3
SANGHAR DISTRICT,40,Male,6746,3175,9921
SANGHAR DISTRICT,40,Female,6657,2968,9625
SANGHAR DISTRICT,40,Transgender,6,6,12
SANGHAR DISTRICT,41,Male,6601,3009,9610
SANGHAR DISTRICT,41,Female,6839,2807,9646
SANGHAR DISTRICT,41,Transgender,1,0,1
SANGHAR DISTRICT,42,Male,6465,3004,9469
SANGHAR DISTRICT,42,Female,7248,3178,10426
SANGHAR DISTRICT,42,Transgender,8,1,9
SANGHAR DISTRICT,43,Male,5686,2847,8533
SANGHAR DISTRICT,43,Female,5350,2593,7943
SANGHAR DISTRICT,43,Transgender,2,1,3
SANGHAR DISTRICT,44,Male,5686,2640,8326
SANGHAR DISTRICT,44,Female,5431,2357,7788
SANGHAR DISTRICT,44,Transgender,0,1,1
SANGHAR DISTRICT,45,Male,5212,2518,7730
SANGHAR DISTRICT,45,Female,4764,2171,6935
SANGHAR DISTRICT,45,Transgender,4,5,9
SANGHAR DISTRICT,46,Male,5418,2424,7842
SANGHAR DISTRICT,46,Female,5031,1971,7002
SANGHAR DISTRICT,46,Transgender,2,1,3
SANGHAR DISTRICT,47,Male,6235,2571,8806
SANGHAR DISTRICT,47,Female,6549,2624,9173
SANGHAR DISTRICT,47,Transgender,3,3,6
SANGHAR DISTRICT,48,Male,5097,2317,7414
SANGHAR DISTRICT,48,Female,4469,1998,6467
SANGHAR DISTRICT,48,Transgender,2,1,3
SANGHAR DISTRICT,49,Male,5562,2486,8048
SANGHAR DISTRICT,49,Female,4831,2236,7067
SANGHAR DISTRICT,49,Transgender,0,2,2
SANGHAR DISTRICT,50,Male,4562,2197,6759
SANGHAR DISTRICT,50,Female,3916,1878,5794
SANGHAR DISTRICT,50,Transgender,7,3,10
SANGHAR DISTRICT,51,Male,4721,2193,6914
SANGHAR DISTRICT,51,Female,4078,1934,6012
SANGHAR DISTRICT,51,Transgender,0,2,2
SANGHAR DISTRICT,52,Male,4134,1972,6106
SANGHAR DISTRICT,52,Female,3941,1883,5824
SANGHAR DISTRICT,52,Transgender,2,0,2
SANGHAR DISTRICT,53,Male,3918,1941,5859
SANGHAR DISTRICT,53,Female,2813,1617,4430
SANGHAR DISTRICT,53,Transgender,1,0,1
SANGHAR DISTRICT,54,Male,3239,1605,4844
SANGHAR DISTRICT,54,Female,2467,1272,3739
SANGHAR DISTRICT,54,Transgender,0,0,0
SANGHAR DISTRICT,55,Male,3002,1556,4558
SANGHAR DISTRICT,55,Female,2595,1184,3779
SANGHAR DISTRICT,55,Transgender,4,1,5
SANGHAR DISTRICT,56,Male,2678,1278,3956
SANGHAR DISTRICT,56,Female,2329,925,3254
SANGHAR DISTRICT,56,Transgender,0,2,2
SANGHAR DISTRICT,57,Male,3154,1310,4464
SANGHAR DISTRICT,57,Female,3521,1272,4793
SANGHAR DISTRICT,57,Transgender,1,2,3
SANGHAR DISTRICT,58,Male,2303,1112,3415
SANGHAR DISTRICT,58,Female,2120,947,3067
SANGHAR DISTRICT,58,Transgender,0,0,0
SANGHAR DISTRICT,59,Male,2511,1123,3634
SANGHAR DISTRICT,59,Female,2402,1168,3570
SANGHAR DISTRICT,59,Transgender,0,0,0
SANGHAR DISTRICT,60,Male,2404,941,3345
SANGHAR DISTRICT,60,Female,2563,1020,3583
SANGHAR DISTRICT,60,Transgender,7,4,11
SANGHAR DISTRICT,61,Male,2378,1064,3442
SANGHAR DISTRICT,61,Female,2595,1175,3770
SANGHAR DISTRICT,61,Transgender,0,0,0
SANGHAR DISTRICT,62,Male,2346,995,3341
SANGHAR DISTRICT,62,Female,2841,1171,4012
SANGHAR DISTRICT,62,Transgender,1,0,1
SANGHAR DISTRICT,63,Male,2231,1042,3273
SANGHAR DISTRICT,63,Female,2255,1085,3340
SANGHAR DISTRICT,63,Transgender,0,0,0
SANGHAR DISTRICT,64,Male,2236,877,3113
SANGHAR DISTRICT,64,Female,2305,920,3225
SANGHAR DISTRICT,64,Transgender,0,0,0
SANGHAR DISTRICT,65,Male,2004,820,2824
SANGHAR DISTRICT,65,Female,1943,793,2736
SANGHAR DISTRICT,65,Transgender,0,1,1
SANGHAR DISTRICT,66,Male,1948,704,2652
SANGHAR DISTRICT,66,Female,1920,657,2577
SANGHAR DISTRICT,66,Transgender,1,0,1
SANGHAR DISTRICT,67,Male,1900,666,2566
SANGHAR DISTRICT,67,Female,2300,732,3032
SANGHAR DISTRICT,67,Transgender,2,2,4
SANGHAR DISTRICT,68,Male,1732,655,2387
SANGHAR DISTRICT,68,Female,1615,725,2340
SANGHAR DISTRICT,68,Transgender,0,0,0
SANGHAR DISTRICT,69,Male,1623,617,2240
SANGHAR DISTRICT,69,Female,1586,644,2230
SANGHAR DISTRICT,69,Transgender,0,0,0
SANGHAR DISTRICT,70,Male,1289,458,1747
SANGHAR DISTRICT,70,Female,1367,497,1864
SANGHAR DISTRICT,70,Transgender,2,1,3
SANGHAR DISTRICT,71,Male,1349,534,1883
SANGHAR DISTRICT,71,Female,1334,551,1885
SANGHAR DISTRICT,71,Transgender,0,0,0
SANGHAR DISTRICT,72,Male,1053,426,1479
SANGHAR DISTRICT,72,Female,1233,483,1716
SANGHAR DISTRICT,72,Transgender,0,0,0
SANGHAR DISTRICT,73,Male,1194,445,1639
SANGHAR DISTRICT,73,Female,1161,568,1729
SANGHAR DISTRICT,73,Transgender,0,0,0
SANGHAR DISTRICT,74,Male,848,303,1151
SANGHAR DISTRICT,74,Female,876,332,1208
SANGHAR DISTRICT,74,Transgender,1,1,2
SANGHAR DISTRICT,>=75,Male,6787,2360,9147
SANGHAR DISTRICT,>=75,Female,7737,2919,10656
SANGHAR DISTRICT,>=75,Transgender,5,2,7
SARGODHA DISTRICT,<1,Male,30958,11975,42933
SARGODHA DISTRICT,<1,Female,29526,11247,40773
SARGODHA DISTRICT,<1,Transgender,0,0,0
SARGODHA DISTRICT,1,Male,32974,12606,45580
SARGODHA DISTRICT,1,Female,31043,12233,43276
SARGODHA DISTRICT,1,Transgender,0,0,0
SARGODHA DISTRICT,2,Male,33352,12970,46322
SARGODHA DISTRICT,2,Female,31950,12114,44064
SARGODHA DISTRICT,2,Transgender,0,0,0
SARGODHA DISTRICT,3,Male,36068,13863,49931
SARGODHA DISTRICT,3,Female,34754,13131,47885
SARGODHA DISTRICT,3,Transgender,0,0,0
SARGODHA DISTRICT,4,Male,36155,13214,49369
SARGODHA DISTRICT,4,Female,34741,12648,47389
SARGODHA DISTRICT,4,Transgender,0,0,0
SARGODHA DISTRICT,5,Male,35724,13005,48729
SARGODHA DISTRICT,5,Female,34252,12654,46906
SARGODHA DISTRICT,5,Transgender,0,0,0
SARGODHA DISTRICT,6,Male,34669,12966,47635
SARGODHA DISTRICT,6,Female,32074,12285,44359
SARGODHA DISTRICT,6,Transgender,0,0,0
SARGODHA DISTRICT,7,Male,36478,13879,50357
SARGODHA DISTRICT,7,Female,34292,12956,47248
SARGODHA DISTRICT,7,Transgender,0,0,0
SARGODHA DISTRICT,8,Male,34126,12315,46441
SARGODHA DISTRICT,8,Female,31734,11783,43517
SARGODHA DISTRICT,8,Transgender,0,0,0
SARGODHA DISTRICT,9,Male,35699,14002,49701
SARGODHA DISTRICT,9,Female,32874,12877,45751
SARGODHA DISTRICT,9,Transgender,0,0,0
SARGODHA DISTRICT,10,Male,31274,11818,43092
SARGODHA DISTRICT,10,Female,29433,10906,40339
SARGODHA DISTRICT,10,Transgender,0,0,0
SARGODHA DISTRICT,11,Male,33521,13867,47388
SARGODHA DISTRICT,11,Female,30712,12939,43651
SARGODHA DISTRICT,11,Transgender,0,0,0
SARGODHA DISTRICT,12,Male,29075,11474,40549
SARGODHA DISTRICT,12,Female,27064,10542,37606
SARGODHA DISTRICT,12,Transgender,0,0,0
SARGODHA DISTRICT,13,Male,30329,12438,42767
SARGODHA DISTRICT,13,Female,27183,11473,38656
SARGODHA DISTRICT,13,Transgender,0,0,0
SARGODHA DISTRICT,14,Male,27662,11487,39149
SARGODHA DISTRICT,14,Female,25282,10299,35581
SARGODHA DISTRICT,14,Transgender,0,0,0
SARGODHA DISTRICT,15,Male,28080,11492,39572
SARGODHA DISTRICT,15,Female,26332,10913,37245
SARGODHA DISTRICT,15,Transgender,3,0,3
SARGODHA DISTRICT,16,Male,27864,11745,39609
SARGODHA DISTRICT,16,Female,26145,10824,36969
SARGODHA DISTRICT,16,Transgender,1,2,3
SARGODHA DISTRICT,17,Male,29666,13187,42853
SARGODHA DISTRICT,17,Female,29382,12751,42133
SARGODHA DISTRICT,17,Transgender,2,6,8
SARGODHA DISTRICT,18,Male,23852,10048,33900
SARGODHA DISTRICT,18,Female,23055,9184,32239
SARGODHA DISTRICT,18,Transgender,2,8,10
SARGODHA DISTRICT,19,Male,25884,11778,37662
SARGODHA DISTRICT,19,Female,25525,11415,36940
SARGODHA DISTRICT,19,Transgender,2,6,8
SARGODHA DISTRICT,20,Male,23311,10068,33379
SARGODHA DISTRICT,20,Female,23800,9318,33118
SARGODHA DISTRICT,20,Transgender,8,8,16
SARGODHA DISTRICT,21,Male,24315,11441,35756
SARGODHA DISTRICT,21,Female,25764,12511,38275
SARGODHA DISTRICT,21,Transgender,6,6,12
SARGODHA DISTRICT,22,Male,21630,10289,31919
SARGODHA DISTRICT,22,Female,23823,10954,34777
SARGODHA DISTRICT,22,Transgender,4,12,16
SARGODHA DISTRICT,23,Male,21623,10210,31833
SARGODHA DISTRICT,23,Female,23024,11268,34292
SARGODHA DISTRICT,23,Transgender,4,10,14
SARGODHA DISTRICT,24,Male,20423,10153,30576
SARGODHA DISTRICT,24,Female,22075,10995,33070
SARGODHA DISTRICT,24,Transgender,5,10,15
SARGODHA DISTRICT,25,Male,19720,8689,28409
SARGODHA DISTRICT,25,Female,22395,9024,31419
SARGODHA DISTRICT,25,Transgender,11,11,22
SARGODHA DISTRICT,26,Male,19379,9093,28472
SARGODHA DISTRICT,26,Female,21734,10408,32142
SARGODHA DISTRICT,26,Transgender,1,13,14
SARGODHA DISTRICT,27,Male,19977,9123,29100
SARGODHA DISTRICT,27,Female,22901,10375,33276
SARGODHA DISTRICT,27,Transgender,9,7,16
SARGODHA DISTRICT,28,Male,18635,8929,27564
SARGODHA DISTRICT,28,Female,20779,9519,30298
SARGODHA DISTRICT,28,Transgender,7,5,12
SARGODHA DISTRICT,29,Male,19722,8808,28530
SARGODHA DISTRICT,29,Female,22240,9847,32087
SARGODHA DISTRICT,29,Transgender,8,3,11
SARGODHA DISTRICT,30,Male,17308,7885,25193
SARGODHA DISTRICT,30,Female,19894,8319,28213
SARGODHA DISTRICT,30,Transgender,12,10,22
SARGODHA DISTRICT,31,Male,17914,8319,26233
SARGODHA DISTRICT,31,Female,20031,9276,29307
SARGODHA DISTRICT,31,Transgender,4,4,8
SARGODHA DISTRICT,32,Male,16450,7924,24374
SARGODHA DISTRICT,32,Female,18719,8683,27402
SARGODHA DISTRICT,32,Transgender,8,6,14
SARGODHA DISTRICT,33,Male,16816,7725,24541
SARGODHA DISTRICT,33,Female,17569,8245,25814
SARGODHA DISTRICT,33,Transgender,2,3,5
SARGODHA DISTRICT,34,Male,17276,7458,24734
SARGODHA DISTRICT,34,Female,16638,7782,24420
SARGODHA DISTRICT,34,Transgender,4,4,8
SARGODHA DISTRICT,35,Male,15152,6621,21773
SARGODHA DISTRICT,35,Female,15631,6882,22513
SARGODHA DISTRICT,35,Transgender,11,10,21
SARGODHA DISTRICT,36,Male,14936,6619,21555
SARGODHA DISTRICT,36,Female,15217,6964,22181
SARGODHA DISTRICT,36,Transgender,6,1,7
SARGODHA DISTRICT,37,Male,14770,6480,21250
SARGODHA DISTRICT,37,Female,16426,6708,23134
SARGODHA DISTRICT,37,Transgender,3,4,7
SARGODHA DISTRICT,38,Male,14406,6954,21360
SARGODHA DISTRICT,38,Female,14568,7029,21597
SARGODHA DISTRICT,38,Transgender,3,8,11
SARGODHA DISTRICT,39,Male,14183,6553,20736
SARGODHA DISTRICT,39,Female,15444,6703,22147
SARGODHA DISTRICT,39,Transgender,2,1,3
SARGODHA DISTRICT,40,Male,12387,6296,18683
SARGODHA DISTRICT,40,Female,13091,6010,19101
SARGODHA DISTRICT,40,Transgender,5,9,14
SARGODHA DISTRICT,41,Male,12748,5806,18554
SARGODHA DISTRICT,41,Female,14009,5961,19970
SARGODHA DISTRICT,41,Transgender,0,1,1
SARGODHA DISTRICT,42,Male,11399,5639,17038
SARGODHA DISTRICT,42,Female,12783,5544,18327
SARGODHA DISTRICT,42,Transgender,4,1,5
SARGODHA DISTRICT,43,Male,11344,5475,16819
SARGODHA DISTRICT,43,Female,11542,5563,17105
SARGODHA DISTRICT,43,Transgender,1,1,2
SARGODHA DISTRICT,44,Male,11374,5115,16489
SARGODHA DISTRICT,44,Female,11076,5083,16159
SARGODHA DISTRICT,44,Transgender,4,1,5
SARGODHA DISTRICT,45,Male,10481,5037,15518
SARGODHA DISTRICT,45,Female,10112,4889,15001
SARGODHA DISTRICT,45,Transgender,4,6,10
SARGODHA DISTRICT,46,Male,11018,4792,15810
SARGODHA DISTRICT,46,Female,10969,4724,15693
SARGODHA DISTRICT,46,Transgender,1,4,5
SARGODHA DISTRICT,47,Male,11301,4567,15868
SARGODHA DISTRICT,47,Female,12123,4396,16519
SARGODHA DISTRICT,47,Transgender,2,0,2
SARGODHA DISTRICT,48,Male,11367,5101,16468
SARGODHA DISTRICT,48,Female,10633,4949,15582
SARGODHA DISTRICT,48,Transgender,2,3,5
SARGODHA DISTRICT,49,Male,11911,5121,17032
SARGODHA DISTRICT,49,Female,11629,5037,16666
SARGODHA DISTRICT,49,Transgender,2,0,2
SARGODHA DISTRICT,50,Male,10652,4875,15527
SARGODHA DISTRICT,50,Female,10012,4730,14742
SARGODHA DISTRICT,50,Transgender,4,4,8
SARGODHA DISTRICT,51,Male,12102,5075,17177
SARGODHA DISTRICT,51,Female,11324,4708,16032
SARGODHA DISTRICT,51,Transgender,2,2,4
SARGODHA DISTRICT,52,Male,11423,4932,16355
SARGODHA DISTRICT,52,Female,10552,4469,15021
SARGODHA DISTRICT,52,Transgender,2,0,2
SARGODHA DISTRICT,53,Male,11208,4759,15967
SARGODHA DISTRICT,53,Female,9238,4414,13652
SARGODHA DISTRICT,53,Transgender,1,5,6
SARGODHA DISTRICT,54,Male,10386,4483,14869
SARGODHA DISTRICT,54,Female,8374,4006,12380
SARGODHA DISTRICT,54,Transgender,0,0,0
SARGODHA DISTRICT,55,Male,8694,4126,12820
SARGODHA DISTRICT,55,Female,7022,3336,10358
SARGODHA DISTRICT,55,Transgender,2,3,5
SARGODHA DISTRICT,56,Male,8636,3751,12387
SARGODHA DISTRICT,56,Female,7209,3040,10249
SARGODHA DISTRICT,56,Transgender,1,1,2
SARGODHA DISTRICT,57,Male,7897,3199,11096
SARGODHA DISTRICT,57,Female,7001,2500,9501
SARGODHA DISTRICT,57,Transgender,1,1,2
SARGODHA DISTRICT,58,Male,7169,3353,10522
SARGODHA DISTRICT,58,Female,5879,2809,8688
SARGODHA DISTRICT,58,Transgender,0,1,1
SARGODHA DISTRICT,59,Male,7134,2995,10129
SARGODHA DISTRICT,59,Female,6528,2739,9267
SARGODHA DISTRICT,59,Transgender,1,0,1
SARGODHA DISTRICT,60,Male,6735,2918,9653
SARGODHA DISTRICT,60,Female,6267,2486,8753
SARGODHA DISTRICT,60,Transgender,7,1,8
SARGODHA DISTRICT,61,Male,7406,3034,10440
SARGODHA DISTRICT,61,Female,7048,2684,9732
SARGODHA DISTRICT,61,Transgender,1,2,3
SARGODHA DISTRICT,62,Male,6899,2881,9780
SARGODHA DISTRICT,62,Female,6498,2427,8925
SARGODHA DISTRICT,62,Transgender,1,0,1
SARGODHA DISTRICT,63,Male,6758,2744,9502
SARGODHA DISTRICT,63,Female,6144,2389,8533
SARGODHA DISTRICT,63,Transgender,0,1,1
SARGODHA DISTRICT,64,Male,6137,2413,8550
SARGODHA DISTRICT,64,Female,5427,2158,7585
SARGODHA DISTRICT,64,Transgender,1,0,1
SARGODHA DISTRICT,65,Male,5611,2179,7790
SARGODHA DISTRICT,65,Female,5003,1868,6871
SARGODHA DISTRICT,65,Transgender,2,3,5
SARGODHA DISTRICT,66,Male,5681,1766,7447
SARGODHA DISTRICT,66,Female,5032,1574,6606
SARGODHA DISTRICT,66,Transgender,2,0,2
SARGODHA DISTRICT,67,Male,5537,1706,7243
SARGODHA DISTRICT,67,Female,4972,1510,6482
SARGODHA DISTRICT,67,Transgender,1,0,1
SARGODHA DISTRICT,68,Male,4636,1599,6235
SARGODHA DISTRICT,68,Female,3922,1412,5334
SARGODHA DISTRICT,68,Transgender,0,0,0
SARGODHA DISTRICT,69,Male,4429,1447,5876
SARGODHA DISTRICT,69,Female,3846,1313,5159
SARGODHA DISTRICT,69,Transgender,2,1,3
SARGODHA DISTRICT,70,Male,4320,1408,5728
SARGODHA DISTRICT,70,Female,3786,1248,5034
SARGODHA DISTRICT,70,Transgender,2,2,4
SARGODHA DISTRICT,71,Male,4729,1436,6165
SARGODHA DISTRICT,71,Female,4041,1243,5284
SARGODHA DISTRICT,71,Transgender,0,1,1
SARGODHA DISTRICT,72,Male,4316,1424,5740
SARGODHA DISTRICT,72,Female,3714,1134,4848
SARGODHA DISTRICT,72,Transgender,0,0,0
SARGODHA DISTRICT,73,Male,3545,1256,4801
SARGODHA DISTRICT,73,Female,2965,1042,4007
SARGODHA DISTRICT,73,Transgender,0,1,1
SARGODHA DISTRICT,74,Male,2823,964,3787
SARGODHA DISTRICT,74,Female,2454,853,3307
SARGODHA DISTRICT,74,Transgender,1,0,1
SARGODHA DISTRICT,>=75,Male,25411,7622,33033
SARGODHA DISTRICT,>=75,Female,22601,6991,29592
SARGODHA DISTRICT,>=75,Transgender,9,5,14
SHAHEED BENAZIRABAD DISTRICT,<1,Male,13322,5394,18716
SHAHEED BENAZIRABAD DISTRICT,<1,Female,12416,5003,17419
SHAHEED BENAZIRABAD DISTRICT,<1,Transgender,0,0,0
SHAHEED BENAZIRABAD DISTRICT,1,Male,15680,6217,21897
SHAHEED BENAZIRABAD DISTRICT,1,Female,15121,5876,20997
SHAHEED BENAZIRABAD DISTRICT,1,Transgender,0,0,0
SHAHEED BENAZIRABAD DISTRICT,2,Male,18921,6742,25663
SHAHEED BENAZIRABAD DISTRICT,2,Female,18316,6506,24822
SHAHEED BENAZIRABAD DISTRICT,2,Transgender,0,0,0
SHAHEED BENAZIRABAD DISTRICT,3,Male,21010,7766,28776
SHAHEED BENAZIRABAD DISTRICT,3,Female,20322,7367,27689
SHAHEED BENAZIRABAD DISTRICT,3,Transgender,0,0,0
SHAHEED BENAZIRABAD DISTRICT,4,Male,22066,7495,29561
SHAHEED BENAZIRABAD DISTRICT,4,Female,21253,7023,28276
SHAHEED BENAZIRABAD DISTRICT,4,Transgender,0,0,0
SHAHEED BENAZIRABAD DISTRICT,5,Male,22374,7922,30296
SHAHEED BENAZIRABAD DISTRICT,5,Female,20583,7301,27884
SHAHEED BENAZIRABAD DISTRICT,5,Transgender,0,0,0
SHAHEED BENAZIRABAD DISTRICT,6,Male,21250,7350,28600
SHAHEED BENAZIRABAD DISTRICT,6,Female,19343,6716,26059
SHAHEED BENAZIRABAD DISTRICT,6,Transgender,0,0,0
SHAHEED BENAZIRABAD DISTRICT,7,Male,19319,7554,26873
SHAHEED BENAZIRABAD DISTRICT,7,Female,16809,6850,23659
SHAHEED BENAZIRABAD DISTRICT,7,Transgender,0,0,0
SHAHEED BENAZIRABAD DISTRICT,8,Male,21654,7376,29030
SHAHEED BENAZIRABAD DISTRICT,8,Female,18811,6599,25410
SHAHEED BENAZIRABAD DISTRICT,8,Transgender,0,0,0
SHAHEED BENAZIRABAD DISTRICT,9,Male,16789,6780,23569
SHAHEED BENAZIRABAD DISTRICT,9,Female,14391,6021,20412
SHAHEED BENAZIRABAD DISTRICT,9,Transgender,0,0,0
SHAHEED BENAZIRABAD DISTRICT,10,Male,19059,6567,25626
SHAHEED BENAZIRABAD DISTRICT,10,Female,16252,5824,22076
SHAHEED BENAZIRABAD DISTRICT,10,Transgender,0,0,0
SHAHEED BENAZIRABAD DISTRICT,11,Male,13572,5977,19549
SHAHEED BENAZIRABAD DISTRICT,11,Female,11343,5389,16732
SHAHEED BENAZIRABAD DISTRICT,11,Transgender,0,0,0
SHAHEED BENAZIRABAD DISTRICT,12,Male,15859,5988,21847
SHAHEED BENAZIRABAD DISTRICT,12,Female,13264,5283,18547
SHAHEED BENAZIRABAD DISTRICT,12,Transgender,0,0,0
SHAHEED BENAZIRABAD DISTRICT,13,Male,12111,5539,17650
SHAHEED BENAZIRABAD DISTRICT,13,Female,10103,5014,15117
SHAHEED BENAZIRABAD DISTRICT,13,Transgender,0,0,0
SHAHEED BENAZIRABAD DISTRICT,14,Male,13014,5437,18451
SHAHEED BENAZIRABAD DISTRICT,14,Female,11078,4865,15943
SHAHEED BENAZIRABAD DISTRICT,14,Transgender,0,0,0
SHAHEED BENAZIRABAD DISTRICT,15,Male,13441,5877,19318
SHAHEED BENAZIRABAD DISTRICT,15,Female,10840,5199,16039
SHAHEED BENAZIRABAD DISTRICT,15,Transgender,5,4,9
SHAHEED BENAZIRABAD DISTRICT,16,Male,12834,5535,18369
SHAHEED BENAZIRABAD DISTRICT,16,Female,10589,5003,15592
SHAHEED BENAZIRABAD DISTRICT,16,Transgender,2,1,3
SHAHEED BENAZIRABAD DISTRICT,17,Male,10674,5615,16289
SHAHEED BENAZIRABAD DISTRICT,17,Female,8837,5023,13860
SHAHEED BENAZIRABAD DISTRICT,17,Transgender,0,1,1
SHAHEED BENAZIRABAD DISTRICT,18,Male,12816,5460,18276
SHAHEED BENAZIRABAD DISTRICT,18,Female,12249,5282,17531
SHAHEED BENAZIRABAD DISTRICT,18,Transgender,9,1,10
SHAHEED BENAZIRABAD DISTRICT,19,Male,9548,5108,14656
SHAHEED BENAZIRABAD DISTRICT,19,Female,8978,5267,14245
SHAHEED BENAZIRABAD DISTRICT,19,Transgender,3,1,4
SHAHEED BENAZIRABAD DISTRICT,20,Male,11950,5355,17305
SHAHEED BENAZIRABAD DISTRICT,20,Female,10914,5090,16004
SHAHEED BENAZIRABAD DISTRICT,20,Transgender,4,2,6
SHAHEED BENAZIRABAD DISTRICT,21,Male,8105,4981,13086
SHAHEED BENAZIRABAD DISTRICT,21,Female,7799,4776,12575
SHAHEED BENAZIRABAD DISTRICT,21,Transgender,1,3,4
SHAHEED BENAZIRABAD DISTRICT,22,Male,8754,4808,13562
SHAHEED BENAZIRABAD DISTRICT,22,Female,7648,4450,12098
SHAHEED BENAZIRABAD DISTRICT,22,Transgender,4,3,7
SHAHEED BENAZIRABAD DISTRICT,23,Male,7246,4478,11724
SHAHEED BENAZIRABAD DISTRICT,23,Female,6717,4209,10926
SHAHEED BENAZIRABAD DISTRICT,23,Transgender,1,0,1
SHAHEED BENAZIRABAD DISTRICT,24,Male,6853,3813,10666
SHAHEED BENAZIRABAD DISTRICT,24,Female,6870,3829,10699
SHAHEED BENAZIRABAD DISTRICT,24,Transgender,1,1,2
SHAHEED BENAZIRABAD DISTRICT,25,Male,8659,4097,12756
SHAHEED BENAZIRABAD DISTRICT,25,Female,8820,4165,12985
SHAHEED BENAZIRABAD DISTRICT,25,Transgender,5,9,14
SHAHEED BENAZIRABAD DISTRICT,26,Male,7072,3879,10951
SHAHEED BENAZIRABAD DISTRICT,26,Female,7358,3933,11291
SHAHEED BENAZIRABAD DISTRICT,26,Transgender,3,1,4
SHAHEED BENAZIRABAD DISTRICT,27,Male,7654,3934,11588
SHAHEED BENAZIRABAD DISTRICT,27,Female,7780,4145,11925
SHAHEED BENAZIRABAD DISTRICT,27,Transgender,3,4,7
SHAHEED BENAZIRABAD DISTRICT,28,Male,7992,3837,11829
SHAHEED BENAZIRABAD DISTRICT,28,Female,9008,4191,13199
SHAHEED BENAZIRABAD DISTRICT,28,Transgender,3,0,3
SHAHEED BENAZIRABAD DISTRICT,29,Male,8511,4064,12575
SHAHEED BENAZIRABAD DISTRICT,29,Female,8991,4124,13115
SHAHEED BENAZIRABAD DISTRICT,29,Transgender,2,3,5
SHAHEED BENAZIRABAD DISTRICT,30,Male,8187,3805,11992
SHAHEED BENAZIRABAD DISTRICT,30,Female,8439,3975,12414
SHAHEED BENAZIRABAD DISTRICT,30,Transgender,7,5,12
SHAHEED BENAZIRABAD DISTRICT,31,Male,8332,3930,12262
SHAHEED BENAZIRABAD DISTRICT,31,Female,8793,3812,12605
SHAHEED BENAZIRABAD DISTRICT,31,Transgender,3,2,5
SHAHEED BENAZIRABAD DISTRICT,32,Male,7741,3839,11580
SHAHEED BENAZIRABAD DISTRICT,32,Female,7653,3553,11206
SHAHEED BENAZIRABAD DISTRICT,32,Transgender,6,4,10
SHAHEED BENAZIRABAD DISTRICT,33,Male,7212,3572,10784
SHAHEED BENAZIRABAD DISTRICT,33,Female,7063,3303,10366
SHAHEED BENAZIRABAD DISTRICT,33,Transgender,2,0,2
SHAHEED BENAZIRABAD DISTRICT,34,Male,6728,3258,9986
SHAHEED BENAZIRABAD DISTRICT,34,Female,6585,2945,9530
SHAHEED BENAZIRABAD DISTRICT,34,Transgender,3,2,5
SHAHEED BENAZIRABAD DISTRICT,35,Male,7026,3099,10125
SHAHEED BENAZIRABAD DISTRICT,35,Female,6206,2947,9153
SHAHEED BENAZIRABAD DISTRICT,35,Transgender,3,3,6
SHAHEED BENAZIRABAD DISTRICT,36,Male,6828,2865,9693
SHAHEED BENAZIRABAD DISTRICT,36,Female,6280,2662,8942
SHAHEED BENAZIRABAD DISTRICT,36,Transgender,4,3,7
SHAHEED BENAZIRABAD DISTRICT,37,Male,7594,3019,10613
SHAHEED BENAZIRABAD DISTRICT,37,Female,7181,2976,10157
SHAHEED BENAZIRABAD DISTRICT,37,Transgender,1,0,1
SHAHEED BENAZIRABAD DISTRICT,38,Male,5669,3017,8686
SHAHEED BENAZIRABAD DISTRICT,38,Female,5776,2781,8557
SHAHEED BENAZIRABAD DISTRICT,38,Transgender,1,0,1
SHAHEED BENAZIRABAD DISTRICT,39,Male,6089,2968,9057
SHAHEED BENAZIRABAD DISTRICT,39,Female,5972,2903,8875
SHAHEED BENAZIRABAD DISTRICT,39,Transgender,1,2,3
SHAHEED BENAZIRABAD DISTRICT,40,Male,5359,2810,8169
SHAHEED BENAZIRABAD DISTRICT,40,Female,5544,2608,8152
SHAHEED BENAZIRABAD DISTRICT,40,Transgender,8,1,9
SHAHEED BENAZIRABAD DISTRICT,41,Male,5269,2518,7787
SHAHEED BENAZIRABAD DISTRICT,41,Female,5742,2544,8286
SHAHEED BENAZIRABAD DISTRICT,41,Transgender,1,2,3
SHAHEED BENAZIRABAD DISTRICT,42,Male,4812,2565,7377
SHAHEED BENAZIRABAD DISTRICT,42,Female,5414,2460,7874
SHAHEED BENAZIRABAD DISTRICT,42,Transgender,0,1,1
SHAHEED BENAZIRABAD DISTRICT,43,Male,4567,2443,7010
SHAHEED BENAZIRABAD DISTRICT,43,Female,4554,2176,6730
SHAHEED BENAZIRABAD DISTRICT,43,Transgender,0,0,0
SHAHEED BENAZIRABAD DISTRICT,44,Male,4498,2142,6640
SHAHEED BENAZIRABAD DISTRICT,44,Female,4432,2050,6482
SHAHEED BENAZIRABAD DISTRICT,44,Transgender,0,0,0
SHAHEED BENAZIRABAD DISTRICT,45,Male,4535,2210,6745
SHAHEED BENAZIRABAD DISTRICT,45,Female,4017,2044,6061
SHAHEED BENAZIRABAD DISTRICT,45,Transgender,3,1,4
SHAHEED BENAZIRABAD DISTRICT,46,Male,4676,2035,6711
SHAHEED BENAZIRABAD DISTRICT,46,Female,4378,1786,6164
SHAHEED BENAZIRABAD DISTRICT,46,Transgender,1,0,1
SHAHEED BENAZIRABAD DISTRICT,47,Male,5072,2103,7175
SHAHEED BENAZIRABAD DISTRICT,47,Female,5246,2013,7259
SHAHEED BENAZIRABAD DISTRICT,47,Transgender,1,0,1
SHAHEED BENAZIRABAD DISTRICT,48,Male,4012,2132,6144
SHAHEED BENAZIRABAD DISTRICT,48,Female,3728,1762,5490
SHAHEED BENAZIRABAD DISTRICT,48,Transgender,0,1,1
SHAHEED BENAZIRABAD DISTRICT,49,Male,4501,2085,6586
SHAHEED BENAZIRABAD DISTRICT,49,Female,3853,1824,5677
SHAHEED BENAZIRABAD DISTRICT,49,Transgender,2,2,4
SHAHEED BENAZIRABAD DISTRICT,50,Male,3907,1828,5735
SHAHEED BENAZIRABAD DISTRICT,50,Female,3259,1574,4833
SHAHEED BENAZIRABAD DISTRICT,50,Transgender,1,2,3
SHAHEED BENAZIRABAD DISTRICT,51,Male,3863,1865,5728
SHAHEED BENAZIRABAD DISTRICT,51,Female,3319,1589,4908
SHAHEED BENAZIRABAD DISTRICT,51,Transgender,0,1,1
SHAHEED BENAZIRABAD DISTRICT,52,Male,3147,1715,4862
SHAHEED BENAZIRABAD DISTRICT,52,Female,2941,1493,4434
SHAHEED BENAZIRABAD DISTRICT,52,Transgender,0,0,0
SHAHEED BENAZIRABAD DISTRICT,53,Male,2859,1527,4386
SHAHEED BENAZIRABAD DISTRICT,53,Female,2233,1284,3517
SHAHEED BENAZIRABAD DISTRICT,53,Transgender,1,0,1
SHAHEED BENAZIRABAD DISTRICT,54,Male,2428,1405,3833
SHAHEED BENAZIRABAD DISTRICT,54,Female,1897,1110,3007
SHAHEED BENAZIRABAD DISTRICT,54,Transgender,1,0,1
SHAHEED BENAZIRABAD DISTRICT,55,Male,2331,1347,3678
SHAHEED BENAZIRABAD DISTRICT,55,Female,2063,1052,3115
SHAHEED BENAZIRABAD DISTRICT,55,Transgender,1,0,1
SHAHEED BENAZIRABAD DISTRICT,56,Male,2246,1204,3450
SHAHEED BENAZIRABAD DISTRICT,56,Female,2188,874,3062
SHAHEED BENAZIRABAD DISTRICT,56,Transgender,0,0,0
SHAHEED BENAZIRABAD DISTRICT,57,Male,2502,1224,3726
SHAHEED BENAZIRABAD DISTRICT,57,Female,3047,1114,4161
SHAHEED BENAZIRABAD DISTRICT,57,Transgender,1,1,2
SHAHEED BENAZIRABAD DISTRICT,58,Male,1930,944,2874
SHAHEED BENAZIRABAD DISTRICT,58,Female,1853,873,2726
SHAHEED BENAZIRABAD DISTRICT,58,Transgender,1,0,1
SHAHEED BENAZIRABAD DISTRICT,59,Male,1899,954,2853
SHAHEED BENAZIRABAD DISTRICT,59,Female,1978,930,2908
SHAHEED BENAZIRABAD DISTRICT,59,Transgender,1,0,1
SHAHEED BENAZIRABAD DISTRICT,60,Male,2026,865,2891
SHAHEED BENAZIRABAD DISTRICT,60,Female,2108,943,3051
SHAHEED BENAZIRABAD DISTRICT,60,Transgender,1,0,1
SHAHEED BENAZIRABAD DISTRICT,61,Male,1920,918,2838
SHAHEED BENAZIRABAD DISTRICT,61,Female,2301,967,3268
SHAHEED BENAZIRABAD DISTRICT,61,Transgender,0,0,0
SHAHEED BENAZIRABAD DISTRICT,62,Male,1959,905,2864
SHAHEED BENAZIRABAD DISTRICT,62,Female,2213,957,3170
SHAHEED BENAZIRABAD DISTRICT,62,Transgender,0,0,0
SHAHEED BENAZIRABAD DISTRICT,63,Male,1899,869,2768
SHAHEED BENAZIRABAD DISTRICT,63,Female,1916,908,2824
SHAHEED BENAZIRABAD DISTRICT,63,Transgender,0,0,0
SHAHEED BENAZIRABAD DISTRICT,64,Male,1857,785,2642
SHAHEED BENAZIRABAD DISTRICT,64,Female,1866,704,2570
SHAHEED BENAZIRABAD DISTRICT,64,Transgender,0,0,0
SHAHEED BENAZIRABAD DISTRICT,65,Male,1586,708,2294
SHAHEED BENAZIRABAD DISTRICT,65,Female,1488,666,2154
SHAHEED BENAZIRABAD DISTRICT,65,Transgender,1,0,1
SHAHEED BENAZIRABAD DISTRICT,66,Male,1681,622,2303
SHAHEED BENAZIRABAD DISTRICT,66,Female,1653,592,2245
SHAHEED BENAZIRABAD DISTRICT,66,Transgender,1,2,3
SHAHEED BENAZIRABAD DISTRICT,67,Male,1539,593,2132
SHAHEED BENAZIRABAD DISTRICT,67,Female,1844,607,2451
SHAHEED BENAZIRABAD DISTRICT,67,Transgender,1,0,1
SHAHEED BENAZIRABAD DISTRICT,68,Male,1253,549,1802
SHAHEED BENAZIRABAD DISTRICT,68,Female,1212,538,1750
SHAHEED BENAZIRABAD DISTRICT,68,Transgender,1,0,1
SHAHEED BENAZIRABAD DISTRICT,69,Male,1238,444,1682
SHAHEED BENAZIRABAD DISTRICT,69,Female,1294,504,1798
SHAHEED BENAZIRABAD DISTRICT,69,Transgender,0,0,0
SHAHEED BENAZIRABAD DISTRICT,70,Male,1055,428,1483
SHAHEED BENAZIRABAD DISTRICT,70,Female,1011,443,1454
SHAHEED BENAZIRABAD DISTRICT,70,Transgender,1,2,3
SHAHEED BENAZIRABAD DISTRICT,71,Male,1028,423,1451
SHAHEED BENAZIRABAD DISTRICT,71,Female,1108,482,1590
SHAHEED BENAZIRABAD DISTRICT,71,Transgender,0,0,0
SHAHEED BENAZIRABAD DISTRICT,72,Male,914,359,1273
SHAHEED BENAZIRABAD DISTRICT,72,Female,1069,409,1478
SHAHEED BENAZIRABAD DISTRICT,72,Transgender,0,0,0
SHAHEED BENAZIRABAD DISTRICT,73,Male,825,385,1210
SHAHEED BENAZIRABAD DISTRICT,73,Female,823,412,1235
SHAHEED BENAZIRABAD DISTRICT,73,Transgender,0,0,0
SHAHEED BENAZIRABAD DISTRICT,74,Male,741,258,999
SHAHEED BENAZIRABAD DISTRICT,74,Female,684,274,958
SHAHEED BENAZIRABAD DISTRICT,74,Transgender,0,0,0
SHAHEED BENAZIRABAD DISTRICT,>=75,Male,5265,2037,7302
SHAHEED BENAZIRABAD DISTRICT,>=75,Female,5845,2471,8316
SHAHEED BENAZIRABAD DISTRICT,>=75,Transgender,4,1,5
SHANGLA DISTRICT,<1,Male,11935,0,11935
SHANGLA DISTRICT,<1,Female,11109,0,11109
SHANGLA DISTRICT,<1,Transgender,0,0,0
SHANGLA DISTRICT,1,Male,12689,0,12689
SHANGLA DISTRICT,1,Female,11814,0,11814
SHANGLA DISTRICT,1,Transgender,0,0,0
SHANGLA DISTRICT,2,Male,14722,0,14722
SHANGLA DISTRICT,2,Female,13880,0,13880
SHANGLA DISTRICT,2,Transgender,0,0,0
SHANGLA DISTRICT,3,Male,14708,0,14708
SHANGLA DISTRICT,3,Female,14181,0,14181
SHANGLA DISTRICT,3,Transgender,0,0,0
SHANGLA DISTRICT,4,Male,15825,0,15825
SHANGLA DISTRICT,4,Female,14855,0,14855
SHANGLA DISTRICT,4,Transgender,0,0,0
SHANGLA DISTRICT,5,Male,14773,0,14773
SHANGLA DISTRICT,5,Female,13362,0,13362
SHANGLA DISTRICT,5,Transgender,0,0,0
SHANGLA DISTRICT,6,Male,14785,0,14785
SHANGLA DISTRICT,6,Female,13433,0,13433
SHANGLA DISTRICT,6,Transgender,0,0,0
SHANGLA DISTRICT,7,Male,14068,0,14068
SHANGLA DISTRICT,7,Female,12610,0,12610
SHANGLA DISTRICT,7,Transgender,0,0,0
SHANGLA DISTRICT,8,Male,14711,0,14711
SHANGLA DISTRICT,8,Female,13238,0,13238
SHANGLA DISTRICT,8,Transgender,0,0,0
SHANGLA DISTRICT,9,Male,13439,0,13439
SHANGLA DISTRICT,9,Female,11858,0,11858
SHANGLA DISTRICT,9,Transgender,0,0,0
SHANGLA DISTRICT,10,Male,12603,0,12603
SHANGLA DISTRICT,10,Female,11386,0,11386
SHANGLA DISTRICT,10,Transgender,0,0,0
SHANGLA DISTRICT,11,Male,11519,0,11519
SHANGLA DISTRICT,11,Female,9430,0,9430
SHANGLA DISTRICT,11,Transgender,0,0,0
SHANGLA DISTRICT,12,Male,11042,0,11042
SHANGLA DISTRICT,12,Female,9653,0,9653
SHANGLA DISTRICT,12,Transgender,0,0,0
SHANGLA DISTRICT,13,Male,10097,0,10097
SHANGLA DISTRICT,13,Female,8681,0,8681
SHANGLA DISTRICT,13,Transgender,0,0,0
SHANGLA DISTRICT,14,Male,8997,0,8997
SHANGLA DISTRICT,14,Female,8251,0,8251
SHANGLA DISTRICT,14,Transgender,0,0,0
SHANGLA DISTRICT,15,Male,8875,0,8875
SHANGLA DISTRICT,15,Female,7855,0,7855
SHANGLA DISTRICT,15,Transgender,2,0,2
SHANGLA DISTRICT,16,Male,7738,0,7738
SHANGLA DISTRICT,16,Female,7159,0,7159
SHANGLA DISTRICT,16,Transgender,0,0,0
SHANGLA DISTRICT,17,Male,7013,0,7013
SHANGLA DISTRICT,17,Female,7486,0,7486
SHANGLA DISTRICT,17,Transgender,0,0,0
SHANGLA DISTRICT,18,Male,7426,0,7426
SHANGLA DISTRICT,18,Female,7818,0,7818
SHANGLA DISTRICT,18,Transgender,0,0,0
SHANGLA DISTRICT,19,Male,7171,0,7171
SHANGLA DISTRICT,19,Female,6669,0,6669
SHANGLA DISTRICT,19,Transgender,0,0,0
SHANGLA DISTRICT,20,Male,7038,0,7038
SHANGLA DISTRICT,20,Female,7860,0,7860
SHANGLA DISTRICT,20,Transgender,2,0,2
SHANGLA DISTRICT,21,Male,5756,0,5756
SHANGLA DISTRICT,21,Female,6251,0,6251
SHANGLA DISTRICT,21,Transgender,0,0,0
SHANGLA DISTRICT,22,Male,5772,0,5772
SHANGLA DISTRICT,22,Female,5743,0,5743
SHANGLA DISTRICT,22,Transgender,1,0,1
SHANGLA DISTRICT,23,Male,5115,0,5115
SHANGLA DISTRICT,23,Female,5446,0,5446
SHANGLA DISTRICT,23,Transgender,0,0,0
SHANGLA DISTRICT,24,Male,5019,0,5019
SHANGLA DISTRICT,24,Female,5173,0,5173
SHANGLA DISTRICT,24,Transgender,0,0,0
SHANGLA DISTRICT,25,Male,6044,0,6044
SHANGLA DISTRICT,25,Female,6791,0,6791
SHANGLA DISTRICT,25,Transgender,2,0,2
SHANGLA DISTRICT,26,Male,5097,0,5097
SHANGLA DISTRICT,26,Female,5787,0,5787
SHANGLA DISTRICT,26,Transgender,2,0,2
SHANGLA DISTRICT,27,Male,4974,0,4974
SHANGLA DISTRICT,27,Female,5975,0,5975
SHANGLA DISTRICT,27,Transgender,0,0,0
SHANGLA DISTRICT,28,Male,4862,0,4862
SHANGLA DISTRICT,28,Female,5379,0,5379
SHANGLA DISTRICT,28,Transgender,0,0,0
SHANGLA DISTRICT,29,Male,4802,0,4802
SHANGLA DISTRICT,29,Female,5913,0,5913
SHANGLA DISTRICT,29,Transgender,1,0,1
SHANGLA DISTRICT,30,Male,5322,0,5322
SHANGLA DISTRICT,30,Female,5468,0,5468
SHANGLA DISTRICT,30,Transgender,0,0,0
SHANGLA DISTRICT,31,Male,4521,0,4521
SHANGLA DISTRICT,31,Female,5175,0,5175
SHANGLA DISTRICT,31,Transgender,1,0,1
SHANGLA DISTRICT,32,Male,3716,0,3716
SHANGLA DISTRICT,32,Female,4224,0,4224
SHANGLA DISTRICT,32,Transgender,0,0,0
SHANGLA DISTRICT,33,Male,3804,0,3804
SHANGLA DISTRICT,33,Female,4016,0,4016
SHANGLA DISTRICT,33,Transgender,0,0,0
SHANGLA DISTRICT,34,Male,3211,0,3211
SHANGLA DISTRICT,34,Female,3493,0,3493
SHANGLA DISTRICT,34,Transgender,0,0,0
SHANGLA DISTRICT,35,Male,3964,0,3964
SHANGLA DISTRICT,35,Female,4062,0,4062
SHANGLA DISTRICT,35,Transgender,0,0,0
SHANGLA DISTRICT,36,Male,3207,0,3207
SHANGLA DISTRICT,36,Female,3651,0,3651
SHANGLA DISTRICT,36,Transgender,0,0,0
SHANGLA DISTRICT,37,Male,3276,0,3276
SHANGLA DISTRICT,37,Female,4289,0,4289
SHANGLA DISTRICT,37,Transgender,0,0,0
SHANGLA DISTRICT,38,Male,2962,0,2962
SHANGLA DISTRICT,38,Female,3033,0,3033
SHANGLA DISTRICT,38,Transgender,0,0,0
SHANGLA DISTRICT,39,Male,2980,0,2980
SHANGLA DISTRICT,39,Female,3223,0,3223
SHANGLA DISTRICT,39,Transgender,0,0,0
SHANGLA DISTRICT,40,Male,3553,0,3553
SHANGLA DISTRICT,40,Female,3640,0,3640
SHANGLA DISTRICT,40,Transgender,0,0,0
SHANGLA DISTRICT,41,Male,3028,0,3028
SHANGLA DISTRICT,41,Female,3085,0,3085
SHANGLA DISTRICT,41,Transgender,1,0,1
SHANGLA DISTRICT,42,Male,2620,0,2620
SHANGLA DISTRICT,42,Female,2749,0,2749
SHANGLA DISTRICT,42,Transgender,0,0,0
SHANGLA DISTRICT,43,Male,2674,0,2674
SHANGLA DISTRICT,43,Female,2641,0,2641
SHANGLA DISTRICT,43,Transgender,0,0,0
SHANGLA DISTRICT,44,Male,2273,0,2273
SHANGLA DISTRICT,44,Female,2201,0,2201
SHANGLA DISTRICT,44,Transgender,0,0,0
SHANGLA DISTRICT,45,Male,2377,0,2377
SHANGLA DISTRICT,45,Female,2554,0,2554
SHANGLA DISTRICT,45,Transgender,0,0,0
SHANGLA DISTRICT,46,Male,2124,0,2124
SHANGLA DISTRICT,46,Female,2133,0,2133
SHANGLA DISTRICT,46,Transgender,1,0,1
SHANGLA DISTRICT,47,Male,2205,0,2205
SHANGLA DISTRICT,47,Female,2443,0,2443
SHANGLA DISTRICT,47,Transgender,0,0,0
SHANGLA DISTRICT,48,Male,2119,0,2119
SHANGLA DISTRICT,48,Female,1813,0,1813
SHANGLA DISTRICT,48,Transgender,0,0,0
SHANGLA DISTRICT,49,Male,2067,0,2067
SHANGLA DISTRICT,49,Female,1923,0,1923
SHANGLA DISTRICT,49,Transgender,0,0,0
SHANGLA DISTRICT,50,Male,2305,0,2305
SHANGLA DISTRICT,50,Female,2404,0,2404
SHANGLA DISTRICT,50,Transgender,1,0,1
SHANGLA DISTRICT,51,Male,1952,0,1952
SHANGLA DISTRICT,51,Female,1887,0,1887
SHANGLA DISTRICT,51,Transgender,0,0,0
SHANGLA DISTRICT,52,Male,1691,0,1691
SHANGLA DISTRICT,52,Female,1431,0,1431
SHANGLA DISTRICT,52,Transgender,0,0,0
SHANGLA DISTRICT,53,Male,1831,0,1831
SHANGLA DISTRICT,53,Female,1568,0,1568
SHANGLA DISTRICT,53,Transgender,0,0,0
SHANGLA DISTRICT,54,Male,1592,0,1592
SHANGLA DISTRICT,54,Female,1321,0,1321
SHANGLA DISTRICT,54,Transgender,0,0,0
SHANGLA DISTRICT,55,Male,1616,0,1616
SHANGLA DISTRICT,55,Female,1650,0,1650
SHANGLA DISTRICT,55,Transgender,0,0,0
SHANGLA DISTRICT,56,Male,1327,0,1327
SHANGLA DISTRICT,56,Female,1147,0,1147
SHANGLA DISTRICT,56,Transgender,0,0,0
SHANGLA DISTRICT,57,Male,1227,0,1227
SHANGLA DISTRICT,57,Female,1273,0,1273
SHANGLA DISTRICT,57,Transgender,1,0,1
SHANGLA DISTRICT,58,Male,1330,0,1330
SHANGLA DISTRICT,58,Female,1224,0,1224
SHANGLA DISTRICT,58,Transgender,1,0,1
SHANGLA DISTRICT,59,Male,1328,0,1328
SHANGLA DISTRICT,59,Female,1367,0,1367
SHANGLA DISTRICT,59,Transgender,0,0,0
SHANGLA DISTRICT,60,Male,1560,0,1560
SHANGLA DISTRICT,60,Female,1611,0,1611
SHANGLA DISTRICT,60,Transgender,1,0,1
SHANGLA DISTRICT,61,Male,1240,0,1240
SHANGLA DISTRICT,61,Female,1286,0,1286
SHANGLA DISTRICT,61,Transgender,0,0,0
SHANGLA DISTRICT,62,Male,1103,0,1103
SHANGLA DISTRICT,62,Female,1106,0,1106
SHANGLA DISTRICT,62,Transgender,0,0,0
SHANGLA DISTRICT,63,Male,1312,0,1312
SHANGLA DISTRICT,63,Female,1155,0,1155
SHANGLA DISTRICT,63,Transgender,1,0,1
SHANGLA DISTRICT,64,Male,1269,0,1269
SHANGLA DISTRICT,64,Female,1168,0,1168
SHANGLA DISTRICT,64,Transgender,0,0,0
SHANGLA DISTRICT,65,Male,1080,0,1080
SHANGLA DISTRICT,65,Female,988,0,988
SHANGLA DISTRICT,65,Transgender,0,0,0
SHANGLA DISTRICT,66,Male,950,0,950
SHANGLA DISTRICT,66,Female,735,0,735
SHANGLA DISTRICT,66,Transgender,0,0,0
SHANGLA DISTRICT,67,Male,853,0,853
SHANGLA DISTRICT,67,Female,831,0,831
SHANGLA DISTRICT,67,Transgender,0,0,0
SHANGLA DISTRICT,68,Male,934,0,934
SHANGLA DISTRICT,68,Female,744,0,744
SHANGLA DISTRICT,68,Transgender,0,0,0
SHANGLA DISTRICT,69,Male,1061,0,1061
SHANGLA DISTRICT,69,Female,833,0,833
SHANGLA DISTRICT,69,Transgender,0,0,0
SHANGLA DISTRICT,70,Male,902,0,902
SHANGLA DISTRICT,70,Female,805,0,805
SHANGLA DISTRICT,70,Transgender,0,0,0
SHANGLA DISTRICT,71,Male,794,0,794
SHANGLA DISTRICT,71,Female,640,0,640
SHANGLA DISTRICT,71,Transgender,0,0,0
SHANGLA DISTRICT,72,Male,659,0,659
SHANGLA DISTRICT,72,Female,525,0,525
SHANGLA DISTRICT,72,Transgender,0,0,0
SHANGLA DISTRICT,73,Male,671,0,671
SHANGLA DISTRICT,73,Female,524,0,524
SHANGLA DISTRICT,73,Transgender,0,0,0
SHANGLA DISTRICT,74,Male,646,0,646
SHANGLA DISTRICT,74,Female,518,0,518
SHANGLA DISTRICT,74,Transgender,0,0,0
SHANGLA DISTRICT,>=75,Male,4231,0,4231
SHANGLA DISTRICT,>=75,Female,3905,0,3905
SHANGLA DISTRICT,>=75,Transgender,1,0,1
SHEIKHUPURA DISTRICT,<1,Male,26714,13560,40274
SHEIKHUPURA DISTRICT,<1,Female,25209,13006,38215
SHEIKHUPURA DISTRICT,<1,Transgender,0,0,0
SHEIKHUPURA DISTRICT,1,Male,28734,14742,43476
SHEIKHUPURA DISTRICT,1,Female,27599,14277,41876
SHEIKHUPURA DISTRICT,1,Transgender,0,0,0
SHEIKHUPURA DISTRICT,2,Male,29574,15139,44713
SHEIKHUPURA DISTRICT,2,Female,28238,14132,42370
SHEIKHUPURA DISTRICT,2,Transgender,0,0,0
SHEIKHUPURA DISTRICT,3,Male,31917,16057,47974
SHEIKHUPURA DISTRICT,3,Female,30920,15514,46434
SHEIKHUPURA DISTRICT,3,Transgender,0,0,0
SHEIKHUPURA DISTRICT,4,Male,30728,15040,45768
SHEIKHUPURA DISTRICT,4,Female,29473,14605,44078
SHEIKHUPURA DISTRICT,4,Transgender,0,0,0
SHEIKHUPURA DISTRICT,5,Male,31619,15515,47134
SHEIKHUPURA DISTRICT,5,Female,30308,14538,44846
SHEIKHUPURA DISTRICT,5,Transgender,0,0,0
SHEIKHUPURA DISTRICT,6,Male,31024,14961,45985
SHEIKHUPURA DISTRICT,6,Female,28999,14182,43181
SHEIKHUPURA DISTRICT,6,Transgender,0,0,0
SHEIKHUPURA DISTRICT,7,Male,32437,16273,48710
SHEIKHUPURA DISTRICT,7,Female,30499,15394,45893
SHEIKHUPURA DISTRICT,7,Transgender,0,0,0
SHEIKHUPURA DISTRICT,8,Male,30939,14654,45593
SHEIKHUPURA DISTRICT,8,Female,29182,13544,42726
SHEIKHUPURA DISTRICT,8,Transgender,0,0,0
SHEIKHUPURA DISTRICT,9,Male,30457,15508,45965
SHEIKHUPURA DISTRICT,9,Female,28377,14399,42776
SHEIKHUPURA DISTRICT,9,Transgender,0,0,0
SHEIKHUPURA DISTRICT,10,Male,29390,13903,43293
SHEIKHUPURA DISTRICT,10,Female,27612,13111,40723
SHEIKHUPURA DISTRICT,10,Transgender,0,0,0
SHEIKHUPURA DISTRICT,11,Male,28865,15066,43931
SHEIKHUPURA DISTRICT,11,Female,26938,14128,41066
SHEIKHUPURA DISTRICT,11,Transgender,0,0,0
SHEIKHUPURA DISTRICT,12,Male,28069,13710,41779
SHEIKHUPURA DISTRICT,12,Female,25767,12849,38616
SHEIKHUPURA DISTRICT,12,Transgender,0,0,0
SHEIKHUPURA DISTRICT,13,Male,27282,14149,41431
SHEIKHUPURA DISTRICT,13,Female,25043,13136,38179
SHEIKHUPURA DISTRICT,13,Transgender,0,0,0
SHEIKHUPURA DISTRICT,14,Male,26462,13485,39947
SHEIKHUPURA DISTRICT,14,Female,24858,12543,37401
SHEIKHUPURA DISTRICT,14,Transgender,0,0,0
SHEIKHUPURA DISTRICT,15,Male,25514,13066,38580
SHEIKHUPURA DISTRICT,15,Female,24550,12685,37235
SHEIKHUPURA DISTRICT,15,Transgender,5,5,10
SHEIKHUPURA DISTRICT,16,Male,25938,13189,39127
SHEIKHUPURA DISTRICT,16,Female,25128,12961,38089
SHEIKHUPURA DISTRICT,16,Transgender,9,4,13
SHEIKHUPURA DISTRICT,17,Male,25006,13822,38828
SHEIKHUPURA DISTRICT,17,Female,23701,12948,36649
SHEIKHUPURA DISTRICT,17,Transgender,3,4,7
SHEIKHUPURA DISTRICT,18,Male,26145,13230,39375
SHEIKHUPURA DISTRICT,18,Female,23504,11729,35233
SHEIKHUPURA DISTRICT,18,Transgender,4,3,7
SHEIKHUPURA DISTRICT,19,Male,24569,13134,37703
SHEIKHUPURA DISTRICT,19,Female,22958,12688,35646
SHEIKHUPURA DISTRICT,19,Transgender,1,2,3
SHEIKHUPURA DISTRICT,20,Male,24718,12454,37172
SHEIKHUPURA DISTRICT,20,Female,23265,11660,34925
SHEIKHUPURA DISTRICT,20,Transgender,7,5,12
SHEIKHUPURA DISTRICT,21,Male,23487,12950,36437
SHEIKHUPURA DISTRICT,21,Female,22349,12792,35141
SHEIKHUPURA DISTRICT,21,Transgender,4,0,4
SHEIKHUPURA DISTRICT,22,Male,23821,12699,36520
SHEIKHUPURA DISTRICT,22,Female,22762,12879,35641
SHEIKHUPURA DISTRICT,22,Transgender,5,10,15
SHEIKHUPURA DISTRICT,23,Male,21282,11723,33005
SHEIKHUPURA DISTRICT,23,Female,20366,11928,32294
SHEIKHUPURA DISTRICT,23,Transgender,5,2,7
SHEIKHUPURA DISTRICT,24,Male,20636,11494,32130
SHEIKHUPURA DISTRICT,24,Female,19283,11744,31027
SHEIKHUPURA DISTRICT,24,Transgender,6,8,14
SHEIKHUPURA DISTRICT,25,Male,20141,10583,30724
SHEIKHUPURA DISTRICT,25,Female,20039,10513,30552
SHEIKHUPURA DISTRICT,25,Transgender,8,4,12
SHEIKHUPURA DISTRICT,26,Male,19095,10795,29890
SHEIKHUPURA DISTRICT,26,Female,18198,11374,29572
SHEIKHUPURA DISTRICT,26,Transgender,6,8,14
SHEIKHUPURA DISTRICT,27,Male,17190,9984,27174
SHEIKHUPURA DISTRICT,27,Female,16698,10326,27024
SHEIKHUPURA DISTRICT,27,Transgender,5,7,12
SHEIKHUPURA DISTRICT,28,Male,18265,10403,28668
SHEIKHUPURA DISTRICT,28,Female,18526,11016,29542
SHEIKHUPURA DISTRICT,28,Transgender,11,9,20
SHEIKHUPURA DISTRICT,29,Male,16040,8988,25028
SHEIKHUPURA DISTRICT,29,Female,15529,9400,24929
SHEIKHUPURA DISTRICT,29,Transgender,4,1,5
SHEIKHUPURA DISTRICT,30,Male,18492,9982,28474
SHEIKHUPURA DISTRICT,30,Female,19475,10448,29923
SHEIKHUPURA DISTRICT,30,Transgender,11,10,21
SHEIKHUPURA DISTRICT,31,Male,15140,8405,23545
SHEIKHUPURA DISTRICT,31,Female,14269,8590,22859
SHEIKHUPURA DISTRICT,31,Transgender,1,3,4
SHEIKHUPURA DISTRICT,32,Male,16037,9368,25405
SHEIKHUPURA DISTRICT,32,Female,15492,9155,24647
SHEIKHUPURA DISTRICT,32,Transgender,8,8,16
SHEIKHUPURA DISTRICT,33,Male,14377,8307,22684
SHEIKHUPURA DISTRICT,33,Female,14270,8402,22672
SHEIKHUPURA DISTRICT,33,Transgender,2,1,3
SHEIKHUPURA DISTRICT,34,Male,13205,7511,20716
SHEIKHUPURA DISTRICT,34,Female,12784,7413,20197
SHEIKHUPURA DISTRICT,34,Transgender,2,2,4
SHEIKHUPURA DISTRICT,35,Male,16415,8795,25210
SHEIKHUPURA DISTRICT,35,Female,15617,8521,24138
SHEIKHUPURA DISTRICT,35,Transgender,12,11,23
SHEIKHUPURA DISTRICT,36,Male,13458,7404,20862
SHEIKHUPURA DISTRICT,36,Female,11587,6963,18550
SHEIKHUPURA DISTRICT,36,Transgender,6,5,11
SHEIKHUPURA DISTRICT,37,Male,12729,6690,19419
SHEIKHUPURA DISTRICT,37,Female,10980,6098,17078
SHEIKHUPURA DISTRICT,37,Transgender,4,1,5
SHEIKHUPURA DISTRICT,38,Male,13785,8140,21925
SHEIKHUPURA DISTRICT,38,Female,13323,7833,21156
SHEIKHUPURA DISTRICT,38,Transgender,2,1,3
SHEIKHUPURA DISTRICT,39,Male,12785,7068,19853
SHEIKHUPURA DISTRICT,39,Female,11973,6610,18583
SHEIKHUPURA DISTRICT,39,Transgender,3,2,5
SHEIKHUPURA DISTRICT,40,Male,15378,8350,23728
SHEIKHUPURA DISTRICT,40,Female,13738,7565,21303
SHEIKHUPURA DISTRICT,40,Transgender,12,4,16
SHEIKHUPURA DISTRICT,41,Male,11541,6447,17988
SHEIKHUPURA DISTRICT,41,Female,10172,6052,16224
SHEIKHUPURA DISTRICT,41,Transgender,4,1,5
SHEIKHUPURA DISTRICT,42,Male,10993,6399,17392
SHEIKHUPURA DISTRICT,42,Female,9872,5703,15575
SHEIKHUPURA DISTRICT,42,Transgender,3,4,7
SHEIKHUPURA DISTRICT,43,Male,10074,5736,15810
SHEIKHUPURA DISTRICT,43,Female,9669,5736,15405
SHEIKHUPURA DISTRICT,43,Transgender,1,1,2
SHEIKHUPURA DISTRICT,44,Male,9140,5267,14407
SHEIKHUPURA DISTRICT,44,Female,8678,5120,13798
SHEIKHUPURA DISTRICT,44,Transgender,0,1,1
SHEIKHUPURA DISTRICT,45,Male,11504,6354,17858
SHEIKHUPURA DISTRICT,45,Female,10120,5639,15759
SHEIKHUPURA DISTRICT,45,Transgender,10,13,23
SHEIKHUPURA DISTRICT,46,Male,8080,4766,12846
SHEIKHUPURA DISTRICT,46,Female,7012,4331,11343
SHEIKHUPURA DISTRICT,46,Transgender,3,4,7
SHEIKHUPURA DISTRICT,47,Male,8480,4570,13050
SHEIKHUPURA DISTRICT,47,Female,7149,3952,11101
SHEIKHUPURA DISTRICT,47,Transgender,0,1,1
SHEIKHUPURA DISTRICT,48,Male,8905,5214,14119
SHEIKHUPURA DISTRICT,48,Female,8638,4929,13567
SHEIKHUPURA DISTRICT,48,Transgender,2,0,2
SHEIKHUPURA DISTRICT,49,Male,8719,4903,13622
SHEIKHUPURA DISTRICT,49,Female,7928,4754,12682
SHEIKHUPURA DISTRICT,49,Transgender,0,1,1
SHEIKHUPURA DISTRICT,50,Male,11131,6027,17158
SHEIKHUPURA DISTRICT,50,Female,9510,5465,14975
SHEIKHUPURA DISTRICT,50,Transgender,3,2,5
SHEIKHUPURA DISTRICT,51,Male,8186,4636,12822
SHEIKHUPURA DISTRICT,51,Female,6890,4091,10981
SHEIKHUPURA DISTRICT,51,Transgender,2,1,3
SHEIKHUPURA DISTRICT,52,Male,8502,4850,13352
SHEIKHUPURA DISTRICT,52,Female,6849,4079,10928
SHEIKHUPURA DISTRICT,52,Transgender,1,0,1
SHEIKHUPURA DISTRICT,53,Male,7965,4458,12423
SHEIKHUPURA DISTRICT,53,Female,6824,4042,10866
SHEIKHUPURA DISTRICT,53,Transgender,1,1,2
SHEIKHUPURA DISTRICT,54,Male,7351,4210,11561
SHEIKHUPURA DISTRICT,54,Female,5888,3614,9502
SHEIKHUPURA DISTRICT,54,Transgender,0,0,0
SHEIKHUPURA DISTRICT,55,Male,8213,4692,12905
SHEIKHUPURA DISTRICT,55,Female,6382,3787,10169
SHEIKHUPURA DISTRICT,55,Transgender,1,2,3
SHEIKHUPURA DISTRICT,56,Male,5860,3397,9257
SHEIKHUPURA DISTRICT,56,Female,4285,2535,6820
SHEIKHUPURA DISTRICT,56,Transgender,1,2,3
SHEIKHUPURA DISTRICT,57,Male,5175,2855,8030
SHEIKHUPURA DISTRICT,57,Female,3853,2063,5916
SHEIKHUPURA DISTRICT,57,Transgender,2,0,2
SHEIKHUPURA DISTRICT,58,Male,5094,3132,8226
SHEIKHUPURA DISTRICT,58,Female,4765,2645,7410
SHEIKHUPURA DISTRICT,58,Transgender,2,0,2
SHEIKHUPURA DISTRICT,59,Male,4946,2783,7729
SHEIKHUPURA DISTRICT,59,Female,4229,2565,6794
SHEIKHUPURA DISTRICT,59,Transgender,1,2,3
SHEIKHUPURA DISTRICT,60,Male,6702,3433,10135
SHEIKHUPURA DISTRICT,60,Female,5436,2865,8301
SHEIKHUPURA DISTRICT,60,Transgender,5,2,7
SHEIKHUPURA DISTRICT,61,Male,4572,2503,7075
SHEIKHUPURA DISTRICT,61,Female,3702,2127,5829
SHEIKHUPURA DISTRICT,61,Transgender,0,0,0
SHEIKHUPURA DISTRICT,62,Male,4509,2608,7117
SHEIKHUPURA DISTRICT,62,Female,3616,2012,5628
SHEIKHUPURA DISTRICT,62,Transgender,2,1,3
SHEIKHUPURA DISTRICT,63,Male,4276,2546,6822
SHEIKHUPURA DISTRICT,63,Female,3855,2163,6018
SHEIKHUPURA DISTRICT,63,Transgender,0,1,1
SHEIKHUPURA DISTRICT,64,Male,3799,2181,5980
SHEIKHUPURA DISTRICT,64,Female,3474,1796,5270
SHEIKHUPURA DISTRICT,64,Transgender,0,0,0
SHEIKHUPURA DISTRICT,65,Male,4961,2495,7456
SHEIKHUPURA DISTRICT,65,Female,4121,2038,6159
SHEIKHUPURA DISTRICT,65,Transgender,4,2,6
SHEIKHUPURA DISTRICT,66,Male,2760,1477,4237
SHEIKHUPURA DISTRICT,66,Female,2338,1224,3562
SHEIKHUPURA DISTRICT,66,Transgender,0,1,1
SHEIKHUPURA DISTRICT,67,Male,2419,1276,3695
SHEIKHUPURA DISTRICT,67,Female,1980,1044,3024
SHEIKHUPURA DISTRICT,67,Transgender,0,0,0
SHEIKHUPURA DISTRICT,68,Male,2768,1466,4234
SHEIKHUPURA DISTRICT,68,Female,2689,1324,4013
SHEIKHUPURA DISTRICT,68,Transgender,0,0,0
SHEIKHUPURA DISTRICT,69,Male,2505,1234,3739
SHEIKHUPURA DISTRICT,69,Female,2467,1222,3689
SHEIKHUPURA DISTRICT,69,Transgender,0,0,0
SHEIKHUPURA DISTRICT,70,Male,4179,1865,6044
SHEIKHUPURA DISTRICT,70,Female,3426,1517,4943
SHEIKHUPURA DISTRICT,70,Transgender,2,3,5
SHEIKHUPURA DISTRICT,71,Male,2545,1227,3772
SHEIKHUPURA DISTRICT,71,Female,2249,986,3235
SHEIKHUPURA DISTRICT,71,Transgender,1,0,1
SHEIKHUPURA DISTRICT,72,Male,2661,1216,3877
SHEIKHUPURA DISTRICT,72,Female,1978,985,2963
SHEIKHUPURA DISTRICT,72,Transgender,0,0,0
SHEIKHUPURA DISTRICT,73,Male,2375,1138,3513
SHEIKHUPURA DISTRICT,73,Female,2040,1013,3053
SHEIKHUPURA DISTRICT,73,Transgender,0,0,0
SHEIKHUPURA DISTRICT,74,Male,2314,991,3305
SHEIKHUPURA DISTRICT,74,Female,1807,818,2625
SHEIKHUPURA DISTRICT,74,Transgender,0,0,0
SHEIKHUPURA DISTRICT,>=75,Male,18761,7911,26672
SHEIKHUPURA DISTRICT,>=75,Female,15184,6946,22130
SHEIKHUPURA DISTRICT,>=75,Transgender,9,7,16
SHERANI DISTRICT,<1,Male,4219,0,4219
SHERANI DISTRICT,<1,Female,3012,0,3012
SHERANI DISTRICT,<1,Transgender,0,0,0
SHERANI DISTRICT,1,Male,4037,0,4037
SHERANI DISTRICT,1,Female,2908,0,2908
SHERANI DISTRICT,1,Transgender,0,0,0
SHERANI DISTRICT,2,Male,4662,0,4662
SHERANI DISTRICT,2,Female,3294,0,3294
SHERANI DISTRICT,2,Transgender,0,0,0
SHERANI DISTRICT,3,Male,3973,0,3973
SHERANI DISTRICT,3,Female,2888,0,2888
SHERANI DISTRICT,3,Transgender,0,0,0
SHERANI DISTRICT,4,Male,4241,0,4241
SHERANI DISTRICT,4,Female,3160,0,3160
SHERANI DISTRICT,4,Transgender,0,0,0
SHERANI DISTRICT,5,Male,3627,0,3627
SHERANI DISTRICT,5,Female,2706,0,2706
SHERANI DISTRICT,5,Transgender,0,0,0
SHERANI DISTRICT,6,Male,4060,0,4060
SHERANI DISTRICT,6,Female,2894,0,2894
SHERANI DISTRICT,6,Transgender,0,0,0
SHERANI DISTRICT,7,Male,3448,0,3448
SHERANI DISTRICT,7,Female,2556,0,2556
SHERANI DISTRICT,7,Transgender,0,0,0
SHERANI DISTRICT,8,Male,3777,0,3777
SHERANI DISTRICT,8,Female,2693,0,2693
SHERANI DISTRICT,8,Transgender,0,0,0
SHERANI DISTRICT,9,Male,3661,0,3661
SHERANI DISTRICT,9,Female,2594,0,2594
SHERANI DISTRICT,9,Transgender,0,0,0
SHERANI DISTRICT,10,Male,3261,0,3261
SHERANI DISTRICT,10,Female,2224,0,2224
SHERANI DISTRICT,10,Transgender,0,0,0
SHERANI DISTRICT,11,Male,2916,0,2916
SHERANI DISTRICT,11,Female,2006,0,2006
SHERANI DISTRICT,11,Transgender,0,0,0
SHERANI DISTRICT,12,Male,2588,0,2588
SHERANI DISTRICT,12,Female,1759,0,1759
SHERANI DISTRICT,12,Transgender,0,0,0
SHERANI DISTRICT,13,Male,2579,0,2579
SHERANI DISTRICT,13,Female,1640,0,1640
SHERANI DISTRICT,13,Transgender,0,0,0
SHERANI DISTRICT,14,Male,2377,0,2377
SHERANI DISTRICT,14,Female,1432,0,1432
SHERANI DISTRICT,14,Transgender,0,0,0
SHERANI DISTRICT,15,Male,2226,0,2226
SHERANI DISTRICT,15,Female,1364,0,1364
SHERANI DISTRICT,15,Transgender,1,0,1
SHERANI DISTRICT,16,Male,1887,0,1887
SHERANI DISTRICT,16,Female,1187,0,1187
SHERANI DISTRICT,16,Transgender,0,0,0
SHERANI DISTRICT,17,Male,1889,0,1889
SHERANI DISTRICT,17,Female,1345,0,1345
SHERANI DISTRICT,17,Transgender,0,0,0
SHERANI DISTRICT,18,Male,1264,0,1264
SHERANI DISTRICT,18,Female,1256,0,1256
SHERANI DISTRICT,18,Transgender,0,0,0
SHERANI DISTRICT,19,Male,1273,0,1273
SHERANI DISTRICT,19,Female,1344,0,1344
SHERANI DISTRICT,19,Transgender,0,0,0
SHERANI DISTRICT,20,Male,1040,0,1040
SHERANI DISTRICT,20,Female,1133,0,1133
SHERANI DISTRICT,20,Transgender,0,0,0
SHERANI DISTRICT,21,Male,1084,0,1084
SHERANI DISTRICT,21,Female,1138,0,1138
SHERANI DISTRICT,21,Transgender,0,0,0
SHERANI DISTRICT,22,Male,824,0,824
SHERANI DISTRICT,22,Female,927,0,927
SHERANI DISTRICT,22,Transgender,0,0,0
SHERANI DISTRICT,23,Male,876,0,876
SHERANI DISTRICT,23,Female,985,0,985
SHERANI DISTRICT,23,Transgender,0,0,0
SHERANI DISTRICT,24,Male,843,0,843
SHERANI DISTRICT,24,Female,896,0,896
SHERANI DISTRICT,24,Transgender,0,0,0
SHERANI DISTRICT,25,Male,861,0,861
SHERANI DISTRICT,25,Female,937,0,937
SHERANI DISTRICT,25,Transgender,0,0,0
SHERANI DISTRICT,26,Male,864,0,864
SHERANI DISTRICT,26,Female,1024,0,1024
SHERANI DISTRICT,26,Transgender,0,0,0
SHERANI DISTRICT,27,Male,931,0,931
SHERANI DISTRICT,27,Female,1115,0,1115
SHERANI DISTRICT,27,Transgender,0,0,0
SHERANI DISTRICT,28,Male,725,0,725
SHERANI DISTRICT,28,Female,864,0,864
SHERANI DISTRICT,28,Transgender,0,0,0
SHERANI DISTRICT,29,Male,861,0,861
SHERANI DISTRICT,29,Female,1033,0,1033
SHERANI DISTRICT,29,Transgender,0,0,0
SHERANI DISTRICT,30,Male,662,0,662
SHERANI DISTRICT,30,Female,640,0,640
SHERANI DISTRICT,30,Transgender,0,0,0
SHERANI DISTRICT,31,Male,665,0,665
SHERANI DISTRICT,31,Female,769,0,769
SHERANI DISTRICT,31,Transgender,0,0,0
SHERANI DISTRICT,32,Male,600,0,600
SHERANI DISTRICT,32,Female,657,0,657
SHERANI DISTRICT,32,Transgender,0,0,0
SHERANI DISTRICT,33,Male,590,0,590
SHERANI DISTRICT,33,Female,664,0,664
SHERANI DISTRICT,33,Transgender,0,0,0
SHERANI DISTRICT,34,Male,459,0,459
SHERANI DISTRICT,34,Female,498,0,498
SHERANI DISTRICT,34,Transgender,0,0,0
SHERANI DISTRICT,35,Male,444,0,444
SHERANI DISTRICT,35,Female,524,0,524
SHERANI DISTRICT,35,Transgender,0,0,0
SHERANI DISTRICT,36,Male,403,0,403
SHERANI DISTRICT,36,Female,445,0,445
SHERANI DISTRICT,36,Transgender,0,0,0
SHERANI DISTRICT,37,Male,538,0,538
SHERANI DISTRICT,37,Female,683,0,683
SHERANI DISTRICT,37,Transgender,0,0,0
SHERANI DISTRICT,38,Male,462,0,462
SHERANI DISTRICT,38,Female,554,0,554
SHERANI DISTRICT,38,Transgender,0,0,0
SHERANI DISTRICT,39,Male,445,0,445
SHERANI DISTRICT,39,Female,534,0,534
SHERANI DISTRICT,39,Transgender,0,0,0
SHERANI DISTRICT,40,Male,419,0,419
SHERANI DISTRICT,40,Female,480,0,480
SHERANI DISTRICT,40,Transgender,0,0,0
SHERANI DISTRICT,41,Male,360,0,360
SHERANI DISTRICT,41,Female,410,0,410
SHERANI DISTRICT,41,Transgender,0,0,0
SHERANI DISTRICT,42,Male,339,0,339
SHERANI DISTRICT,42,Female,445,0,445
SHERANI DISTRICT,42,Transgender,0,0,0
SHERANI DISTRICT,43,Male,283,0,283
SHERANI DISTRICT,43,Female,375,0,375
SHERANI DISTRICT,43,Transgender,0,0,0
SHERANI DISTRICT,44,Male,296,0,296
SHERANI DISTRICT,44,Female,357,0,357
SHERANI DISTRICT,44,Transgender,0,0,0
SHERANI DISTRICT,45,Male,291,0,291
SHERANI DISTRICT,45,Female,300,0,300
SHERANI DISTRICT,45,Transgender,0,0,0
SHERANI DISTRICT,46,Male,263,0,263
SHERANI DISTRICT,46,Female,276,0,276
SHERANI DISTRICT,46,Transgender,0,0,0
SHERANI DISTRICT,47,Male,376,0,376
SHERANI DISTRICT,47,Female,469,0,469
SHERANI DISTRICT,47,Transgender,0,0,0
SHERANI DISTRICT,48,Male,314,0,314
SHERANI DISTRICT,48,Female,266,0,266
SHERANI DISTRICT,48,Transgender,0,0,0
SHERANI DISTRICT,49,Male,340,0,340
SHERANI DISTRICT,49,Female,307,0,307
SHERANI DISTRICT,49,Transgender,0,0,0
SHERANI DISTRICT,50,Male,249,0,249
SHERANI DISTRICT,50,Female,234,0,234
SHERANI DISTRICT,50,Transgender,0,0,0
SHERANI DISTRICT,51,Male,286,0,286
SHERANI DISTRICT,51,Female,254,0,254
SHERANI DISTRICT,51,Transgender,0,0,0
SHERANI DISTRICT,52,Male,268,0,268
SHERANI DISTRICT,52,Female,254,0,254
SHERANI DISTRICT,52,Transgender,0,0,0
SHERANI DISTRICT,53,Male,308,0,308
SHERANI DISTRICT,53,Female,254,0,254
SHERANI DISTRICT,53,Transgender,0,0,0
SHERANI DISTRICT,54,Male,235,0,235
SHERANI DISTRICT,54,Female,215,0,215
SHERANI DISTRICT,54,Transgender,0,0,0
SHERANI DISTRICT,55,Male,163,0,163
SHERANI DISTRICT,55,Female,169,0,169
SHERANI DISTRICT,55,Transgender,0,0,0
SHERANI DISTRICT,56,Male,162,0,162
SHERANI DISTRICT,56,Female,193,0,193
SHERANI DISTRICT,56,Transgender,0,0,0
SHERANI DISTRICT,57,Male,235,0,235
SHERANI DISTRICT,57,Female,275,0,275
SHERANI DISTRICT,57,Transgender,0,0,0
SHERANI DISTRICT,58,Male,183,0,183
SHERANI DISTRICT,58,Female,148,0,148
SHERANI DISTRICT,58,Transgender,0,0,0
SHERANI DISTRICT,59,Male,241,0,241
SHERANI DISTRICT,59,Female,188,0,188
SHERANI DISTRICT,59,Transgender,0,0,0
SHERANI DISTRICT,60,Male,141,0,141
SHERANI DISTRICT,60,Female,151,0,151
SHERANI DISTRICT,60,Transgender,0,0,0
SHERANI DISTRICT,61,Male,147,0,147
SHERANI DISTRICT,61,Female,171,0,171
SHERANI DISTRICT,61,Transgender,0,0,0
SHERANI DISTRICT,62,Male,146,0,146
SHERANI DISTRICT,62,Female,159,0,159
SHERANI DISTRICT,62,Transgender,0,0,0
SHERANI DISTRICT,63,Male,142,0,142
SHERANI DISTRICT,63,Female,173,0,173
SHERANI DISTRICT,63,Transgender,0,0,0
SHERANI DISTRICT,64,Male,184,0,184
SHERANI DISTRICT,64,Female,224,0,224
SHERANI DISTRICT,64,Transgender,0,0,0
SHERANI DISTRICT,65,Male,121,0,121
SHERANI DISTRICT,65,Female,84,0,84
SHERANI DISTRICT,65,Transgender,0,0,0
SHERANI DISTRICT,66,Male,111,0,111
SHERANI DISTRICT,66,Female,122,0,122
SHERANI DISTRICT,66,Transgender,0,0,0
SHERANI DISTRICT,67,Male,161,0,161
SHERANI DISTRICT,67,Female,190,0,190
SHERANI DISTRICT,67,Transgender,0,0,0
SHERANI DISTRICT,68,Male,119,0,119
SHERANI DISTRICT,68,Female,98,0,98
SHERANI DISTRICT,68,Transgender,0,0,0
SHERANI DISTRICT,69,Male,247,0,247
SHERANI DISTRICT,69,Female,200,0,200
SHERANI DISTRICT,69,Transgender,0,0,0
SHERANI DISTRICT,70,Male,72,0,72
SHERANI DISTRICT,70,Female,65,0,65
SHERANI DISTRICT,70,Transgender,0,0,0
SHERANI DISTRICT,71,Male,100,0,100
SHERANI DISTRICT,71,Female,93,0,93
SHERANI DISTRICT,71,Transgender,0,0,0
SHERANI DISTRICT,72,Male,83,0,83
SHERANI DISTRICT,72,Female,77,0,77
SHERANI DISTRICT,72,Transgender,0,0,0
SHERANI DISTRICT,73,Male,78,0,78
SHERANI DISTRICT,73,Female,56,0,56
SHERANI DISTRICT,73,Transgender,0,0,0
SHERANI DISTRICT,74,Male,158,0,158
SHERANI DISTRICT,74,Female,101,0,101
SHERANI DISTRICT,74,Transgender,0,0,0
SHERANI DISTRICT,>=75,Male,627,0,627
SHERANI DISTRICT,>=75,Female,446,0,446
SHERANI DISTRICT,>=75,Transgender,0,0,0
SHIKARPUR DISTRICT,<1,Male,11508,3249,14757
SHIKARPUR DISTRICT,<1,Female,10799,3059,13858
SHIKARPUR DISTRICT,<1,Transgender,0,0,0
SHIKARPUR DISTRICT,1,Male,14906,3817,18723
SHIKARPUR DISTRICT,1,Female,14091,3631,17722
SHIKARPUR DISTRICT,1,Transgender,0,0,0
SHIKARPUR DISTRICT,2,Male,18139,4232,22371
SHIKARPUR DISTRICT,2,Female,17805,4218,22023
SHIKARPUR DISTRICT,2,Transgender,0,0,0
SHIKARPUR DISTRICT,3,Male,19370,5039,24409
SHIKARPUR DISTRICT,3,Female,18499,4926,23425
SHIKARPUR DISTRICT,3,Transgender,0,0,0
SHIKARPUR DISTRICT,4,Male,19921,4736,24657
SHIKARPUR DISTRICT,4,Female,19450,4630,24080
SHIKARPUR DISTRICT,4,Transgender,0,0,0
SHIKARPUR DISTRICT,5,Male,19798,5149,24947
SHIKARPUR DISTRICT,5,Female,17855,4615,22470
SHIKARPUR DISTRICT,5,Transgender,0,0,0
SHIKARPUR DISTRICT,6,Male,19871,4300,24171
SHIKARPUR DISTRICT,6,Female,17654,3949,21603
SHIKARPUR DISTRICT,6,Transgender,0,0,0
SHIKARPUR DISTRICT,7,Male,18834,5031,23865
SHIKARPUR DISTRICT,7,Female,16170,4630,20800
SHIKARPUR DISTRICT,7,Transgender,0,0,0
SHIKARPUR DISTRICT,8,Male,20712,4611,25323
SHIKARPUR DISTRICT,8,Female,17505,4052,21557
SHIKARPUR DISTRICT,8,Transgender,0,0,0
SHIKARPUR DISTRICT,9,Male,16317,4421,20738
SHIKARPUR DISTRICT,9,Female,13395,3991,17386
SHIKARPUR DISTRICT,9,Transgender,0,0,0
SHIKARPUR DISTRICT,10,Male,17889,4127,22016
SHIKARPUR DISTRICT,10,Female,14754,3581,18335
SHIKARPUR DISTRICT,10,Transgender,0,0,0
SHIKARPUR DISTRICT,11,Male,12425,3785,16210
SHIKARPUR DISTRICT,11,Female,10103,3472,13575
SHIKARPUR DISTRICT,11,Transgender,0,0,0
SHIKARPUR DISTRICT,12,Male,14038,3667,17705
SHIKARPUR DISTRICT,12,Female,11204,3273,14477
SHIKARPUR DISTRICT,12,Transgender,0,0,0
SHIKARPUR DISTRICT,13,Male,10745,3572,14317
SHIKARPUR DISTRICT,13,Female,8596,3278,11874
SHIKARPUR DISTRICT,13,Transgender,0,0,0
SHIKARPUR DISTRICT,14,Male,11210,3475,14685
SHIKARPUR DISTRICT,14,Female,9049,3196,12245
SHIKARPUR DISTRICT,14,Transgender,0,0,0
SHIKARPUR DISTRICT,15,Male,11182,3748,14930
SHIKARPUR DISTRICT,15,Female,8320,3336,11656
SHIKARPUR DISTRICT,15,Transgender,2,3,5
SHIKARPUR DISTRICT,16,Male,10304,3529,13833
SHIKARPUR DISTRICT,16,Female,8490,3359,11849
SHIKARPUR DISTRICT,16,Transgender,0,1,1
SHIKARPUR DISTRICT,17,Male,9133,3881,13014
SHIKARPUR DISTRICT,17,Female,7731,3495,11226
SHIKARPUR DISTRICT,17,Transgender,3,0,3
SHIKARPUR DISTRICT,18,Male,9913,3678,13591
SHIKARPUR DISTRICT,18,Female,9747,3614,13361
SHIKARPUR DISTRICT,18,Transgender,4,1,5
SHIKARPUR DISTRICT,19,Male,7561,3198,10759
SHIKARPUR DISTRICT,19,Female,7597,3234,10831
SHIKARPUR DISTRICT,19,Transgender,0,0,0
SHIKARPUR DISTRICT,20,Male,8828,2946,11774
SHIKARPUR DISTRICT,20,Female,8745,3000,11745
SHIKARPUR DISTRICT,20,Transgender,1,1,2
SHIKARPUR DISTRICT,21,Male,6324,2814,9138
SHIKARPUR DISTRICT,21,Female,6277,2745,9022
SHIKARPUR DISTRICT,21,Transgender,1,1,2
SHIKARPUR DISTRICT,22,Male,6476,2753,9229
SHIKARPUR DISTRICT,22,Female,6033,2774,8807
SHIKARPUR DISTRICT,22,Transgender,1,0,1
SHIKARPUR DISTRICT,23,Male,5258,2519,7777
SHIKARPUR DISTRICT,23,Female,5489,2468,7957
SHIKARPUR DISTRICT,23,Transgender,1,1,2
SHIKARPUR DISTRICT,24,Male,5093,2296,7389
SHIKARPUR DISTRICT,24,Female,5328,2205,7533
SHIKARPUR DISTRICT,24,Transgender,0,0,0
SHIKARPUR DISTRICT,25,Male,6924,2455,9379
SHIKARPUR DISTRICT,25,Female,6884,2490,9374
SHIKARPUR DISTRICT,25,Transgender,0,0,0
SHIKARPUR DISTRICT,26,Male,5057,2190,7247
SHIKARPUR DISTRICT,26,Female,5472,2252,7724
SHIKARPUR DISTRICT,26,Transgender,0,0,0
SHIKARPUR DISTRICT,27,Male,5566,2399,7965
SHIKARPUR DISTRICT,27,Female,5925,2371,8296
SHIKARPUR DISTRICT,27,Transgender,1,1,2
SHIKARPUR DISTRICT,28,Male,5830,2311,8141
SHIKARPUR DISTRICT,28,Female,6531,2407,8938
SHIKARPUR DISTRICT,28,Transgender,1,0,1
SHIKARPUR DISTRICT,29,Male,5782,2388,8170
SHIKARPUR DISTRICT,29,Female,6887,2562,9449
SHIKARPUR DISTRICT,29,Transgender,0,1,1
SHIKARPUR DISTRICT,30,Male,6427,2381,8808
SHIKARPUR DISTRICT,30,Female,6889,2343,9232
SHIKARPUR DISTRICT,30,Transgender,1,0,1
SHIKARPUR DISTRICT,31,Male,5528,2425,7953
SHIKARPUR DISTRICT,31,Female,6097,2372,8469
SHIKARPUR DISTRICT,31,Transgender,1,1,2
SHIKARPUR DISTRICT,32,Male,5536,2342,7878
SHIKARPUR DISTRICT,32,Female,5613,2135,7748
SHIKARPUR DISTRICT,32,Transgender,2,2,4
SHIKARPUR DISTRICT,33,Male,4948,2189,7137
SHIKARPUR DISTRICT,33,Female,5251,1985,7236
SHIKARPUR DISTRICT,33,Transgender,2,0,2
SHIKARPUR DISTRICT,34,Male,4213,1893,6106
SHIKARPUR DISTRICT,34,Female,4695,1752,6447
SHIKARPUR DISTRICT,34,Transgender,0,1,1
SHIKARPUR DISTRICT,35,Male,5553,1916,7469
SHIKARPUR DISTRICT,35,Female,5297,1865,7162
SHIKARPUR DISTRICT,35,Transgender,2,2,4
SHIKARPUR DISTRICT,36,Male,4536,1697,6233
SHIKARPUR DISTRICT,36,Female,4408,1559,5967
SHIKARPUR DISTRICT,36,Transgender,0,1,1
SHIKARPUR DISTRICT,37,Male,5881,1866,7747
SHIKARPUR DISTRICT,37,Female,5958,1863,7821
SHIKARPUR DISTRICT,37,Transgender,1,0,1
SHIKARPUR DISTRICT,38,Male,4715,1843,6558
SHIKARPUR DISTRICT,38,Female,5055,1800,6855
SHIKARPUR DISTRICT,38,Transgender,1,0,1
SHIKARPUR DISTRICT,39,Male,5041,1719,6760
SHIKARPUR DISTRICT,39,Female,4929,1738,6667
SHIKARPUR DISTRICT,39,Transgender,0,0,0
SHIKARPUR DISTRICT,40,Male,4617,1778,6395
SHIKARPUR DISTRICT,40,Female,4639,1661,6300
SHIKARPUR DISTRICT,40,Transgender,2,0,2
SHIKARPUR DISTRICT,41,Male,3688,1518,5206
SHIKARPUR DISTRICT,41,Female,3680,1450,5130
SHIKARPUR DISTRICT,41,Transgender,0,0,0
SHIKARPUR DISTRICT,42,Male,3845,1499,5344
SHIKARPUR DISTRICT,42,Female,4133,1472,5605
SHIKARPUR DISTRICT,42,Transgender,0,0,0
SHIKARPUR DISTRICT,43,Male,2957,1468,4425
SHIKARPUR DISTRICT,43,Female,3166,1300,4466
SHIKARPUR DISTRICT,43,Transgender,1,0,1
SHIKARPUR DISTRICT,44,Male,2778,1348,4126
SHIKARPUR DISTRICT,44,Female,2955,1182,4137
SHIKARPUR DISTRICT,44,Transgender,0,0,0
SHIKARPUR DISTRICT,45,Male,3248,1251,4499
SHIKARPUR DISTRICT,45,Female,3245,1192,4437
SHIKARPUR DISTRICT,45,Transgender,3,1,4
SHIKARPUR DISTRICT,46,Male,2600,1123,3723
SHIKARPUR DISTRICT,46,Female,2592,1023,3615
SHIKARPUR DISTRICT,46,Transgender,1,2,3
SHIKARPUR DISTRICT,47,Male,3175,1206,4381
SHIKARPUR DISTRICT,47,Female,3658,1262,4920
SHIKARPUR DISTRICT,47,Transgender,0,0,0
SHIKARPUR DISTRICT,48,Male,2796,1281,4077
SHIKARPUR DISTRICT,48,Female,2874,1116,3990
SHIKARPUR DISTRICT,48,Transgender,0,0,0
SHIKARPUR DISTRICT,49,Male,2921,1203,4124
SHIKARPUR DISTRICT,49,Female,2852,1131,3983
SHIKARPUR DISTRICT,49,Transgender,0,0,0
SHIKARPUR DISTRICT,50,Male,3031,1151,4182
SHIKARPUR DISTRICT,50,Female,2911,1046,3957
SHIKARPUR DISTRICT,50,Transgender,1,0,1
SHIKARPUR DISTRICT,51,Male,2321,1113,3434
SHIKARPUR DISTRICT,51,Female,2314,891,3205
SHIKARPUR DISTRICT,51,Transgender,0,0,0
SHIKARPUR DISTRICT,52,Male,2473,1019,3492
SHIKARPUR DISTRICT,52,Female,2559,957,3516
SHIKARPUR DISTRICT,52,Transgender,0,1,1
SHIKARPUR DISTRICT,53,Male,1973,938,2911
SHIKARPUR DISTRICT,53,Female,1813,780,2593
SHIKARPUR DISTRICT,53,Transgender,1,0,1
SHIKARPUR DISTRICT,54,Male,1968,817,2785
SHIKARPUR DISTRICT,54,Female,1728,670,2398
SHIKARPUR DISTRICT,54,Transgender,0,0,0
SHIKARPUR DISTRICT,55,Male,2176,871,3047
SHIKARPUR DISTRICT,55,Female,2066,753,2819
SHIKARPUR DISTRICT,55,Transgender,0,2,2
SHIKARPUR DISTRICT,56,Male,1647,768,2415
SHIKARPUR DISTRICT,56,Female,1461,577,2038
SHIKARPUR DISTRICT,56,Transgender,0,0,0
SHIKARPUR DISTRICT,57,Male,2069,758,2827
SHIKARPUR DISTRICT,57,Female,2194,723,2917
SHIKARPUR DISTRICT,57,Transgender,0,0,0
SHIKARPUR DISTRICT,58,Male,1533,649,2182
SHIKARPUR DISTRICT,58,Female,1421,658,2079
SHIKARPUR DISTRICT,58,Transgender,1,0,1
SHIKARPUR DISTRICT,59,Male,1620,673,2293
SHIKARPUR DISTRICT,59,Female,1593,705,2298
SHIKARPUR DISTRICT,59,Transgender,0,0,0
SHIKARPUR DISTRICT,60,Male,1759,594,2353
SHIKARPUR DISTRICT,60,Female,1791,635,2426
SHIKARPUR DISTRICT,60,Transgender,1,1,2
SHIKARPUR DISTRICT,61,Male,1265,574,1839
SHIKARPUR DISTRICT,61,Female,1332,568,1900
SHIKARPUR DISTRICT,61,Transgender,1,0,1
SHIKARPUR DISTRICT,62,Male,1421,566,1987
SHIKARPUR DISTRICT,62,Female,1641,603,2244
SHIKARPUR DISTRICT,62,Transgender,0,0,0
SHIKARPUR DISTRICT,63,Male,1210,557,1767
SHIKARPUR DISTRICT,63,Female,1177,570,1747
SHIKARPUR DISTRICT,63,Transgender,0,0,0
SHIKARPUR DISTRICT,64,Male,1363,511,1874
SHIKARPUR DISTRICT,64,Female,1181,532,1713
SHIKARPUR DISTRICT,64,Transgender,1,0,1
SHIKARPUR DISTRICT,65,Male,1277,431,1708
SHIKARPUR DISTRICT,65,Female,1126,430,1556
SHIKARPUR DISTRICT,65,Transgender,0,1,1
SHIKARPUR DISTRICT,66,Male,1017,411,1428
SHIKARPUR DISTRICT,66,Female,890,344,1234
SHIKARPUR DISTRICT,66,Transgender,0,1,1
SHIKARPUR DISTRICT,67,Male,1054,363,1417
SHIKARPUR DISTRICT,67,Female,1333,382,1715
SHIKARPUR DISTRICT,67,Transgender,1,0,1
SHIKARPUR DISTRICT,68,Male,819,337,1156
SHIKARPUR DISTRICT,68,Female,714,363,1077
SHIKARPUR DISTRICT,68,Transgender,0,0,0
SHIKARPUR DISTRICT,69,Male,961,335,1296
SHIKARPUR DISTRICT,69,Female,871,340,1211
SHIKARPUR DISTRICT,69,Transgender,0,1,1
SHIKARPUR DISTRICT,70,Male,824,251,1075
SHIKARPUR DISTRICT,70,Female,782,288,1070
SHIKARPUR DISTRICT,70,Transgender,1,1,2
SHIKARPUR DISTRICT,71,Male,670,225,895
SHIKARPUR DISTRICT,71,Female,704,254,958
SHIKARPUR DISTRICT,71,Transgender,0,0,0
SHIKARPUR DISTRICT,72,Male,642,248,890
SHIKARPUR DISTRICT,72,Female,809,250,1059
SHIKARPUR DISTRICT,72,Transgender,1,0,1
SHIKARPUR DISTRICT,73,Male,531,206,737
SHIKARPUR DISTRICT,73,Female,522,221,743
SHIKARPUR DISTRICT,73,Transgender,1,0,1
SHIKARPUR DISTRICT,74,Male,543,195,738
SHIKARPUR DISTRICT,74,Female,515,200,715
SHIKARPUR DISTRICT,74,Transgender,0,0,0
SHIKARPUR DISTRICT,>=75,Male,3386,1265,4651
SHIKARPUR DISTRICT,>=75,Female,3987,1570,5557
SHIKARPUR DISTRICT,>=75,Transgender,1,1,2
SIALKOT DISTRICT,<1,Male,34740,12807,47547
SIALKOT DISTRICT,<1,Female,33240,12480,45720
SIALKOT DISTRICT,<1,Transgender,0,0,0
SIALKOT DISTRICT,1,Male,35557,13780,49337
SIALKOT DISTRICT,1,Female,34138,13107,47245
SIALKOT DISTRICT,1,Transgender,0,0,0
SIALKOT DISTRICT,2,Male,35322,13177,48499
SIALKOT DISTRICT,2,Female,33550,12931,46481
SIALKOT DISTRICT,2,Transgender,0,0,0
SIALKOT DISTRICT,3,Male,37247,14094,51341
SIALKOT DISTRICT,3,Female,36027,13632,49659
SIALKOT DISTRICT,3,Transgender,0,0,0
SIALKOT DISTRICT,4,Male,35708,13058,48766
SIALKOT DISTRICT,4,Female,34432,12823,47255
SIALKOT DISTRICT,4,Transgender,0,0,0
SIALKOT DISTRICT,5,Male,35858,13512,49370
SIALKOT DISTRICT,5,Female,34426,12901,47327
SIALKOT DISTRICT,5,Transgender,0,0,0
SIALKOT DISTRICT,6,Male,36204,13480,49684
SIALKOT DISTRICT,6,Female,34041,12751,46792
SIALKOT DISTRICT,6,Transgender,0,0,0
SIALKOT DISTRICT,7,Male,38080,14274,52354
SIALKOT DISTRICT,7,Female,36144,13578,49722
SIALKOT DISTRICT,7,Transgender,0,0,0
SIALKOT DISTRICT,8,Male,34570,13052,47622
SIALKOT DISTRICT,8,Female,33013,12127,45140
SIALKOT DISTRICT,8,Transgender,0,0,0
SIALKOT DISTRICT,9,Male,37903,14423,52326
SIALKOT DISTRICT,9,Female,35707,13491,49198
SIALKOT DISTRICT,9,Transgender,0,0,0
SIALKOT DISTRICT,10,Male,33025,12018,45043
SIALKOT DISTRICT,10,Female,31669,11686,43355
SIALKOT DISTRICT,10,Transgender,0,0,0
SIALKOT DISTRICT,11,Male,36987,14307,51294
SIALKOT DISTRICT,11,Female,35426,13750,49176
SIALKOT DISTRICT,11,Transgender,0,0,0
SIALKOT DISTRICT,12,Male,32376,12000,44376
SIALKOT DISTRICT,12,Female,30480,11393,41873
SIALKOT DISTRICT,12,Transgender,0,0,0
SIALKOT DISTRICT,13,Male,34828,13294,48122
SIALKOT DISTRICT,13,Female,32833,12433,45266
SIALKOT DISTRICT,13,Transgender,0,0,0
SIALKOT DISTRICT,14,Male,32626,12313,44939
SIALKOT DISTRICT,14,Female,30784,11301,42085
SIALKOT DISTRICT,14,Transgender,0,0,0
SIALKOT DISTRICT,15,Male,31877,12181,44058
SIALKOT DISTRICT,15,Female,31326,11740,43066
SIALKOT DISTRICT,15,Transgender,7,0,7
SIALKOT DISTRICT,16,Male,32846,12717,45563
SIALKOT DISTRICT,16,Female,32000,11651,43651
SIALKOT DISTRICT,16,Transgender,8,7,15
SIALKOT DISTRICT,17,Male,31294,12560,43854
SIALKOT DISTRICT,17,Female,31158,12194,43352
SIALKOT DISTRICT,17,Transgender,6,1,7
SIALKOT DISTRICT,18,Male,28537,11144,39681
SIALKOT DISTRICT,18,Female,27183,10071,37254
SIALKOT DISTRICT,18,Transgender,7,7,14
SIALKOT DISTRICT,19,Male,29625,12036,41661
SIALKOT DISTRICT,19,Female,31340,12065,43405
SIALKOT DISTRICT,19,Transgender,6,3,9
SIALKOT DISTRICT,20,Male,25376,10438,35814
SIALKOT DISTRICT,20,Female,26459,9731,36190
SIALKOT DISTRICT,20,Transgender,10,8,18
SIALKOT DISTRICT,21,Male,26674,11884,38558
SIALKOT DISTRICT,21,Female,31401,12861,44262
SIALKOT DISTRICT,21,Transgender,3,2,5
SIALKOT DISTRICT,22,Male,23189,10390,33579
SIALKOT DISTRICT,22,Female,29135,11140,40275
SIALKOT DISTRICT,22,Transgender,14,5,19
SIALKOT DISTRICT,23,Male,21623,10706,32329
SIALKOT DISTRICT,23,Female,29354,12116,41470
SIALKOT DISTRICT,23,Transgender,11,4,15
SIALKOT DISTRICT,24,Male,21064,10749,31813
SIALKOT DISTRICT,24,Female,28520,11692,40212
SIALKOT DISTRICT,24,Transgender,10,4,14
SIALKOT DISTRICT,25,Male,17610,8936,26546
SIALKOT DISTRICT,25,Female,23455,9071,32526
SIALKOT DISTRICT,25,Transgender,17,5,22
SIALKOT DISTRICT,26,Male,19681,10419,30100
SIALKOT DISTRICT,26,Female,26513,11633,38146
SIALKOT DISTRICT,26,Transgender,15,6,21
SIALKOT DISTRICT,27,Male,17481,9961,27442
SIALKOT DISTRICT,27,Female,24003,10858,34861
SIALKOT DISTRICT,27,Transgender,8,4,12
SIALKOT DISTRICT,28,Male,17774,9492,27266
SIALKOT DISTRICT,28,Female,23738,10245,33983
SIALKOT DISTRICT,28,Transgender,14,4,18
SIALKOT DISTRICT,29,Male,16577,9240,25817
SIALKOT DISTRICT,29,Female,21818,9836,31654
SIALKOT DISTRICT,29,Transgender,4,2,6
SIALKOT DISTRICT,30,Male,17083,8656,25739
SIALKOT DISTRICT,30,Female,21989,9108,31097
SIALKOT DISTRICT,30,Transgender,19,12,31
SIALKOT DISTRICT,31,Male,16091,8827,24918
SIALKOT DISTRICT,31,Female,20764,9432,30196
SIALKOT DISTRICT,31,Transgender,2,3,5
SIALKOT DISTRICT,32,Male,15877,8816,24693
SIALKOT DISTRICT,32,Female,20144,9117,29261
SIALKOT DISTRICT,32,Transgender,6,9,15
SIALKOT DISTRICT,33,Male,15180,8422,23602
SIALKOT DISTRICT,33,Female,19584,8736,28320
SIALKOT DISTRICT,33,Transgender,8,6,14
SIALKOT DISTRICT,34,Male,14623,7979,22602
SIALKOT DISTRICT,34,Female,18182,8184,26366
SIALKOT DISTRICT,34,Transgender,6,2,8
SIALKOT DISTRICT,35,Male,14277,6929,21206
SIALKOT DISTRICT,35,Female,17411,7486,24897
SIALKOT DISTRICT,35,Transgender,9,9,18
SIALKOT DISTRICT,36,Male,15583,7724,23307
SIALKOT DISTRICT,36,Female,18155,7892,26047
SIALKOT DISTRICT,36,Transgender,5,6,11
SIALKOT DISTRICT,37,Male,12968,6721,19689
SIALKOT DISTRICT,37,Female,15377,6737,22114
SIALKOT DISTRICT,37,Transgender,5,4,9
SIALKOT DISTRICT,38,Male,14931,7917,22848
SIALKOT DISTRICT,38,Female,17447,8141,25588
SIALKOT DISTRICT,38,Transgender,5,1,6
SIALKOT DISTRICT,39,Male,13330,6873,20203
SIALKOT DISTRICT,39,Female,15908,7105,23013
SIALKOT DISTRICT,39,Transgender,2,2,4
SIALKOT DISTRICT,40,Male,14067,6963,21030
SIALKOT DISTRICT,40,Female,15324,7084,22408
SIALKOT DISTRICT,40,Transgender,15,6,21
SIALKOT DISTRICT,41,Male,12722,6534,19256
SIALKOT DISTRICT,41,Female,14810,6258,21068
SIALKOT DISTRICT,41,Transgender,1,2,3
SIALKOT DISTRICT,42,Male,11848,6270,18118
SIALKOT DISTRICT,42,Female,13148,6183,19331
SIALKOT DISTRICT,42,Transgender,7,2,9
SIALKOT DISTRICT,43,Male,11598,5891,17489
SIALKOT DISTRICT,43,Female,12989,6063,19052
SIALKOT DISTRICT,43,Transgender,1,3,4
SIALKOT DISTRICT,44,Male,11260,5427,16687
SIALKOT DISTRICT,44,Female,12032,5793,17825
SIALKOT DISTRICT,44,Transgender,3,2,5
SIALKOT DISTRICT,45,Male,10916,5140,16056
SIALKOT DISTRICT,45,Female,11205,5112,16317
SIALKOT DISTRICT,45,Transgender,11,5,16
SIALKOT DISTRICT,46,Male,10765,5102,15867
SIALKOT DISTRICT,46,Female,11420,4894,16314
SIALKOT DISTRICT,46,Transgender,8,0,8
SIALKOT DISTRICT,47,Male,9736,4572,14308
SIALKOT DISTRICT,47,Female,9654,4134,13788
SIALKOT DISTRICT,47,Transgender,5,1,6
SIALKOT DISTRICT,48,Male,10992,5069,16061
SIALKOT DISTRICT,48,Female,11410,5250,16660
SIALKOT DISTRICT,48,Transgender,4,0,4
SIALKOT DISTRICT,49,Male,10304,4672,14976
SIALKOT DISTRICT,49,Female,11130,4749,15879
SIALKOT DISTRICT,49,Transgender,2,1,3
SIALKOT DISTRICT,50,Male,10908,5203,16111
SIALKOT DISTRICT,50,Female,11084,5209,16293
SIALKOT DISTRICT,50,Transgender,6,7,13
SIALKOT DISTRICT,51,Male,10240,4465,14705
SIALKOT DISTRICT,51,Female,10943,4711,15654
SIALKOT DISTRICT,51,Transgender,4,3,7
SIALKOT DISTRICT,52,Male,10253,4556,14809
SIALKOT DISTRICT,52,Female,10295,4603,14898
SIALKOT DISTRICT,52,Transgender,1,0,1
SIALKOT DISTRICT,53,Male,10050,4372,14422
SIALKOT DISTRICT,53,Female,9679,4701,14380
SIALKOT DISTRICT,53,Transgender,1,1,2
SIALKOT DISTRICT,54,Male,9498,4247,13745
SIALKOT DISTRICT,54,Female,8844,4233,13077
SIALKOT DISTRICT,54,Transgender,0,1,1
SIALKOT DISTRICT,55,Male,8711,4015,12726
SIALKOT DISTRICT,55,Female,7576,3626,11202
SIALKOT DISTRICT,55,Transgender,3,4,7
SIALKOT DISTRICT,56,Male,8290,3765,12055
SIALKOT DISTRICT,56,Female,7115,3285,10400
SIALKOT DISTRICT,56,Transgender,5,2,7
SIALKOT DISTRICT,57,Male,6839,3156,9995
SIALKOT DISTRICT,57,Female,5711,2332,8043
SIALKOT DISTRICT,57,Transgender,3,1,4
SIALKOT DISTRICT,58,Male,7320,3174,10494
SIALKOT DISTRICT,58,Female,6808,2983,9791
SIALKOT DISTRICT,58,Transgender,2,1,3
SIALKOT DISTRICT,59,Male,6760,2988,9748
SIALKOT DISTRICT,59,Female,6079,2730,8809
SIALKOT DISTRICT,59,Transgender,4,1,5
SIALKOT DISTRICT,60,Male,7328,3227,10555
SIALKOT DISTRICT,60,Female,6568,2817,9385
SIALKOT DISTRICT,60,Transgender,4,4,8
SIALKOT DISTRICT,61,Male,7108,2971,10079
SIALKOT DISTRICT,61,Female,6044,2574,8618
SIALKOT DISTRICT,61,Transgender,0,0,0
SIALKOT DISTRICT,62,Male,6683,2903,9586
SIALKOT DISTRICT,62,Female,5616,2446,8062
SIALKOT DISTRICT,62,Transgender,1,2,3
SIALKOT DISTRICT,63,Male,6526,2853,9379
SIALKOT DISTRICT,63,Female,5650,2449,8099
SIALKOT DISTRICT,63,Transgender,1,0,1
SIALKOT DISTRICT,64,Male,5735,2472,8207
SIALKOT DISTRICT,64,Female,5200,2291,7491
SIALKOT DISTRICT,64,Transgender,0,1,1
SIALKOT DISTRICT,65,Male,5246,2281,7527
SIALKOT DISTRICT,65,Female,5086,2121,7207
SIALKOT DISTRICT,65,Transgender,4,4,8
SIALKOT DISTRICT,66,Male,4283,1859,6142
SIALKOT DISTRICT,66,Female,4132,1622,5754
SIALKOT DISTRICT,66,Transgender,0,1,1
SIALKOT DISTRICT,67,Male,3896,1619,5515
SIALKOT DISTRICT,67,Female,3450,1313,4763
SIALKOT DISTRICT,67,Transgender,1,1,2
SIALKOT DISTRICT,68,Male,4239,1741,5980
SIALKOT DISTRICT,68,Female,4137,1614,5751
SIALKOT DISTRICT,68,Transgender,1,0,1
SIALKOT DISTRICT,69,Male,4082,1618,5700
SIALKOT DISTRICT,69,Female,3839,1457,5296
SIALKOT DISTRICT,69,Transgender,2,0,2
SIALKOT DISTRICT,70,Male,4919,1865,6784
SIALKOT DISTRICT,70,Female,4321,1598,5919
SIALKOT DISTRICT,70,Transgender,4,0,4
SIALKOT DISTRICT,71,Male,3807,1460,5267
SIALKOT DISTRICT,71,Female,3410,1330,4740
SIALKOT DISTRICT,71,Transgender,1,0,1
SIALKOT DISTRICT,72,Male,3848,1528,5376
SIALKOT DISTRICT,72,Female,3288,1221,4509
SIALKOT DISTRICT,72,Transgender,0,0,0
SIALKOT DISTRICT,73,Male,3670,1436,5106
SIALKOT DISTRICT,73,Female,3126,1150,4276
SIALKOT DISTRICT,73,Transgender,0,0,0
SIALKOT DISTRICT,74,Male,3217,1181,4398
SIALKOT DISTRICT,74,Female,2733,999,3732
SIALKOT DISTRICT,74,Transgender,3,0,3
SIALKOT DISTRICT,>=75,Male,25054,8468,33522
SIALKOT DISTRICT,>=75,Female,23030,7829,30859
SIALKOT DISTRICT,>=75,Transgender,8,4,12
SIBI DISTRICT,<1,Male,1540,766,2306
SIBI DISTRICT,<1,Female,1382,668,2050
SIBI DISTRICT,<1,Transgender,0,0,0
SIBI DISTRICT,1,Male,1849,790,2639
SIBI DISTRICT,1,Female,1769,815,2584
SIBI DISTRICT,1,Transgender,0,0,0
SIBI DISTRICT,2,Male,2077,957,3034
SIBI DISTRICT,2,Female,2000,874,2874
SIBI DISTRICT,2,Transgender,0,0,0
SIBI DISTRICT,3,Male,2309,981,3290
SIBI DISTRICT,3,Female,2141,926,3067
SIBI DISTRICT,3,Transgender,0,0,0
SIBI DISTRICT,4,Male,2190,922,3112
SIBI DISTRICT,4,Female,2076,798,2874
SIBI DISTRICT,4,Transgender,0,0,0
SIBI DISTRICT,5,Male,2212,987,3199
SIBI DISTRICT,5,Female,1940,896,2836
SIBI DISTRICT,5,Transgender,0,0,0
SIBI DISTRICT,6,Male,2088,882,2970
SIBI DISTRICT,6,Female,1828,807,2635
SIBI DISTRICT,6,Transgender,0,0,0
SIBI DISTRICT,7,Male,2151,1043,3194
SIBI DISTRICT,7,Female,1892,918,2810
SIBI DISTRICT,7,Transgender,0,0,0
SIBI DISTRICT,8,Male,2174,904,3078
SIBI DISTRICT,8,Female,1786,789,2575
SIBI DISTRICT,8,Transgender,0,0,0
SIBI DISTRICT,9,Male,1755,986,2741
SIBI DISTRICT,9,Female,1519,824,2343
SIBI DISTRICT,9,Transgender,0,0,0
SIBI DISTRICT,10,Male,1890,772,2662
SIBI DISTRICT,10,Female,1541,689,2230
SIBI DISTRICT,10,Transgender,0,0,0
SIBI DISTRICT,11,Male,1325,858,2183
SIBI DISTRICT,11,Female,1205,733,1938
SIBI DISTRICT,11,Transgender,0,0,0
SIBI DISTRICT,12,Male,1434,701,2135
SIBI DISTRICT,12,Female,1175,695,1870
SIBI DISTRICT,12,Transgender,0,0,0
SIBI DISTRICT,13,Male,1208,782,1990
SIBI DISTRICT,13,Female,1052,689,1741
SIBI DISTRICT,13,Transgender,0,0,0
SIBI DISTRICT,14,Male,1173,725,1898
SIBI DISTRICT,14,Female,922,639,1561
SIBI DISTRICT,14,Transgender,0,0,0
SIBI DISTRICT,15,Male,1183,773,1956
SIBI DISTRICT,15,Female,930,624,1554
SIBI DISTRICT,15,Transgender,1,0,1
SIBI DISTRICT,16,Male,1103,715,1818
SIBI DISTRICT,16,Female,944,664,1608
SIBI DISTRICT,16,Transgender,0,2,2
SIBI DISTRICT,17,Male,1015,737,1752
SIBI DISTRICT,17,Female,897,704,1601
SIBI DISTRICT,17,Transgender,0,1,1
SIBI DISTRICT,18,Male,1187,636,1823
SIBI DISTRICT,18,Female,1170,636,1806
SIBI DISTRICT,18,Transgender,1,0,1
SIBI DISTRICT,19,Male,1094,743,1837
SIBI DISTRICT,19,Female,956,619,1575
SIBI DISTRICT,19,Transgender,1,0,1
SIBI DISTRICT,20,Male,1109,602,1711
SIBI DISTRICT,20,Female,1060,592,1652
SIBI DISTRICT,20,Transgender,0,0,0
SIBI DISTRICT,21,Male,1151,749,1900
SIBI DISTRICT,21,Female,867,633,1500
SIBI DISTRICT,21,Transgender,0,0,0
SIBI DISTRICT,22,Male,959,574,1533
SIBI DISTRICT,22,Female,734,526,1260
SIBI DISTRICT,22,Transgender,0,0,0
SIBI DISTRICT,23,Male,1071,559,1630
SIBI DISTRICT,23,Female,741,529,1270
SIBI DISTRICT,23,Transgender,0,0,0
SIBI DISTRICT,24,Male,899,602,1501
SIBI DISTRICT,24,Female,674,523,1197
SIBI DISTRICT,24,Transgender,0,0,0
SIBI DISTRICT,25,Male,892,477,1369
SIBI DISTRICT,25,Female,936,481,1417
SIBI DISTRICT,25,Transgender,1,0,1
SIBI DISTRICT,26,Male,855,515,1370
SIBI DISTRICT,26,Female,707,489,1196
SIBI DISTRICT,26,Transgender,0,0,0
SIBI DISTRICT,27,Male,1066,690,1756
SIBI DISTRICT,27,Female,872,615,1487
SIBI DISTRICT,27,Transgender,1,1,2
SIBI DISTRICT,28,Male,833,493,1326
SIBI DISTRICT,28,Female,744,516,1260
SIBI DISTRICT,28,Transgender,0,0,0
SIBI DISTRICT,29,Male,900,566,1466
SIBI DISTRICT,29,Female,942,608,1550
SIBI DISTRICT,29,Transgender,0,0,0
SIBI DISTRICT,30,Male,753,410,1163
SIBI DISTRICT,30,Female,865,382,1247
SIBI DISTRICT,30,Transgender,0,0,0
SIBI DISTRICT,31,Male,885,615,1500
SIBI DISTRICT,31,Female,790,529,1319
SIBI DISTRICT,31,Transgender,0,0,0
SIBI DISTRICT,32,Male,808,523,1331
SIBI DISTRICT,32,Female,773,461,1234
SIBI DISTRICT,32,Transgender,0,0,0
SIBI DISTRICT,33,Male,807,509,1316
SIBI DISTRICT,33,Female,645,431,1076
SIBI DISTRICT,33,Transgender,0,0,0
SIBI DISTRICT,34,Male,706,451,1157
SIBI DISTRICT,34,Female,585,405,990
SIBI DISTRICT,34,Transgender,0,0,0
SIBI DISTRICT,35,Male,770,332,1102
SIBI DISTRICT,35,Female,690,330,1020
SIBI DISTRICT,35,Transgender,0,1,1
SIBI DISTRICT,36,Male,672,392,1064
SIBI DISTRICT,36,Female,520,360,880
SIBI DISTRICT,36,Transgender,0,0,0
SIBI DISTRICT,37,Male,925,503,1428
SIBI DISTRICT,37,Female,749,503,1252
SIBI DISTRICT,37,Transgender,0,1,1
SIBI DISTRICT,38,Male,631,374,1005
SIBI DISTRICT,38,Female,485,356,841
SIBI DISTRICT,38,Transgender,0,1,1
SIBI DISTRICT,39,Male,713,400,1113
SIBI DISTRICT,39,Female,576,417,993
SIBI DISTRICT,39,Transgender,0,1,1
SIBI DISTRICT,40,Male,499,291,790
SIBI DISTRICT,40,Female,535,266,801
SIBI DISTRICT,40,Transgender,0,1,1
SIBI DISTRICT,41,Male,512,363,875
SIBI DISTRICT,41,Female,489,298,787
SIBI DISTRICT,41,Transgender,0,1,1
SIBI DISTRICT,42,Male,459,268,727
SIBI DISTRICT,42,Female,556,332,888
SIBI DISTRICT,42,Transgender,0,2,2
SIBI DISTRICT,43,Male,406,311,717
SIBI DISTRICT,43,Female,406,269,675
SIBI DISTRICT,43,Transgender,0,1,1
SIBI DISTRICT,44,Male,369,285,654
SIBI DISTRICT,44,Female,421,246,667
SIBI DISTRICT,44,Transgender,0,0,0
SIBI DISTRICT,45,Male,384,210,594
SIBI DISTRICT,45,Female,419,228,647
SIBI DISTRICT,45,Transgender,0,0,0
SIBI DISTRICT,46,Male,426,252,678
SIBI DISTRICT,46,Female,372,232,604
SIBI DISTRICT,46,Transgender,0,0,0
SIBI DISTRICT,47,Male,548,326,874
SIBI DISTRICT,47,Female,561,409,970
SIBI DISTRICT,47,Transgender,0,0,0
SIBI DISTRICT,48,Male,430,274,704
SIBI DISTRICT,48,Female,332,196,528
SIBI DISTRICT,48,Transgender,0,0,0
SIBI DISTRICT,49,Male,513,310,823
SIBI DISTRICT,49,Female,387,288,675
SIBI DISTRICT,49,Transgender,0,0,0
SIBI DISTRICT,50,Male,357,233,590
SIBI DISTRICT,50,Female,372,190,562
SIBI DISTRICT,50,Transgender,0,0,0
SIBI DISTRICT,51,Male,424,312,736
SIBI DISTRICT,51,Female,358,272,630
SIBI DISTRICT,51,Transgender,0,0,0
SIBI DISTRICT,52,Male,414,281,695
SIBI DISTRICT,52,Female,326,229,555
SIBI DISTRICT,52,Transgender,0,0,0
SIBI DISTRICT,53,Male,368,265,633
SIBI DISTRICT,53,Female,227,171,398
SIBI DISTRICT,53,Transgender,0,0,0
SIBI DISTRICT,54,Male,312,173,485
SIBI DISTRICT,54,Female,207,145,352
SIBI DISTRICT,54,Transgender,0,0,0
SIBI DISTRICT,55,Male,231,164,395
SIBI DISTRICT,55,Female,211,131,342
SIBI DISTRICT,55,Transgender,0,1,1
SIBI DISTRICT,56,Male,269,184,453
SIBI DISTRICT,56,Female,201,143,344
SIBI DISTRICT,56,Transgender,0,0,0
SIBI DISTRICT,57,Male,338,211,549
SIBI DISTRICT,57,Female,332,183,515
SIBI DISTRICT,57,Transgender,0,0,0
SIBI DISTRICT,58,Male,197,131,328
SIBI DISTRICT,58,Female,169,131,300
SIBI DISTRICT,58,Transgender,0,0,0
SIBI DISTRICT,59,Male,238,168,406
SIBI DISTRICT,59,Female,218,178,396
SIBI DISTRICT,59,Transgender,0,0,0
SIBI DISTRICT,60,Male,215,117,332
SIBI DISTRICT,60,Female,240,136,376
SIBI DISTRICT,60,Transgender,0,0,0
SIBI DISTRICT,61,Male,271,179,450
SIBI DISTRICT,61,Female,260,171,431
SIBI DISTRICT,61,Transgender,0,0,0
SIBI DISTRICT,62,Male,238,153,391
SIBI DISTRICT,62,Female,191,161,352
SIBI DISTRICT,62,Transgender,0,0,0
SIBI DISTRICT,63,Male,224,142,366
SIBI DISTRICT,63,Female,178,139,317
SIBI DISTRICT,63,Transgender,0,0,0
SIBI DISTRICT,64,Male,157,133,290
SIBI DISTRICT,64,Female,132,103,235
SIBI DISTRICT,64,Transgender,0,0,0
SIBI DISTRICT,65,Male,156,67,223
SIBI DISTRICT,65,Female,141,80,221
SIBI DISTRICT,65,Transgender,0,0,0
SIBI DISTRICT,66,Male,220,121,341
SIBI DISTRICT,66,Female,159,101,260
SIBI DISTRICT,66,Transgender,0,0,0
SIBI DISTRICT,67,Male,183,96,279
SIBI DISTRICT,67,Female,197,97,294
SIBI DISTRICT,67,Transgender,0,0,0
SIBI DISTRICT,68,Male,120,68,188
SIBI DISTRICT,68,Female,95,62,157
SIBI DISTRICT,68,Transgender,0,0,0
SIBI DISTRICT,69,Male,130,76,206
SIBI DISTRICT,69,Female,124,65,189
SIBI DISTRICT,69,Transgender,0,0,0
SIBI DISTRICT,70,Male,105,63,168
SIBI DISTRICT,70,Female,89,51,140
SIBI DISTRICT,70,Transgender,0,0,0
SIBI DISTRICT,71,Male,171,65,236
SIBI DISTRICT,71,Female,123,67,190
SIBI DISTRICT,71,Transgender,0,0,0
SIBI DISTRICT,72,Male,88,53,141
SIBI DISTRICT,72,Female,93,82,175
SIBI DISTRICT,72,Transgender,0,0,0
SIBI DISTRICT,73,Male,78,42,120
SIBI DISTRICT,73,Female,69,39,108
SIBI DISTRICT,73,Transgender,0,0,0
SIBI DISTRICT,74,Male,52,31,83
SIBI DISTRICT,74,Female,80,33,113
SIBI DISTRICT,74,Transgender,0,0,0
SIBI DISTRICT,>=75,Male,579,266,845
SIBI DISTRICT,>=75,Female,679,363,1042
SIBI DISTRICT,>=75,Transgender,0,0,0
SOHBATPUR DISTRICT,<1,Male,2636,156,2792
SOHBATPUR DISTRICT,<1,Female,2620,121,2741
SOHBATPUR DISTRICT,<1,Transgender,0,0,0
SOHBATPUR DISTRICT,1,Male,4036,196,4232
SOHBATPUR DISTRICT,1,Female,3930,185,4115
SOHBATPUR DISTRICT,1,Transgender,0,0,0
SOHBATPUR DISTRICT,2,Male,4083,223,4306
SOHBATPUR DISTRICT,2,Female,4124,214,4338
SOHBATPUR DISTRICT,2,Transgender,0,0,0
SOHBATPUR DISTRICT,3,Male,4296,220,4516
SOHBATPUR DISTRICT,3,Female,4009,235,4244
SOHBATPUR DISTRICT,3,Transgender,0,0,0
SOHBATPUR DISTRICT,4,Male,4246,218,4464
SOHBATPUR DISTRICT,4,Female,4072,230,4302
SOHBATPUR DISTRICT,4,Transgender,0,0,0
SOHBATPUR DISTRICT,5,Male,4012,250,4262
SOHBATPUR DISTRICT,5,Female,3629,219,3848
SOHBATPUR DISTRICT,5,Transgender,0,0,0
SOHBATPUR DISTRICT,6,Male,3993,224,4217
SOHBATPUR DISTRICT,6,Female,3655,222,3877
SOHBATPUR DISTRICT,6,Transgender,0,0,0
SOHBATPUR DISTRICT,7,Male,4129,267,4396
SOHBATPUR DISTRICT,7,Female,3465,254,3719
SOHBATPUR DISTRICT,7,Transgender,0,0,0
SOHBATPUR DISTRICT,8,Male,3984,238,4222
SOHBATPUR DISTRICT,8,Female,3372,234,3606
SOHBATPUR DISTRICT,8,Transgender,0,0,0
SOHBATPUR DISTRICT,9,Male,3309,244,3553
SOHBATPUR DISTRICT,9,Female,2869,176,3045
SOHBATPUR DISTRICT,9,Transgender,0,0,0
SOHBATPUR DISTRICT,10,Male,3329,217,3546
SOHBATPUR DISTRICT,10,Female,2751,195,2946
SOHBATPUR DISTRICT,10,Transgender,0,0,0
SOHBATPUR DISTRICT,11,Male,2473,224,2697
SOHBATPUR DISTRICT,11,Female,1946,145,2091
SOHBATPUR DISTRICT,11,Transgender,0,0,0
SOHBATPUR DISTRICT,12,Male,2437,200,2637
SOHBATPUR DISTRICT,12,Female,1978,154,2132
SOHBATPUR DISTRICT,12,Transgender,0,0,0
SOHBATPUR DISTRICT,13,Male,2060,167,2227
SOHBATPUR DISTRICT,13,Female,1568,142,1710
SOHBATPUR DISTRICT,13,Transgender,0,0,0
SOHBATPUR DISTRICT,14,Male,2025,150,2175
SOHBATPUR DISTRICT,14,Female,1434,123,1557
SOHBATPUR DISTRICT,14,Transgender,0,0,0
SOHBATPUR DISTRICT,15,Male,1822,172,1994
SOHBATPUR DISTRICT,15,Female,1349,124,1473
SOHBATPUR DISTRICT,15,Transgender,1,0,1
SOHBATPUR DISTRICT,16,Male,1663,140,1803
SOHBATPUR DISTRICT,16,Female,1433,126,1559
SOHBATPUR DISTRICT,16,Transgender,1,0,1
SOHBATPUR DISTRICT,17,Male,1734,141,1875
SOHBATPUR DISTRICT,17,Female,1599,125,1724
SOHBATPUR DISTRICT,17,Transgender,0,0,0
SOHBATPUR DISTRICT,18,Male,2049,131,2180
SOHBATPUR DISTRICT,18,Female,1916,135,2051
SOHBATPUR DISTRICT,18,Transgender,0,0,0
SOHBATPUR DISTRICT,19,Male,1825,118,1943
SOHBATPUR DISTRICT,19,Female,1633,140,1773
SOHBATPUR DISTRICT,19,Transgender,0,0,0
SOHBATPUR DISTRICT,20,Male,1413,92,1505
SOHBATPUR DISTRICT,20,Female,1577,99,1676
SOHBATPUR DISTRICT,20,Transgender,0,0,0
SOHBATPUR DISTRICT,21,Male,1286,101,1387
SOHBATPUR DISTRICT,21,Female,1346,101,1447
SOHBATPUR DISTRICT,21,Transgender,0,0,0
SOHBATPUR DISTRICT,22,Male,1116,96,1212
SOHBATPUR DISTRICT,22,Female,1063,93,1156
SOHBATPUR DISTRICT,22,Transgender,0,0,0
SOHBATPUR DISTRICT,23,Male,1179,94,1273
SOHBATPUR DISTRICT,23,Female,1103,95,1198
SOHBATPUR DISTRICT,23,Transgender,0,0,0
SOHBATPUR DISTRICT,24,Male,1080,89,1169
SOHBATPUR DISTRICT,24,Female,1112,79,1191
SOHBATPUR DISTRICT,24,Transgender,1,0,1
SOHBATPUR DISTRICT,25,Male,1096,85,1181
SOHBATPUR DISTRICT,25,Female,1283,78,1361
SOHBATPUR DISTRICT,25,Transgender,1,0,1
SOHBATPUR DISTRICT,26,Male,991,96,1087
SOHBATPUR DISTRICT,26,Female,1063,82,1145
SOHBATPUR DISTRICT,26,Transgender,1,0,1
SOHBATPUR DISTRICT,27,Male,1301,110,1411
SOHBATPUR DISTRICT,27,Female,1484,102,1586
SOHBATPUR DISTRICT,27,Transgender,0,0,0
SOHBATPUR DISTRICT,28,Male,981,99,1080
SOHBATPUR DISTRICT,28,Female,1131,75,1206
SOHBATPUR DISTRICT,28,Transgender,0,0,0
SOHBATPUR DISTRICT,29,Male,1415,100,1515
SOHBATPUR DISTRICT,29,Female,1498,110,1608
SOHBATPUR DISTRICT,29,Transgender,0,0,0
SOHBATPUR DISTRICT,30,Male,959,79,1038
SOHBATPUR DISTRICT,30,Female,1199,68,1267
SOHBATPUR DISTRICT,30,Transgender,0,0,0
SOHBATPUR DISTRICT,31,Male,1146,82,1228
SOHBATPUR DISTRICT,31,Female,1270,99,1369
SOHBATPUR DISTRICT,31,Transgender,0,0,0
SOHBATPUR DISTRICT,32,Male,1067,93,1160
SOHBATPUR DISTRICT,32,Female,1232,114,1346
SOHBATPUR DISTRICT,32,Transgender,0,0,0
SOHBATPUR DISTRICT,33,Male,911,65,976
SOHBATPUR DISTRICT,33,Female,1029,56,1085
SOHBATPUR DISTRICT,33,Transgender,0,0,0
SOHBATPUR DISTRICT,34,Male,956,60,1016
SOHBATPUR DISTRICT,34,Female,970,59,1029
SOHBATPUR DISTRICT,34,Transgender,1,0,1
SOHBATPUR DISTRICT,35,Male,937,74,1011
SOHBATPUR DISTRICT,35,Female,988,75,1063
SOHBATPUR DISTRICT,35,Transgender,1,0,1
SOHBATPUR DISTRICT,36,Male,924,63,987
SOHBATPUR DISTRICT,36,Female,805,50,855
SOHBATPUR DISTRICT,36,Transgender,0,0,0
SOHBATPUR DISTRICT,37,Male,1529,100,1629
SOHBATPUR DISTRICT,37,Female,1296,112,1408
SOHBATPUR DISTRICT,37,Transgender,1,0,1
SOHBATPUR DISTRICT,38,Male,809,63,872
SOHBATPUR DISTRICT,38,Female,882,51,933
SOHBATPUR DISTRICT,38,Transgender,0,0,0
SOHBATPUR DISTRICT,39,Male,1135,90,1225
SOHBATPUR DISTRICT,39,Female,1109,75,1184
SOHBATPUR DISTRICT,39,Transgender,0,0,0
SOHBATPUR DISTRICT,40,Male,643,50,693
SOHBATPUR DISTRICT,40,Female,810,37,847
SOHBATPUR DISTRICT,40,Transgender,0,0,0
SOHBATPUR DISTRICT,41,Male,762,56,818
SOHBATPUR DISTRICT,41,Female,701,42,743
SOHBATPUR DISTRICT,41,Transgender,0,0,0
SOHBATPUR DISTRICT,42,Male,821,58,879
SOHBATPUR DISTRICT,42,Female,750,62,812
SOHBATPUR DISTRICT,42,Transgender,1,0,1
SOHBATPUR DISTRICT,43,Male,574,37,611
SOHBATPUR DISTRICT,43,Female,619,43,662
SOHBATPUR DISTRICT,43,Transgender,0,0,0
SOHBATPUR DISTRICT,44,Male,529,44,573
SOHBATPUR DISTRICT,44,Female,563,25,588
SOHBATPUR DISTRICT,44,Transgender,0,0,0
SOHBATPUR DISTRICT,45,Male,468,31,499
SOHBATPUR DISTRICT,45,Female,535,31,566
SOHBATPUR DISTRICT,45,Transgender,0,0,0
SOHBATPUR DISTRICT,46,Male,489,39,528
SOHBATPUR DISTRICT,46,Female,462,24,486
SOHBATPUR DISTRICT,46,Transgender,0,0,0
SOHBATPUR DISTRICT,47,Male,864,52,916
SOHBATPUR DISTRICT,47,Female,820,77,897
SOHBATPUR DISTRICT,47,Transgender,0,0,0
SOHBATPUR DISTRICT,48,Male,507,34,541
SOHBATPUR DISTRICT,48,Female,530,25,555
SOHBATPUR DISTRICT,48,Transgender,0,0,0
SOHBATPUR DISTRICT,49,Male,597,53,650
SOHBATPUR DISTRICT,49,Female,582,56,638
SOHBATPUR DISTRICT,49,Transgender,0,0,0
SOHBATPUR DISTRICT,50,Male,431,34,465
SOHBATPUR DISTRICT,50,Female,488,45,533
SOHBATPUR DISTRICT,50,Transgender,0,0,0
SOHBATPUR DISTRICT,51,Male,505,53,558
SOHBATPUR DISTRICT,51,Female,512,39,551
SOHBATPUR DISTRICT,51,Transgender,0,0,0
SOHBATPUR DISTRICT,52,Male,577,39,616
SOHBATPUR DISTRICT,52,Female,556,54,610
SOHBATPUR DISTRICT,52,Transgender,0,0,0
SOHBATPUR DISTRICT,53,Male,444,42,486
SOHBATPUR DISTRICT,53,Female,369,31,400
SOHBATPUR DISTRICT,53,Transgender,0,0,0
SOHBATPUR DISTRICT,54,Male,388,38,426
SOHBATPUR DISTRICT,54,Female,344,27,371
SOHBATPUR DISTRICT,54,Transgender,0,0,0
SOHBATPUR DISTRICT,55,Male,295,28,323
SOHBATPUR DISTRICT,55,Female,346,21,367
SOHBATPUR DISTRICT,55,Transgender,0,0,0
SOHBATPUR DISTRICT,56,Male,298,28,326
SOHBATPUR DISTRICT,56,Female,263,19,282
SOHBATPUR DISTRICT,56,Transgender,0,0,0
SOHBATPUR DISTRICT,57,Male,596,37,633
SOHBATPUR DISTRICT,57,Female,551,51,602
SOHBATPUR DISTRICT,57,Transgender,0,0,0
SOHBATPUR DISTRICT,58,Male,261,19,280
SOHBATPUR DISTRICT,58,Female,291,22,313
SOHBATPUR DISTRICT,58,Transgender,0,0,0
SOHBATPUR DISTRICT,59,Male,315,24,339
SOHBATPUR DISTRICT,59,Female,304,25,329
SOHBATPUR DISTRICT,59,Transgender,0,0,0
SOHBATPUR DISTRICT,60,Male,252,22,274
SOHBATPUR DISTRICT,60,Female,303,26,329
SOHBATPUR DISTRICT,60,Transgender,0,0,0
SOHBATPUR DISTRICT,61,Male,243,21,264
SOHBATPUR DISTRICT,61,Female,265,15,280
SOHBATPUR DISTRICT,61,Transgender,0,0,0
SOHBATPUR DISTRICT,62,Male,280,25,305
SOHBATPUR DISTRICT,62,Female,367,28,395
SOHBATPUR DISTRICT,62,Transgender,0,0,0
SOHBATPUR DISTRICT,63,Male,235,18,253
SOHBATPUR DISTRICT,63,Female,232,15,247
SOHBATPUR DISTRICT,63,Transgender,0,0,0
SOHBATPUR DISTRICT,64,Male,246,11,257
SOHBATPUR DISTRICT,64,Female,225,18,243
SOHBATPUR DISTRICT,64,Transgender,0,0,0
SOHBATPUR DISTRICT,65,Male,189,12,201
SOHBATPUR DISTRICT,65,Female,237,15,252
SOHBATPUR DISTRICT,65,Transgender,0,0,0
SOHBATPUR DISTRICT,66,Male,164,19,183
SOHBATPUR DISTRICT,66,Female,174,12,186
SOHBATPUR DISTRICT,66,Transgender,0,0,0
SOHBATPUR DISTRICT,67,Male,308,16,324
SOHBATPUR DISTRICT,67,Female,359,30,389
SOHBATPUR DISTRICT,67,Transgender,1,0,1
SOHBATPUR DISTRICT,68,Male,149,12,161
SOHBATPUR DISTRICT,68,Female,139,10,149
SOHBATPUR DISTRICT,68,Transgender,0,0,0
SOHBATPUR DISTRICT,69,Male,193,17,210
SOHBATPUR DISTRICT,69,Female,179,8,187
SOHBATPUR DISTRICT,69,Transgender,0,0,0
SOHBATPUR DISTRICT,70,Male,118,6,124
SOHBATPUR DISTRICT,70,Female,154,10,164
SOHBATPUR DISTRICT,70,Transgender,0,0,0
SOHBATPUR DISTRICT,71,Male,133,11,144
SOHBATPUR DISTRICT,71,Female,144,7,151
SOHBATPUR DISTRICT,71,Transgender,0,0,0
SOHBATPUR DISTRICT,72,Male,115,5,120
SOHBATPUR DISTRICT,72,Female,189,5,194
SOHBATPUR DISTRICT,72,Transgender,0,0,0
SOHBATPUR DISTRICT,73,Male,99,4,103
SOHBATPUR DISTRICT,73,Female,107,5,112
SOHBATPUR DISTRICT,73,Transgender,0,0,0
SOHBATPUR DISTRICT,74,Male,129,1,130
SOHBATPUR DISTRICT,74,Female,90,9,99
SOHBATPUR DISTRICT,74,Transgender,0,0,0
SOHBATPUR DISTRICT,>=75,Male,714,41,755
SOHBATPUR DISTRICT,>=75,Female,894,62,956
SOHBATPUR DISTRICT,>=75,Transgender,0,0,0
SOUTH WAZIRISTAN AGENCY,<1,Male,9042,0,9042
SOUTH WAZIRISTAN AGENCY,<1,Female,8294,0,8294
SOUTH WAZIRISTAN AGENCY,<1,Transgender,0,0,0
SOUTH WAZIRISTAN AGENCY,1,Male,11706,0,11706
SOUTH WAZIRISTAN AGENCY,1,Female,10791,0,10791
SOUTH WAZIRISTAN AGENCY,1,Transgender,0,0,0
SOUTH WAZIRISTAN AGENCY,2,Male,13565,0,13565
SOUTH WAZIRISTAN AGENCY,2,Female,13130,0,13130
SOUTH WAZIRISTAN AGENCY,2,Transgender,0,0,0
SOUTH WAZIRISTAN AGENCY,3,Male,13879,0,13879
SOUTH WAZIRISTAN AGENCY,3,Female,13130,0,13130
SOUTH WAZIRISTAN AGENCY,3,Transgender,0,0,0
SOUTH WAZIRISTAN AGENCY,4,Male,13901,0,13901
SOUTH WAZIRISTAN AGENCY,4,Female,13400,0,13400
SOUTH WAZIRISTAN AGENCY,4,Transgender,0,0,0
SOUTH WAZIRISTAN AGENCY,5,Male,13468,0,13468
SOUTH WAZIRISTAN AGENCY,5,Female,12252,0,12252
SOUTH WAZIRISTAN AGENCY,5,Transgender,0,0,0
SOUTH WAZIRISTAN AGENCY,6,Male,13836,0,13836
SOUTH WAZIRISTAN AGENCY,6,Female,12504,0,12504
SOUTH WAZIRISTAN AGENCY,6,Transgender,0,0,0
SOUTH WAZIRISTAN AGENCY,7,Male,12898,0,12898
SOUTH WAZIRISTAN AGENCY,7,Female,11020,0,11020
SOUTH WAZIRISTAN AGENCY,7,Transgender,0,0,0
SOUTH WAZIRISTAN AGENCY,8,Male,13889,0,13889
SOUTH WAZIRISTAN AGENCY,8,Female,11605,0,11605
SOUTH WAZIRISTAN AGENCY,8,Transgender,0,0,0
SOUTH WAZIRISTAN AGENCY,9,Male,12414,0,12414
SOUTH WAZIRISTAN AGENCY,9,Female,10639,0,10639
SOUTH WAZIRISTAN AGENCY,9,Transgender,0,0,0
SOUTH WAZIRISTAN AGENCY,10,Male,12224,0,12224
SOUTH WAZIRISTAN AGENCY,10,Female,9643,0,9643
SOUTH WAZIRISTAN AGENCY,10,Transgender,0,0,0
SOUTH WAZIRISTAN AGENCY,11,Male,10231,0,10231
SOUTH WAZIRISTAN AGENCY,11,Female,8457,0,8457
SOUTH WAZIRISTAN AGENCY,11,Transgender,0,0,0
SOUTH WAZIRISTAN AGENCY,12,Male,10081,0,10081
SOUTH WAZIRISTAN AGENCY,12,Female,8323,0,8323
SOUTH WAZIRISTAN AGENCY,12,Transgender,0,0,0
SOUTH WAZIRISTAN AGENCY,13,Male,9046,0,9046
SOUTH WAZIRISTAN AGENCY,13,Female,7371,0,7371
SOUTH WAZIRISTAN AGENCY,13,Transgender,0,0,0
SOUTH WAZIRISTAN AGENCY,14,Male,8123,0,8123
SOUTH WAZIRISTAN AGENCY,14,Female,6664,0,6664
SOUTH WAZIRISTAN AGENCY,14,Transgender,0,0,0
SOUTH WAZIRISTAN AGENCY,15,Male,7992,0,7992
SOUTH WAZIRISTAN AGENCY,15,Female,6353,0,6353
SOUTH WAZIRISTAN AGENCY,15,Transgender,1,0,1
SOUTH WAZIRISTAN AGENCY,16,Male,6494,0,6494
SOUTH WAZIRISTAN AGENCY,16,Female,5566,0,5566
SOUTH WAZIRISTAN AGENCY,16,Transgender,0,0,0
SOUTH WAZIRISTAN AGENCY,17,Male,5532,0,5532
SOUTH WAZIRISTAN AGENCY,17,Female,4844,0,4844
SOUTH WAZIRISTAN AGENCY,17,Transgender,0,0,0
SOUTH WAZIRISTAN AGENCY,18,Male,7071,0,7071
SOUTH WAZIRISTAN AGENCY,18,Female,5902,0,5902
SOUTH WAZIRISTAN AGENCY,18,Transgender,1,0,1
SOUTH WAZIRISTAN AGENCY,19,Male,6937,0,6937
SOUTH WAZIRISTAN AGENCY,19,Female,5685,0,5685
SOUTH WAZIRISTAN AGENCY,19,Transgender,1,0,1
SOUTH WAZIRISTAN AGENCY,20,Male,6619,0,6619
SOUTH WAZIRISTAN AGENCY,20,Female,5868,0,5868
SOUTH WAZIRISTAN AGENCY,20,Transgender,1,0,1
SOUTH WAZIRISTAN AGENCY,21,Male,6256,0,6256
SOUTH WAZIRISTAN AGENCY,21,Female,5525,0,5525
SOUTH WAZIRISTAN AGENCY,21,Transgender,1,0,1
SOUTH WAZIRISTAN AGENCY,22,Male,5552,0,5552
SOUTH WAZIRISTAN AGENCY,22,Female,4857,0,4857
SOUTH WAZIRISTAN AGENCY,22,Transgender,2,0,2
SOUTH WAZIRISTAN AGENCY,23,Male,5493,0,5493
SOUTH WAZIRISTAN AGENCY,23,Female,5150,0,5150
SOUTH WAZIRISTAN AGENCY,23,Transgender,0,0,0
SOUTH WAZIRISTAN AGENCY,24,Male,4763,0,4763
SOUTH WAZIRISTAN AGENCY,24,Female,4501,0,4501
SOUTH WAZIRISTAN AGENCY,24,Transgender,0,0,0
SOUTH WAZIRISTAN AGENCY,25,Male,5541,0,5541
SOUTH WAZIRISTAN AGENCY,25,Female,5389,0,5389
SOUTH WAZIRISTAN AGENCY,25,Transgender,0,0,0
SOUTH WAZIRISTAN AGENCY,26,Male,4877,0,4877
SOUTH WAZIRISTAN AGENCY,26,Female,4535,0,4535
SOUTH WAZIRISTAN AGENCY,26,Transgender,3,0,3
SOUTH WAZIRISTAN AGENCY,27,Male,5459,0,5459
SOUTH WAZIRISTAN AGENCY,27,Female,5191,0,5191
SOUTH WAZIRISTAN AGENCY,27,Transgender,2,0,2
SOUTH WAZIRISTAN AGENCY,28,Male,4899,0,4899
SOUTH WAZIRISTAN AGENCY,28,Female,4276,0,4276
SOUTH WAZIRISTAN AGENCY,28,Transgender,1,0,1
SOUTH WAZIRISTAN AGENCY,29,Male,4398,0,4398
SOUTH WAZIRISTAN AGENCY,29,Female,4303,0,4303
SOUTH WAZIRISTAN AGENCY,29,Transgender,0,0,0
SOUTH WAZIRISTAN AGENCY,30,Male,4586,0,4586
SOUTH WAZIRISTAN AGENCY,30,Female,4454,0,4454
SOUTH WAZIRISTAN AGENCY,30,Transgender,2,0,2
SOUTH WAZIRISTAN AGENCY,31,Male,4463,0,4463
SOUTH WAZIRISTAN AGENCY,31,Female,3923,0,3923
SOUTH WAZIRISTAN AGENCY,31,Transgender,0,0,0
SOUTH WAZIRISTAN AGENCY,32,Male,3737,0,3737
SOUTH WAZIRISTAN AGENCY,32,Female,3482,0,3482
SOUTH WAZIRISTAN AGENCY,32,Transgender,0,0,0
SOUTH WAZIRISTAN AGENCY,33,Male,3724,0,3724
SOUTH WAZIRISTAN AGENCY,33,Female,3641,0,3641
SOUTH WAZIRISTAN AGENCY,33,Transgender,1,0,1
SOUTH WAZIRISTAN AGENCY,34,Male,3518,0,3518
SOUTH WAZIRISTAN AGENCY,34,Female,2994,0,2994
SOUTH WAZIRISTAN AGENCY,34,Transgender,0,0,0
SOUTH WAZIRISTAN AGENCY,35,Male,3462,0,3462
SOUTH WAZIRISTAN AGENCY,35,Female,3362,0,3362
SOUTH WAZIRISTAN AGENCY,35,Transgender,3,0,3
SOUTH WAZIRISTAN AGENCY,36,Male,2997,0,2997
SOUTH WAZIRISTAN AGENCY,36,Female,2840,0,2840
SOUTH WAZIRISTAN AGENCY,36,Transgender,0,0,0
SOUTH WAZIRISTAN AGENCY,37,Male,3350,0,3350
SOUTH WAZIRISTAN AGENCY,37,Female,3306,0,3306
SOUTH WAZIRISTAN AGENCY,37,Transgender,0,0,0
SOUTH WAZIRISTAN AGENCY,38,Male,3051,0,3051
SOUTH WAZIRISTAN AGENCY,38,Female,2988,0,2988
SOUTH WAZIRISTAN AGENCY,38,Transgender,1,0,1
SOUTH WAZIRISTAN AGENCY,39,Male,3063,0,3063
SOUTH WAZIRISTAN AGENCY,39,Female,2754,0,2754
SOUTH WAZIRISTAN AGENCY,39,Transgender,0,0,0
SOUTH WAZIRISTAN AGENCY,40,Male,3126,0,3126
SOUTH WAZIRISTAN AGENCY,40,Female,3548,0,3548
SOUTH WAZIRISTAN AGENCY,40,Transgender,4,0,4
SOUTH WAZIRISTAN AGENCY,41,Male,2908,0,2908
SOUTH WAZIRISTAN AGENCY,41,Female,2670,0,2670
SOUTH WAZIRISTAN AGENCY,41,Transgender,2,0,2
SOUTH WAZIRISTAN AGENCY,42,Male,2361,0,2361
SOUTH WAZIRISTAN AGENCY,42,Female,2243,0,2243
SOUTH WAZIRISTAN AGENCY,42,Transgender,0,0,0
SOUTH WAZIRISTAN AGENCY,43,Male,2371,0,2371
SOUTH WAZIRISTAN AGENCY,43,Female,2383,0,2383
SOUTH WAZIRISTAN AGENCY,43,Transgender,0,0,0
SOUTH WAZIRISTAN AGENCY,44,Male,2043,0,2043
SOUTH WAZIRISTAN AGENCY,44,Female,1924,0,1924
SOUTH WAZIRISTAN AGENCY,44,Transgender,0,0,0
SOUTH WAZIRISTAN AGENCY,45,Male,1899,0,1899
SOUTH WAZIRISTAN AGENCY,45,Female,2281,0,2281
SOUTH WAZIRISTAN AGENCY,45,Transgender,2,0,2
SOUTH WAZIRISTAN AGENCY,46,Male,1919,0,1919
SOUTH WAZIRISTAN AGENCY,46,Female,1771,0,1771
SOUTH WAZIRISTAN AGENCY,46,Transgender,1,0,1
SOUTH WAZIRISTAN AGENCY,47,Male,2078,0,2078
SOUTH WAZIRISTAN AGENCY,47,Female,2141,0,2141
SOUTH WAZIRISTAN AGENCY,47,Transgender,0,0,0
SOUTH WAZIRISTAN AGENCY,48,Male,1746,0,1746
SOUTH WAZIRISTAN AGENCY,48,Female,1805,0,1805
SOUTH WAZIRISTAN AGENCY,48,Transgender,3,0,3
SOUTH WAZIRISTAN AGENCY,49,Male,1758,0,1758
SOUTH WAZIRISTAN AGENCY,49,Female,1667,0,1667
SOUTH WAZIRISTAN AGENCY,49,Transgender,0,0,0
SOUTH WAZIRISTAN AGENCY,50,Male,1959,0,1959
SOUTH WAZIRISTAN AGENCY,50,Female,2340,0,2340
SOUTH WAZIRISTAN AGENCY,50,Transgender,1,0,1
SOUTH WAZIRISTAN AGENCY,51,Male,1762,0,1762
SOUTH WAZIRISTAN AGENCY,51,Female,1642,0,1642
SOUTH WAZIRISTAN AGENCY,51,Transgender,0,0,0
SOUTH WAZIRISTAN AGENCY,52,Male,1607,0,1607
SOUTH WAZIRISTAN AGENCY,52,Female,1504,0,1504
SOUTH WAZIRISTAN AGENCY,52,Transgender,0,0,0
SOUTH WAZIRISTAN AGENCY,53,Male,1615,0,1615
SOUTH WAZIRISTAN AGENCY,53,Female,1489,0,1489
SOUTH WAZIRISTAN AGENCY,53,Transgender,2,0,2
SOUTH WAZIRISTAN AGENCY,54,Male,1461,0,1461
SOUTH WAZIRISTAN AGENCY,54,Female,1290,0,1290
SOUTH WAZIRISTAN AGENCY,54,Transgender,1,0,1
SOUTH WAZIRISTAN AGENCY,55,Male,1517,0,1517
SOUTH WAZIRISTAN AGENCY,55,Female,1583,0,1583
SOUTH WAZIRISTAN AGENCY,55,Transgender,2,0,2
SOUTH WAZIRISTAN AGENCY,56,Male,1358,0,1358
SOUTH WAZIRISTAN AGENCY,56,Female,1281,0,1281
SOUTH WAZIRISTAN AGENCY,56,Transgender,2,0,2
SOUTH WAZIRISTAN AGENCY,57,Male,1567,0,1567
SOUTH WAZIRISTAN AGENCY,57,Female,1443,0,1443
SOUTH WAZIRISTAN AGENCY,57,Transgender,0,0,0
SOUTH WAZIRISTAN AGENCY,58,Male,1209,0,1209
SOUTH WAZIRISTAN AGENCY,58,Female,1045,0,1045
SOUTH WAZIRISTAN AGENCY,58,Transgender,2,0,2
SOUTH WAZIRISTAN AGENCY,59,Male,1258,0,1258
SOUTH WAZIRISTAN AGENCY,59,Female,969,0,969
SOUTH WAZIRISTAN AGENCY,59,Transgender,0,0,0
SOUTH WAZIRISTAN AGENCY,60,Male,1304,0,1304
SOUTH WAZIRISTAN AGENCY,60,Female,1375,0,1375
SOUTH WAZIRISTAN AGENCY,60,Transgender,3,0,3
SOUTH WAZIRISTAN AGENCY,61,Male,1309,0,1309
SOUTH WAZIRISTAN AGENCY,61,Female,1075,0,1075
SOUTH WAZIRISTAN AGENCY,61,Transgender,1,0,1
SOUTH WAZIRISTAN AGENCY,62,Male,1200,0,1200
SOUTH WAZIRISTAN AGENCY,62,Female,1133,0,1133
SOUTH WAZIRISTAN AGENCY,62,Transgender,0,0,0
SOUTH WAZIRISTAN AGENCY,63,Male,1198,0,1198
SOUTH WAZIRISTAN AGENCY,63,Female,1002,0,1002
SOUTH WAZIRISTAN AGENCY,63,Transgender,0,0,0
SOUTH WAZIRISTAN AGENCY,64,Male,1047,0,1047
SOUTH WAZIRISTAN AGENCY,64,Female,864,0,864
SOUTH WAZIRISTAN AGENCY,64,Transgender,0,0,0
SOUTH WAZIRISTAN AGENCY,65,Male,909,0,909
SOUTH WAZIRISTAN AGENCY,65,Female,762,0,762
SOUTH WAZIRISTAN AGENCY,65,Transgender,0,0,0
SOUTH WAZIRISTAN AGENCY,66,Male,912,0,912
SOUTH WAZIRISTAN AGENCY,66,Female,709,0,709
SOUTH WAZIRISTAN AGENCY,66,Transgender,0,0,0
SOUTH WAZIRISTAN AGENCY,67,Male,1137,0,1137
SOUTH WAZIRISTAN AGENCY,67,Female,803,0,803
SOUTH WAZIRISTAN AGENCY,67,Transgender,0,0,0
SOUTH WAZIRISTAN AGENCY,68,Male,779,0,779
SOUTH WAZIRISTAN AGENCY,68,Female,542,0,542
SOUTH WAZIRISTAN AGENCY,68,Transgender,0,0,0
SOUTH WAZIRISTAN AGENCY,69,Male,733,0,733
SOUTH WAZIRISTAN AGENCY,69,Female,520,0,520
SOUTH WAZIRISTAN AGENCY,69,Transgender,1,0,1
SOUTH WAZIRISTAN AGENCY,70,Male,578,0,578
SOUTH WAZIRISTAN AGENCY,70,Female,533,0,533
SOUTH WAZIRISTAN AGENCY,70,Transgender,1,0,1
SOUTH WAZIRISTAN AGENCY,71,Male,618,0,618
SOUTH WAZIRISTAN AGENCY,71,Female,431,0,431
SOUTH WAZIRISTAN AGENCY,71,Transgender,1,0,1
SOUTH WAZIRISTAN AGENCY,72,Male,551,0,551
SOUTH WAZIRISTAN AGENCY,72,Female,401,0,401
SOUTH WAZIRISTAN AGENCY,72,Transgender,0,0,0
SOUTH WAZIRISTAN AGENCY,73,Male,490,0,490
SOUTH WAZIRISTAN AGENCY,73,Female,355,0,355
SOUTH WAZIRISTAN AGENCY,73,Transgender,0,0,0
SOUTH WAZIRISTAN AGENCY,74,Male,378,0,378
SOUTH WAZIRISTAN AGENCY,74,Female,311,0,311
SOUTH WAZIRISTAN AGENCY,74,Transgender,0,0,0
SOUTH WAZIRISTAN AGENCY,>=75,Male,2809,0,2809
SOUTH WAZIRISTAN AGENCY,>=75,Female,2807,0,2807
SOUTH WAZIRISTAN AGENCY,>=75,Transgender,1,0,1
SUJAWAL DISTRICT,<1,Male,8203,803,9006
SUJAWAL DISTRICT,<1,Female,7450,689,8139
SUJAWAL DISTRICT,<1,Transgender,0,0,0
SUJAWAL DISTRICT,1,Male,9021,1132,10153
SUJAWAL DISTRICT,1,Female,8710,1164,9874
SUJAWAL DISTRICT,1,Transgender,0,0,0
SUJAWAL DISTRICT,2,Male,11921,1220,13141
SUJAWAL DISTRICT,2,Female,11901,1166,13067
SUJAWAL DISTRICT,2,Transgender,0,0,0
SUJAWAL DISTRICT,3,Male,12921,1402,14323
SUJAWAL DISTRICT,3,Female,12679,1346,14025
SUJAWAL DISTRICT,3,Transgender,0,0,0
SUJAWAL DISTRICT,4,Male,13641,1304,14945
SUJAWAL DISTRICT,4,Female,13195,1292,14487
SUJAWAL DISTRICT,4,Transgender,0,0,0
SUJAWAL DISTRICT,5,Male,13590,1484,15074
SUJAWAL DISTRICT,5,Female,12560,1298,13858
SUJAWAL DISTRICT,5,Transgender,0,0,0
SUJAWAL DISTRICT,6,Male,13734,1257,14991
SUJAWAL DISTRICT,6,Female,12437,1190,13627
SUJAWAL DISTRICT,6,Transgender,0,0,0
SUJAWAL DISTRICT,7,Male,11179,1298,12477
SUJAWAL DISTRICT,7,Female,9840,1223,11063
SUJAWAL DISTRICT,7,Transgender,0,0,0
SUJAWAL DISTRICT,8,Male,14546,1328,15874
SUJAWAL DISTRICT,8,Female,12485,1177,13662
SUJAWAL DISTRICT,8,Transgender,0,0,0
SUJAWAL DISTRICT,9,Male,9298,1143,10441
SUJAWAL DISTRICT,9,Female,8140,1112,9252
SUJAWAL DISTRICT,9,Transgender,0,0,0
SUJAWAL DISTRICT,10,Male,13277,1145,14422
SUJAWAL DISTRICT,10,Female,11331,998,12329
SUJAWAL DISTRICT,10,Transgender,0,0,0
SUJAWAL DISTRICT,11,Male,7633,966,8599
SUJAWAL DISTRICT,11,Female,6399,929,7328
SUJAWAL DISTRICT,11,Transgender,0,0,0
SUJAWAL DISTRICT,12,Male,10260,1040,11300
SUJAWAL DISTRICT,12,Female,8405,916,9321
SUJAWAL DISTRICT,12,Transgender,0,0,0
SUJAWAL DISTRICT,13,Male,6883,889,7772
SUJAWAL DISTRICT,13,Female,5376,792,6168
SUJAWAL DISTRICT,13,Transgender,0,0,0
SUJAWAL DISTRICT,14,Male,7538,878,8416
SUJAWAL DISTRICT,14,Female,6299,810,7109
SUJAWAL DISTRICT,14,Transgender,0,0,0
SUJAWAL DISTRICT,15,Male,7928,921,8849
SUJAWAL DISTRICT,15,Female,6093,845,6938
SUJAWAL DISTRICT,15,Transgender,2,0,2
SUJAWAL DISTRICT,16,Male,7128,888,8016
SUJAWAL DISTRICT,16,Female,6479,793,7272
SUJAWAL DISTRICT,16,Transgender,2,0,2
SUJAWAL DISTRICT,17,Male,5509,876,6385
SUJAWAL DISTRICT,17,Female,4809,859,5668
SUJAWAL DISTRICT,17,Transgender,3,0,3
SUJAWAL DISTRICT,18,Male,8279,914,9193
SUJAWAL DISTRICT,18,Female,7554,880,8434
SUJAWAL DISTRICT,18,Transgender,1,0,1
SUJAWAL DISTRICT,19,Male,5382,831,6213
SUJAWAL DISTRICT,19,Female,5127,810,5937
SUJAWAL DISTRICT,19,Transgender,0,0,0
SUJAWAL DISTRICT,20,Male,7851,857,8708
SUJAWAL DISTRICT,20,Female,7276,867,8143
SUJAWAL DISTRICT,20,Transgender,7,0,7
SUJAWAL DISTRICT,21,Male,4362,778,5140
SUJAWAL DISTRICT,21,Female,4606,761,5367
SUJAWAL DISTRICT,21,Transgender,0,0,0
SUJAWAL DISTRICT,22,Male,5748,761,6509
SUJAWAL DISTRICT,22,Female,5185,773,5958
SUJAWAL DISTRICT,22,Transgender,3,0,3
SUJAWAL DISTRICT,23,Male,4345,714,5059
SUJAWAL DISTRICT,23,Female,4279,722,5001
SUJAWAL DISTRICT,23,Transgender,0,0,0
SUJAWAL DISTRICT,24,Male,4129,656,4785
SUJAWAL DISTRICT,24,Female,3956,682,4638
SUJAWAL DISTRICT,24,Transgender,3,0,3
SUJAWAL DISTRICT,25,Male,6735,751,7486
SUJAWAL DISTRICT,25,Female,6087,723,6810
SUJAWAL DISTRICT,25,Transgender,0,0,0
SUJAWAL DISTRICT,26,Male,4396,674,5070
SUJAWAL DISTRICT,26,Female,4420,689,5109
SUJAWAL DISTRICT,26,Transgender,4,1,5
SUJAWAL DISTRICT,27,Male,4688,708,5396
SUJAWAL DISTRICT,27,Female,4787,691,5478
SUJAWAL DISTRICT,27,Transgender,3,0,3
SUJAWAL DISTRICT,28,Male,4901,718,5619
SUJAWAL DISTRICT,28,Female,5223,713,5936
SUJAWAL DISTRICT,28,Transgender,0,0,0
SUJAWAL DISTRICT,29,Male,4709,656,5365
SUJAWAL DISTRICT,29,Female,5226,698,5924
SUJAWAL DISTRICT,29,Transgender,0,1,1
SUJAWAL DISTRICT,30,Male,5884,679,6563
SUJAWAL DISTRICT,30,Female,5553,689,6242
SUJAWAL DISTRICT,30,Transgender,11,0,11
SUJAWAL DISTRICT,31,Male,4366,689,5055
SUJAWAL DISTRICT,31,Female,4788,714,5502
SUJAWAL DISTRICT,31,Transgender,0,0,0
SUJAWAL DISTRICT,32,Male,4599,654,5253
SUJAWAL DISTRICT,32,Female,4623,708,5331
SUJAWAL DISTRICT,32,Transgender,1,0,1
SUJAWAL DISTRICT,33,Male,3887,639,4526
SUJAWAL DISTRICT,33,Female,4502,616,5118
SUJAWAL DISTRICT,33,Transgender,3,0,3
SUJAWAL DISTRICT,34,Male,3426,574,4000
SUJAWAL DISTRICT,34,Female,3779,511,4290
SUJAWAL DISTRICT,34,Transgender,2,0,2
SUJAWAL DISTRICT,35,Male,5223,643,5866
SUJAWAL DISTRICT,35,Female,4197,532,4729
SUJAWAL DISTRICT,35,Transgender,3,1,4
SUJAWAL DISTRICT,36,Male,3839,458,4297
SUJAWAL DISTRICT,36,Female,3218,434,3652
SUJAWAL DISTRICT,36,Transgender,2,0,2
SUJAWAL DISTRICT,37,Male,4915,562,5477
SUJAWAL DISTRICT,37,Female,4149,543,4692
SUJAWAL DISTRICT,37,Transgender,4,0,4
SUJAWAL DISTRICT,38,Male,3765,550,4315
SUJAWAL DISTRICT,38,Female,3640,472,4112
SUJAWAL DISTRICT,38,Transgender,2,1,3
SUJAWAL DISTRICT,39,Male,4198,602,4800
SUJAWAL DISTRICT,39,Female,3763,509,4272
SUJAWAL DISTRICT,39,Transgender,2,0,2
SUJAWAL DISTRICT,40,Male,4050,543,4593
SUJAWAL DISTRICT,40,Female,4187,477,4664
SUJAWAL DISTRICT,40,Transgender,4,4,8
SUJAWAL DISTRICT,41,Male,3447,467,3914
SUJAWAL DISTRICT,41,Female,3448,453,3901
SUJAWAL DISTRICT,41,Transgender,2,0,2
SUJAWAL DISTRICT,42,Male,3209,442,3651
SUJAWAL DISTRICT,42,Female,3143,442,3585
SUJAWAL DISTRICT,42,Transgender,2,1,3
SUJAWAL DISTRICT,43,Male,3074,448,3522
SUJAWAL DISTRICT,43,Female,3026,369,3395
SUJAWAL DISTRICT,43,Transgender,0,0,0
SUJAWAL DISTRICT,44,Male,3016,448,3464
SUJAWAL DISTRICT,44,Female,2633,327,2960
SUJAWAL DISTRICT,44,Transgender,0,0,0
SUJAWAL DISTRICT,45,Male,3235,385,3620
SUJAWAL DISTRICT,45,Female,2639,354,2993
SUJAWAL DISTRICT,45,Transgender,2,3,5
SUJAWAL DISTRICT,46,Male,2856,384,3240
SUJAWAL DISTRICT,46,Female,2128,277,2405
SUJAWAL DISTRICT,46,Transgender,1,0,1
SUJAWAL DISTRICT,47,Male,2936,371,3307
SUJAWAL DISTRICT,47,Female,2579,329,2908
SUJAWAL DISTRICT,47,Transgender,0,1,1
SUJAWAL DISTRICT,48,Male,2573,380,2953
SUJAWAL DISTRICT,48,Female,2229,265,2494
SUJAWAL DISTRICT,48,Transgender,0,2,2
SUJAWAL DISTRICT,49,Male,2767,380,3147
SUJAWAL DISTRICT,49,Female,2273,317,2590
SUJAWAL DISTRICT,49,Transgender,1,0,1
SUJAWAL DISTRICT,50,Male,2770,303,3073
SUJAWAL DISTRICT,50,Female,2355,320,2675
SUJAWAL DISTRICT,50,Transgender,0,2,2
SUJAWAL DISTRICT,51,Male,2180,319,2499
SUJAWAL DISTRICT,51,Female,1833,252,2085
SUJAWAL DISTRICT,51,Transgender,0,0,0
SUJAWAL DISTRICT,52,Male,1973,283,2256
SUJAWAL DISTRICT,52,Female,1779,245,2024
SUJAWAL DISTRICT,52,Transgender,0,1,1
SUJAWAL DISTRICT,53,Male,1699,285,1984
SUJAWAL DISTRICT,53,Female,1489,233,1722
SUJAWAL DISTRICT,53,Transgender,1,0,1
SUJAWAL DISTRICT,54,Male,1649,268,1917
SUJAWAL DISTRICT,54,Female,1346,218,1564
SUJAWAL DISTRICT,54,Transgender,2,0,2
SUJAWAL DISTRICT,55,Male,1733,244,1977
SUJAWAL DISTRICT,55,Female,1518,231,1749
SUJAWAL DISTRICT,55,Transgender,2,0,2
SUJAWAL DISTRICT,56,Male,1307,173,1480
SUJAWAL DISTRICT,56,Female,1203,166,1369
SUJAWAL DISTRICT,56,Transgender,1,0,1
SUJAWAL DISTRICT,57,Male,1416,202,1618
SUJAWAL DISTRICT,57,Female,1615,175,1790
SUJAWAL DISTRICT,57,Transgender,0,0,0
SUJAWAL DISTRICT,58,Male,1160,193,1353
SUJAWAL DISTRICT,58,Female,1142,205,1347
SUJAWAL DISTRICT,58,Transgender,1,0,1
SUJAWAL DISTRICT,59,Male,1475,205,1680
SUJAWAL DISTRICT,59,Female,1288,200,1488
SUJAWAL DISTRICT,59,Transgender,2,1,3
SUJAWAL DISTRICT,60,Male,1637,180,1817
SUJAWAL DISTRICT,60,Female,1554,211,1765
SUJAWAL DISTRICT,60,Transgender,1,0,1
SUJAWAL DISTRICT,61,Male,1228,181,1409
SUJAWAL DISTRICT,61,Female,1305,172,1477
SUJAWAL DISTRICT,61,Transgender,0,0,0
SUJAWAL DISTRICT,62,Male,1126,171,1297
SUJAWAL DISTRICT,62,Female,1339,175,1514
SUJAWAL DISTRICT,62,Transgender,1,0,1
SUJAWAL DISTRICT,63,Male,1219,168,1387
SUJAWAL DISTRICT,63,Female,1160,161,1321
SUJAWAL DISTRICT,63,Transgender,0,0,0
SUJAWAL DISTRICT,64,Male,1471,158,1629
SUJAWAL DISTRICT,64,Female,1132,159,1291
SUJAWAL DISTRICT,64,Transgender,1,0,1
SUJAWAL DISTRICT,65,Male,1236,163,1399
SUJAWAL DISTRICT,65,Female,1039,140,1179
SUJAWAL DISTRICT,65,Transgender,2,0,2
SUJAWAL DISTRICT,66,Male,951,145,1096
SUJAWAL DISTRICT,66,Female,922,115,1037
SUJAWAL DISTRICT,66,Transgender,0,0,0
SUJAWAL DISTRICT,67,Male,758,109,867
SUJAWAL DISTRICT,67,Female,943,91,1034
SUJAWAL DISTRICT,67,Transgender,0,0,0
SUJAWAL DISTRICT,68,Male,824,112,936
SUJAWAL DISTRICT,68,Female,754,128,882
SUJAWAL DISTRICT,68,Transgender,1,0,1
SUJAWAL DISTRICT,69,Male,1017,98,1115
SUJAWAL DISTRICT,69,Female,852,104,956
SUJAWAL DISTRICT,69,Transgender,0,0,0
SUJAWAL DISTRICT,70,Male,934,84,1018
SUJAWAL DISTRICT,70,Female,838,104,942
SUJAWAL DISTRICT,70,Transgender,1,0,1
SUJAWAL DISTRICT,71,Male,671,79,750
SUJAWAL DISTRICT,71,Female,719,91,810
SUJAWAL DISTRICT,71,Transgender,0,0,0
SUJAWAL DISTRICT,72,Male,528,71,599
SUJAWAL DISTRICT,72,Female,659,70,729
SUJAWAL DISTRICT,72,Transgender,0,0,0
SUJAWAL DISTRICT,73,Male,608,72,680
SUJAWAL DISTRICT,73,Female,506,69,575
SUJAWAL DISTRICT,73,Transgender,0,0,0
SUJAWAL DISTRICT,74,Male,617,58,675
SUJAWAL DISTRICT,74,Female,529,65,594
SUJAWAL DISTRICT,74,Transgender,0,0,0
SUJAWAL DISTRICT,>=75,Male,3657,352,4009
SUJAWAL DISTRICT,>=75,Female,4002,464,4466
SUJAWAL DISTRICT,>=75,Transgender,4,1,5
SUKKUR DISTRICT,<1,Male,9900,7907,17807
SUKKUR DISTRICT,<1,Female,9220,7514,16734
SUKKUR DISTRICT,<1,Transgender,0,0,0
SUKKUR DISTRICT,1,Male,11637,9258,20895
SUKKUR DISTRICT,1,Female,11307,8804,20111
SUKKUR DISTRICT,1,Transgender,0,0,0
SUKKUR DISTRICT,2,Male,13880,10306,24186
SUKKUR DISTRICT,2,Female,13756,9874,23630
SUKKUR DISTRICT,2,Transgender,0,0,0
SUKKUR DISTRICT,3,Male,14811,11326,26137
SUKKUR DISTRICT,3,Female,14187,11001,25188
SUKKUR DISTRICT,3,Transgender,0,0,0
SUKKUR DISTRICT,4,Male,15519,10866,26385
SUKKUR DISTRICT,4,Female,15066,10618,25684
SUKKUR DISTRICT,4,Transgender,0,0,0
SUKKUR DISTRICT,5,Male,15550,11432,26982
SUKKUR DISTRICT,5,Female,14143,10530,24673
SUKKUR DISTRICT,5,Transgender,0,0,0
SUKKUR DISTRICT,6,Male,15468,10410,25878
SUKKUR DISTRICT,6,Female,13983,9783,23766
SUKKUR DISTRICT,6,Transgender,0,0,0
SUKKUR DISTRICT,7,Male,13611,10932,24543
SUKKUR DISTRICT,7,Female,12189,10108,22297
SUKKUR DISTRICT,7,Transgender,0,0,0
SUKKUR DISTRICT,8,Male,16250,10499,26749
SUKKUR DISTRICT,8,Female,14200,9594,23794
SUKKUR DISTRICT,8,Transgender,0,0,0
SUKKUR DISTRICT,9,Male,12254,9675,21929
SUKKUR DISTRICT,9,Female,10639,9106,19745
SUKKUR DISTRICT,9,Transgender,0,0,0
SUKKUR DISTRICT,10,Male,14438,9642,24080
SUKKUR DISTRICT,10,Female,12064,8514,20578
SUKKUR DISTRICT,10,Transgender,0,0,0
SUKKUR DISTRICT,11,Male,9830,8832,18662
SUKKUR DISTRICT,11,Female,8168,7916,16084
SUKKUR DISTRICT,11,Transgender,0,0,0
SUKKUR DISTRICT,12,Male,11215,8939,20154
SUKKUR DISTRICT,12,Female,9422,7830,17252
SUKKUR DISTRICT,12,Transgender,0,0,0
SUKKUR DISTRICT,13,Male,8798,7940,16738
SUKKUR DISTRICT,13,Female,7062,7178,14240
SUKKUR DISTRICT,13,Transgender,0,0,0
SUKKUR DISTRICT,14,Male,9368,7818,17186
SUKKUR DISTRICT,14,Female,7710,6931,14641
SUKKUR DISTRICT,14,Transgender,0,0,0
SUKKUR DISTRICT,Under 15,Male,192529,145782,338311
SUKKUR DISTRICT,Under 15,Female,173116,135301,308417
SUKKUR DISTRICT,Under 15,Transgender,0,0,0
SUKKUR DISTRICT,15,Male,9470,8309,17779
SUKKUR DISTRICT,15,Female,7478,7405,14883
SUKKUR DISTRICT,15,Transgender,3,2,5
SUKKUR DISTRICT,16,Male,8841,8056,16897
SUKKUR DISTRICT,16,Female,7171,7132,14303
SUKKUR DISTRICT,16,Transgender,3,3,6
SUKKUR DISTRICT,17,Male,7845,8340,16185
SUKKUR DISTRICT,17,Female,6360,7208,13568
SUKKUR DISTRICT,17,Transgender,2,3,5
SUKKUR DISTRICT,18,Male,9351,8381,17732
SUKKUR DISTRICT,18,Female,8931,7765,16696
SUKKUR DISTRICT,18,Transgender,2,5,7
SUKKUR DISTRICT,19,Male,7025,7670,14695
SUKKUR DISTRICT,19,Female,6966,7626,14592
SUKKUR DISTRICT,19,Transgender,0,2,2
SUKKUR DISTRICT,20,Male,8237,7415,15652
SUKKUR DISTRICT,20,Female,7870,7211,15081
SUKKUR DISTRICT,20,Transgender,8,6,14
SUKKUR DISTRICT,21,Male,5652,6865,12517
SUKKUR DISTRICT,21,Female,5850,6839,12689
SUKKUR DISTRICT,21,Transgender,3,2,5
SUKKUR DISTRICT,22,Male,6253,7095,13348
SUKKUR DISTRICT,22,Female,5638,6565,12203
SUKKUR DISTRICT,22,Transgender,1,3,4
SUKKUR DISTRICT,23,Male,4984,6643,11627
SUKKUR DISTRICT,23,Female,4910,6057,10967
SUKKUR DISTRICT,23,Transgender,3,2,5
SUKKUR DISTRICT,24,Male,4916,6626,11542
SUKKUR DISTRICT,24,Female,4745,5830,10575
SUKKUR DISTRICT,24,Transgender,2,0,2
SUKKUR DISTRICT,25,Male,6387,6456,12843
SUKKUR DISTRICT,25,Female,6238,6015,12253
SUKKUR DISTRICT,25,Transgender,4,3,7
SUKKUR DISTRICT,26,Male,4639,6209,10848
SUKKUR DISTRICT,26,Female,4637,5824,10461
SUKKUR DISTRICT,26,Transgender,0,1,1
SUKKUR DISTRICT,27,Male,4914,6323,11237
SUKKUR DISTRICT,27,Female,5184,5926,11110
SUKKUR DISTRICT,27,Transgender,2,0,2
SUKKUR DISTRICT,28,Male,5265,6615,11880
SUKKUR DISTRICT,28,Female,5640,6452,12092
SUKKUR DISTRICT,28,Transgender,1,2,3
SUKKUR DISTRICT,29,Male,5038,6115,11153
SUKKUR DISTRICT,29,Female,5510,5625,11135
SUKKUR DISTRICT,29,Transgender,0,1,1
SUKKUR DISTRICT,30,Male,5846,6446,12292
SUKKUR DISTRICT,30,Female,5890,5932,11822
SUKKUR DISTRICT,30,Transgender,5,5,10
SUKKUR DISTRICT,31,Male,4617,6220,10837
SUKKUR DISTRICT,31,Female,4751,5459,10210
SUKKUR DISTRICT,31,Transgender,0,0,0
SUKKUR DISTRICT,32,Male,4665,5986,10651
SUKKUR DISTRICT,32,Female,4496,4986,9482
SUKKUR DISTRICT,32,Transgender,2,3,5
SUKKUR DISTRICT,33,Male,4317,5740,10057
SUKKUR DISTRICT,33,Female,4212,4623,8835
SUKKUR DISTRICT,33,Transgender,0,0,0
SUKKUR DISTRICT,34,Male,4064,5224,9288
SUKKUR DISTRICT,34,Female,4012,4334,8346
SUKKUR DISTRICT,34,Transgender,1,2,3
SUKKUR DISTRICT,35,Male,5123,5241,10364
SUKKUR DISTRICT,35,Female,4613,4774,9387
SUKKUR DISTRICT,35,Transgender,2,9,11
SUKKUR DISTRICT,36,Male,4022,4687,8709
SUKKUR DISTRICT,36,Female,3679,3830,7509
SUKKUR DISTRICT,36,Transgender,1,1,2
SUKKUR DISTRICT,37,Male,4703,4490,9193
SUKKUR DISTRICT,37,Female,4253,3827,8080
SUKKUR DISTRICT,37,Transgender,1,0,1
SUKKUR DISTRICT,38,Male,3887,5151,9038
SUKKUR DISTRICT,38,Female,3820,4455,8275
SUKKUR DISTRICT,38,Transgender,1,3,4
SUKKUR DISTRICT,39,Male,3928,4533,8461
SUKKUR DISTRICT,39,Female,3567,3862,7429
SUKKUR DISTRICT,39,Transgender,1,1,2
SUKKUR DISTRICT,40,Male,3795,4808,8603
SUKKUR DISTRICT,40,Female,4010,4294,8304
SUKKUR DISTRICT,40,Transgender,0,4,4
SUKKUR DISTRICT,41,Male,3102,3903,7005
SUKKUR DISTRICT,41,Female,3033,3221,6254
SUKKUR DISTRICT,41,Transgender,0,1,1
SUKKUR DISTRICT,42,Male,3007,3955,6962
SUKKUR DISTRICT,42,Female,2949,3210,6159
SUKKUR DISTRICT,42,Transgender,3,2,5
SUKKUR DISTRICT,43,Male,2751,3507,6258
SUKKUR DISTRICT,43,Female,2697,3098,5795
SUKKUR DISTRICT,43,Transgender,1,2,3
SUKKUR DISTRICT,44,Male,2501,3175,5676
SUKKUR DISTRICT,44,Female,2653,2674,5327
SUKKUR DISTRICT,44,Transgender,0,0,0
SUKKUR DISTRICT,45,Male,3083,3436,6519
SUKKUR DISTRICT,45,Female,2960,3054,6014
SUKKUR DISTRICT,45,Transgender,3,4,7
SUKKUR DISTRICT,46,Male,2299,2674,4973
SUKKUR DISTRICT,46,Female,1970,2262,4232
SUKKUR DISTRICT,46,Transgender,0,0,0
SUKKUR DISTRICT,47,Male,2573,2776,5349
SUKKUR DISTRICT,47,Female,2510,2335,4845
SUKKUR DISTRICT,47,Transgender,1,1,2
SUKKUR DISTRICT,48,Male,2378,2977,5355
SUKKUR DISTRICT,48,Female,2365,2732,5097
SUKKUR DISTRICT,48,Transgender,0,1,1
SUKKUR DISTRICT,49,Male,2501,2780,5281
SUKKUR DISTRICT,49,Female,2138,2449,4587
SUKKUR DISTRICT,49,Transgender,0,1,1
SUKKUR DISTRICT,50,Male,2716,2961,5677
SUKKUR DISTRICT,50,Female,2525,2722,5247
SUKKUR DISTRICT,50,Transgender,2,4,6
SUKKUR DISTRICT,51,Male,2068,2472,4540
SUKKUR DISTRICT,51,Female,1775,2069,3844
SUKKUR DISTRICT,51,Transgender,0,0,0
SUKKUR DISTRICT,52,Male,1991,2436,4427
SUKKUR DISTRICT,52,Female,1713,1961,3674
SUKKUR DISTRICT,52,Transgender,0,3,3
SUKKUR DISTRICT,53,Male,1848,2188,4036
SUKKUR DISTRICT,53,Female,1521,1926,3447
SUKKUR DISTRICT,53,Transgender,1,0,1
SUKKUR DISTRICT,54,Male,1635,2011,3646
SUKKUR DISTRICT,54,Female,1365,1683,3048
SUKKUR DISTRICT,54,Transgender,0,0,0
SUKKUR DISTRICT,55,Male,2023,2239,4262
SUKKUR DISTRICT,55,Female,1715,1913,3628
SUKKUR DISTRICT,55,Transgender,0,0,0
SUKKUR DISTRICT,56,Male,1452,1734,3186
SUKKUR DISTRICT,56,Female,1108,1348,2456
SUKKUR DISTRICT,56,Transgender,3,2,5
SUKKUR DISTRICT,57,Male,1475,1695,3170
SUKKUR DISTRICT,57,Female,1347,1309,2656
SUKKUR DISTRICT,57,Transgender,0,0,0
SUKKUR DISTRICT,58,Male,1318,1572,2890
SUKKUR DISTRICT,58,Female,1208,1421,2629
SUKKUR DISTRICT,58,Transgender,0,0,0
SUKKUR DISTRICT,59,Male,1245,1421,2666
SUKKUR DISTRICT,59,Female,1241,1360,2601
SUKKUR DISTRICT,59,Transgender,0,0,0
SUKKUR DISTRICT,60,Male,1571,1440,3011
SUKKUR DISTRICT,60,Female,1416,1519,2935
SUKKUR DISTRICT,60,Transgender,2,0,2
SUKKUR DISTRICT,61,Male,1110,1302,2412
SUKKUR DISTRICT,61,Female,1183,1223,2406
SUKKUR DISTRICT,61,Transgender,0,0,0
SUKKUR DISTRICT,62,Male,1108,1373,2481
SUKKUR DISTRICT,62,Female,1145,1252,2397
SUKKUR DISTRICT,62,Transgender,0,0,0
SUKKUR DISTRICT,63,Male,1180,1262,2442
SUKKUR DISTRICT,63,Female,1089,1191,2280
SUKKUR DISTRICT,63,Transgender,0,0,0
SUKKUR DISTRICT,64,Male,1125,1035,2160
SUKKUR DISTRICT,64,Female,1111,1004,2115
SUKKUR DISTRICT,64,Transgender,0,0,0
SUKKUR DISTRICT,65,Male,1197,1183,2380
SUKKUR DISTRICT,65,Female,1021,1019,2040
SUKKUR DISTRICT,65,Transgender,0,1,1
SUKKUR DISTRICT,66,Male,964,811,1775
SUKKUR DISTRICT,66,Female,757,736,1493
SUKKUR DISTRICT,66,Transgender,1,0,1
SUKKUR DISTRICT,67,Male,875,695,1570
SUKKUR DISTRICT,67,Female,924,658,1582
SUKKUR DISTRICT,67,Transgender,0,1,1
SUKKUR DISTRICT,68,Male,731,783,1514
SUKKUR DISTRICT,68,Female,665,773,1438
SUKKUR DISTRICT,68,Transgender,0,1,1
SUKKUR DISTRICT,69,Male,788,619,1407
SUKKUR DISTRICT,69,Female,732,660,1392
SUKKUR DISTRICT,69,Transgender,0,0,0
SUKKUR DISTRICT,70,Male,802,691,1493
SUKKUR DISTRICT,70,Female,744,656,1400
SUKKUR DISTRICT,70,Transgender,0,0,0
SUKKUR DISTRICT,71,Male,654,559,1213
SUKKUR DISTRICT,71,Female,592,553,1145
SUKKUR DISTRICT,71,Transgender,0,0,0
SUKKUR DISTRICT,72,Male,567,526,1093
SUKKUR DISTRICT,72,Female,526,493,1019
SUKKUR DISTRICT,72,Transgender,0,0,0
SUKKUR DISTRICT,73,Male,488,502,990
SUKKUR DISTRICT,73,Female,491,491,982
SUKKUR DISTRICT,73,Transgender,0,0,0
SUKKUR DISTRICT,74,Male,441,403,844
SUKKUR DISTRICT,74,Female,423,392,815
SUKKUR DISTRICT,74,Transgender,0,0,0
SUKKUR DISTRICT,>=75,Male,3263,2667,5930
SUKKUR DISTRICT,>=75,Female,3199,3000,6199
SUKKUR DISTRICT,>=75,Transgender,0,6,6
SWABI DISTRICT,<1,Male,17769,3553,21322
SWABI DISTRICT,<1,Female,16593,3387,19980
SWABI DISTRICT,<1,Transgender,0,0,0
SWABI DISTRICT,1,Male,17988,3649,21637
SWABI DISTRICT,1,Female,17041,3404,20445
SWABI DISTRICT,1,Transgender,0,0,0
SWABI DISTRICT,2,Male,19214,3757,22971
SWABI DISTRICT,2,Female,18185,3404,21589
SWABI DISTRICT,2,Transgender,0,0,0
SWABI DISTRICT,3,Male,20170,4035,24205
SWABI DISTRICT,3,Female,19373,3907,23280
SWABI DISTRICT,3,Transgender,0,0,0
SWABI DISTRICT,4,Male,21157,4036,25193
SWABI DISTRICT,4,Female,19849,3879,23728
SWABI DISTRICT,4,Transgender,0,0,0
SWABI DISTRICT,5,Male,20160,4047,24207
SWABI DISTRICT,5,Female,18810,3809,22619
SWABI DISTRICT,5,Transgender,0,0,0
SWABI DISTRICT,6,Male,19992,3843,23835
SWABI DISTRICT,6,Female,18212,3710,21922
SWABI DISTRICT,6,Transgender,0,0,0
SWABI DISTRICT,7,Male,20357,4004,24361
SWABI DISTRICT,7,Female,18818,3716,22534
SWABI DISTRICT,7,Transgender,0,0,0
SWABI DISTRICT,8,Male,19388,3666,23054
SWABI DISTRICT,8,Female,18774,3558,22332
SWABI DISTRICT,8,Transgender,0,0,0
SWABI DISTRICT,9,Male,20635,3941,24576
SWABI DISTRICT,9,Female,18419,3746,22165
SWABI DISTRICT,9,Transgender,0,0,0
SWABI DISTRICT,10,Male,18096,3436,21532
SWABI DISTRICT,10,Female,16882,3354,20236
SWABI DISTRICT,10,Transgender,0,0,0
SWABI DISTRICT,11,Male,18920,3744,22664
SWABI DISTRICT,11,Female,16803,3420,20223
SWABI DISTRICT,11,Transgender,0,0,0
SWABI DISTRICT,12,Male,16843,3383,20226
SWABI DISTRICT,12,Female,15807,3077,18884
SWABI DISTRICT,12,Transgender,0,0,0
SWABI DISTRICT,13,Male,18464,3714,22178
SWABI DISTRICT,13,Female,16657,3497,20154
SWABI DISTRICT,13,Transgender,0,0,0
SWABI DISTRICT,14,Male,17279,3418,20697
SWABI DISTRICT,14,Female,15675,3223,18898
SWABI DISTRICT,14,Transgender,0,0,0
SWABI DISTRICT,15,Male,17495,3400,20895
SWABI DISTRICT,15,Female,16050,3346,19396
SWABI DISTRICT,15,Transgender,0,0,0
SWABI DISTRICT,16,Male,15970,3199,19169
SWABI DISTRICT,16,Female,14903,3127,18030
SWABI DISTRICT,16,Transgender,5,0,5
SWABI DISTRICT,17,Male,15787,3165,18952
SWABI DISTRICT,17,Female,16084,3289,19373
SWABI DISTRICT,17,Transgender,1,3,4
SWABI DISTRICT,18,Male,14468,2954,17422
SWABI DISTRICT,18,Female,13715,2835,16550
SWABI DISTRICT,18,Transgender,2,0,2
SWABI DISTRICT,19,Male,15451,3164,18615
SWABI DISTRICT,19,Female,13758,2982,16740
SWABI DISTRICT,19,Transgender,1,0,1
SWABI DISTRICT,20,Male,13059,2574,15633
SWABI DISTRICT,20,Female,14091,2840,16931
SWABI DISTRICT,20,Transgender,2,1,3
SWABI DISTRICT,21,Male,12891,2632,15523
SWABI DISTRICT,21,Female,12853,2796,15649
SWABI DISTRICT,21,Transgender,2,2,4
SWABI DISTRICT,22,Male,11201,2218,13419
SWABI DISTRICT,22,Female,12237,2577,14814
SWABI DISTRICT,22,Transgender,1,1,2
SWABI DISTRICT,23,Male,11033,2227,13260
SWABI DISTRICT,23,Female,12080,2569,14649
SWABI DISTRICT,23,Transgender,5,1,6
SWABI DISTRICT,24,Male,10243,1994,12237
SWABI DISTRICT,24,Female,11421,2461,13882
SWABI DISTRICT,24,Transgender,1,2,3
SWABI DISTRICT,25,Male,9920,1888,11808
SWABI DISTRICT,25,Female,12291,2483,14774
SWABI DISTRICT,25,Transgender,7,3,10
SWABI DISTRICT,26,Male,9807,1913,11720
SWABI DISTRICT,26,Female,11487,2445,13932
SWABI DISTRICT,26,Transgender,2,1,3
SWABI DISTRICT,27,Male,9512,1907,11419
SWABI DISTRICT,27,Female,11488,2453,13941
SWABI DISTRICT,27,Transgender,4,1,5
SWABI DISTRICT,28,Male,9247,1835,11082
SWABI DISTRICT,28,Female,9846,2167,12013
SWABI DISTRICT,28,Transgender,1,0,1
SWABI DISTRICT,29,Male,9175,1859,11034
SWABI DISTRICT,29,Female,11074,2351,13425
SWABI DISTRICT,29,Transgender,1,0,1
SWABI DISTRICT,30,Male,8665,1798,10463
SWABI DISTRICT,30,Female,10734,2212,12946
SWABI DISTRICT,30,Transgender,2,2,4
SWABI DISTRICT,31,Male,8334,1752,10086
SWABI DISTRICT,31,Female,9883,2126,12009
SWABI DISTRICT,31,Transgender,1,1,2
SWABI DISTRICT,32,Male,7370,1485,8855
SWABI DISTRICT,32,Female,8215,1877,10092
SWABI DISTRICT,32,Transgender,2,0,2
SWABI DISTRICT,33,Male,7520,1596,9116
SWABI DISTRICT,33,Female,8396,1892,10288
SWABI DISTRICT,33,Transgender,1,1,2
SWABI DISTRICT,34,Male,7029,1407,8436
SWABI DISTRICT,34,Female,7538,1623,9161
SWABI DISTRICT,34,Transgender,1,0,1
SWABI DISTRICT,35,Male,6622,1211,7833
SWABI DISTRICT,35,Female,7899,1617,9516
SWABI DISTRICT,35,Transgender,3,0,3
SWABI DISTRICT,36,Male,6592,1281,7873
SWABI DISTRICT,36,Female,7207,1430,8637
SWABI DISTRICT,36,Transgender,1,1,2
SWABI DISTRICT,37,Male,6278,1301,7579
SWABI DISTRICT,37,Female,7695,1586,9281
SWABI DISTRICT,37,Transgender,0,0,0
SWABI DISTRICT,38,Male,6535,1348,7883
SWABI DISTRICT,38,Female,6176,1441,7617
SWABI DISTRICT,38,Transgender,0,1,1
SWABI DISTRICT,39,Male,6268,1338,7606
SWABI DISTRICT,39,Female,6915,1462,8377
SWABI DISTRICT,39,Transgender,1,0,1
SWABI DISTRICT,40,Male,6157,1353,7510
SWABI DISTRICT,40,Female,7521,1600,9121
SWABI DISTRICT,40,Transgender,3,1,4
SWABI DISTRICT,41,Male,5756,1266,7022
SWABI DISTRICT,41,Female,6605,1472,8077
SWABI DISTRICT,41,Transgender,0,1,1
SWABI DISTRICT,42,Male,5366,1236,6602
SWABI DISTRICT,42,Female,5900,1343,7243
SWABI DISTRICT,42,Transgender,1,0,1
SWABI DISTRICT,43,Male,5657,1279,6936
SWABI DISTRICT,43,Female,5921,1270,7191
SWABI DISTRICT,43,Transgender,0,0,0
SWABI DISTRICT,44,Male,5615,1181,6796
SWABI DISTRICT,44,Female,5320,1225,6545
SWABI DISTRICT,44,Transgender,1,0,1
SWABI DISTRICT,45,Male,4630,1003,5633
SWABI DISTRICT,45,Female,5169,1082,6251
SWABI DISTRICT,45,Transgender,3,0,3
SWABI DISTRICT,46,Male,5148,1130,6278
SWABI DISTRICT,46,Female,5091,972,6063
SWABI DISTRICT,46,Transgender,0,0,0
SWABI DISTRICT,47,Male,4942,1056,5998
SWABI DISTRICT,47,Female,5153,1131,6284
SWABI DISTRICT,47,Transgender,0,0,0
SWABI DISTRICT,48,Male,5046,1036,6082
SWABI DISTRICT,48,Female,4421,917,5338
SWABI DISTRICT,48,Transgender,0,2,2
SWABI DISTRICT,49,Male,4762,955,5717
SWABI DISTRICT,49,Female,4598,1056,5654
SWABI DISTRICT,49,Transgender,1,0,1
SWABI DISTRICT,50,Male,4437,943,5380
SWABI DISTRICT,50,Female,5226,1143,6369
SWABI DISTRICT,50,Transgender,2,0,2
SWABI DISTRICT,51,Male,4538,927,5465
SWABI DISTRICT,51,Female,4371,971,5342
SWABI DISTRICT,51,Transgender,0,0,0
SWABI DISTRICT,52,Male,4116,800,4916
SWABI DISTRICT,52,Female,3865,852,4717
SWABI DISTRICT,52,Transgender,1,0,1
SWABI DISTRICT,53,Male,4257,875,5132
SWABI DISTRICT,53,Female,3673,834,4507
SWABI DISTRICT,53,Transgender,1,0,1
SWABI DISTRICT,54,Male,3949,813,4762
SWABI DISTRICT,54,Female,3422,744,4166
SWABI DISTRICT,54,Transgender,0,0,0
SWABI DISTRICT,55,Male,3464,736,4200
SWABI DISTRICT,55,Female,3367,726,4093
SWABI DISTRICT,55,Transgender,0,0,0
SWABI DISTRICT,56,Male,3206,696,3902
SWABI DISTRICT,56,Female,2939,607,3546
SWABI DISTRICT,56,Transgender,0,0,0
SWABI DISTRICT,57,Male,2969,625,3594
SWABI DISTRICT,57,Female,3031,611,3642
SWABI DISTRICT,57,Transgender,2,0,2
SWABI DISTRICT,58,Male,3308,713,4021
SWABI DISTRICT,58,Female,2779,635,3414
SWABI DISTRICT,58,Transgender,1,0,1
SWABI DISTRICT,59,Male,3663,794,4457
SWABI DISTRICT,59,Female,3166,687,3853
SWABI DISTRICT,59,Transgender,1,0,1
SWABI DISTRICT,60,Male,3403,716,4119
SWABI DISTRICT,60,Female,3371,685,4056
SWABI DISTRICT,60,Transgender,2,0,2
SWABI DISTRICT,61,Male,3642,867,4509
SWABI DISTRICT,61,Female,3251,728,3979
SWABI DISTRICT,61,Transgender,0,0,0
SWABI DISTRICT,62,Male,3287,722,4009
SWABI DISTRICT,62,Female,2718,596,3314
SWABI DISTRICT,62,Transgender,1,0,1
SWABI DISTRICT,63,Male,3193,697,3890
SWABI DISTRICT,63,Female,2615,586,3201
SWABI DISTRICT,63,Transgender,0,0,0
SWABI DISTRICT,64,Male,2811,641,3452
SWABI DISTRICT,64,Female,2482,517,2999
SWABI DISTRICT,64,Transgender,1,0,1
SWABI DISTRICT,65,Male,2318,474,2792
SWABI DISTRICT,65,Female,2038,460,2498
SWABI DISTRICT,65,Transgender,1,0,1
SWABI DISTRICT,66,Male,2674,566,3240
SWABI DISTRICT,66,Female,2111,492,2603
SWABI DISTRICT,66,Transgender,0,0,0
SWABI DISTRICT,67,Male,2512,576,3088
SWABI DISTRICT,67,Female,1811,426,2237
SWABI DISTRICT,67,Transgender,0,0,0
SWABI DISTRICT,68,Male,2275,443,2718
SWABI DISTRICT,68,Female,1509,308,1817
SWABI DISTRICT,68,Transgender,3,0,3
SWABI DISTRICT,69,Male,2047,385,2432
SWABI DISTRICT,69,Female,1569,310,1879
SWABI DISTRICT,69,Transgender,1,0,1
SWABI DISTRICT,70,Male,1904,376,2280
SWABI DISTRICT,70,Female,1684,324,2008
SWABI DISTRICT,70,Transgender,0,0,0
SWABI DISTRICT,71,Male,1974,448,2422
SWABI DISTRICT,71,Female,1507,369,1876
SWABI DISTRICT,71,Transgender,0,0,0
SWABI DISTRICT,72,Male,1696,377,2073
SWABI DISTRICT,72,Female,1254,317,1571
SWABI DISTRICT,72,Transgender,0,0,0
SWABI DISTRICT,73,Male,1532,343,1875
SWABI DISTRICT,73,Female,1087,203,1290
SWABI DISTRICT,73,Transgender,0,0,0
SWABI DISTRICT,74,Male,1221,228,1449
SWABI DISTRICT,74,Female,1035,180,1215
SWABI DISTRICT,74,Transgender,0,0,0
SWABI DISTRICT,>=75,Male,8763,1738,10501
SWABI DISTRICT,>=75,Female,8783,1796,10579
SWABI DISTRICT,>=75,Transgender,1,0,1
SWAT DISTRICT,<1,Male,22146,9400,31546
SWAT DISTRICT,<1,Female,20735,8929,29664
SWAT DISTRICT,<1,Transgender,0,0,0
SWAT DISTRICT,1,Male,24122,9754,33876
SWAT DISTRICT,1,Female,22575,8980,31555
SWAT DISTRICT,1,Transgender,0,0,0
SWAT DISTRICT,2,Male,26804,10456,37260
SWAT DISTRICT,2,Female,25627,9912,35539
SWAT DISTRICT,2,Transgender,0,0,0
SWAT DISTRICT,3,Male,27254,11026,38280
SWAT DISTRICT,3,Female,25903,10305,36208
SWAT DISTRICT,3,Transgender,0,0,0
SWAT DISTRICT,4,Male,28427,10966,39393
SWAT DISTRICT,4,Female,27072,10452,37524
SWAT DISTRICT,4,Transgender,0,0,0
SWAT DISTRICT,5,Male,28201,11062,39263
SWAT DISTRICT,5,Female,26451,10398,36849
SWAT DISTRICT,5,Transgender,0,0,0
SWAT DISTRICT,6,Male,28260,10874,39134
SWAT DISTRICT,6,Female,26144,10009,36153
SWAT DISTRICT,6,Transgender,0,0,0
SWAT DISTRICT,7,Male,27161,11394,38555
SWAT DISTRICT,7,Female,25065,10556,35621
SWAT DISTRICT,7,Transgender,0,0,0
SWAT DISTRICT,8,Male,29257,10623,39880
SWAT DISTRICT,8,Female,26937,10075,37012
SWAT DISTRICT,8,Transgender,0,0,0
SWAT DISTRICT,9,Male,27402,11005,38407
SWAT DISTRICT,9,Female,24167,10172,34339
SWAT DISTRICT,9,Transgender,0,0,0
SWAT DISTRICT,10,Male,26765,10030,36795
SWAT DISTRICT,10,Female,24658,9173,33831
SWAT DISTRICT,10,Transgender,0,0,0
SWAT DISTRICT,11,Male,24175,10172,34347
SWAT DISTRICT,11,Female,21363,9183,30546
SWAT DISTRICT,11,Transgender,0,0,0
SWAT DISTRICT,12,Male,23682,9220,32902
SWAT DISTRICT,12,Female,21595,8473,30068
SWAT DISTRICT,12,Transgender,0,0,0
SWAT DISTRICT,13,Male,22902,9852,32754
SWAT DISTRICT,13,Female,20110,9015,29125
SWAT DISTRICT,13,Transgender,0,0,0
SWAT DISTRICT,14,Male,20527,8638,29165
SWAT DISTRICT,14,Female,18809,7877,26686
SWAT DISTRICT,14,Transgender,0,0,0
SWAT DISTRICT,15,Male,21062,9007,30069
SWAT DISTRICT,15,Female,18921,8236,27157
SWAT DISTRICT,15,Transgender,4,4,8
SWAT DISTRICT,16,Male,18113,8047,26160
SWAT DISTRICT,16,Female,17345,7534,24879
SWAT DISTRICT,16,Transgender,1,2,3
SWAT DISTRICT,17,Male,17112,8176,25288
SWAT DISTRICT,17,Female,17698,8260,25958
SWAT DISTRICT,17,Transgender,1,1,2
SWAT DISTRICT,18,Male,17588,7794,25382
SWAT DISTRICT,18,Female,17651,7582,25233
SWAT DISTRICT,18,Transgender,0,1,1
SWAT DISTRICT,19,Male,15411,7337,22748
SWAT DISTRICT,19,Female,14642,7038,21680
SWAT DISTRICT,19,Transgender,0,0,0
SWAT DISTRICT,20,Male,15671,6949,22620
SWAT DISTRICT,20,Female,18579,7519,26098
SWAT DISTRICT,20,Transgender,3,7,10
SWAT DISTRICT,21,Male,13092,6411,19503
SWAT DISTRICT,21,Female,13920,6220,20140
SWAT DISTRICT,21,Transgender,1,2,3
SWAT DISTRICT,22,Male,13138,6028,19166
SWAT DISTRICT,22,Female,13092,5856,18948
SWAT DISTRICT,22,Transgender,2,7,9
SWAT DISTRICT,23,Male,11993,5972,17965
SWAT DISTRICT,23,Female,12267,5476,17743
SWAT DISTRICT,23,Transgender,3,4,7
SWAT DISTRICT,24,Male,10642,5365,16007
SWAT DISTRICT,24,Female,10968,4988,15956
SWAT DISTRICT,24,Transgender,0,4,4
SWAT DISTRICT,25,Male,12920,5833,18753
SWAT DISTRICT,25,Female,16205,6478,22683
SWAT DISTRICT,25,Transgender,2,4,6
SWAT DISTRICT,26,Male,11075,5446,16521
SWAT DISTRICT,26,Female,13311,5960,19271
SWAT DISTRICT,26,Transgender,0,3,3
SWAT DISTRICT,27,Male,11047,5611,16658
SWAT DISTRICT,27,Female,14225,6334,20559
SWAT DISTRICT,27,Transgender,3,2,5
SWAT DISTRICT,28,Male,11039,5443,16482
SWAT DISTRICT,28,Female,12625,5512,18137
SWAT DISTRICT,28,Transgender,4,0,4
SWAT DISTRICT,29,Male,10159,5078,15237
SWAT DISTRICT,29,Female,12877,5695,18572
SWAT DISTRICT,29,Transgender,1,0,1
SWAT DISTRICT,30,Male,11788,5552,17340
SWAT DISTRICT,30,Female,13522,5824,19346
SWAT DISTRICT,30,Transgender,1,2,3
SWAT DISTRICT,31,Male,9481,5026,14507
SWAT DISTRICT,31,Female,10929,5123,16052
SWAT DISTRICT,31,Transgender,2,2,4
SWAT DISTRICT,32,Male,8171,4422,12593
SWAT DISTRICT,32,Female,9986,4327,14313
SWAT DISTRICT,32,Transgender,2,1,3
SWAT DISTRICT,33,Male,8490,4441,12931
SWAT DISTRICT,33,Female,9841,4633,14474
SWAT DISTRICT,33,Transgender,0,2,2
SWAT DISTRICT,34,Male,7341,3697,11038
SWAT DISTRICT,34,Female,8030,3459,11489
SWAT DISTRICT,34,Transgender,0,0,0
SWAT DISTRICT,35,Male,8500,4014,12514
SWAT DISTRICT,35,Female,9619,4146,13765
SWAT DISTRICT,35,Transgender,3,2,5
SWAT DISTRICT,36,Male,7126,3558,10684
SWAT DISTRICT,36,Female,7604,3337,10941
SWAT DISTRICT,36,Transgender,2,0,2
SWAT DISTRICT,37,Male,7115,3547,10662
SWAT DISTRICT,37,Female,8460,3647,12107
SWAT DISTRICT,37,Transgender,1,1,2
SWAT DISTRICT,38,Male,7400,3642,11042
SWAT DISTRICT,38,Female,7236,3325,10561
SWAT DISTRICT,38,Transgender,2,0,2
SWAT DISTRICT,39,Male,6684,3480,10164
SWAT DISTRICT,39,Female,6917,3203,10120
SWAT DISTRICT,39,Transgender,0,0,0
SWAT DISTRICT,40,Male,7593,3893,11486
SWAT DISTRICT,40,Female,9071,3921,12992
SWAT DISTRICT,40,Transgender,0,3,3
SWAT DISTRICT,41,Male,5889,3055,8944
SWAT DISTRICT,41,Female,6303,2727,9030
SWAT DISTRICT,41,Transgender,0,0,0
SWAT DISTRICT,42,Male,5322,2711,8033
SWAT DISTRICT,42,Female,5500,2468,7968
SWAT DISTRICT,42,Transgender,1,0,1
SWAT DISTRICT,43,Male,5803,2979,8782
SWAT DISTRICT,43,Female,5785,2628,8413
SWAT DISTRICT,43,Transgender,0,1,1
SWAT DISTRICT,44,Male,5089,2646,7735
SWAT DISTRICT,44,Female,4776,2266,7042
SWAT DISTRICT,44,Transgender,0,0,0
SWAT DISTRICT,45,Male,5385,2654,8039
SWAT DISTRICT,45,Female,5869,2647,8516
SWAT DISTRICT,45,Transgender,1,0,1
SWAT DISTRICT,46,Male,4718,2301,7019
SWAT DISTRICT,46,Female,4566,2015,6581
SWAT DISTRICT,46,Transgender,0,0,0
SWAT DISTRICT,47,Male,4624,2286,6910
SWAT DISTRICT,47,Female,4866,2189,7055
SWAT DISTRICT,47,Transgender,1,1,2
SWAT DISTRICT,48,Male,4629,2332,6961
SWAT DISTRICT,48,Female,4508,2099,6607
SWAT DISTRICT,48,Transgender,0,0,0
SWAT DISTRICT,49,Male,4476,2180,6656
SWAT DISTRICT,49,Female,4410,1990,6400
SWAT DISTRICT,49,Transgender,0,0,0
SWAT DISTRICT,50,Male,5204,2531,7735
SWAT DISTRICT,50,Female,5843,2507,8350
SWAT DISTRICT,50,Transgender,2,3,5
SWAT DISTRICT,51,Male,4128,2015,6143
SWAT DISTRICT,51,Female,3930,1783,5713
SWAT DISTRICT,51,Transgender,2,1,3
SWAT DISTRICT,52,Male,3889,1909,5798
SWAT DISTRICT,52,Female,3040,1558,4598
SWAT DISTRICT,52,Transgender,2,0,2
SWAT DISTRICT,53,Male,4047,1990,6037
SWAT DISTRICT,53,Female,3607,1587,5194
SWAT DISTRICT,53,Transgender,0,0,0
SWAT DISTRICT,54,Male,3782,1766,5548
SWAT DISTRICT,54,Female,3086,1342,4428
SWAT DISTRICT,54,Transgender,1,0,1
SWAT DISTRICT,55,Male,3969,1927,5896
SWAT DISTRICT,55,Female,3610,1653,5263
SWAT DISTRICT,55,Transgender,0,1,1
SWAT DISTRICT,56,Male,3056,1549,4605
SWAT DISTRICT,56,Female,2393,1104,3497
SWAT DISTRICT,56,Transgender,0,0,0
SWAT DISTRICT,57,Male,2779,1411,4190
SWAT DISTRICT,57,Female,2352,1009,3361
SWAT DISTRICT,57,Transgender,1,0,1
SWAT DISTRICT,58,Male,2685,1413,4098
SWAT DISTRICT,58,Female,2312,1055,3367
SWAT DISTRICT,58,Transgender,3,0,3
SWAT DISTRICT,59,Male,2737,1361,4098
SWAT DISTRICT,59,Female,2520,1053,3573
SWAT DISTRICT,59,Transgender,0,0,0
SWAT DISTRICT,60,Male,3737,1751,5488
SWAT DISTRICT,60,Female,3816,1462,5278
SWAT DISTRICT,60,Transgender,3,3,6
SWAT DISTRICT,61,Male,3199,1517,4716
SWAT DISTRICT,61,Female,2957,1225,4182
SWAT DISTRICT,61,Transgender,0,0,0
SWAT DISTRICT,62,Male,2740,1364,4104
SWAT DISTRICT,62,Female,2380,1066,3446
SWAT DISTRICT,62,Transgender,1,0,1
SWAT DISTRICT,63,Male,2864,1347,4211
SWAT DISTRICT,63,Female,2585,1160,3745
SWAT DISTRICT,63,Transgender,0,0,0
SWAT DISTRICT,64,Male,2482,1122,3604
SWAT DISTRICT,64,Female,2118,869,2987
SWAT DISTRICT,64,Transgender,0,0,0
SWAT DISTRICT,65,Male,2508,1121,3629
SWAT DISTRICT,65,Female,2189,785,2974
SWAT DISTRICT,65,Transgender,2,1,3
SWAT DISTRICT,66,Male,2399,937,3336
SWAT DISTRICT,66,Female,1824,683,2507
SWAT DISTRICT,66,Transgender,0,0,0
SWAT DISTRICT,67,Male,2169,1006,3175
SWAT DISTRICT,67,Female,1642,701,2343
SWAT DISTRICT,67,Transgender,1,0,1
SWAT DISTRICT,68,Male,1948,826,2774
SWAT DISTRICT,68,Female,1471,594,2065
SWAT DISTRICT,68,Transgender,1,0,1
SWAT DISTRICT,69,Male,1760,731,2491
SWAT DISTRICT,69,Female,1415,505,1920
SWAT DISTRICT,69,Transgender,0,0,0
SWAT DISTRICT,70,Male,2215,855,3070
SWAT DISTRICT,70,Female,1764,585,2349
SWAT DISTRICT,70,Transgender,1,0,1
SWAT DISTRICT,71,Male,2123,764,2887
SWAT DISTRICT,71,Female,1541,514,2055
SWAT DISTRICT,71,Transgender,0,0,0
SWAT DISTRICT,72,Male,1700,692,2392
SWAT DISTRICT,72,Female,1104,486,1590
SWAT DISTRICT,72,Transgender,1,0,1
SWAT DISTRICT,73,Male,1549,694,2243
SWAT DISTRICT,73,Female,1106,458,1564
SWAT DISTRICT,73,Transgender,0,0,0
SWAT DISTRICT,74,Male,1253,472,1725
SWAT DISTRICT,74,Female,885,345,1230
SWAT DISTRICT,74,Transgender,0,0,0
SWAT DISTRICT,>=75,Male,10061,3737,13798
SWAT DISTRICT,>=75,Female,8159,3300,11459
SWAT DISTRICT,>=75,Transgender,3,3,6
TANDO ALLAHYAR DISTRICT,<1,Male,7239,3087,10326
TANDO ALLAHYAR DISTRICT,<1,Female,6585,2884,9469
TANDO ALLAHYAR DISTRICT,<1,Transgender,0,0,0
TANDO ALLAHYAR DISTRICT,1,Male,8386,3420,11806
TANDO ALLAHYAR DISTRICT,1,Female,8122,3266,11388
TANDO ALLAHYAR DISTRICT,1,Transgender,0,0,0
TANDO ALLAHYAR DISTRICT,2,Male,9548,3837,13385
TANDO ALLAHYAR DISTRICT,2,Female,9230,3679,12909
TANDO ALLAHYAR DISTRICT,2,Transgender,0,0,0
TANDO ALLAHYAR DISTRICT,3,Male,10372,4263,14635
TANDO ALLAHYAR DISTRICT,3,Female,10114,4070,14184
TANDO ALLAHYAR DISTRICT,3,Transgender,0,0,0
TANDO ALLAHYAR DISTRICT,4,Male,10436,4078,14514
TANDO ALLAHYAR DISTRICT,4,Female,10293,3854,14147
TANDO ALLAHYAR DISTRICT,4,Transgender,0,0,0
TANDO ALLAHYAR DISTRICT,5,Male,10890,4436,15326
TANDO ALLAHYAR DISTRICT,5,Female,9863,4130,13993
TANDO ALLAHYAR DISTRICT,5,Transgender,0,0,0
TANDO ALLAHYAR DISTRICT,6,Male,10869,3999,14868
TANDO ALLAHYAR DISTRICT,6,Female,9698,3837,13535
TANDO ALLAHYAR DISTRICT,6,Transgender,0,0,0
TANDO ALLAHYAR DISTRICT,7,Male,9714,4219,13933
TANDO ALLAHYAR DISTRICT,7,Female,8645,3786,12431
TANDO ALLAHYAR DISTRICT,7,Transgender,0,0,0
TANDO ALLAHYAR DISTRICT,8,Male,11330,4152,15482
TANDO ALLAHYAR DISTRICT,8,Female,10006,3938,13944
TANDO ALLAHYAR DISTRICT,8,Transgender,0,0,0
TANDO ALLAHYAR DISTRICT,9,Male,8286,3699,11985
TANDO ALLAHYAR DISTRICT,9,Female,7388,3377,10765
TANDO ALLAHYAR DISTRICT,9,Transgender,0,0,0
TANDO ALLAHYAR DISTRICT,10,Male,10214,3988,14202
TANDO ALLAHYAR DISTRICT,10,Female,8896,3588,12484
TANDO ALLAHYAR DISTRICT,10,Transgender,0,0,0
TANDO ALLAHYAR DISTRICT,11,Male,6972,3344,10316
TANDO ALLAHYAR DISTRICT,11,Female,5983,2936,8919
TANDO ALLAHYAR DISTRICT,11,Transgender,0,0,0
TANDO ALLAHYAR DISTRICT,12,Male,8203,3569,11772
TANDO ALLAHYAR DISTRICT,12,Female,6803,3045,9848
TANDO ALLAHYAR DISTRICT,12,Transgender,0,0,0
TANDO ALLAHYAR DISTRICT,13,Male,6280,3086,9366
TANDO ALLAHYAR DISTRICT,13,Female,5209,2782,7991
TANDO ALLAHYAR DISTRICT,13,Transgender,0,0,0
TANDO ALLAHYAR DISTRICT,14,Male,6344,2907,9251
TANDO ALLAHYAR DISTRICT,14,Female,5365,2732,8097
TANDO ALLAHYAR DISTRICT,14,Transgender,0,0,0
TANDO ALLAHYAR DISTRICT,15,Male,6870,3248,10118
TANDO ALLAHYAR DISTRICT,15,Female,5414,2876,8290
TANDO ALLAHYAR DISTRICT,15,Transgender,2,0,2
TANDO ALLAHYAR DISTRICT,16,Male,6225,3081,9306
TANDO ALLAHYAR DISTRICT,16,Female,5250,2856,8106
TANDO ALLAHYAR DISTRICT,16,Transgender,4,0,4
TANDO ALLAHYAR DISTRICT,17,Male,5317,2938,8255
TANDO ALLAHYAR DISTRICT,17,Female,4658,2696,7354
TANDO ALLAHYAR DISTRICT,17,Transgender,2,4,6
TANDO ALLAHYAR DISTRICT,18,Male,6562,3102,9664
TANDO ALLAHYAR DISTRICT,18,Female,6507,2934,9441
TANDO ALLAHYAR DISTRICT,18,Transgender,3,2,5
TANDO ALLAHYAR DISTRICT,19,Male,5149,2839,7988
TANDO ALLAHYAR DISTRICT,19,Female,5060,2690,7750
TANDO ALLAHYAR DISTRICT,19,Transgender,2,3,5
TANDO ALLAHYAR DISTRICT,20,Male,6273,3010,9283
TANDO ALLAHYAR DISTRICT,20,Female,5593,2617,8210
TANDO ALLAHYAR DISTRICT,20,Transgender,3,2,5
TANDO ALLAHYAR DISTRICT,21,Male,4378,2518,6896
TANDO ALLAHYAR DISTRICT,21,Female,4359,2497,6856
TANDO ALLAHYAR DISTRICT,21,Transgender,0,1,1
TANDO ALLAHYAR DISTRICT,22,Male,4508,2476,6984
TANDO ALLAHYAR DISTRICT,22,Female,3946,2241,6187
TANDO ALLAHYAR DISTRICT,22,Transgender,3,0,3
TANDO ALLAHYAR DISTRICT,23,Male,3925,2260,6185
TANDO ALLAHYAR DISTRICT,23,Female,3873,2115,5988
TANDO ALLAHYAR DISTRICT,23,Transgender,2,0,2
TANDO ALLAHYAR DISTRICT,24,Male,3512,2114,5626
TANDO ALLAHYAR DISTRICT,24,Female,3606,2111,5717
TANDO ALLAHYAR DISTRICT,24,Transgender,1,0,1
TANDO ALLAHYAR DISTRICT,25,Male,4512,2351,6863
TANDO ALLAHYAR DISTRICT,25,Female,4089,2165,6254
TANDO ALLAHYAR DISTRICT,25,Transgender,1,0,1
TANDO ALLAHYAR DISTRICT,26,Male,3725,2136,5861
TANDO ALLAHYAR DISTRICT,26,Female,3778,2099,5877
TANDO ALLAHYAR DISTRICT,26,Transgender,1,0,1
TANDO ALLAHYAR DISTRICT,27,Male,4166,2251,6417
TANDO ALLAHYAR DISTRICT,27,Female,4570,2226,6796
TANDO ALLAHYAR DISTRICT,27,Transgender,0,2,2
TANDO ALLAHYAR DISTRICT,28,Male,4031,2049,6080
TANDO ALLAHYAR DISTRICT,28,Female,4356,2131,6487
TANDO ALLAHYAR DISTRICT,28,Transgender,2,1,3
TANDO ALLAHYAR DISTRICT,29,Male,4139,2157,6296
TANDO ALLAHYAR DISTRICT,29,Female,4838,2276,7114
TANDO ALLAHYAR DISTRICT,29,Transgender,3,1,4
TANDO ALLAHYAR DISTRICT,30,Male,4072,2028,6100
TANDO ALLAHYAR DISTRICT,30,Female,3878,2045,5923
TANDO ALLAHYAR DISTRICT,30,Transgender,2,4,6
TANDO ALLAHYAR DISTRICT,31,Male,4256,2186,6442
TANDO ALLAHYAR DISTRICT,31,Female,4504,2070,6574
TANDO ALLAHYAR DISTRICT,31,Transgender,0,0,0
TANDO ALLAHYAR DISTRICT,32,Male,3841,1903,5744
TANDO ALLAHYAR DISTRICT,32,Female,4008,1926,5934
TANDO ALLAHYAR DISTRICT,32,Transgender,2,1,3
TANDO ALLAHYAR DISTRICT,33,Male,3890,1993,5883
TANDO ALLAHYAR DISTRICT,33,Female,4150,1928,6078
TANDO ALLAHYAR DISTRICT,33,Transgender,1,0,1
TANDO ALLAHYAR DISTRICT,34,Male,3533,1784,5317
TANDO ALLAHYAR DISTRICT,34,Female,3647,1766,5413
TANDO ALLAHYAR DISTRICT,34,Transgender,1,0,1
TANDO ALLAHYAR DISTRICT,35,Male,3415,1784,5199
TANDO ALLAHYAR DISTRICT,35,Female,3131,1521,4652
TANDO ALLAHYAR DISTRICT,35,Transgender,1,3,4
TANDO ALLAHYAR DISTRICT,36,Male,3471,1755,5226
TANDO ALLAHYAR DISTRICT,36,Female,3399,1562,4961
TANDO ALLAHYAR DISTRICT,36,Transgender,2,0,2
TANDO ALLAHYAR DISTRICT,37,Male,4703,2027,6730
TANDO ALLAHYAR DISTRICT,37,Female,4381,1870,6251
TANDO ALLAHYAR DISTRICT,37,Transgender,2,0,2
TANDO ALLAHYAR DISTRICT,38,Male,3031,1576,4607
TANDO ALLAHYAR DISTRICT,38,Female,2824,1494,4318
TANDO ALLAHYAR DISTRICT,38,Transgender,2,1,3
TANDO ALLAHYAR DISTRICT,39,Male,3631,1743,5374
TANDO ALLAHYAR DISTRICT,39,Female,3373,1607,4980
TANDO ALLAHYAR DISTRICT,39,Transgender,0,0,0
TANDO ALLAHYAR DISTRICT,40,Male,2548,1318,3866
TANDO ALLAHYAR DISTRICT,40,Female,2313,1242,3555
TANDO ALLAHYAR DISTRICT,40,Transgender,2,1,3
TANDO ALLAHYAR DISTRICT,41,Male,2669,1400,4069
TANDO ALLAHYAR DISTRICT,41,Female,2681,1338,4019
TANDO ALLAHYAR DISTRICT,41,Transgender,0,1,1
TANDO ALLAHYAR DISTRICT,42,Male,2423,1257,3680
TANDO ALLAHYAR DISTRICT,42,Female,2661,1312,3973
TANDO ALLAHYAR DISTRICT,42,Transgender,1,0,1
TANDO ALLAHYAR DISTRICT,43,Male,2345,1187,3532
TANDO ALLAHYAR DISTRICT,43,Female,2210,1116,3326
TANDO ALLAHYAR DISTRICT,43,Transgender,0,0,0
TANDO ALLAHYAR DISTRICT,44,Male,2232,1282,3514
TANDO ALLAHYAR DISTRICT,44,Female,2123,1083,3206
TANDO ALLAHYAR DISTRICT,44,Transgender,1,1,2
TANDO ALLAHYAR DISTRICT,45,Male,1946,1044,2990
TANDO ALLAHYAR DISTRICT,45,Female,1780,931,2711
TANDO ALLAHYAR DISTRICT,45,Transgender,3,4,7
TANDO ALLAHYAR DISTRICT,46,Male,2207,1151,3358
TANDO ALLAHYAR DISTRICT,46,Female,1982,1020,3002
TANDO ALLAHYAR DISTRICT,46,Transgender,1,1,2
TANDO ALLAHYAR DISTRICT,47,Male,2526,1205,3731
TANDO ALLAHYAR DISTRICT,47,Female,2614,1144,3758
TANDO ALLAHYAR DISTRICT,47,Transgender,2,1,3
TANDO ALLAHYAR DISTRICT,48,Male,2038,1097,3135
TANDO ALLAHYAR DISTRICT,48,Female,1856,984,2840
TANDO ALLAHYAR DISTRICT,48,Transgender,0,2,2
TANDO ALLAHYAR DISTRICT,49,Male,2175,1207,3382
TANDO ALLAHYAR DISTRICT,49,Female,1994,1034,3028
TANDO ALLAHYAR DISTRICT,49,Transgender,1,1,2
TANDO ALLAHYAR DISTRICT,50,Male,1669,916,2585
TANDO ALLAHYAR DISTRICT,50,Female,1274,737,2011
TANDO ALLAHYAR DISTRICT,50,Transgender,1,0,1
TANDO ALLAHYAR DISTRICT,51,Male,1834,1020,2854
TANDO ALLAHYAR DISTRICT,51,Female,1560,862,2422
TANDO ALLAHYAR DISTRICT,51,Transgender,0,0,0
TANDO ALLAHYAR DISTRICT,52,Male,1613,814,2427
TANDO ALLAHYAR DISTRICT,52,Female,1413,728,2141
TANDO ALLAHYAR DISTRICT,52,Transgender,0,1,1
TANDO ALLAHYAR DISTRICT,53,Male,1408,815,2223
TANDO ALLAHYAR DISTRICT,53,Female,1079,653,1732
TANDO ALLAHYAR DISTRICT,53,Transgender,0,1,1
TANDO ALLAHYAR DISTRICT,54,Male,1201,691,1892
TANDO ALLAHYAR DISTRICT,54,Female,911,586,1497
TANDO ALLAHYAR DISTRICT,54,Transgender,0,1,1
TANDO ALLAHYAR DISTRICT,55,Male,998,586,1584
TANDO ALLAHYAR DISTRICT,55,Female,872,479,1351
TANDO ALLAHYAR DISTRICT,55,Transgender,2,0,2
TANDO ALLAHYAR DISTRICT,56,Male,920,575,1495
TANDO ALLAHYAR DISTRICT,56,Female,896,503,1399
TANDO ALLAHYAR DISTRICT,56,Transgender,1,1,2
TANDO ALLAHYAR DISTRICT,57,Male,1068,542,1610
TANDO ALLAHYAR DISTRICT,57,Female,1426,595,2021
TANDO ALLAHYAR DISTRICT,57,Transgender,2,1,3
TANDO ALLAHYAR DISTRICT,58,Male,890,477,1367
TANDO ALLAHYAR DISTRICT,58,Female,931,503,1434
TANDO ALLAHYAR DISTRICT,58,Transgender,1,0,1
TANDO ALLAHYAR DISTRICT,59,Male,1111,551,1662
TANDO ALLAHYAR DISTRICT,59,Female,1147,541,1688
TANDO ALLAHYAR DISTRICT,59,Transgender,0,0,0
TANDO ALLAHYAR DISTRICT,60,Male,910,431,1341
TANDO ALLAHYAR DISTRICT,60,Female,893,387,1280
TANDO ALLAHYAR DISTRICT,60,Transgender,3,0,3
TANDO ALLAHYAR DISTRICT,61,Male,1018,518,1536
TANDO ALLAHYAR DISTRICT,61,Female,1047,539,1586
TANDO ALLAHYAR DISTRICT,61,Transgender,1,0,1
TANDO ALLAHYAR DISTRICT,62,Male,896,465,1361
TANDO ALLAHYAR DISTRICT,62,Female,1025,456,1481
TANDO ALLAHYAR DISTRICT,62,Transgender,0,0,0
TANDO ALLAHYAR DISTRICT,63,Male,853,442,1295
TANDO ALLAHYAR DISTRICT,63,Female,865,443,1308
TANDO ALLAHYAR DISTRICT,63,Transgender,0,0,0
TANDO ALLAHYAR DISTRICT,64,Male,899,454,1353
TANDO ALLAHYAR DISTRICT,64,Female,914,419,1333
TANDO ALLAHYAR DISTRICT,64,Transgender,0,0,0
TANDO ALLAHYAR DISTRICT,65,Male,753,364,1117
TANDO ALLAHYAR DISTRICT,65,Female,678,338,1016
TANDO ALLAHYAR DISTRICT,65,Transgender,1,1,2
TANDO ALLAHYAR DISTRICT,66,Male,736,336,1072
TANDO ALLAHYAR DISTRICT,66,Female,742,304,1046
TANDO ALLAHYAR DISTRICT,66,Transgender,0,1,1
TANDO ALLAHYAR DISTRICT,67,Male,618,317,935
TANDO ALLAHYAR DISTRICT,67,Female,778,317,1095
TANDO ALLAHYAR DISTRICT,67,Transgender,1,1,2
TANDO ALLAHYAR DISTRICT,68,Male,556,288,844
TANDO ALLAHYAR DISTRICT,68,Female,586,294,880
TANDO ALLAHYAR DISTRICT,68,Transgender,1,1,2
TANDO ALLAHYAR DISTRICT,69,Male,654,249,903
TANDO ALLAHYAR DISTRICT,69,Female,613,297,910
TANDO ALLAHYAR DISTRICT,69,Transgender,2,0,2
TANDO ALLAHYAR DISTRICT,70,Male,480,238,718
TANDO ALLAHYAR DISTRICT,70,Female,496,222,718
TANDO ALLAHYAR DISTRICT,70,Transgender,1,1,2
TANDO ALLAHYAR DISTRICT,71,Male,507,233,740
TANDO ALLAHYAR DISTRICT,71,Female,538,230,768
TANDO ALLAHYAR DISTRICT,71,Transgender,0,0,0
TANDO ALLAHYAR DISTRICT,72,Male,354,173,527
TANDO ALLAHYAR DISTRICT,72,Female,444,210,654
TANDO ALLAHYAR DISTRICT,72,Transgender,0,0,0
TANDO ALLAHYAR DISTRICT,73,Male,348,193,541
TANDO ALLAHYAR DISTRICT,73,Female,379,201,580
TANDO ALLAHYAR DISTRICT,73,Transgender,0,0,0
TANDO ALLAHYAR DISTRICT,74,Male,366,138,504
TANDO ALLAHYAR DISTRICT,74,Female,356,163,519
TANDO ALLAHYAR DISTRICT,74,Transgender,0,0,0
TANDO ALLAHYAR DISTRICT,>=75,Male,2321,1022,3343
TANDO ALLAHYAR DISTRICT,>=75,Female,2579,1227,3806
TANDO ALLAHYAR DISTRICT,>=75,Transgender,2,2,4
TANDO MUHAMMAD KHAN DISTRICT,<1,Male,6242,1518,7760
TANDO MUHAMMAD KHAN DISTRICT,<1,Female,5849,1489,7338
TANDO MUHAMMAD KHAN DISTRICT,<1,Transgender,0,0,0
TANDO MUHAMMAD KHAN DISTRICT,1,Male,7417,1736,9153
TANDO MUHAMMAD KHAN DISTRICT,1,Female,7187,1719,8906
TANDO MUHAMMAD KHAN DISTRICT,1,Transgender,0,0,0
TANDO MUHAMMAD KHAN DISTRICT,2,Male,8838,1999,10837
TANDO MUHAMMAD KHAN DISTRICT,2,Female,8807,1922,10729
TANDO MUHAMMAD KHAN DISTRICT,2,Transgender,0,0,0
TANDO MUHAMMAD KHAN DISTRICT,3,Male,9798,2333,12131
TANDO MUHAMMAD KHAN DISTRICT,3,Female,9648,2161,11809
TANDO MUHAMMAD KHAN DISTRICT,3,Transgender,0,0,0
TANDO MUHAMMAD KHAN DISTRICT,4,Male,10245,2181,12426
TANDO MUHAMMAD KHAN DISTRICT,4,Female,10045,2081,12126
TANDO MUHAMMAD KHAN DISTRICT,4,Transgender,0,0,0
TANDO MUHAMMAD KHAN DISTRICT,5,Male,10242,2336,12578
TANDO MUHAMMAD KHAN DISTRICT,5,Female,9613,2152,11765
TANDO MUHAMMAD KHAN DISTRICT,5,Transgender,0,0,0
TANDO MUHAMMAD KHAN DISTRICT,6,Male,10039,2186,12225
TANDO MUHAMMAD KHAN DISTRICT,6,Female,9296,1940,11236
TANDO MUHAMMAD KHAN DISTRICT,6,Transgender,0,0,0
TANDO MUHAMMAD KHAN DISTRICT,7,Male,8953,2258,11211
TANDO MUHAMMAD KHAN DISTRICT,7,Female,7964,2015,9979
TANDO MUHAMMAD KHAN DISTRICT,7,Transgender,0,0,0
TANDO MUHAMMAD KHAN DISTRICT,8,Male,10588,2170,12758
TANDO MUHAMMAD KHAN DISTRICT,8,Female,9577,2007,11584
TANDO MUHAMMAD KHAN DISTRICT,8,Transgender,0,0,0
TANDO MUHAMMAD KHAN DISTRICT,9,Male,7355,1991,9346
TANDO MUHAMMAD KHAN DISTRICT,9,Female,6620,1767,8387
TANDO MUHAMMAD KHAN DISTRICT,9,Transgender,0,0,0
TANDO MUHAMMAD KHAN DISTRICT,10,Male,9566,1988,11554
TANDO MUHAMMAD KHAN DISTRICT,10,Female,8277,1682,9959
TANDO MUHAMMAD KHAN DISTRICT,10,Transgender,0,0,0
TANDO MUHAMMAD KHAN DISTRICT,11,Male,6118,1707,7825
TANDO MUHAMMAD KHAN DISTRICT,11,Female,5041,1524,6565
TANDO MUHAMMAD KHAN DISTRICT,11,Transgender,0,0,0
TANDO MUHAMMAD KHAN DISTRICT,12,Male,7339,1704,9043
TANDO MUHAMMAD KHAN DISTRICT,12,Female,6100,1496,7596
TANDO MUHAMMAD KHAN DISTRICT,12,Transgender,0,0,0
TANDO MUHAMMAD KHAN DISTRICT,13,Male,5568,1582,7150
TANDO MUHAMMAD KHAN DISTRICT,13,Female,4522,1447,5969
TANDO MUHAMMAD KHAN DISTRICT,13,Transgender,0,0,0
TANDO MUHAMMAD KHAN DISTRICT,14,Male,5666,1482,7148
TANDO MUHAMMAD KHAN DISTRICT,14,Female,5020,1365,6385
TANDO MUHAMMAD KHAN DISTRICT,14,Transgender,0,0,0
TANDO MUHAMMAD KHAN DISTRICT,15,Male,6197,1714,7911
TANDO MUHAMMAD KHAN DISTRICT,15,Female,4900,1460,6360
TANDO MUHAMMAD KHAN DISTRICT,15,Transgender,4,1,5
TANDO MUHAMMAD KHAN DISTRICT,16,Male,5712,1552,7264
TANDO MUHAMMAD KHAN DISTRICT,16,Female,4749,1465,6214
TANDO MUHAMMAD KHAN DISTRICT,16,Transgender,1,0,1
TANDO MUHAMMAD KHAN DISTRICT,17,Male,4846,1584,6430
TANDO MUHAMMAD KHAN DISTRICT,17,Female,4026,1364,5390
TANDO MUHAMMAD KHAN DISTRICT,17,Transgender,0,0,0
TANDO MUHAMMAD KHAN DISTRICT,18,Male,6257,1599,7856
TANDO MUHAMMAD KHAN DISTRICT,18,Female,6036,1542,7578
TANDO MUHAMMAD KHAN DISTRICT,18,Transgender,2,0,2
TANDO MUHAMMAD KHAN DISTRICT,19,Male,4500,1417,5917
TANDO MUHAMMAD KHAN DISTRICT,19,Female,4888,1421,6309
TANDO MUHAMMAD KHAN DISTRICT,19,Transgender,1,0,1
TANDO MUHAMMAD KHAN DISTRICT,20,Male,6365,1567,7932
TANDO MUHAMMAD KHAN DISTRICT,20,Female,5753,1407,7160
TANDO MUHAMMAD KHAN DISTRICT,20,Transgender,4,1,5
TANDO MUHAMMAD KHAN DISTRICT,21,Male,3873,1280,5153
TANDO MUHAMMAD KHAN DISTRICT,21,Female,3954,1289,5243
TANDO MUHAMMAD KHAN DISTRICT,21,Transgender,0,0,0
TANDO MUHAMMAD KHAN DISTRICT,22,Male,4436,1327,5763
TANDO MUHAMMAD KHAN DISTRICT,22,Female,3944,1187,5131
TANDO MUHAMMAD KHAN DISTRICT,22,Transgender,1,1,2
TANDO MUHAMMAD KHAN DISTRICT,23,Male,3358,1139,4497
TANDO MUHAMMAD KHAN DISTRICT,23,Female,3510,1144,4654
TANDO MUHAMMAD KHAN DISTRICT,23,Transgender,2,0,2
TANDO MUHAMMAD KHAN DISTRICT,24,Male,3077,1042,4119
TANDO MUHAMMAD KHAN DISTRICT,24,Female,3359,1074,4433
TANDO MUHAMMAD KHAN DISTRICT,24,Transgender,0,0,0
TANDO MUHAMMAD KHAN DISTRICT,25,Male,4729,1235,5964
TANDO MUHAMMAD KHAN DISTRICT,25,Female,4416,1155,5571
TANDO MUHAMMAD KHAN DISTRICT,25,Transgender,4,0,4
TANDO MUHAMMAD KHAN DISTRICT,26,Male,3561,1144,4705
TANDO MUHAMMAD KHAN DISTRICT,26,Female,3812,1089,4901
TANDO MUHAMMAD KHAN DISTRICT,26,Transgender,0,1,1
TANDO MUHAMMAD KHAN DISTRICT,27,Male,3818,1164,4982
TANDO MUHAMMAD KHAN DISTRICT,27,Female,4171,1274,5445
TANDO MUHAMMAD KHAN DISTRICT,27,Transgender,2,1,3
TANDO MUHAMMAD KHAN DISTRICT,28,Male,3888,1087,4975
TANDO MUHAMMAD KHAN DISTRICT,28,Female,4370,1194,5564
TANDO MUHAMMAD KHAN DISTRICT,28,Transgender,4,0,4
TANDO MUHAMMAD KHAN DISTRICT,29,Male,3975,1199,5174
TANDO MUHAMMAD KHAN DISTRICT,29,Female,4315,1259,5574
TANDO MUHAMMAD KHAN DISTRICT,29,Transgender,1,1,2
TANDO MUHAMMAD KHAN DISTRICT,30,Male,4216,1067,5283
TANDO MUHAMMAD KHAN DISTRICT,30,Female,4000,1057,5057
TANDO MUHAMMAD KHAN DISTRICT,30,Transgender,5,1,6
TANDO MUHAMMAD KHAN DISTRICT,31,Male,3576,1197,4773
TANDO MUHAMMAD KHAN DISTRICT,31,Female,3918,1074,4992
TANDO MUHAMMAD KHAN DISTRICT,31,Transgender,2,1,3
TANDO MUHAMMAD KHAN DISTRICT,32,Male,3577,1065,4642
TANDO MUHAMMAD KHAN DISTRICT,32,Female,3504,1010,4514
TANDO MUHAMMAD KHAN DISTRICT,32,Transgender,3,0,3
TANDO MUHAMMAD KHAN DISTRICT,33,Male,3281,1023,4304
TANDO MUHAMMAD KHAN DISTRICT,33,Female,3324,924,4248
TANDO MUHAMMAD KHAN DISTRICT,33,Transgender,0,0,0
TANDO MUHAMMAD KHAN DISTRICT,34,Male,2834,904,3738
TANDO MUHAMMAD KHAN DISTRICT,34,Female,3112,881,3993
TANDO MUHAMMAD KHAN DISTRICT,34,Transgender,2,0,2
TANDO MUHAMMAD KHAN DISTRICT,35,Male,3665,902,4567
TANDO MUHAMMAD KHAN DISTRICT,35,Female,3197,842,4039
TANDO MUHAMMAD KHAN DISTRICT,35,Transgender,0,0,0
TANDO MUHAMMAD KHAN DISTRICT,36,Male,3470,943,4413
TANDO MUHAMMAD KHAN DISTRICT,36,Female,3128,908,4036
TANDO MUHAMMAD KHAN DISTRICT,36,Transgender,0,1,1
TANDO MUHAMMAD KHAN DISTRICT,37,Male,4464,1089,5553
TANDO MUHAMMAD KHAN DISTRICT,37,Female,3868,1031,4899
TANDO MUHAMMAD KHAN DISTRICT,37,Transgender,1,0,1
TANDO MUHAMMAD KHAN DISTRICT,38,Male,2942,910,3852
TANDO MUHAMMAD KHAN DISTRICT,38,Female,2797,830,3627
TANDO MUHAMMAD KHAN DISTRICT,38,Transgender,0,1,1
TANDO MUHAMMAD KHAN DISTRICT,39,Male,3436,960,4396
TANDO MUHAMMAD KHAN DISTRICT,39,Female,3002,831,3833
TANDO MUHAMMAD KHAN DISTRICT,39,Transgender,0,1,1
TANDO MUHAMMAD KHAN DISTRICT,40,Male,2661,768,3429
TANDO MUHAMMAD KHAN DISTRICT,40,Female,2439,618,3057
TANDO MUHAMMAD KHAN DISTRICT,40,Transgender,4,1,5
TANDO MUHAMMAD KHAN DISTRICT,41,Male,2623,756,3379
TANDO MUHAMMAD KHAN DISTRICT,41,Female,2550,703,3253
TANDO MUHAMMAD KHAN DISTRICT,41,Transgender,1,1,2
TANDO MUHAMMAD KHAN DISTRICT,42,Male,2530,711,3241
TANDO MUHAMMAD KHAN DISTRICT,42,Female,2473,687,3160
TANDO MUHAMMAD KHAN DISTRICT,42,Transgender,2,0,2
TANDO MUHAMMAD KHAN DISTRICT,43,Male,2096,605,2701
TANDO MUHAMMAD KHAN DISTRICT,43,Female,2039,620,2659
TANDO MUHAMMAD KHAN DISTRICT,43,Transgender,0,0,0
TANDO MUHAMMAD KHAN DISTRICT,44,Male,1951,726,2677
TANDO MUHAMMAD KHAN DISTRICT,44,Female,1901,609,2510
TANDO MUHAMMAD KHAN DISTRICT,44,Transgender,0,0,0
TANDO MUHAMMAD KHAN DISTRICT,45,Male,2049,594,2643
TANDO MUHAMMAD KHAN DISTRICT,45,Female,1821,496,2317
TANDO MUHAMMAD KHAN DISTRICT,45,Transgender,1,0,1
TANDO MUHAMMAD KHAN DISTRICT,46,Male,2142,665,2807
TANDO MUHAMMAD KHAN DISTRICT,46,Female,1950,546,2496
TANDO MUHAMMAD KHAN DISTRICT,46,Transgender,2,0,2
TANDO MUHAMMAD KHAN DISTRICT,47,Male,2377,634,3011
TANDO MUHAMMAD KHAN DISTRICT,47,Female,2310,618,2928
TANDO MUHAMMAD KHAN DISTRICT,47,Transgender,0,1,1
TANDO MUHAMMAD KHAN DISTRICT,48,Male,1935,572,2507
TANDO MUHAMMAD KHAN DISTRICT,48,Female,1624,545,2169
TANDO MUHAMMAD KHAN DISTRICT,48,Transgender,0,0,0
TANDO MUHAMMAD KHAN DISTRICT,49,Male,1987,632,2619
TANDO MUHAMMAD KHAN DISTRICT,49,Female,1698,509,2207
TANDO MUHAMMAD KHAN DISTRICT,49,Transgender,0,0,0
TANDO MUHAMMAD KHAN DISTRICT,50,Male,1763,518,2281
TANDO MUHAMMAD KHAN DISTRICT,50,Female,1413,411,1824
TANDO MUHAMMAD KHAN DISTRICT,50,Transgender,2,0,2
TANDO MUHAMMAD KHAN DISTRICT,51,Male,1677,511,2188
TANDO MUHAMMAD KHAN DISTRICT,51,Female,1391,506,1897
TANDO MUHAMMAD KHAN DISTRICT,51,Transgender,0,0,0
TANDO MUHAMMAD KHAN DISTRICT,52,Male,1444,495,1939
TANDO MUHAMMAD KHAN DISTRICT,52,Female,1277,447,1724
TANDO MUHAMMAD KHAN DISTRICT,52,Transgender,2,0,2
TANDO MUHAMMAD KHAN DISTRICT,53,Male,1182,471,1653
TANDO MUHAMMAD KHAN DISTRICT,53,Female,1013,325,1338
TANDO MUHAMMAD KHAN DISTRICT,53,Transgender,0,1,1
TANDO MUHAMMAD KHAN DISTRICT,54,Male,1065,389,1454
TANDO MUHAMMAD KHAN DISTRICT,54,Female,914,291,1205
TANDO MUHAMMAD KHAN DISTRICT,54,Transgender,1,0,1
TANDO MUHAMMAD KHAN DISTRICT,55,Male,1095,365,1460
TANDO MUHAMMAD KHAN DISTRICT,55,Female,1018,290,1308
TANDO MUHAMMAD KHAN DISTRICT,55,Transgender,3,0,3
TANDO MUHAMMAD KHAN DISTRICT,56,Male,920,328,1248
TANDO MUHAMMAD KHAN DISTRICT,56,Female,967,299,1266
TANDO MUHAMMAD KHAN DISTRICT,56,Transgender,0,0,0
TANDO MUHAMMAD KHAN DISTRICT,57,Male,1056,336,1392
TANDO MUHAMMAD KHAN DISTRICT,57,Female,1430,383,1813
TANDO MUHAMMAD KHAN DISTRICT,57,Transgender,0,0,0
TANDO MUHAMMAD KHAN DISTRICT,58,Male,915,310,1225
TANDO MUHAMMAD KHAN DISTRICT,58,Female,940,272,1212
TANDO MUHAMMAD KHAN DISTRICT,58,Transgender,1,0,1
TANDO MUHAMMAD KHAN DISTRICT,59,Male,1041,318,1359
TANDO MUHAMMAD KHAN DISTRICT,59,Female,1043,323,1366
TANDO MUHAMMAD KHAN DISTRICT,59,Transgender,0,0,0
TANDO MUHAMMAD KHAN DISTRICT,60,Male,1061,267,1328
TANDO MUHAMMAD KHAN DISTRICT,60,Female,926,223,1149
TANDO MUHAMMAD KHAN DISTRICT,60,Transgender,1,1,2
TANDO MUHAMMAD KHAN DISTRICT,61,Male,971,310,1281
TANDO MUHAMMAD KHAN DISTRICT,61,Female,1052,327,1379
TANDO MUHAMMAD KHAN DISTRICT,61,Transgender,1,0,1
TANDO MUHAMMAD KHAN DISTRICT,62,Male,860,285,1145
TANDO MUHAMMAD KHAN DISTRICT,62,Female,1072,296,1368
TANDO MUHAMMAD KHAN DISTRICT,62,Transgender,1,0,1
TANDO MUHAMMAD KHAN DISTRICT,63,Male,896,256,1152
TANDO MUHAMMAD KHAN DISTRICT,63,Female,898,245,1143
TANDO MUHAMMAD KHAN DISTRICT,63,Transgender,0,0,0
TANDO MUHAMMAD KHAN DISTRICT,64,Male,1032,245,1277
TANDO MUHAMMAD KHAN DISTRICT,64,Female,913,236,1149
TANDO MUHAMMAD KHAN DISTRICT,64,Transgender,1,0,1
TANDO MUHAMMAD KHAN DISTRICT,65,Male,984,204,1188
TANDO MUHAMMAD KHAN DISTRICT,65,Female,850,200,1050
TANDO MUHAMMAD KHAN DISTRICT,65,Transgender,2,0,2
TANDO MUHAMMAD KHAN DISTRICT,66,Male,712,219,931
TANDO MUHAMMAD KHAN DISTRICT,66,Female,731,168,899
TANDO MUHAMMAD KHAN DISTRICT,66,Transgender,0,0,0
TANDO MUHAMMAD KHAN DISTRICT,67,Male,611,179,790
TANDO MUHAMMAD KHAN DISTRICT,67,Female,808,201,1009
TANDO MUHAMMAD KHAN DISTRICT,67,Transgender,0,0,0
TANDO MUHAMMAD KHAN DISTRICT,68,Male,624,159,783
TANDO MUHAMMAD KHAN DISTRICT,68,Female,608,163,771
TANDO MUHAMMAD KHAN DISTRICT,68,Transgender,0,0,0
TANDO MUHAMMAD KHAN DISTRICT,69,Male,716,163,879
TANDO MUHAMMAD KHAN DISTRICT,69,Female,661,146,807
TANDO MUHAMMAD KHAN DISTRICT,69,Transgender,1,0,1
TANDO MUHAMMAD KHAN DISTRICT,70,Male,593,140,733
TANDO MUHAMMAD KHAN DISTRICT,70,Female,521,142,663
TANDO MUHAMMAD KHAN DISTRICT,70,Transgender,1,0,1
TANDO MUHAMMAD KHAN DISTRICT,71,Male,452,164,616
TANDO MUHAMMAD KHAN DISTRICT,71,Female,496,143,639
TANDO MUHAMMAD KHAN DISTRICT,71,Transgender,0,1,1
TANDO MUHAMMAD KHAN DISTRICT,72,Male,383,126,509
TANDO MUHAMMAD KHAN DISTRICT,72,Female,451,135,586
TANDO MUHAMMAD KHAN DISTRICT,72,Transgender,0,0,0
TANDO MUHAMMAD KHAN DISTRICT,73,Male,398,122,520
TANDO MUHAMMAD KHAN DISTRICT,73,Female,376,120,496
TANDO MUHAMMAD KHAN DISTRICT,73,Transgender,0,0,0
TANDO MUHAMMAD KHAN DISTRICT,74,Male,411,90,501
TANDO MUHAMMAD KHAN DISTRICT,74,Female,373,87,460
TANDO MUHAMMAD KHAN DISTRICT,74,Transgender,0,0,0
TANDO MUHAMMAD KHAN DISTRICT,>=75,Male,2394,574,2968
TANDO MUHAMMAD KHAN DISTRICT,>=75,Female,2791,722,3513
TANDO MUHAMMAD KHAN DISTRICT,>=75,Transgender,4,1,5
TANK DISTRICT,<1,Male,5117,575,5692
TANK DISTRICT,<1,Female,5008,516,5524
TANK DISTRICT,<1,Transgender,0,0,0
TANK DISTRICT,1,Male,5668,653,6321
TANK DISTRICT,1,Female,5328,557,5885
TANK DISTRICT,1,Transgender,0,0,0
TANK DISTRICT,2,Male,6558,740,7298
TANK DISTRICT,2,Female,6542,697,7239
TANK DISTRICT,2,Transgender,0,0,0
TANK DISTRICT,3,Male,6852,822,7674
TANK DISTRICT,3,Female,6553,705,7258
TANK DISTRICT,3,Transgender,0,0,0
TANK DISTRICT,4,Male,7035,745,7780
TANK DISTRICT,4,Female,6635,672,7307
TANK DISTRICT,4,Transgender,0,0,0
TANK DISTRICT,5,Male,6794,850,7644
TANK DISTRICT,5,Female,6172,712,6884
TANK DISTRICT,5,Transgender,0,0,0
TANK DISTRICT,6,Male,6676,709,7385
TANK DISTRICT,6,Female,5915,654,6569
TANK DISTRICT,6,Transgender,0,0,0
TANK DISTRICT,7,Male,6494,783,7277
TANK DISTRICT,7,Female,5778,683,6461
TANK DISTRICT,7,Transgender,0,0,0
TANK DISTRICT,8,Male,6536,689,7225
TANK DISTRICT,8,Female,5702,644,6346
TANK DISTRICT,8,Transgender,0,0,0
TANK DISTRICT,9,Male,6016,704,6720
TANK DISTRICT,9,Female,5180,648,5828
TANK DISTRICT,9,Transgender,0,0,0
TANK DISTRICT,10,Male,5743,687,6430
TANK DISTRICT,10,Female,4985,571,5556
TANK DISTRICT,10,Transgender,0,0,0
TANK DISTRICT,11,Male,4951,696,5647
TANK DISTRICT,11,Female,4104,552,4656
TANK DISTRICT,11,Transgender,0,0,0
TANK DISTRICT,12,Male,4657,656,5313
TANK DISTRICT,12,Female,4196,498,4694
TANK DISTRICT,12,Transgender,0,0,0
TANK DISTRICT,13,Male,4467,626,5093
TANK DISTRICT,13,Female,3806,548,4354
TANK DISTRICT,13,Transgender,0,0,0
TANK DISTRICT,14,Male,4291,587,4878
TANK DISTRICT,14,Female,3692,439,4131
TANK DISTRICT,14,Transgender,0,0,0
TANK DISTRICT,15,Male,3812,574,4386
TANK DISTRICT,15,Female,3506,549,4055
TANK DISTRICT,15,Transgender,0,0,0
TANK DISTRICT,16,Male,3564,575,4139
TANK DISTRICT,16,Female,3261,498,3759
TANK DISTRICT,16,Transgender,1,0,1
TANK DISTRICT,17,Male,3440,506,3946
TANK DISTRICT,17,Female,3295,514,3809
TANK DISTRICT,17,Transgender,0,0,0
TANK DISTRICT,18,Male,3169,449,3618
TANK DISTRICT,18,Female,2920,428,3348
TANK DISTRICT,18,Transgender,0,0,0
TANK DISTRICT,19,Male,3174,460,3634
TANK DISTRICT,19,Female,2653,420,3073
TANK DISTRICT,19,Transgender,1,0,1
TANK DISTRICT,20,Male,3000,406,3406
TANK DISTRICT,20,Female,3187,422,3609
TANK DISTRICT,20,Transgender,0,0,0
TANK DISTRICT,21,Male,2537,447,2984
TANK DISTRICT,21,Female,2727,451,3178
TANK DISTRICT,21,Transgender,2,0,2
TANK DISTRICT,22,Male,2426,413,2839
TANK DISTRICT,22,Female,2453,397,2850
TANK DISTRICT,22,Transgender,2,0,2
TANK DISTRICT,23,Male,2395,463,2858
TANK DISTRICT,23,Female,2661,385,3046
TANK DISTRICT,23,Transgender,0,0,0
TANK DISTRICT,24,Male,2398,418,2816
TANK DISTRICT,24,Female,3005,360,3365
TANK DISTRICT,24,Transgender,1,0,1
TANK DISTRICT,25,Male,2673,419,3092
TANK DISTRICT,25,Female,3235,427,3662
TANK DISTRICT,25,Transgender,0,0,0
TANK DISTRICT,26,Male,2508,503,3011
TANK DISTRICT,26,Female,2707,432,3139
TANK DISTRICT,26,Transgender,1,0,1
TANK DISTRICT,27,Male,2495,403,2898
TANK DISTRICT,27,Female,3127,429,3556
TANK DISTRICT,27,Transgender,1,0,1
TANK DISTRICT,28,Male,2384,396,2780
TANK DISTRICT,28,Female,2294,346,2640
TANK DISTRICT,28,Transgender,0,0,0
TANK DISTRICT,29,Male,2134,390,2524
TANK DISTRICT,29,Female,2510,361,2871
TANK DISTRICT,29,Transgender,0,0,0
TANK DISTRICT,30,Male,2224,360,2584
TANK DISTRICT,30,Female,2343,356,2699
TANK DISTRICT,30,Transgender,1,0,1
TANK DISTRICT,31,Male,1928,345,2273
TANK DISTRICT,31,Female,2195,326,2521
TANK DISTRICT,31,Transgender,1,0,1
TANK DISTRICT,32,Male,1703,334,2037
TANK DISTRICT,32,Female,1868,309,2177
TANK DISTRICT,32,Transgender,2,0,2
TANK DISTRICT,33,Male,1660,324,1984
TANK DISTRICT,33,Female,1679,269,1948
TANK DISTRICT,33,Transgender,0,0,0
TANK DISTRICT,34,Male,1586,287,1873
TANK DISTRICT,34,Female,1473,286,1759
TANK DISTRICT,34,Transgender,0,0,0
TANK DISTRICT,35,Male,1779,292,2071
TANK DISTRICT,35,Female,1723,248,1971
TANK DISTRICT,35,Transgender,0,0,0
TANK DISTRICT,36,Male,1477,287,1764
TANK DISTRICT,36,Female,1527,237,1764
TANK DISTRICT,36,Transgender,0,0,0
TANK DISTRICT,37,Male,1366,246,1612
TANK DISTRICT,37,Female,1693,221,1914
TANK DISTRICT,37,Transgender,0,0,0
TANK DISTRICT,38,Male,1461,271,1732
TANK DISTRICT,38,Female,1360,218,1578
TANK DISTRICT,38,Transgender,0,1,1
TANK DISTRICT,39,Male,1384,257,1641
TANK DISTRICT,39,Female,1374,235,1609
TANK DISTRICT,39,Transgender,2,0,2
TANK DISTRICT,40,Male,1398,230,1628
TANK DISTRICT,40,Female,1612,219,1831
TANK DISTRICT,40,Transgender,2,0,2
TANK DISTRICT,41,Male,1226,218,1444
TANK DISTRICT,41,Female,1350,187,1537
TANK DISTRICT,41,Transgender,0,0,0
TANK DISTRICT,42,Male,1153,196,1349
TANK DISTRICT,42,Female,1239,208,1447
TANK DISTRICT,42,Transgender,2,0,2
TANK DISTRICT,43,Male,1140,207,1347
TANK DISTRICT,43,Female,1149,174,1323
TANK DISTRICT,43,Transgender,0,0,0
TANK DISTRICT,44,Male,1058,193,1251
TANK DISTRICT,44,Female,1061,160,1221
TANK DISTRICT,44,Transgender,0,0,0
TANK DISTRICT,45,Male,994,168,1162
TANK DISTRICT,45,Female,1138,163,1301
TANK DISTRICT,45,Transgender,0,1,1
TANK DISTRICT,46,Male,946,187,1133
TANK DISTRICT,46,Female,1043,137,1180
TANK DISTRICT,46,Transgender,0,0,0
TANK DISTRICT,47,Male,979,197,1176
TANK DISTRICT,47,Female,1229,163,1392
TANK DISTRICT,47,Transgender,0,0,0
TANK DISTRICT,48,Male,1039,154,1193
TANK DISTRICT,48,Female,1033,166,1199
TANK DISTRICT,48,Transgender,0,0,0
TANK DISTRICT,49,Male,1053,168,1221
TANK DISTRICT,49,Female,966,162,1128
TANK DISTRICT,49,Transgender,0,0,0
TANK DISTRICT,50,Male,1137,184,1321
TANK DISTRICT,50,Female,1116,173,1289
TANK DISTRICT,50,Transgender,0,0,0
TANK DISTRICT,51,Male,1031,150,1181
TANK DISTRICT,51,Female,1012,146,1158
TANK DISTRICT,51,Transgender,0,0,0
TANK DISTRICT,52,Male,919,158,1077
TANK DISTRICT,52,Female,858,125,983
TANK DISTRICT,52,Transgender,0,0,0
TANK DISTRICT,53,Male,996,142,1138
TANK DISTRICT,53,Female,811,124,935
TANK DISTRICT,53,Transgender,0,0,0
TANK DISTRICT,54,Male,930,109,1039
TANK DISTRICT,54,Female,780,109,889
TANK DISTRICT,54,Transgender,0,0,0
TANK DISTRICT,55,Male,824,111,935
TANK DISTRICT,55,Female,796,111,907
TANK DISTRICT,55,Transgender,3,0,3
TANK DISTRICT,56,Male,759,116,875
TANK DISTRICT,56,Female,668,92,760
TANK DISTRICT,56,Transgender,0,0,0
TANK DISTRICT,57,Male,712,91,803
TANK DISTRICT,57,Female,816,103,919
TANK DISTRICT,57,Transgender,0,0,0
TANK DISTRICT,58,Male,685,113,798
TANK DISTRICT,58,Female,618,74,692
TANK DISTRICT,58,Transgender,0,0,0
TANK DISTRICT,59,Male,750,106,856
TANK DISTRICT,59,Female,617,79,696
TANK DISTRICT,59,Transgender,0,0,0
TANK DISTRICT,60,Male,802,113,915
TANK DISTRICT,60,Female,751,90,841
TANK DISTRICT,60,Transgender,0,0,0
TANK DISTRICT,61,Male,722,94,816
TANK DISTRICT,61,Female,620,73,693
TANK DISTRICT,61,Transgender,1,0,1
TANK DISTRICT,62,Male,692,95,787
TANK DISTRICT,62,Female,659,80,739
TANK DISTRICT,62,Transgender,0,0,0
TANK DISTRICT,63,Male,631,114,745
TANK DISTRICT,63,Female,493,90,583
TANK DISTRICT,63,Transgender,0,0,0
TANK DISTRICT,64,Male,582,85,667
TANK DISTRICT,64,Female,518,70,588
TANK DISTRICT,64,Transgender,0,0,0
TANK DISTRICT,65,Male,517,73,590
TANK DISTRICT,65,Female,444,52,496
TANK DISTRICT,65,Transgender,0,0,0
TANK DISTRICT,66,Male,501,77,578
TANK DISTRICT,66,Female,432,68,500
TANK DISTRICT,66,Transgender,0,0,0
TANK DISTRICT,67,Male,560,63,623
TANK DISTRICT,67,Female,451,63,514
TANK DISTRICT,67,Transgender,1,0,1
TANK DISTRICT,68,Male,424,52,476
TANK DISTRICT,68,Female,334,58,392
TANK DISTRICT,68,Transgender,0,0,0
TANK DISTRICT,69,Male,422,39,461
TANK DISTRICT,69,Female,335,57,392
TANK DISTRICT,69,Transgender,0,0,0
TANK DISTRICT,70,Male,378,52,430
TANK DISTRICT,70,Female,318,34,352
TANK DISTRICT,70,Transgender,0,0,0
TANK DISTRICT,71,Male,370,70,440
TANK DISTRICT,71,Female,345,44,389
TANK DISTRICT,71,Transgender,0,0,0
TANK DISTRICT,72,Male,320,61,381
TANK DISTRICT,72,Female,305,49,354
TANK DISTRICT,72,Transgender,0,0,0
TANK DISTRICT,73,Male,276,35,311
TANK DISTRICT,73,Female,230,40,270
TANK DISTRICT,73,Transgender,0,0,0
TANK DISTRICT,74,Male,230,22,252
TANK DISTRICT,74,Female,183,28,211
TANK DISTRICT,74,Transgender,0,0,0
TANK DISTRICT,>=75,Male,1576,246,1822
TANK DISTRICT,>=75,Female,1571,235,1806
TANK DISTRICT,>=75,Transgender,1,0,1
THARPARKAR DISTRICT,<1,Male,34991,2096,37087
THARPARKAR DISTRICT,<1,Female,24109,1625,25734
THARPARKAR DISTRICT,<1,Transgender,0,0,0
THARPARKAR DISTRICT,1,Male,30090,2207,32297
THARPARKAR DISTRICT,1,Female,22558,1830,24388
THARPARKAR DISTRICT,1,Transgender,0,0,0
THARPARKAR DISTRICT,2,Male,38082,2318,40400
THARPARKAR DISTRICT,2,Female,29556,1982,31538
THARPARKAR DISTRICT,2,Transgender,0,0,0
THARPARKAR DISTRICT,3,Male,33744,2264,36008
THARPARKAR DISTRICT,3,Female,26406,2073,28479
THARPARKAR DISTRICT,3,Transgender,0,0,0
THARPARKAR DISTRICT,4,Male,35672,2279,37951
THARPARKAR DISTRICT,4,Female,28669,2066,30735
THARPARKAR DISTRICT,4,Transgender,0,0,0
THARPARKAR DISTRICT,5,Male,32105,2384,34489
THARPARKAR DISTRICT,5,Female,25675,1915,27590
THARPARKAR DISTRICT,5,Transgender,0,0,0
THARPARKAR DISTRICT,6,Male,34786,2179,36965
THARPARKAR DISTRICT,6,Female,27789,1901,29690
THARPARKAR DISTRICT,6,Transgender,0,0,0
THARPARKAR DISTRICT,7,Male,26413,2071,28484
THARPARKAR DISTRICT,7,Female,21123,1779,22902
THARPARKAR DISTRICT,7,Transgender,0,0,0
THARPARKAR DISTRICT,8,Male,34641,2232,36873
THARPARKAR DISTRICT,8,Female,28507,1950,30457
THARPARKAR DISTRICT,8,Transgender,0,0,0
THARPARKAR DISTRICT,9,Male,26962,2041,29003
THARPARKAR DISTRICT,9,Female,21576,1672,23248
THARPARKAR DISTRICT,9,Transgender,0,0,0
THARPARKAR DISTRICT,10,Male,29756,1956,31712
THARPARKAR DISTRICT,10,Female,25086,1613,26699
THARPARKAR DISTRICT,10,Transgender,0,0,0
THARPARKAR DISTRICT,11,Male,22359,1794,24153
THARPARKAR DISTRICT,11,Female,18591,1449,20040
THARPARKAR DISTRICT,11,Transgender,0,0,0
THARPARKAR DISTRICT,12,Male,23552,1742,25294
THARPARKAR DISTRICT,12,Female,19911,1547,21458
THARPARKAR DISTRICT,12,Transgender,0,0,0
THARPARKAR DISTRICT,13,Male,20397,1744,22141
THARPARKAR DISTRICT,13,Female,15641,1325,16966
THARPARKAR DISTRICT,13,Transgender,0,0,0
THARPARKAR DISTRICT,14,Male,20040,1582,21622
THARPARKAR DISTRICT,14,Female,15973,1232,17205
THARPARKAR DISTRICT,14,Transgender,0,0,0
THARPARKAR DISTRICT,15,Male,19413,1667,21080
THARPARKAR DISTRICT,15,Female,15532,1342,16874
THARPARKAR DISTRICT,15,Transgender,3,0,3
THARPARKAR DISTRICT,16,Male,16530,1388,17918
THARPARKAR DISTRICT,16,Female,13390,1182,14572
THARPARKAR DISTRICT,16,Transgender,3,0,3
THARPARKAR DISTRICT,17,Male,14629,1493,16122
THARPARKAR DISTRICT,17,Female,12267,1315,13582
THARPARKAR DISTRICT,17,Transgender,1,0,1
THARPARKAR DISTRICT,18,Male,13686,1215,14901
THARPARKAR DISTRICT,18,Female,13410,1282,14692
THARPARKAR DISTRICT,18,Transgender,3,1,4
THARPARKAR DISTRICT,19,Male,10617,1295,11912
THARPARKAR DISTRICT,19,Female,11436,1250,12686
THARPARKAR DISTRICT,19,Transgender,6,0,6
THARPARKAR DISTRICT,20,Male,12702,1218,13920
THARPARKAR DISTRICT,20,Female,12519,1185,13704
THARPARKAR DISTRICT,20,Transgender,10,0,10
THARPARKAR DISTRICT,21,Male,11070,1360,12430
THARPARKAR DISTRICT,21,Female,11428,1235,12663
THARPARKAR DISTRICT,21,Transgender,5,0,5
THARPARKAR DISTRICT,22,Male,10029,1120,11149
THARPARKAR DISTRICT,22,Female,9275,976,10251
THARPARKAR DISTRICT,22,Transgender,4,0,4
THARPARKAR DISTRICT,23,Male,9558,1243,10801
THARPARKAR DISTRICT,23,Female,9303,1099,10402
THARPARKAR DISTRICT,23,Transgender,4,0,4
THARPARKAR DISTRICT,24,Male,7883,1014,8897
THARPARKAR DISTRICT,24,Female,8121,873,8994
THARPARKAR DISTRICT,24,Transgender,3,0,3
THARPARKAR DISTRICT,25,Male,8695,901,9596
THARPARKAR DISTRICT,25,Female,8647,897,9544
THARPARKAR DISTRICT,25,Transgender,6,0,6
THARPARKAR DISTRICT,26,Male,7938,959,8897
THARPARKAR DISTRICT,26,Female,7879,886,8765
THARPARKAR DISTRICT,26,Transgender,3,0,3
THARPARKAR DISTRICT,27,Male,9361,1079,10440
THARPARKAR DISTRICT,27,Female,9887,1071,10958
THARPARKAR DISTRICT,27,Transgender,5,1,6
THARPARKAR DISTRICT,28,Male,7980,864,8844
THARPARKAR DISTRICT,28,Female,8830,898,9728
THARPARKAR DISTRICT,28,Transgender,0,2,2
THARPARKAR DISTRICT,29,Male,9500,1073,10573
THARPARKAR DISTRICT,29,Female,10561,1082,11643
THARPARKAR DISTRICT,29,Transgender,1,1,2
THARPARKAR DISTRICT,30,Male,7955,789,8744
THARPARKAR DISTRICT,30,Female,7352,706,8058
THARPARKAR DISTRICT,30,Transgender,9,0,9
THARPARKAR DISTRICT,31,Male,8875,1070,9945
THARPARKAR DISTRICT,31,Female,9462,1029,10491
THARPARKAR DISTRICT,31,Transgender,2,0,2
THARPARKAR DISTRICT,32,Male,8562,964,9526
THARPARKAR DISTRICT,32,Female,9313,1054,10367
THARPARKAR DISTRICT,32,Transgender,2,0,2
THARPARKAR DISTRICT,33,Male,7292,890,8182
THARPARKAR DISTRICT,33,Female,7683,751,8434
THARPARKAR DISTRICT,33,Transgender,2,0,2
THARPARKAR DISTRICT,34,Male,6936,806,7742
THARPARKAR DISTRICT,34,Female,7404,767,8171
THARPARKAR DISTRICT,34,Transgender,2,0,2
THARPARKAR DISTRICT,35,Male,7534,713,8247
THARPARKAR DISTRICT,35,Female,6341,608,6949
THARPARKAR DISTRICT,35,Transgender,5,1,6
THARPARKAR DISTRICT,36,Male,6967,716,7683
THARPARKAR DISTRICT,36,Female,6643,705,7348
THARPARKAR DISTRICT,36,Transgender,4,0,4
THARPARKAR DISTRICT,37,Male,10684,1069,11753
THARPARKAR DISTRICT,37,Female,11332,1219,12551
THARPARKAR DISTRICT,37,Transgender,5,1,6
THARPARKAR DISTRICT,38,Male,6273,720,6993
THARPARKAR DISTRICT,38,Female,6078,621,6699
THARPARKAR DISTRICT,38,Transgender,3,2,5
THARPARKAR DISTRICT,39,Male,8051,928,8979
THARPARKAR DISTRICT,39,Female,7859,826,8685
THARPARKAR DISTRICT,39,Transgender,5,0,5
THARPARKAR DISTRICT,40,Male,4946,558,5504
THARPARKAR DISTRICT,40,Female,4300,429,4729
THARPARKAR DISTRICT,40,Transgender,2,0,2
THARPARKAR DISTRICT,41,Male,5594,635,6229
THARPARKAR DISTRICT,41,Female,5641,659,6300
THARPARKAR DISTRICT,41,Transgender,0,0,0
THARPARKAR DISTRICT,42,Male,5349,534,5883
THARPARKAR DISTRICT,42,Female,6837,728,7565
THARPARKAR DISTRICT,42,Transgender,2,0,2
THARPARKAR DISTRICT,43,Male,4708,624,5332
THARPARKAR DISTRICT,43,Female,4141,491,4632
THARPARKAR DISTRICT,43,Transgender,3,0,3
THARPARKAR DISTRICT,44,Male,4721,639,5360
THARPARKAR DISTRICT,44,Female,4082,468,4550
THARPARKAR DISTRICT,44,Transgender,0,0,0
THARPARKAR DISTRICT,45,Male,3897,455,4352
THARPARKAR DISTRICT,45,Female,3350,361,3711
THARPARKAR DISTRICT,45,Transgender,3,1,4
THARPARKAR DISTRICT,46,Male,4308,488,4796
THARPARKAR DISTRICT,46,Female,3811,416,4227
THARPARKAR DISTRICT,46,Transgender,2,0,2
THARPARKAR DISTRICT,47,Male,5572,531,6103
THARPARKAR DISTRICT,47,Female,6653,668,7321
THARPARKAR DISTRICT,47,Transgender,1,0,1
THARPARKAR DISTRICT,48,Male,4239,511,4750
THARPARKAR DISTRICT,48,Female,3520,365,3885
THARPARKAR DISTRICT,48,Transgender,1,0,1
THARPARKAR DISTRICT,49,Male,5073,611,5684
THARPARKAR DISTRICT,49,Female,4047,457,4504
THARPARKAR DISTRICT,49,Transgender,0,0,0
THARPARKAR DISTRICT,50,Male,3586,408,3994
THARPARKAR DISTRICT,50,Female,2553,285,2838
THARPARKAR DISTRICT,50,Transgender,4,0,4
THARPARKAR DISTRICT,51,Male,4467,611,5078
THARPARKAR DISTRICT,51,Female,3415,404,3819
THARPARKAR DISTRICT,51,Transgender,2,0,2
THARPARKAR DISTRICT,52,Male,3557,425,3982
THARPARKAR DISTRICT,52,Female,3823,354,4177
THARPARKAR DISTRICT,52,Transgender,2,0,2
THARPARKAR DISTRICT,53,Male,3141,473,3614
THARPARKAR DISTRICT,53,Female,2226,282,2508
THARPARKAR DISTRICT,53,Transgender,0,0,0
THARPARKAR DISTRICT,54,Male,2944,377,3321
THARPARKAR DISTRICT,54,Female,2008,239,2247
THARPARKAR DISTRICT,54,Transgender,0,0,0
THARPARKAR DISTRICT,55,Male,2393,245,2638
THARPARKAR DISTRICT,55,Female,1774,159,1933
THARPARKAR DISTRICT,55,Transgender,1,2,3
THARPARKAR DISTRICT,56,Male,2221,249,2470
THARPARKAR DISTRICT,56,Female,2081,183,2264
THARPARKAR DISTRICT,56,Transgender,1,0,1
THARPARKAR DISTRICT,57,Male,2704,279,2983
THARPARKAR DISTRICT,57,Female,3641,328,3969
THARPARKAR DISTRICT,57,Transgender,1,0,1
THARPARKAR DISTRICT,58,Male,2537,287,2824
THARPARKAR DISTRICT,58,Female,2434,256,2690
THARPARKAR DISTRICT,58,Transgender,2,0,2
THARPARKAR DISTRICT,59,Male,3192,334,3526
THARPARKAR DISTRICT,59,Female,2990,298,3288
THARPARKAR DISTRICT,59,Transgender,0,0,0
THARPARKAR DISTRICT,60,Male,2270,209,2479
THARPARKAR DISTRICT,60,Female,1951,198,2149
THARPARKAR DISTRICT,60,Transgender,4,0,4
THARPARKAR DISTRICT,61,Male,2477,285,2762
THARPARKAR DISTRICT,61,Female,2292,286,2578
THARPARKAR DISTRICT,61,Transgender,0,0,0
THARPARKAR DISTRICT,62,Male,2091,210,2301
THARPARKAR DISTRICT,62,Female,2545,263,2808
THARPARKAR DISTRICT,62,Transgender,0,0,0
THARPARKAR DISTRICT,63,Male,2616,239,2855
THARPARKAR DISTRICT,63,Female,2268,271,2539
THARPARKAR DISTRICT,63,Transgender,1,0,1
THARPARKAR DISTRICT,64,Male,3762,282,4044
THARPARKAR DISTRICT,64,Female,2921,270,3191
THARPARKAR DISTRICT,64,Transgender,1,0,1
THARPARKAR DISTRICT,65,Male,1970,203,2173
THARPARKAR DISTRICT,65,Female,1649,166,1815
THARPARKAR DISTRICT,65,Transgender,1,0,1
THARPARKAR DISTRICT,66,Male,1676,210,1886
THARPARKAR DISTRICT,66,Female,1498,172,1670
THARPARKAR DISTRICT,66,Transgender,1,0,1
THARPARKAR DISTRICT,67,Male,1795,167,1962
THARPARKAR DISTRICT,67,Female,2133,168,2301
THARPARKAR DISTRICT,67,Transgender,1,0,1
THARPARKAR DISTRICT,68,Male,1837,155,1992
THARPARKAR DISTRICT,68,Female,1648,155,1803
THARPARKAR DISTRICT,68,Transgender,1,0,1
THARPARKAR DISTRICT,69,Male,3003,212,3215
THARPARKAR DISTRICT,69,Female,2419,213,2632
THARPARKAR DISTRICT,69,Transgender,1,0,1
THARPARKAR DISTRICT,70,Male,1456,125,1581
THARPARKAR DISTRICT,70,Female,1345,110,1455
THARPARKAR DISTRICT,70,Transgender,2,1,3
THARPARKAR DISTRICT,71,Male,1386,164,1550
THARPARKAR DISTRICT,71,Female,1145,158,1303
THARPARKAR DISTRICT,71,Transgender,0,0,0
THARPARKAR DISTRICT,72,Male,1011,98,1109
THARPARKAR DISTRICT,72,Female,1212,103,1315
THARPARKAR DISTRICT,72,Transgender,0,0,0
THARPARKAR DISTRICT,73,Male,1360,121,1481
THARPARKAR DISTRICT,73,Female,1119,132,1251
THARPARKAR DISTRICT,73,Transgender,0,0,0
THARPARKAR DISTRICT,74,Male,1989,149,2138
THARPARKAR DISTRICT,74,Female,1594,141,1735
THARPARKAR DISTRICT,74,Transgender,0,0,0
THARPARKAR DISTRICT,>=75,Male,8638,676,9314
THARPARKAR DISTRICT,>=75,Female,9376,844,10220
THARPARKAR DISTRICT,>=75,Transgender,6,1,7
THATTA DISTRICT,<1,Male,9548,2035,11583
THATTA DISTRICT,<1,Female,8988,1972,10960
THATTA DISTRICT,<1,Transgender,0,0,0
THATTA DISTRICT,1,Male,10699,2175,12874
THATTA DISTRICT,1,Female,10605,2137,12742
THATTA DISTRICT,1,Transgender,0,0,0
THATTA DISTRICT,2,Male,13082,2490,15572
THATTA DISTRICT,2,Female,12825,2540,15365
THATTA DISTRICT,2,Transgender,0,0,0
THATTA DISTRICT,3,Male,14402,3066,17468
THATTA DISTRICT,3,Female,14157,2851,17008
THATTA DISTRICT,3,Transgender,0,0,0
THATTA DISTRICT,4,Male,14570,2804,17374
THATTA DISTRICT,4,Female,14502,2656,17158
THATTA DISTRICT,4,Transgender,0,0,0
THATTA DISTRICT,5,Male,14840,2845,17685
THATTA DISTRICT,5,Female,13737,2703,16440
THATTA DISTRICT,5,Transgender,0,0,0
THATTA DISTRICT,6,Male,14504,2704,17208
THATTA DISTRICT,6,Female,13381,2488,15869
THATTA DISTRICT,6,Transgender,0,0,0
THATTA DISTRICT,7,Male,12997,2801,15798
THATTA DISTRICT,7,Female,11715,2561,14276
THATTA DISTRICT,7,Transgender,0,0,0
THATTA DISTRICT,8,Male,15179,2714,17893
THATTA DISTRICT,8,Female,13809,2512,16321
THATTA DISTRICT,8,Transgender,0,0,0
THATTA DISTRICT,9,Male,11103,2490,13593
THATTA DISTRICT,9,Female,9735,2217,11952
THATTA DISTRICT,9,Transgender,0,0,0
THATTA DISTRICT,10,Male,14174,2458,16632
THATTA DISTRICT,10,Female,12150,2253,14403
THATTA DISTRICT,10,Transgender,0,0,0
THATTA DISTRICT,11,Male,9065,2118,11183
THATTA DISTRICT,11,Female,7613,1938,9551
THATTA DISTRICT,11,Transgender,0,0,0
THATTA DISTRICT,12,Male,11452,2217,13669
THATTA DISTRICT,12,Female,9205,1910,11115
THATTA DISTRICT,12,Transgender,0,0,0
THATTA DISTRICT,13,Male,8164,1951,10115
THATTA DISTRICT,13,Female,6657,1711,8368
THATTA DISTRICT,13,Transgender,0,0,0
THATTA DISTRICT,14,Male,8821,1763,10584
THATTA DISTRICT,14,Female,7772,1730,9502
THATTA DISTRICT,14,Transgender,0,0,0
THATTA DISTRICT,15,Male,8956,1998,10954
THATTA DISTRICT,15,Female,7511,1736,9247
THATTA DISTRICT,15,Transgender,0,0,0
THATTA DISTRICT,16,Male,8782,1819,10601
THATTA DISTRICT,16,Female,7345,1745,9090
THATTA DISTRICT,16,Transgender,0,0,0
THATTA DISTRICT,17,Male,7040,1927,8967
THATTA DISTRICT,17,Female,6001,1765,7766
THATTA DISTRICT,17,Transgender,0,0,0
THATTA DISTRICT,18,Male,9419,1909,11328
THATTA DISTRICT,18,Female,8250,1774,10024
THATTA DISTRICT,18,Transgender,0,0,0
THATTA DISTRICT,19,Male,6656,1754,8410
THATTA DISTRICT,19,Female,6362,1818,8180
THATTA DISTRICT,19,Transgender,0,0,0
THATTA DISTRICT,20,Male,8856,1763,10619
THATTA DISTRICT,20,Female,7802,1625,9427
THATTA DISTRICT,20,Transgender,0,0,0
THATTA DISTRICT,21,Male,5842,1576,7418
THATTA DISTRICT,21,Female,5899,1505,7404
THATTA DISTRICT,21,Transgender,0,0,0
THATTA DISTRICT,22,Male,7341,1609,8950
THATTA DISTRICT,22,Female,6255,1567,7822
THATTA DISTRICT,22,Transgender,0,0,0
THATTA DISTRICT,23,Male,5538,1425,6963
THATTA DISTRICT,23,Female,5351,1444,6795
THATTA DISTRICT,23,Transgender,2,0,2
THATTA DISTRICT,24,Male,5371,1396,6767
THATTA DISTRICT,24,Female,5294,1312,6606
THATTA DISTRICT,24,Transgender,0,0,0
THATTA DISTRICT,25,Male,7824,1545,9369
THATTA DISTRICT,25,Female,6838,1478,8316
THATTA DISTRICT,25,Transgender,1,0,1
THATTA DISTRICT,26,Male,5611,1337,6948
THATTA DISTRICT,26,Female,5854,1458,7312
THATTA DISTRICT,26,Transgender,0,0,0
THATTA DISTRICT,27,Male,5543,1367,6910
THATTA DISTRICT,27,Female,6011,1506,7517
THATTA DISTRICT,27,Transgender,0,0,0
THATTA DISTRICT,28,Male,6198,1382,7580
THATTA DISTRICT,28,Female,6467,1535,8002
THATTA DISTRICT,28,Transgender,1,0,1
THATTA DISTRICT,29,Male,5377,1393,6770
THATTA DISTRICT,29,Female,6262,1450,7712
THATTA DISTRICT,29,Transgender,0,0,0
THATTA DISTRICT,30,Male,6900,1481,8381
THATTA DISTRICT,30,Female,6479,1476,7955
THATTA DISTRICT,30,Transgender,1,1,2
THATTA DISTRICT,31,Male,5525,1349,6874
THATTA DISTRICT,31,Female,5720,1430,7150
THATTA DISTRICT,31,Transgender,0,0,0
THATTA DISTRICT,32,Male,5354,1371,6725
THATTA DISTRICT,32,Female,5133,1254,6387
THATTA DISTRICT,32,Transgender,0,0,0
THATTA DISTRICT,33,Male,5092,1223,6315
THATTA DISTRICT,33,Female,5412,1218,6630
THATTA DISTRICT,33,Transgender,1,0,1
THATTA DISTRICT,34,Male,4271,1125,5396
THATTA DISTRICT,34,Female,4583,1088,5671
THATTA DISTRICT,34,Transgender,0,0,0
THATTA DISTRICT,35,Male,6415,1255,7670
THATTA DISTRICT,35,Female,5147,1084,6231
THATTA DISTRICT,35,Transgender,0,1,1
THATTA DISTRICT,36,Male,4556,1060,5616
THATTA DISTRICT,36,Female,3717,949,4666
THATTA DISTRICT,36,Transgender,0,0,0
THATTA DISTRICT,37,Male,5799,1143,6942
THATTA DISTRICT,37,Female,4514,1078,5592
THATTA DISTRICT,37,Transgender,1,1,2
THATTA DISTRICT,38,Male,4834,1141,5975
THATTA DISTRICT,38,Female,4750,1001,5751
THATTA DISTRICT,38,Transgender,1,0,1
THATTA DISTRICT,39,Male,5508,1216,6724
THATTA DISTRICT,39,Female,4750,1047,5797
THATTA DISTRICT,39,Transgender,0,0,0
THATTA DISTRICT,40,Male,4969,1059,6028
THATTA DISTRICT,40,Female,4512,970,5482
THATTA DISTRICT,40,Transgender,1,2,3
THATTA DISTRICT,41,Male,4046,943,4989
THATTA DISTRICT,41,Female,3977,877,4854
THATTA DISTRICT,41,Transgender,0,0,0
THATTA DISTRICT,42,Male,3832,867,4699
THATTA DISTRICT,42,Female,3383,812,4195
THATTA DISTRICT,42,Transgender,0,1,1
THATTA DISTRICT,43,Male,3484,852,4336
THATTA DISTRICT,43,Female,3441,761,4202
THATTA DISTRICT,43,Transgender,0,0,0
THATTA DISTRICT,44,Male,3232,788,4020
THATTA DISTRICT,44,Female,2964,719,3683
THATTA DISTRICT,44,Transgender,0,1,1
THATTA DISTRICT,45,Male,3856,785,4641
THATTA DISTRICT,45,Female,3068,698,3766
THATTA DISTRICT,45,Transgender,0,4,4
THATTA DISTRICT,46,Male,2888,715,3603
THATTA DISTRICT,46,Female,2227,585,2812
THATTA DISTRICT,46,Transgender,0,0,0
THATTA DISTRICT,47,Male,3115,727,3842
THATTA DISTRICT,47,Female,2713,602,3315
THATTA DISTRICT,47,Transgender,0,1,1
THATTA DISTRICT,48,Male,2820,655,3475
THATTA DISTRICT,48,Female,2682,598,3280
THATTA DISTRICT,48,Transgender,0,1,1
THATTA DISTRICT,49,Male,3025,735,3760
THATTA DISTRICT,49,Female,2936,615,3551
THATTA DISTRICT,49,Transgender,0,0,0
THATTA DISTRICT,50,Male,3335,702,4037
THATTA DISTRICT,50,Female,2704,566,3270
THATTA DISTRICT,50,Transgender,1,1,2
THATTA DISTRICT,51,Male,2546,619,3165
THATTA DISTRICT,51,Female,2264,511,2775
THATTA DISTRICT,51,Transgender,0,0,0
THATTA DISTRICT,52,Male,2250,606,2856
THATTA DISTRICT,52,Female,1969,471,2440
THATTA DISTRICT,52,Transgender,0,0,0
THATTA DISTRICT,53,Male,2129,524,2653
THATTA DISTRICT,53,Female,1872,445,2317
THATTA DISTRICT,53,Transgender,0,0,0
THATTA DISTRICT,54,Male,1974,465,2439
THATTA DISTRICT,54,Female,1646,454,2100
THATTA DISTRICT,54,Transgender,0,1,1
THATTA DISTRICT,55,Male,2265,489,2754
THATTA DISTRICT,55,Female,1913,411,2324
THATTA DISTRICT,55,Transgender,1,2,3
THATTA DISTRICT,56,Male,1601,388,1989
THATTA DISTRICT,56,Female,1316,313,1629
THATTA DISTRICT,56,Transgender,0,0,0
THATTA DISTRICT,57,Male,1785,401,2186
THATTA DISTRICT,57,Female,1786,384,2170
THATTA DISTRICT,57,Transgender,0,0,0
THATTA DISTRICT,58,Male,1541,396,1937
THATTA DISTRICT,58,Female,1428,395,1823
THATTA DISTRICT,58,Transgender,0,0,0
THATTA DISTRICT,59,Male,1717,431,2148
THATTA DISTRICT,59,Female,1795,392,2187
THATTA DISTRICT,59,Transgender,0,0,0
THATTA DISTRICT,60,Male,1884,409,2293
THATTA DISTRICT,60,Female,1684,402,2086
THATTA DISTRICT,60,Transgender,2,1,3
THATTA DISTRICT,61,Male,1602,426,2028
THATTA DISTRICT,61,Female,1564,364,1928
THATTA DISTRICT,61,Transgender,0,0,0
THATTA DISTRICT,62,Male,1442,351,1793
THATTA DISTRICT,62,Female,1458,299,1757
THATTA DISTRICT,62,Transgender,1,0,1
THATTA DISTRICT,63,Male,1486,370,1856
THATTA DISTRICT,63,Female,1348,364,1712
THATTA DISTRICT,63,Transgender,0,0,0
THATTA DISTRICT,64,Male,1451,353,1804
THATTA DISTRICT,64,Female,1314,262,1576
THATTA DISTRICT,64,Transgender,0,0,0
THATTA DISTRICT,65,Male,1432,283,1715
THATTA DISTRICT,65,Female,1285,271,1556
THATTA DISTRICT,65,Transgender,0,0,0
THATTA DISTRICT,66,Male,1212,256,1468
THATTA DISTRICT,66,Female,978,214,1192
THATTA DISTRICT,66,Transgender,0,0,0
THATTA DISTRICT,67,Male,965,194,1159
THATTA DISTRICT,67,Female,1033,184,1217
THATTA DISTRICT,67,Transgender,0,0,0
THATTA DISTRICT,68,Male,887,215,1102
THATTA DISTRICT,68,Female,891,190,1081
THATTA DISTRICT,68,Transgender,0,0,0
THATTA DISTRICT,69,Male,1028,193,1221
THATTA DISTRICT,69,Female,1115,215,1330
THATTA DISTRICT,69,Transgender,0,0,0
THATTA DISTRICT,70,Male,993,184,1177
THATTA DISTRICT,70,Female,956,185,1141
THATTA DISTRICT,70,Transgender,1,1,2
THATTA DISTRICT,71,Male,903,164,1067
THATTA DISTRICT,71,Female,791,155,946
THATTA DISTRICT,71,Transgender,0,0,0
THATTA DISTRICT,72,Male,641,113,754
THATTA DISTRICT,72,Female,703,129,832
THATTA DISTRICT,72,Transgender,0,0,0
THATTA DISTRICT,73,Male,683,154,837
THATTA DISTRICT,73,Female,684,146,830
THATTA DISTRICT,73,Transgender,0,0,0
THATTA DISTRICT,74,Male,645,137,782
THATTA DISTRICT,74,Female,588,115,703
THATTA DISTRICT,74,Transgender,0,0,0
THATTA DISTRICT,>=75,Male,4371,756,5127
THATTA DISTRICT,>=75,Female,4856,960,5816
THATTA DISTRICT,>=75,Transgender,2,1,3
TOBA TEK SINGH DISTRICT,<1,Male,22365,5198,27563
TOBA TEK SINGH DISTRICT,<1,Female,21166,4870,26036
TOBA TEK SINGH DISTRICT,<1,Transgender,0,0,0
TOBA TEK SINGH DISTRICT,1,Male,23107,5526,28633
TOBA TEK SINGH DISTRICT,1,Female,22195,5293,27488
TOBA TEK SINGH DISTRICT,1,Transgender,0,0,0
TOBA TEK SINGH DISTRICT,2,Male,22087,5180,27267
TOBA TEK SINGH DISTRICT,2,Female,21111,4980,26091
TOBA TEK SINGH DISTRICT,2,Transgender,0,0,0
TOBA TEK SINGH DISTRICT,3,Male,23545,5450,28995
TOBA TEK SINGH DISTRICT,3,Female,23144,5376,28520
TOBA TEK SINGH DISTRICT,3,Transgender,0,0,0
TOBA TEK SINGH DISTRICT,4,Male,24138,5257,29395
TOBA TEK SINGH DISTRICT,4,Female,22951,5141,28092
TOBA TEK SINGH DISTRICT,4,Transgender,0,0,0
TOBA TEK SINGH DISTRICT,5,Male,23457,5226,28683
TOBA TEK SINGH DISTRICT,5,Female,22370,5079,27449
TOBA TEK SINGH DISTRICT,5,Transgender,0,0,0
TOBA TEK SINGH DISTRICT,6,Male,22930,5141,28071
TOBA TEK SINGH DISTRICT,6,Female,21478,4919,26397
TOBA TEK SINGH DISTRICT,6,Transgender,0,0,0
TOBA TEK SINGH DISTRICT,7,Male,24537,5528,30065
TOBA TEK SINGH DISTRICT,7,Female,23416,5174,28590
TOBA TEK SINGH DISTRICT,7,Transgender,0,0,0
TOBA TEK SINGH DISTRICT,8,Male,22466,4921,27387
TOBA TEK SINGH DISTRICT,8,Female,21155,4583,25738
TOBA TEK SINGH DISTRICT,8,Transgender,0,0,0
TOBA TEK SINGH DISTRICT,9,Male,23650,5633,29283
TOBA TEK SINGH DISTRICT,9,Female,22494,5224,27718
TOBA TEK SINGH DISTRICT,9,Transgender,0,0,0
TOBA TEK SINGH DISTRICT,10,Male,20769,4673,25442
TOBA TEK SINGH DISTRICT,10,Female,19579,4373,23952
TOBA TEK SINGH DISTRICT,10,Transgender,0,0,0
TOBA TEK SINGH DISTRICT,11,Male,22198,5666,27864
TOBA TEK SINGH DISTRICT,11,Female,20686,5359,26045
TOBA TEK SINGH DISTRICT,11,Transgender,0,0,0
TOBA TEK SINGH DISTRICT,12,Male,19364,4627,23991
TOBA TEK SINGH DISTRICT,12,Female,17665,4288,21953
TOBA TEK SINGH DISTRICT,12,Transgender,0,0,0
TOBA TEK SINGH DISTRICT,13,Male,20133,5141,25274
TOBA TEK SINGH DISTRICT,13,Female,18609,4929,23538
TOBA TEK SINGH DISTRICT,13,Transgender,0,0,0
TOBA TEK SINGH DISTRICT,14,Male,19030,4821,23851
TOBA TEK SINGH DISTRICT,14,Female,17161,4477,21638
TOBA TEK SINGH DISTRICT,14,Transgender,0,0,0
TOBA TEK SINGH DISTRICT,15,Male,19261,4851,24112
TOBA TEK SINGH DISTRICT,15,Female,18168,4717,22885
TOBA TEK SINGH DISTRICT,15,Transgender,1,1,2
TOBA TEK SINGH DISTRICT,16,Male,18875,4950,23825
TOBA TEK SINGH DISTRICT,16,Female,17855,4616,22471
TOBA TEK SINGH DISTRICT,16,Transgender,4,3,7
TOBA TEK SINGH DISTRICT,17,Male,20098,5255,25353
TOBA TEK SINGH DISTRICT,17,Female,19788,5354,25142
TOBA TEK SINGH DISTRICT,17,Transgender,4,1,5
TOBA TEK SINGH DISTRICT,18,Male,15210,3706,18916
TOBA TEK SINGH DISTRICT,18,Female,14616,3622,18238
TOBA TEK SINGH DISTRICT,18,Transgender,2,0,2
TOBA TEK SINGH DISTRICT,19,Male,17454,4615,22069
TOBA TEK SINGH DISTRICT,19,Female,17268,4774,22042
TOBA TEK SINGH DISTRICT,19,Transgender,1,1,2
TOBA TEK SINGH DISTRICT,20,Male,15346,3814,19160
TOBA TEK SINGH DISTRICT,20,Female,15569,3936,19505
TOBA TEK SINGH DISTRICT,20,Transgender,8,2,10
TOBA TEK SINGH DISTRICT,21,Male,16289,4626,20915
TOBA TEK SINGH DISTRICT,21,Female,17553,5015,22568
TOBA TEK SINGH DISTRICT,21,Transgender,3,3,6
TOBA TEK SINGH DISTRICT,22,Male,14632,3763,18395
TOBA TEK SINGH DISTRICT,22,Female,16526,4363,20889
TOBA TEK SINGH DISTRICT,22,Transgender,2,1,3
TOBA TEK SINGH DISTRICT,23,Male,14651,3906,18557
TOBA TEK SINGH DISTRICT,23,Female,15772,4637,20409
TOBA TEK SINGH DISTRICT,23,Transgender,7,1,8
TOBA TEK SINGH DISTRICT,24,Male,13467,3837,17304
TOBA TEK SINGH DISTRICT,24,Female,14979,4433,19412
TOBA TEK SINGH DISTRICT,24,Transgender,1,4,5
TOBA TEK SINGH DISTRICT,25,Male,11650,3061,14711
TOBA TEK SINGH DISTRICT,25,Female,13950,3413,17363
TOBA TEK SINGH DISTRICT,25,Transgender,6,6,12
TOBA TEK SINGH DISTRICT,26,Male,12740,3631,16371
TOBA TEK SINGH DISTRICT,26,Female,14792,4268,19060
TOBA TEK SINGH DISTRICT,26,Transgender,2,0,2
TOBA TEK SINGH DISTRICT,27,Male,12655,3517,16172
TOBA TEK SINGH DISTRICT,27,Female,14193,4332,18525
TOBA TEK SINGH DISTRICT,27,Transgender,1,5,6
TOBA TEK SINGH DISTRICT,28,Male,11802,3506,15308
TOBA TEK SINGH DISTRICT,28,Female,13795,3944,17739
TOBA TEK SINGH DISTRICT,28,Transgender,4,4,8
TOBA TEK SINGH DISTRICT,29,Male,12422,3652,16074
TOBA TEK SINGH DISTRICT,29,Female,13910,3900,17810
TOBA TEK SINGH DISTRICT,29,Transgender,1,3,4
TOBA TEK SINGH DISTRICT,30,Male,10583,2909,13492
TOBA TEK SINGH DISTRICT,30,Female,13242,3300,16542
TOBA TEK SINGH DISTRICT,30,Transgender,10,7,17
TOBA TEK SINGH DISTRICT,31,Male,12230,3372,15602
TOBA TEK SINGH DISTRICT,31,Female,13810,3791,17601
TOBA TEK SINGH DISTRICT,31,Transgender,2,2,4
TOBA TEK SINGH DISTRICT,32,Male,10639,3061,13700
TOBA TEK SINGH DISTRICT,32,Female,12113,3466,15579
TOBA TEK SINGH DISTRICT,32,Transgender,3,4,7
TOBA TEK SINGH DISTRICT,33,Male,10954,3174,14128
TOBA TEK SINGH DISTRICT,33,Female,11656,3420,15076
TOBA TEK SINGH DISTRICT,33,Transgender,2,4,6
TOBA TEK SINGH DISTRICT,34,Male,11485,3025,14510
TOBA TEK SINGH DISTRICT,34,Female,11859,3296,15155
TOBA TEK SINGH DISTRICT,34,Transgender,1,1,2
TOBA TEK SINGH DISTRICT,35,Male,9619,2383,12002
TOBA TEK SINGH DISTRICT,35,Female,10307,2589,12896
TOBA TEK SINGH DISTRICT,35,Transgender,8,6,14
TOBA TEK SINGH DISTRICT,36,Male,11605,2944,14549
TOBA TEK SINGH DISTRICT,36,Female,11555,3052,14607
TOBA TEK SINGH DISTRICT,36,Transgender,4,1,5
TOBA TEK SINGH DISTRICT,37,Male,10393,2659,13052
TOBA TEK SINGH DISTRICT,37,Female,10800,2846,13646
TOBA TEK SINGH DISTRICT,37,Transgender,3,4,7
TOBA TEK SINGH DISTRICT,38,Male,10258,2701,12959
TOBA TEK SINGH DISTRICT,38,Female,10407,2815,13222
TOBA TEK SINGH DISTRICT,38,Transgender,2,5,7
TOBA TEK SINGH DISTRICT,39,Male,9816,2613,12429
TOBA TEK SINGH DISTRICT,39,Female,10651,2871,13522
TOBA TEK SINGH DISTRICT,39,Transgender,1,1,2
TOBA TEK SINGH DISTRICT,40,Male,7871,2168,10039
TOBA TEK SINGH DISTRICT,40,Female,8568,2198,10766
TOBA TEK SINGH DISTRICT,40,Transgender,5,2,7
TOBA TEK SINGH DISTRICT,41,Male,9546,2391,11937
TOBA TEK SINGH DISTRICT,41,Female,10306,2628,12934
TOBA TEK SINGH DISTRICT,41,Transgender,2,2,4
TOBA TEK SINGH DISTRICT,42,Male,7862,2069,9931
TOBA TEK SINGH DISTRICT,42,Female,8586,2247,10833
TOBA TEK SINGH DISTRICT,42,Transgender,3,0,3
TOBA TEK SINGH DISTRICT,43,Male,8085,2132,10217
TOBA TEK SINGH DISTRICT,43,Female,8094,2362,10456
TOBA TEK SINGH DISTRICT,43,Transgender,1,0,1
TOBA TEK SINGH DISTRICT,44,Male,8082,2082,10164
TOBA TEK SINGH DISTRICT,44,Female,8017,2250,10267
TOBA TEK SINGH DISTRICT,44,Transgender,0,1,1
TOBA TEK SINGH DISTRICT,45,Male,6556,1738,8294
TOBA TEK SINGH DISTRICT,45,Female,6311,1683,7994
TOBA TEK SINGH DISTRICT,45,Transgender,4,3,7
TOBA TEK SINGH DISTRICT,46,Male,7747,1970,9717
TOBA TEK SINGH DISTRICT,46,Female,8077,2111,10188
TOBA TEK SINGH DISTRICT,46,Transgender,3,0,3
TOBA TEK SINGH DISTRICT,47,Male,7252,1872,9124
TOBA TEK SINGH DISTRICT,47,Female,7116,1816,8932
TOBA TEK SINGH DISTRICT,47,Transgender,2,4,6
TOBA TEK SINGH DISTRICT,48,Male,7896,2138,10034
TOBA TEK SINGH DISTRICT,48,Female,7179,2069,9248
TOBA TEK SINGH DISTRICT,48,Transgender,0,1,1
TOBA TEK SINGH DISTRICT,49,Male,8031,2082,10113
TOBA TEK SINGH DISTRICT,49,Female,7618,2081,9699
TOBA TEK SINGH DISTRICT,49,Transgender,1,0,1
TOBA TEK SINGH DISTRICT,50,Male,6671,1808,8479
TOBA TEK SINGH DISTRICT,50,Female,6098,1680,7778
TOBA TEK SINGH DISTRICT,50,Transgender,3,1,4
TOBA TEK SINGH DISTRICT,51,Male,8219,2103,10322
TOBA TEK SINGH DISTRICT,51,Female,8029,2008,10037
TOBA TEK SINGH DISTRICT,51,Transgender,1,1,2
TOBA TEK SINGH DISTRICT,52,Male,7482,1939,9421
TOBA TEK SINGH DISTRICT,52,Female,6844,1857,8701
TOBA TEK SINGH DISTRICT,52,Transgender,1,0,1
TOBA TEK SINGH DISTRICT,53,Male,7421,1993,9414
TOBA TEK SINGH DISTRICT,53,Female,6504,1993,8497
TOBA TEK SINGH DISTRICT,53,Transgender,2,1,3
TOBA TEK SINGH DISTRICT,54,Male,7003,1914,8917
TOBA TEK SINGH DISTRICT,54,Female,5897,1850,7747
TOBA TEK SINGH DISTRICT,54,Transgender,1,0,1
TOBA TEK SINGH DISTRICT,55,Male,5348,1477,6825
TOBA TEK SINGH DISTRICT,55,Female,4371,1208,5579
TOBA TEK SINGH DISTRICT,55,Transgender,1,2,3
TOBA TEK SINGH DISTRICT,56,Male,6195,1624,7819
TOBA TEK SINGH DISTRICT,56,Female,5481,1475,6956
TOBA TEK SINGH DISTRICT,56,Transgender,2,1,3
TOBA TEK SINGH DISTRICT,57,Male,4951,1368,6319
TOBA TEK SINGH DISTRICT,57,Female,4567,1091,5658
TOBA TEK SINGH DISTRICT,57,Transgender,3,1,4
TOBA TEK SINGH DISTRICT,58,Male,5044,1296,6340
TOBA TEK SINGH DISTRICT,58,Female,4613,1166,5779
TOBA TEK SINGH DISTRICT,58,Transgender,2,0,2
TOBA TEK SINGH DISTRICT,59,Male,5269,1323,6592
TOBA TEK SINGH DISTRICT,59,Female,5033,1283,6316
TOBA TEK SINGH DISTRICT,59,Transgender,1,1,2
TOBA TEK SINGH DISTRICT,60,Male,4125,1030,5155
TOBA TEK SINGH DISTRICT,60,Female,3767,907,4674
TOBA TEK SINGH DISTRICT,60,Transgender,3,1,4
TOBA TEK SINGH DISTRICT,61,Male,5235,1319,6554
TOBA TEK SINGH DISTRICT,61,Female,4938,1142,6080
TOBA TEK SINGH DISTRICT,61,Transgender,0,1,1
TOBA TEK SINGH DISTRICT,62,Male,4819,1214,6033
TOBA TEK SINGH DISTRICT,62,Female,4283,1042,5325
TOBA TEK SINGH DISTRICT,62,Transgender,0,0,0
TOBA TEK SINGH DISTRICT,63,Male,4516,1157,5673
TOBA TEK SINGH DISTRICT,63,Female,3935,1092,5027
TOBA TEK SINGH DISTRICT,63,Transgender,0,1,1
TOBA TEK SINGH DISTRICT,64,Male,4222,956,5178
TOBA TEK SINGH DISTRICT,64,Female,3781,846,4627
TOBA TEK SINGH DISTRICT,64,Transgender,1,1,2
TOBA TEK SINGH DISTRICT,65,Male,3393,752,4145
TOBA TEK SINGH DISTRICT,65,Female,3093,655,3748
TOBA TEK SINGH DISTRICT,65,Transgender,2,3,5
TOBA TEK SINGH DISTRICT,66,Male,4007,842,4849
TOBA TEK SINGH DISTRICT,66,Female,3567,771,4338
TOBA TEK SINGH DISTRICT,66,Transgender,3,2,5
TOBA TEK SINGH DISTRICT,67,Male,3087,629,3716
TOBA TEK SINGH DISTRICT,67,Female,2642,563,3205
TOBA TEK SINGH DISTRICT,67,Transgender,1,0,1
TOBA TEK SINGH DISTRICT,68,Male,3007,665,3672
TOBA TEK SINGH DISTRICT,68,Female,2808,619,3427
TOBA TEK SINGH DISTRICT,68,Transgender,1,0,1
TOBA TEK SINGH DISTRICT,69,Male,3042,628,3670
TOBA TEK SINGH DISTRICT,69,Female,2753,592,3345
TOBA TEK SINGH DISTRICT,69,Transgender,1,0,1
TOBA TEK SINGH DISTRICT,70,Male,2565,519,3084
TOBA TEK SINGH DISTRICT,70,Female,2283,487,2770
TOBA TEK SINGH DISTRICT,70,Transgender,4,2,6
TOBA TEK SINGH DISTRICT,71,Male,3275,574,3849
TOBA TEK SINGH DISTRICT,71,Female,2889,589,3478
TOBA TEK SINGH DISTRICT,71,Transgender,0,0,0
TOBA TEK SINGH DISTRICT,72,Male,2669,639,3308
TOBA TEK SINGH DISTRICT,72,Female,2329,544,2873
TOBA TEK SINGH DISTRICT,72,Transgender,2,0,2
TOBA TEK SINGH DISTRICT,73,Male,2480,506,2986
TOBA TEK SINGH DISTRICT,73,Female,2066,473,2539
TOBA TEK SINGH DISTRICT,73,Transgender,0,1,1
TOBA TEK SINGH DISTRICT,74,Male,2196,464,2660
TOBA TEK SINGH DISTRICT,74,Female,1783,355,2138
TOBA TEK SINGH DISTRICT,74,Transgender,0,0,0
TOBA TEK SINGH DISTRICT,>=75,Male,17082,3304,20386
TOBA TEK SINGH DISTRICT,>=75,Female,14676,3095,17771
TOBA TEK SINGH DISTRICT,>=75,Transgender,8,1,9
TORGHAR DISTRICT,<1,Male,2941,0,2941
TORGHAR DISTRICT,<1,Female,2761,0,2761
TORGHAR DISTRICT,<1,Transgender,0,0,0
TORGHAR DISTRICT,1,Male,2667,0,2667
TORGHAR DISTRICT,1,Female,2456,0,2456
TORGHAR DISTRICT,1,Transgender,0,0,0
TORGHAR DISTRICT,2,Male,3118,0,3118
TORGHAR DISTRICT,2,Female,2892,0,2892
TORGHAR DISTRICT,2,Transgender,0,0,0
TORGHAR DISTRICT,3,Male,3090,0,3090
TORGHAR DISTRICT,3,Female,3078,0,3078
TORGHAR DISTRICT,3,Transgender,0,0,0
TORGHAR DISTRICT,4,Male,3299,0,3299
TORGHAR DISTRICT,4,Female,3087,0,3087
TORGHAR DISTRICT,4,Transgender,0,0,0
TORGHAR DISTRICT,5,Male,3257,0,3257
TORGHAR DISTRICT,5,Female,2977,0,2977
TORGHAR DISTRICT,5,Transgender,0,0,0
TORGHAR DISTRICT,6,Male,3140,0,3140
TORGHAR DISTRICT,6,Female,2958,0,2958
TORGHAR DISTRICT,6,Transgender,0,0,0
TORGHAR DISTRICT,7,Male,3107,0,3107
TORGHAR DISTRICT,7,Female,2878,0,2878
TORGHAR DISTRICT,7,Transgender,0,0,0
TORGHAR DISTRICT,8,Male,3250,0,3250
TORGHAR DISTRICT,8,Female,3007,0,3007
TORGHAR DISTRICT,8,Transgender,0,0,0
TORGHAR DISTRICT,9,Male,3087,0,3087
TORGHAR DISTRICT,9,Female,2742,0,2742
TORGHAR DISTRICT,9,Transgender,0,0,0
TORGHAR DISTRICT,10,Male,2958,0,2958
TORGHAR DISTRICT,10,Female,2671,0,2671
TORGHAR DISTRICT,10,Transgender,0,0,0
TORGHAR DISTRICT,11,Male,2545,0,2545
TORGHAR DISTRICT,11,Female,2265,0,2265
TORGHAR DISTRICT,11,Transgender,0,0,0
TORGHAR DISTRICT,12,Male,2571,0,2571
TORGHAR DISTRICT,12,Female,2216,0,2216
TORGHAR DISTRICT,12,Transgender,0,0,0
TORGHAR DISTRICT,13,Male,2256,0,2256
TORGHAR DISTRICT,13,Female,2059,0,2059
TORGHAR DISTRICT,13,Transgender,0,0,0
TORGHAR DISTRICT,14,Male,1979,0,1979
TORGHAR DISTRICT,14,Female,1775,0,1775
TORGHAR DISTRICT,14,Transgender,0,0,0
TORGHAR DISTRICT,15,Male,1921,0,1921
TORGHAR DISTRICT,15,Female,1828,0,1828
TORGHAR DISTRICT,15,Transgender,1,0,1
TORGHAR DISTRICT,16,Male,1601,0,1601
TORGHAR DISTRICT,16,Female,1511,0,1511
TORGHAR DISTRICT,16,Transgender,0,0,0
TORGHAR DISTRICT,17,Male,1368,0,1368
TORGHAR DISTRICT,17,Female,1561,0,1561
TORGHAR DISTRICT,17,Transgender,0,0,0
TORGHAR DISTRICT,18,Male,1476,0,1476
TORGHAR DISTRICT,18,Female,1634,0,1634
TORGHAR DISTRICT,18,Transgender,0,0,0
TORGHAR DISTRICT,19,Male,1440,0,1440
TORGHAR DISTRICT,19,Female,1342,0,1342
TORGHAR DISTRICT,19,Transgender,0,0,0
TORGHAR DISTRICT,20,Male,1414,0,1414
TORGHAR DISTRICT,20,Female,1655,0,1655
TORGHAR DISTRICT,20,Transgender,2,0,2
TORGHAR DISTRICT,21,Male,1326,0,1326
TORGHAR DISTRICT,21,Female,1400,0,1400
TORGHAR DISTRICT,21,Transgender,0,0,0
TORGHAR DISTRICT,22,Male,1322,0,1322
TORGHAR DISTRICT,22,Female,1286,0,1286
TORGHAR DISTRICT,22,Transgender,0,0,0
TORGHAR DISTRICT,23,Male,1167,0,1167
TORGHAR DISTRICT,23,Female,1250,0,1250
TORGHAR DISTRICT,23,Transgender,0,0,0
TORGHAR DISTRICT,24,Male,1184,0,1184
TORGHAR DISTRICT,24,Female,1265,0,1265
TORGHAR DISTRICT,24,Transgender,0,0,0
TORGHAR DISTRICT,25,Male,1173,0,1173
TORGHAR DISTRICT,25,Female,1271,0,1271
TORGHAR DISTRICT,25,Transgender,0,0,0
TORGHAR DISTRICT,26,Male,1194,0,1194
TORGHAR DISTRICT,26,Female,1310,0,1310
TORGHAR DISTRICT,26,Transgender,1,0,1
TORGHAR DISTRICT,27,Male,1135,0,1135
TORGHAR DISTRICT,27,Female,1480,0,1480
TORGHAR DISTRICT,27,Transgender,1,0,1
TORGHAR DISTRICT,28,Male,922,0,922
TORGHAR DISTRICT,28,Female,1047,0,1047
TORGHAR DISTRICT,28,Transgender,0,0,0
TORGHAR DISTRICT,29,Male,1122,0,1122
TORGHAR DISTRICT,29,Female,1321,0,1321
TORGHAR DISTRICT,29,Transgender,0,0,0
TORGHAR DISTRICT,30,Male,919,0,919
TORGHAR DISTRICT,30,Female,1034,0,1034
TORGHAR DISTRICT,30,Transgender,1,0,1
TORGHAR DISTRICT,31,Male,953,0,953
TORGHAR DISTRICT,31,Female,1354,0,1354
TORGHAR DISTRICT,31,Transgender,0,0,0
TORGHAR DISTRICT,32,Male,818,0,818
TORGHAR DISTRICT,32,Female,1087,0,1087
TORGHAR DISTRICT,32,Transgender,0,0,0
TORGHAR DISTRICT,33,Male,815,0,815
TORGHAR DISTRICT,33,Female,850,0,850
TORGHAR DISTRICT,33,Transgender,0,0,0
TORGHAR DISTRICT,34,Male,864,0,864
TORGHAR DISTRICT,34,Female,860,0,860
TORGHAR DISTRICT,34,Transgender,0,0,0
TORGHAR DISTRICT,35,Male,766,0,766
TORGHAR DISTRICT,35,Female,772,0,772
TORGHAR DISTRICT,35,Transgender,0,0,0
TORGHAR DISTRICT,36,Male,882,0,882
TORGHAR DISTRICT,36,Female,962,0,962
TORGHAR DISTRICT,36,Transgender,0,0,0
TORGHAR DISTRICT,37,Male,782,0,782
TORGHAR DISTRICT,37,Female,1059,0,1059
TORGHAR DISTRICT,37,Transgender,0,0,0
TORGHAR DISTRICT,38,Male,685,0,685
TORGHAR DISTRICT,38,Female,678,0,678
TORGHAR DISTRICT,38,Transgender,0,0,0
TORGHAR DISTRICT,39,Male,726,0,726
TORGHAR DISTRICT,39,Female,770,0,770
TORGHAR DISTRICT,39,Transgender,0,0,0
TORGHAR DISTRICT,40,Male,658,0,658
TORGHAR DISTRICT,40,Female,617,0,617
TORGHAR DISTRICT,40,Transgender,0,0,0
TORGHAR DISTRICT,41,Male,770,0,770
TORGHAR DISTRICT,41,Female,944,0,944
TORGHAR DISTRICT,41,Transgender,0,0,0
TORGHAR DISTRICT,42,Male,612,0,612
TORGHAR DISTRICT,42,Female,782,0,782
TORGHAR DISTRICT,42,Transgender,0,0,0
TORGHAR DISTRICT,43,Male,600,0,600
TORGHAR DISTRICT,43,Female,546,0,546
TORGHAR DISTRICT,43,Transgender,0,0,0
TORGHAR DISTRICT,44,Male,593,0,593
TORGHAR DISTRICT,44,Female,521,0,521
TORGHAR DISTRICT,44,Transgender,0,0,0
TORGHAR DISTRICT,45,Male,525,0,525
TORGHAR DISTRICT,45,Female,440,0,440
TORGHAR DISTRICT,45,Transgender,0,0,0
TORGHAR DISTRICT,46,Male,558,0,558
TORGHAR DISTRICT,46,Female,741,0,741
TORGHAR DISTRICT,46,Transgender,0,0,0
TORGHAR DISTRICT,47,Male,507,0,507
TORGHAR DISTRICT,47,Female,723,0,723
TORGHAR DISTRICT,47,Transgender,0,0,0
TORGHAR DISTRICT,48,Male,465,0,465
TORGHAR DISTRICT,48,Female,401,0,401
TORGHAR DISTRICT,48,Transgender,1,0,1
TORGHAR DISTRICT,49,Male,505,0,505
TORGHAR DISTRICT,49,Female,491,0,491
TORGHAR DISTRICT,49,Transgender,0,0,0
TORGHAR DISTRICT,50,Male,445,0,445
TORGHAR DISTRICT,50,Female,409,0,409
TORGHAR DISTRICT,50,Transgender,1,0,1
TORGHAR DISTRICT,51,Male,478,0,478
TORGHAR DISTRICT,51,Female,554,0,554
TORGHAR DISTRICT,51,Transgender,0,0,0
TORGHAR DISTRICT,52,Male,422,0,422
TORGHAR DISTRICT,52,Female,465,0,465
TORGHAR DISTRICT,52,Transgender,0,0,0
TORGHAR DISTRICT,53,Male,407,0,407
TORGHAR DISTRICT,53,Female,288,0,288
TORGHAR DISTRICT,53,Transgender,0,0,0
TORGHAR DISTRICT,54,Male,359,0,359
TORGHAR DISTRICT,54,Female,281,0,281
TORGHAR DISTRICT,54,Transgender,0,0,0
TORGHAR DISTRICT,55,Male,284,0,284
TORGHAR DISTRICT,55,Female,309,0,309
TORGHAR DISTRICT,55,Transgender,0,0,0
TORGHAR DISTRICT,56,Male,318,0,318
TORGHAR DISTRICT,56,Female,408,0,408
TORGHAR DISTRICT,56,Transgender,1,0,1
TORGHAR DISTRICT,57,Male,344,0,344
TORGHAR DISTRICT,57,Female,452,0,452
TORGHAR DISTRICT,57,Transgender,0,0,0
TORGHAR DISTRICT,58,Male,348,0,348
TORGHAR DISTRICT,58,Female,246,0,246
TORGHAR DISTRICT,58,Transgender,0,0,0
TORGHAR DISTRICT,59,Male,308,0,308
TORGHAR DISTRICT,59,Female,281,0,281
TORGHAR DISTRICT,59,Transgender,0,0,0
TORGHAR DISTRICT,60,Male,302,0,302
TORGHAR DISTRICT,60,Female,314,0,314
TORGHAR DISTRICT,60,Transgender,1,0,1
TORGHAR DISTRICT,61,Male,316,0,316
TORGHAR DISTRICT,61,Female,351,0,351
TORGHAR DISTRICT,61,Transgender,0,0,0
TORGHAR DISTRICT,62,Male,316,0,316
TORGHAR DISTRICT,62,Female,323,0,323
TORGHAR DISTRICT,62,Transgender,0,0,0
TORGHAR DISTRICT,63,Male,286,0,286
TORGHAR DISTRICT,63,Female,267,0,267
TORGHAR DISTRICT,63,Transgender,1,0,1
TORGHAR DISTRICT,64,Male,319,0,319
TORGHAR DISTRICT,64,Female,283,0,283
TORGHAR DISTRICT,64,Transgender,0,0,0
TORGHAR DISTRICT,65,Male,257,0,257
TORGHAR DISTRICT,65,Female,234,0,234
TORGHAR DISTRICT,65,Transgender,0,0,0
TORGHAR DISTRICT,66,Male,271,0,271
TORGHAR DISTRICT,66,Female,283,0,283
TORGHAR DISTRICT,66,Transgender,0,0,0
TORGHAR DISTRICT,67,Male,260,0,260
TORGHAR DISTRICT,67,Female,328,0,328
TORGHAR DISTRICT,67,Transgender,0,0,0
TORGHAR DISTRICT,68,Male,282,0,282
TORGHAR DISTRICT,68,Female,215,0,215
TORGHAR DISTRICT,68,Transgender,0,0,0
TORGHAR DISTRICT,69,Male,294,0,294
TORGHAR DISTRICT,69,Female,272,0,272
TORGHAR DISTRICT,69,Transgender,1,0,1
TORGHAR DISTRICT,70,Male,232,0,232
TORGHAR DISTRICT,70,Female,223,0,223
TORGHAR DISTRICT,70,Transgender,1,0,1
TORGHAR DISTRICT,71,Male,203,0,203
TORGHAR DISTRICT,71,Female,209,0,209
TORGHAR DISTRICT,71,Transgender,0,0,0
TORGHAR DISTRICT,72,Male,199,0,199
TORGHAR DISTRICT,72,Female,167,0,167
TORGHAR DISTRICT,72,Transgender,1,0,1
TORGHAR DISTRICT,73,Male,215,0,215
TORGHAR DISTRICT,73,Female,147,0,147
TORGHAR DISTRICT,73,Transgender,0,0,0
TORGHAR DISTRICT,74,Male,230,0,230
TORGHAR DISTRICT,74,Female,151,0,151
TORGHAR DISTRICT,74,Transgender,0,0,0
TORGHAR DISTRICT,>=75,Male,1331,0,1331
TORGHAR DISTRICT,>=75,Female,1199,0,1199
TORGHAR DISTRICT,>=75,Transgender,2,0,2
UMER KOT DISTRICT,<1,Male,12622,3052,15674
UMER KOT DISTRICT,<1,Female,11211,2803,14014
UMER KOT DISTRICT,<1,Transgender,0,0,0
UMER KOT DISTRICT,1,Male,13969,3733,17702
UMER KOT DISTRICT,1,Female,13128,3279,16407
UMER KOT DISTRICT,1,Transgender,0,0,0
UMER KOT DISTRICT,2,Male,16097,3906,20003
UMER KOT DISTRICT,2,Female,15410,3665,19075
UMER KOT DISTRICT,2,Transgender,0,0,0
UMER KOT DISTRICT,3,Male,16268,4058,20326
UMER KOT DISTRICT,3,Female,15603,3816,19419
UMER KOT DISTRICT,3,Transgender,0,0,0
UMER KOT DISTRICT,4,Male,16477,4189,20666
UMER KOT DISTRICT,4,Female,16213,3939,20152
UMER KOT DISTRICT,4,Transgender,0,0,0
UMER KOT DISTRICT,5,Male,16304,4123,20427
UMER KOT DISTRICT,5,Female,14769,3621,18390
UMER KOT DISTRICT,5,Transgender,0,0,0
UMER KOT DISTRICT,6,Male,16647,3931,20578
UMER KOT DISTRICT,6,Female,15051,3607,18658
UMER KOT DISTRICT,6,Transgender,0,0,0
UMER KOT DISTRICT,7,Male,13306,3547,16853
UMER KOT DISTRICT,7,Female,12029,3145,15174
UMER KOT DISTRICT,7,Transgender,0,0,0
UMER KOT DISTRICT,8,Male,17598,4094,21692
UMER KOT DISTRICT,8,Female,15352,3703,19055
UMER KOT DISTRICT,8,Transgender,0,0,0
UMER KOT DISTRICT,9,Male,12489,3512,16001
UMER KOT DISTRICT,9,Female,10754,3085,13839
UMER KOT DISTRICT,9,Transgender,0,0,0
UMER KOT DISTRICT,10,Male,14602,3475,18077
UMER KOT DISTRICT,10,Female,12948,3161,16109
UMER KOT DISTRICT,10,Transgender,0,0,0
UMER KOT DISTRICT,11,Male,9723,3032,12755
UMER KOT DISTRICT,11,Female,8379,2660,11039
UMER KOT DISTRICT,11,Transgender,0,0,0
UMER KOT DISTRICT,12,Male,11575,3068,14643
UMER KOT DISTRICT,12,Female,9880,2765,12645
UMER KOT DISTRICT,12,Transgender,0,0,0
UMER KOT DISTRICT,13,Male,8559,2824,11383
UMER KOT DISTRICT,13,Female,6887,2308,9195
UMER KOT DISTRICT,13,Transgender,0,0,0
UMER KOT DISTRICT,14,Male,8775,2603,11378
UMER KOT DISTRICT,14,Female,7066,2194,9260
UMER KOT DISTRICT,14,Transgender,0,0,0
UMER KOT DISTRICT,15,Male,9250,2868,12118
UMER KOT DISTRICT,15,Female,6938,2343,9281
UMER KOT DISTRICT,15,Transgender,2,1,3
UMER KOT DISTRICT,16,Male,8409,2618,11027
UMER KOT DISTRICT,16,Female,6469,2161,8630
UMER KOT DISTRICT,16,Transgender,1,2,3
UMER KOT DISTRICT,17,Male,6817,2744,9561
UMER KOT DISTRICT,17,Female,5687,2216,7903
UMER KOT DISTRICT,17,Transgender,0,1,1
UMER KOT DISTRICT,18,Male,8912,2528,11440
UMER KOT DISTRICT,18,Female,8937,2403,11340
UMER KOT DISTRICT,18,Transgender,3,0,3
UMER KOT DISTRICT,19,Male,7078,2602,9680
UMER KOT DISTRICT,19,Female,7310,2406,9716
UMER KOT DISTRICT,19,Transgender,0,1,1
UMER KOT DISTRICT,20,Male,8749,2486,11235
UMER KOT DISTRICT,20,Female,7937,2280,10217
UMER KOT DISTRICT,20,Transgender,8,5,13
UMER KOT DISTRICT,21,Male,6450,2302,8752
UMER KOT DISTRICT,21,Female,6019,2084,8103
UMER KOT DISTRICT,21,Transgender,2,1,3
UMER KOT DISTRICT,22,Male,6420,2011,8431
UMER KOT DISTRICT,22,Female,5429,1865,7294
UMER KOT DISTRICT,22,Transgender,2,2,4
UMER KOT DISTRICT,23,Male,5905,2092,7997
UMER KOT DISTRICT,23,Female,5716,2052,7768
UMER KOT DISTRICT,23,Transgender,1,1,2
UMER KOT DISTRICT,24,Male,5601,2064,7665
UMER KOT DISTRICT,24,Female,5547,1785,7332
UMER KOT DISTRICT,24,Transgender,2,0,2
UMER KOT DISTRICT,25,Male,6405,1977,8382
UMER KOT DISTRICT,25,Female,5425,1734,7159
UMER KOT DISTRICT,25,Transgender,0,1,1
UMER KOT DISTRICT,26,Male,5689,2014,7703
UMER KOT DISTRICT,26,Female,5788,1750,7538
UMER KOT DISTRICT,26,Transgender,1,2,3
UMER KOT DISTRICT,27,Male,6564,2187,8751
UMER KOT DISTRICT,27,Female,7066,2080,9146
UMER KOT DISTRICT,27,Transgender,5,2,7
UMER KOT DISTRICT,28,Male,5278,1877,7155
UMER KOT DISTRICT,28,Female,5802,1757,7559
UMER KOT DISTRICT,28,Transgender,6,0,6
UMER KOT DISTRICT,29,Male,6002,2195,8197
UMER KOT DISTRICT,29,Female,6843,2125,8968
UMER KOT DISTRICT,29,Transgender,5,1,6
UMER KOT DISTRICT,30,Male,5223,1745,6968
UMER KOT DISTRICT,30,Female,4844,1455,6299
UMER KOT DISTRICT,30,Transgender,6,2,8
UMER KOT DISTRICT,31,Male,6347,2190,8537
UMER KOT DISTRICT,31,Female,6678,2024,8702
UMER KOT DISTRICT,31,Transgender,0,1,1
UMER KOT DISTRICT,32,Male,5827,1903,7730
UMER KOT DISTRICT,32,Female,6157,1853,8010
UMER KOT DISTRICT,32,Transgender,2,0,2
UMER KOT DISTRICT,33,Male,5163,1946,7109
UMER KOT DISTRICT,33,Female,5339,1693,7032
UMER KOT DISTRICT,33,Transgender,1,0,1
UMER KOT DISTRICT,34,Male,4755,1776,6531
UMER KOT DISTRICT,34,Female,5000,1676,6676
UMER KOT DISTRICT,34,Transgender,1,0,1
UMER KOT DISTRICT,35,Male,4710,1419,6129
UMER KOT DISTRICT,35,Female,4174,1226,5400
UMER KOT DISTRICT,35,Transgender,4,5,9
UMER KOT DISTRICT,36,Male,5086,1665,6751
UMER KOT DISTRICT,36,Female,5104,1584,6688
UMER KOT DISTRICT,36,Transgender,1,2,3
UMER KOT DISTRICT,37,Male,6812,1929,8741
UMER KOT DISTRICT,37,Female,6880,2019,8899
UMER KOT DISTRICT,37,Transgender,2,3,5
UMER KOT DISTRICT,38,Male,3962,1485,5447
UMER KOT DISTRICT,38,Female,3679,1212,4891
UMER KOT DISTRICT,38,Transgender,1,2,3
UMER KOT DISTRICT,39,Male,4903,1651,6554
UMER KOT DISTRICT,39,Female,4786,1501,6287
UMER KOT DISTRICT,39,Transgender,0,3,3
UMER KOT DISTRICT,40,Male,2965,1035,4000
UMER KOT DISTRICT,40,Female,2659,855,3514
UMER KOT DISTRICT,40,Transgender,2,2,4
UMER KOT DISTRICT,41,Male,3675,1237,4912
UMER KOT DISTRICT,41,Female,3821,1183,5004
UMER KOT DISTRICT,41,Transgender,2,0,2
UMER KOT DISTRICT,42,Male,3481,1136,4617
UMER KOT DISTRICT,42,Female,3956,1238,5194
UMER KOT DISTRICT,42,Transgender,4,2,6
UMER KOT DISTRICT,43,Male,2958,1074,4032
UMER KOT DISTRICT,43,Female,2801,940,3741
UMER KOT DISTRICT,43,Transgender,0,0,0
UMER KOT DISTRICT,44,Male,2928,962,3890
UMER KOT DISTRICT,44,Female,2808,843,3651
UMER KOT DISTRICT,44,Transgender,1,1,2
UMER KOT DISTRICT,45,Male,2536,793,3329
UMER KOT DISTRICT,45,Female,2229,645,2874
UMER KOT DISTRICT,45,Transgender,0,4,4
UMER KOT DISTRICT,46,Male,3027,998,4025
UMER KOT DISTRICT,46,Female,2959,878,3837
UMER KOT DISTRICT,46,Transgender,1,1,2
UMER KOT DISTRICT,47,Male,3487,963,4450
UMER KOT DISTRICT,47,Female,3790,1155,4945
UMER KOT DISTRICT,47,Transgender,2,1,3
UMER KOT DISTRICT,48,Male,2680,932,3612
UMER KOT DISTRICT,48,Female,2326,750,3076
UMER KOT DISTRICT,48,Transgender,2,0,2
UMER KOT DISTRICT,49,Male,2964,1011,3975
UMER KOT DISTRICT,49,Female,2652,850,3502
UMER KOT DISTRICT,49,Transgender,2,0,2
UMER KOT DISTRICT,50,Male,2166,698,2864
UMER KOT DISTRICT,50,Female,1661,553,2214
UMER KOT DISTRICT,50,Transgender,2,1,3
UMER KOT DISTRICT,51,Male,2753,912,3665
UMER KOT DISTRICT,51,Female,2401,760,3161
UMER KOT DISTRICT,51,Transgender,0,1,1
UMER KOT DISTRICT,52,Male,2241,728,2969
UMER KOT DISTRICT,52,Female,2127,743,2870
UMER KOT DISTRICT,52,Transgender,2,1,3
UMER KOT DISTRICT,53,Male,1978,752,2730
UMER KOT DISTRICT,53,Female,1467,574,2041
UMER KOT DISTRICT,53,Transgender,0,0,0
UMER KOT DISTRICT,54,Male,1700,668,2368
UMER KOT DISTRICT,54,Female,1270,517,1787
UMER KOT DISTRICT,54,Transgender,0,0,0
UMER KOT DISTRICT,55,Male,1337,520,1857
UMER KOT DISTRICT,55,Female,1093,361,1454
UMER KOT DISTRICT,55,Transgender,0,1,1
UMER KOT DISTRICT,56,Male,1370,511,1881
UMER KOT DISTRICT,56,Female,1315,385,1700
UMER KOT DISTRICT,56,Transgender,0,1,1
UMER KOT DISTRICT,57,Male,1607,534,2141
UMER KOT DISTRICT,57,Female,1850,552,2402
UMER KOT DISTRICT,57,Transgender,1,2,3
UMER KOT DISTRICT,58,Male,1301,479,1780
UMER KOT DISTRICT,58,Female,1334,432,1766
UMER KOT DISTRICT,58,Transgender,0,0,0
UMER KOT DISTRICT,59,Male,1462,475,1937
UMER KOT DISTRICT,59,Female,1592,506,2098
UMER KOT DISTRICT,59,Transgender,0,1,1
UMER KOT DISTRICT,60,Male,1183,320,1503
UMER KOT DISTRICT,60,Female,1153,325,1478
UMER KOT DISTRICT,60,Transgender,1,2,3
UMER KOT DISTRICT,61,Male,1320,456,1776
UMER KOT DISTRICT,61,Female,1494,473,1967
UMER KOT DISTRICT,61,Transgender,0,0,0
UMER KOT DISTRICT,62,Male,1256,372,1628
UMER KOT DISTRICT,62,Female,1475,480,1955
UMER KOT DISTRICT,62,Transgender,2,0,2
UMER KOT DISTRICT,63,Male,1304,433,1737
UMER KOT DISTRICT,63,Female,1286,467,1753
UMER KOT DISTRICT,63,Transgender,1,1,2
UMER KOT DISTRICT,64,Male,1504,479,1983
UMER KOT DISTRICT,64,Female,1366,431,1797
UMER KOT DISTRICT,64,Transgender,0,0,0
UMER KOT DISTRICT,65,Male,1071,300,1371
UMER KOT DISTRICT,65,Female,970,282,1252
UMER KOT DISTRICT,65,Transgender,1,2,3
UMER KOT DISTRICT,66,Male,977,330,1307
UMER KOT DISTRICT,66,Female,1059,311,1370
UMER KOT DISTRICT,66,Transgender,0,0,0
UMER KOT DISTRICT,67,Male,933,265,1198
UMER KOT DISTRICT,67,Female,1113,330,1443
UMER KOT DISTRICT,67,Transgender,1,0,1
UMER KOT DISTRICT,68,Male,1009,280,1289
UMER KOT DISTRICT,68,Female,972,289,1261
UMER KOT DISTRICT,68,Transgender,0,1,1
UMER KOT DISTRICT,69,Male,1079,258,1337
UMER KOT DISTRICT,69,Female,1139,299,1438
UMER KOT DISTRICT,69,Transgender,0,1,1
UMER KOT DISTRICT,70,Male,716,211,927
UMER KOT DISTRICT,70,Female,725,194,919
UMER KOT DISTRICT,70,Transgender,1,0,1
UMER KOT DISTRICT,71,Male,794,239,1033
UMER KOT DISTRICT,71,Female,837,258,1095
UMER KOT DISTRICT,71,Transgender,0,0,0
UMER KOT DISTRICT,72,Male,604,180,784
UMER KOT DISTRICT,72,Female,704,249,953
UMER KOT DISTRICT,72,Transgender,2,0,2
UMER KOT DISTRICT,73,Male,662,193,855
UMER KOT DISTRICT,73,Female,659,229,888
UMER KOT DISTRICT,73,Transgender,0,0,0
UMER KOT DISTRICT,74,Male,664,195,859
UMER KOT DISTRICT,74,Female,648,164,812
UMER KOT DISTRICT,74,Transgender,1,0,1
UMER KOT DISTRICT,>=75,Male,4010,1090,5100
UMER KOT DISTRICT,>=75,Female,4866,1494,6360
UMER KOT DISTRICT,>=75,Transgender,4,3,7
UPPER DIR DISTRICT,<1,Male,14407,592,14999
UPPER DIR DISTRICT,<1,Female,13715,520,14235
UPPER DIR DISTRICT,<1,Transgender,0,0,0
UPPER DIR DISTRICT,1,Male,16538,649,17187
UPPER DIR DISTRICT,1,Female,15943,611,16554
UPPER DIR DISTRICT,1,Transgender,0,0,0
UPPER DIR DISTRICT,2,Male,18918,748,19666
UPPER DIR DISTRICT,2,Female,18028,676,18704
UPPER DIR DISTRICT,2,Transgender,0,0,0
UPPER DIR DISTRICT,3,Male,18292,818,19110
UPPER DIR DISTRICT,3,Female,17554,707,18261
UPPER DIR DISTRICT,3,Transgender,0,0,0
UPPER DIR DISTRICT,4,Male,19916,739,20655
UPPER DIR DISTRICT,4,Female,19108,750,19858
UPPER DIR DISTRICT,4,Transgender,0,0,0
UPPER DIR DISTRICT,5,Male,17559,736,18295
UPPER DIR DISTRICT,5,Female,16656,717,17373
UPPER DIR DISTRICT,5,Transgender,0,0,0
UPPER DIR DISTRICT,6,Male,18094,787,18881
UPPER DIR DISTRICT,6,Female,17147,729,17876
UPPER DIR DISTRICT,6,Transgender,0,0,0
UPPER DIR DISTRICT,7,Male,16517,742,17259
UPPER DIR DISTRICT,7,Female,15134,647,15781
UPPER DIR DISTRICT,7,Transgender,0,0,0
UPPER DIR DISTRICT,8,Male,17699,708,18407
UPPER DIR DISTRICT,8,Female,16289,720,17009
UPPER DIR DISTRICT,8,Transgender,0,0,0
UPPER DIR DISTRICT,9,Male,16748,735,17483
UPPER DIR DISTRICT,9,Female,15054,643,15697
UPPER DIR DISTRICT,9,Transgender,0,0,0
UPPER DIR DISTRICT,10,Male,14857,661,15518
UPPER DIR DISTRICT,10,Female,14164,664,14828
UPPER DIR DISTRICT,10,Transgender,0,0,0
UPPER DIR DISTRICT,11,Male,14009,602,14611
UPPER DIR DISTRICT,11,Female,12400,550,12950
UPPER DIR DISTRICT,11,Transgender,0,0,0
UPPER DIR DISTRICT,12,Male,13252,565,13817
UPPER DIR DISTRICT,12,Female,12248,579,12827
UPPER DIR DISTRICT,12,Transgender,0,0,0
UPPER DIR DISTRICT,13,Male,12033,580,12613
UPPER DIR DISTRICT,13,Female,10716,553,11269
UPPER DIR DISTRICT,13,Transgender,0,0,0
UPPER DIR DISTRICT,14,Male,11631,599,12230
UPPER DIR DISTRICT,14,Female,11115,576,11691
UPPER DIR DISTRICT,14,Transgender,0,0,0
UPPER DIR DISTRICT,15,Male,10870,581,11451
UPPER DIR DISTRICT,15,Female,10407,535,10942
UPPER DIR DISTRICT,15,Transgender,1,0,1
UPPER DIR DISTRICT,16,Male,9787,464,10251
UPPER DIR DISTRICT,16,Female,9898,511,10409
UPPER DIR DISTRICT,16,Transgender,0,0,0
UPPER DIR DISTRICT,17,Male,8213,465,8678
UPPER DIR DISTRICT,17,Female,9028,488,9516
UPPER DIR DISTRICT,17,Transgender,2,0,2
UPPER DIR DISTRICT,18,Male,8699,491,9190
UPPER DIR DISTRICT,18,Female,9285,475,9760
UPPER DIR DISTRICT,18,Transgender,1,0,1
UPPER DIR DISTRICT,19,Male,7943,459,8402
UPPER DIR DISTRICT,19,Female,8038,371,8409
UPPER DIR DISTRICT,19,Transgender,1,0,1
UPPER DIR DISTRICT,20,Male,7660,455,8115
UPPER DIR DISTRICT,20,Female,9604,444,10048
UPPER DIR DISTRICT,20,Transgender,1,1,2
UPPER DIR DISTRICT,21,Male,6192,411,6603
UPPER DIR DISTRICT,21,Female,7978,400,8378
UPPER DIR DISTRICT,21,Transgender,0,0,0
UPPER DIR DISTRICT,22,Male,6647,377,7024
UPPER DIR DISTRICT,22,Female,7867,402,8269
UPPER DIR DISTRICT,22,Transgender,2,0,2
UPPER DIR DISTRICT,23,Male,6554,377,6931
UPPER DIR DISTRICT,23,Female,7564,357,7921
UPPER DIR DISTRICT,23,Transgender,1,0,1
UPPER DIR DISTRICT,24,Male,5666,335,6001
UPPER DIR DISTRICT,24,Female,6946,374,7320
UPPER DIR DISTRICT,24,Transgender,0,0,0
UPPER DIR DISTRICT,25,Male,5840,369,6209
UPPER DIR DISTRICT,25,Female,7604,416,8020
UPPER DIR DISTRICT,25,Transgender,0,0,0
UPPER DIR DISTRICT,26,Male,5460,349,5809
UPPER DIR DISTRICT,26,Female,6834,351,7185
UPPER DIR DISTRICT,26,Transgender,0,0,0
UPPER DIR DISTRICT,27,Male,5192,336,5528
UPPER DIR DISTRICT,27,Female,7435,365,7800
UPPER DIR DISTRICT,27,Transgender,2,0,2
UPPER DIR DISTRICT,28,Male,5095,342,5437
UPPER DIR DISTRICT,28,Female,6214,359,6573
UPPER DIR DISTRICT,28,Transgender,0,0,0
UPPER DIR DISTRICT,29,Male,4818,286,5104
UPPER DIR DISTRICT,29,Female,6666,333,6999
UPPER DIR DISTRICT,29,Transgender,0,0,0
UPPER DIR DISTRICT,30,Male,4820,313,5133
UPPER DIR DISTRICT,30,Female,5530,331,5861
UPPER DIR DISTRICT,30,Transgender,0,1,1
UPPER DIR DISTRICT,31,Male,4374,275,4649
UPPER DIR DISTRICT,31,Female,5948,247,6195
UPPER DIR DISTRICT,31,Transgender,0,0,0
UPPER DIR DISTRICT,32,Male,3683,289,3972
UPPER DIR DISTRICT,32,Female,5395,254,5649
UPPER DIR DISTRICT,32,Transgender,1,0,1
UPPER DIR DISTRICT,33,Male,3741,288,4029
UPPER DIR DISTRICT,33,Female,4447,250,4697
UPPER DIR DISTRICT,33,Transgender,0,0,0
UPPER DIR DISTRICT,34,Male,3232,216,3448
UPPER DIR DISTRICT,34,Female,4200,209,4409
UPPER DIR DISTRICT,34,Transgender,0,0,0
UPPER DIR DISTRICT,35,Male,3221,217,3438
UPPER DIR DISTRICT,35,Female,4099,233,4332
UPPER DIR DISTRICT,35,Transgender,3,0,3
UPPER DIR DISTRICT,36,Male,3336,189,3525
UPPER DIR DISTRICT,36,Female,4442,171,4613
UPPER DIR DISTRICT,36,Transgender,0,0,0
UPPER DIR DISTRICT,37,Male,3426,202,3628
UPPER DIR DISTRICT,37,Female,5302,218,5520
UPPER DIR DISTRICT,37,Transgender,0,0,0
UPPER DIR DISTRICT,38,Male,3331,236,3567
UPPER DIR DISTRICT,38,Female,3897,214,4111
UPPER DIR DISTRICT,38,Transgender,1,0,1
UPPER DIR DISTRICT,39,Male,3377,217,3594
UPPER DIR DISTRICT,39,Female,4277,171,4448
UPPER DIR DISTRICT,39,Transgender,0,0,0
UPPER DIR DISTRICT,40,Male,3130,243,3373
UPPER DIR DISTRICT,40,Female,3739,246,3985
UPPER DIR DISTRICT,40,Transgender,1,0,1
UPPER DIR DISTRICT,41,Male,3033,194,3227
UPPER DIR DISTRICT,41,Female,3641,159,3800
UPPER DIR DISTRICT,41,Transgender,3,0,3
UPPER DIR DISTRICT,42,Male,2647,163,2810
UPPER DIR DISTRICT,42,Female,3470,160,3630
UPPER DIR DISTRICT,42,Transgender,1,0,1
UPPER DIR DISTRICT,43,Male,2753,231,2984
UPPER DIR DISTRICT,43,Female,2723,160,2883
UPPER DIR DISTRICT,43,Transgender,0,0,0
UPPER DIR DISTRICT,44,Male,2452,168,2620
UPPER DIR DISTRICT,44,Female,2450,155,2605
UPPER DIR DISTRICT,44,Transgender,2,0,2
UPPER DIR DISTRICT,45,Male,2302,161,2463
UPPER DIR DISTRICT,45,Female,2559,178,2737
UPPER DIR DISTRICT,45,Transgender,0,0,0
UPPER DIR DISTRICT,46,Male,2256,137,2393
UPPER DIR DISTRICT,46,Female,2581,109,2690
UPPER DIR DISTRICT,46,Transgender,1,0,1
UPPER DIR DISTRICT,47,Male,2219,125,2344
UPPER DIR DISTRICT,47,Female,2916,113,3029
UPPER DIR DISTRICT,47,Transgender,1,0,1
UPPER DIR DISTRICT,48,Male,2305,155,2460
UPPER DIR DISTRICT,48,Female,2172,104,2276
UPPER DIR DISTRICT,48,Transgender,0,0,0
UPPER DIR DISTRICT,49,Male,2212,136,2348
UPPER DIR DISTRICT,49,Female,2213,134,2347
UPPER DIR DISTRICT,49,Transgender,0,0,0
UPPER DIR DISTRICT,50,Male,2105,155,2260
UPPER DIR DISTRICT,50,Female,2199,144,2343
UPPER DIR DISTRICT,50,Transgender,1,0,1
UPPER DIR DISTRICT,51,Male,1996,130,2126
UPPER DIR DISTRICT,51,Female,1895,112,2007
UPPER DIR DISTRICT,51,Transgender,1,0,1
UPPER DIR DISTRICT,52,Male,1627,102,1729
UPPER DIR DISTRICT,52,Female,1636,93,1729
UPPER DIR DISTRICT,52,Transgender,0,0,0
UPPER DIR DISTRICT,53,Male,1698,124,1822
UPPER DIR DISTRICT,53,Female,1429,76,1505
UPPER DIR DISTRICT,53,Transgender,0,0,0
UPPER DIR DISTRICT,54,Male,1490,127,1617
UPPER DIR DISTRICT,54,Female,1338,78,1416
UPPER DIR DISTRICT,54,Transgender,0,0,0
UPPER DIR DISTRICT,55,Male,1442,120,1562
UPPER DIR DISTRICT,55,Female,1666,121,1787
UPPER DIR DISTRICT,55,Transgender,1,0,1
UPPER DIR DISTRICT,56,Male,1188,81,1269
UPPER DIR DISTRICT,56,Female,1291,51,1342
UPPER DIR DISTRICT,56,Transgender,0,0,0
UPPER DIR DISTRICT,57,Male,1131,72,1203
UPPER DIR DISTRICT,57,Female,1478,59,1537
UPPER DIR DISTRICT,57,Transgender,0,0,0
UPPER DIR DISTRICT,58,Male,1225,75,1300
UPPER DIR DISTRICT,58,Female,1424,71,1495
UPPER DIR DISTRICT,58,Transgender,0,0,0
UPPER DIR DISTRICT,59,Male,1406,82,1488
UPPER DIR DISTRICT,59,Female,1572,86,1658
UPPER DIR DISTRICT,59,Transgender,0,0,0
UPPER DIR DISTRICT,60,Male,1469,127,1596
UPPER DIR DISTRICT,60,Female,1781,107,1888
UPPER DIR DISTRICT,60,Transgender,0,0,0
UPPER DIR DISTRICT,61,Male,1402,95,1497
UPPER DIR DISTRICT,61,Female,1631,63,1694
UPPER DIR DISTRICT,61,Transgender,0,0,0
UPPER DIR DISTRICT,62,Male,1132,85,1217
UPPER DIR DISTRICT,62,Female,1502,66,1568
UPPER DIR DISTRICT,62,Transgender,1,0,1
UPPER DIR DISTRICT,63,Male,1266,59,1325
UPPER DIR DISTRICT,63,Female,1316,65,1381
UPPER DIR DISTRICT,63,Transgender,0,0,0
UPPER DIR DISTRICT,64,Male,1436,60,1496
UPPER DIR DISTRICT,64,Female,1216,60,1276
UPPER DIR DISTRICT,64,Transgender,0,0,0
UPPER DIR DISTRICT,65,Male,1153,71,1224
UPPER DIR DISTRICT,65,Female,1149,73,1222
UPPER DIR DISTRICT,65,Transgender,0,0,0
UPPER DIR DISTRICT,66,Male,1112,37,1149
UPPER DIR DISTRICT,66,Female,1107,31,1138
UPPER DIR DISTRICT,66,Transgender,0,0,0
UPPER DIR DISTRICT,67,Male,1048,69,1117
UPPER DIR DISTRICT,67,Female,1034,51,1085
UPPER DIR DISTRICT,67,Transgender,2,0,2
UPPER DIR DISTRICT,68,Male,1024,41,1065
UPPER DIR DISTRICT,68,Female,875,33,908
UPPER DIR DISTRICT,68,Transgender,1,0,1
UPPER DIR DISTRICT,69,Male,1133,34,1167
UPPER DIR DISTRICT,69,Female,917,31,948
UPPER DIR DISTRICT,69,Transgender,0,0,0
UPPER DIR DISTRICT,70,Male,983,52,1035
UPPER DIR DISTRICT,70,Female,959,40,999
UPPER DIR DISTRICT,70,Transgender,0,0,0
UPPER DIR DISTRICT,71,Male,1032,36,1068
UPPER DIR DISTRICT,71,Female,796,30,826
UPPER DIR DISTRICT,71,Transgender,2,0,2
UPPER DIR DISTRICT,72,Male,802,45,847
UPPER DIR DISTRICT,72,Female,712,26,738
UPPER DIR DISTRICT,72,Transgender,0,0,0
UPPER DIR DISTRICT,73,Male,662,41,703
UPPER DIR DISTRICT,73,Female,577,28,605
UPPER DIR DISTRICT,73,Transgender,0,0,0
UPPER DIR DISTRICT,74,Male,724,27,751
UPPER DIR DISTRICT,74,Female,566,18,584
UPPER DIR DISTRICT,74,Transgender,0,0,0
UPPER DIR DISTRICT,>=75,Male,5291,201,5492
UPPER DIR DISTRICT,>=75,Female,4623,185,4808
UPPER DIR DISTRICT,>=75,Transgender,5,0,5
VEHARI DISTRICT,<1,Male,32787,6070,38857
VEHARI DISTRICT,<1,Female,31136,5995,37131
VEHARI DISTRICT,<1,Transgender,0,0,0
VEHARI DISTRICT,1,Male,34367,6965,41332
VEHARI DISTRICT,1,Female,32701,6521,39222
VEHARI DISTRICT,1,Transgender,0,0,0
VEHARI DISTRICT,2,Male,33333,6300,39633
VEHARI DISTRICT,2,Female,31686,5943,37629
VEHARI DISTRICT,2,Transgender,0,0,0
VEHARI DISTRICT,3,Male,35865,6946,42811
VEHARI DISTRICT,3,Female,34656,6651,41307
VEHARI DISTRICT,3,Transgender,0,0,0
VEHARI DISTRICT,4,Male,37278,6680,43958
VEHARI DISTRICT,4,Female,34985,6286,41271
VEHARI DISTRICT,4,Transgender,0,0,0
VEHARI DISTRICT,5,Male,35401,6613,42014
VEHARI DISTRICT,5,Female,33571,6347,39918
VEHARI DISTRICT,5,Transgender,0,0,0
VEHARI DISTRICT,6,Male,34225,6467,40692
VEHARI DISTRICT,6,Female,31861,6078,37939
VEHARI DISTRICT,6,Transgender,0,0,0
VEHARI DISTRICT,7,Male,36429,6779,43208
VEHARI DISTRICT,7,Female,34442,6425,40867
VEHARI DISTRICT,7,Transgender,0,0,0
VEHARI DISTRICT,8,Male,33864,5839,39703
VEHARI DISTRICT,8,Female,31626,5704,37330
VEHARI DISTRICT,8,Transgender,0,0,0
VEHARI DISTRICT,9,Male,33839,6730,40569
VEHARI DISTRICT,9,Female,31199,6291,37490
VEHARI DISTRICT,9,Transgender,0,0,0
VEHARI DISTRICT,10,Male,31558,5708,37266
VEHARI DISTRICT,10,Female,28995,5205,34200
VEHARI DISTRICT,10,Transgender,0,0,0
VEHARI DISTRICT,11,Male,29879,6663,36542
VEHARI DISTRICT,11,Female,26952,6127,33079
VEHARI DISTRICT,11,Transgender,0,0,0
VEHARI DISTRICT,12,Male,28069,5328,33397
VEHARI DISTRICT,12,Female,25571,4966,30537
VEHARI DISTRICT,12,Transgender,0,0,0
VEHARI DISTRICT,13,Male,26474,5976,32450
VEHARI DISTRICT,13,Female,23858,5450,29308
VEHARI DISTRICT,13,Transgender,0,0,0
VEHARI DISTRICT,14,Male,25117,5439,30556
VEHARI DISTRICT,14,Female,23513,4987,28500
VEHARI DISTRICT,14,Transgender,0,0,0
VEHARI DISTRICT,15,Male,24708,5407,30115
VEHARI DISTRICT,15,Female,23481,5083,28564
VEHARI DISTRICT,15,Transgender,4,0,4
VEHARI DISTRICT,16,Male,24832,5596,30428
VEHARI DISTRICT,16,Female,23520,5303,28823
VEHARI DISTRICT,16,Transgender,5,0,5
VEHARI DISTRICT,17,Male,24565,5574,30139
VEHARI DISTRICT,17,Female,23193,5333,28526
VEHARI DISTRICT,17,Transgender,3,0,3
VEHARI DISTRICT,18,Male,23018,5041,28059
VEHARI DISTRICT,18,Female,22590,4685,27275
VEHARI DISTRICT,18,Transgender,4,0,4
VEHARI DISTRICT,19,Male,22796,5239,28035
VEHARI DISTRICT,19,Female,22568,5440,28008
VEHARI DISTRICT,19,Transgender,5,0,5
VEHARI DISTRICT,20,Male,22515,4703,27218
VEHARI DISTRICT,20,Female,23233,4565,27798
VEHARI DISTRICT,20,Transgender,11,2,13
VEHARI DISTRICT,21,Male,21191,5212,26403
VEHARI DISTRICT,21,Female,21997,5676,27673
VEHARI DISTRICT,21,Transgender,3,2,5
VEHARI DISTRICT,22,Male,20095,4489,24584
VEHARI DISTRICT,22,Female,22538,4840,27378
VEHARI DISTRICT,22,Transgender,3,6,9
VEHARI DISTRICT,23,Male,18187,4476,22663
VEHARI DISTRICT,23,Female,20124,5090,25214
VEHARI DISTRICT,23,Transgender,4,1,5
VEHARI DISTRICT,24,Male,17931,4401,22332
VEHARI DISTRICT,24,Female,19333,4771,24104
VEHARI DISTRICT,24,Transgender,7,2,9
VEHARI DISTRICT,25,Male,16733,3510,20243
VEHARI DISTRICT,25,Female,20174,4068,24242
VEHARI DISTRICT,25,Transgender,8,5,13
VEHARI DISTRICT,26,Male,17253,4275,21528
VEHARI DISTRICT,26,Female,19337,4800,24137
VEHARI DISTRICT,26,Transgender,12,0,12
VEHARI DISTRICT,27,Male,16506,3962,20468
VEHARI DISTRICT,27,Female,18433,4611,23044
VEHARI DISTRICT,27,Transgender,9,1,10
VEHARI DISTRICT,28,Male,17607,4113,21720
VEHARI DISTRICT,28,Female,19184,4478,23662
VEHARI DISTRICT,28,Transgender,5,3,8
VEHARI DISTRICT,29,Male,18130,4149,22279
VEHARI DISTRICT,29,Female,18826,4349,23175
VEHARI DISTRICT,29,Transgender,4,1,5
VEHARI DISTRICT,30,Male,15729,3501,19230
VEHARI DISTRICT,30,Female,18231,3797,22028
VEHARI DISTRICT,30,Transgender,8,3,11
VEHARI DISTRICT,31,Male,17014,3988,21002
VEHARI DISTRICT,31,Female,18400,4207,22607
VEHARI DISTRICT,31,Transgender,4,1,5
VEHARI DISTRICT,32,Male,14539,3463,18002
VEHARI DISTRICT,32,Female,16167,3670,19837
VEHARI DISTRICT,32,Transgender,2,3,5
VEHARI DISTRICT,33,Male,14095,3496,17591
VEHARI DISTRICT,33,Female,15348,3733,19081
VEHARI DISTRICT,33,Transgender,4,3,7
VEHARI DISTRICT,34,Male,15391,3474,18865
VEHARI DISTRICT,34,Female,15368,3730,19098
VEHARI DISTRICT,34,Transgender,1,3,4
VEHARI DISTRICT,35,Male,13157,2854,16011
VEHARI DISTRICT,35,Female,13999,2846,16845
VEHARI DISTRICT,35,Transgender,14,2,16
VEHARI DISTRICT,36,Male,16454,3376,19830
VEHARI DISTRICT,36,Female,16544,3625,20169
VEHARI DISTRICT,36,Transgender,3,1,4
VEHARI DISTRICT,37,Male,13775,2958,16733
VEHARI DISTRICT,37,Female,13500,2884,16384
VEHARI DISTRICT,37,Transgender,1,1,2
VEHARI DISTRICT,38,Male,13521,3246,16767
VEHARI DISTRICT,38,Female,13898,3248,17146
VEHARI DISTRICT,38,Transgender,1,3,4
VEHARI DISTRICT,39,Male,13659,2953,16612
VEHARI DISTRICT,39,Female,13732,3065,16797
VEHARI DISTRICT,39,Transgender,1,1,2
VEHARI DISTRICT,40,Male,11004,2657,13661
VEHARI DISTRICT,40,Female,12123,2526,14649
VEHARI DISTRICT,40,Transgender,7,5,12
VEHARI DISTRICT,41,Male,13413,2940,16353
VEHARI DISTRICT,41,Female,14617,3140,17757
VEHARI DISTRICT,41,Transgender,1,1,2
VEHARI DISTRICT,42,Male,11141,2502,13643
VEHARI DISTRICT,42,Female,11221,2429,13650
VEHARI DISTRICT,42,Transgender,3,3,6
VEHARI DISTRICT,43,Male,10665,2645,13310
VEHARI DISTRICT,43,Female,10457,2513,12970
VEHARI DISTRICT,43,Transgender,0,0,0
VEHARI DISTRICT,44,Male,11029,2567,13596
VEHARI DISTRICT,44,Female,10587,2479,13066
VEHARI DISTRICT,44,Transgender,2,0,2
VEHARI DISTRICT,45,Male,8908,2034,10942
VEHARI DISTRICT,45,Female,8738,1838,10576
VEHARI DISTRICT,45,Transgender,19,5,24
VEHARI DISTRICT,46,Male,11430,2435,13865
VEHARI DISTRICT,46,Female,11855,2623,14478
VEHARI DISTRICT,46,Transgender,1,2,3
VEHARI DISTRICT,47,Male,10164,2224,12388
VEHARI DISTRICT,47,Female,9431,1929,11360
VEHARI DISTRICT,47,Transgender,1,2,3
VEHARI DISTRICT,48,Male,10147,2299,12446
VEHARI DISTRICT,48,Female,9540,2301,11841
VEHARI DISTRICT,48,Transgender,2,2,4
VEHARI DISTRICT,49,Male,10448,2290,12738
VEHARI DISTRICT,49,Female,9922,2223,12145
VEHARI DISTRICT,49,Transgender,3,0,3
VEHARI DISTRICT,50,Male,8619,1970,10589
VEHARI DISTRICT,50,Female,8335,1806,10141
VEHARI DISTRICT,50,Transgender,4,2,6
VEHARI DISTRICT,51,Male,10750,2315,13065
VEHARI DISTRICT,51,Female,10772,2390,13162
VEHARI DISTRICT,51,Transgender,2,1,3
VEHARI DISTRICT,52,Male,9335,2018,11353
VEHARI DISTRICT,52,Female,8319,1936,10255
VEHARI DISTRICT,52,Transgender,3,1,4
VEHARI DISTRICT,53,Male,8870,2071,10941
VEHARI DISTRICT,53,Female,7686,1881,9567
VEHARI DISTRICT,53,Transgender,0,3,3
VEHARI DISTRICT,54,Male,8362,1994,10356
VEHARI DISTRICT,54,Female,7016,1725,8741
VEHARI DISTRICT,54,Transgender,0,3,3
VEHARI DISTRICT,55,Male,6487,1476,7963
VEHARI DISTRICT,55,Female,5481,1202,6683
VEHARI DISTRICT,55,Transgender,0,2,2
VEHARI DISTRICT,56,Male,7780,1668,9448
VEHARI DISTRICT,56,Female,7471,1463,8934
VEHARI DISTRICT,56,Transgender,2,2,4
VEHARI DISTRICT,57,Male,6308,1425,7733
VEHARI DISTRICT,57,Female,5710,1190,6900
VEHARI DISTRICT,57,Transgender,0,0,0
VEHARI DISTRICT,58,Male,6214,1388,7602
VEHARI DISTRICT,58,Female,5845,1374,7219
VEHARI DISTRICT,58,Transgender,1,2,3
VEHARI DISTRICT,59,Male,6069,1332,7401
VEHARI DISTRICT,59,Female,5757,1224,6981
VEHARI DISTRICT,59,Transgender,3,0,3
VEHARI DISTRICT,60,Male,4941,1049,5990
VEHARI DISTRICT,60,Female,5005,1030,6035
VEHARI DISTRICT,60,Transgender,1,4,5
VEHARI DISTRICT,61,Male,6443,1313,7756
VEHARI DISTRICT,61,Female,6315,1214,7529
VEHARI DISTRICT,61,Transgender,0,0,0
VEHARI DISTRICT,62,Male,5288,1161,6449
VEHARI DISTRICT,62,Female,5053,992,6045
VEHARI DISTRICT,62,Transgender,2,0,2
VEHARI DISTRICT,63,Male,5412,1152,6564
VEHARI DISTRICT,63,Female,5128,1045,6173
VEHARI DISTRICT,63,Transgender,0,0,0
VEHARI DISTRICT,64,Male,5179,968,6147
VEHARI DISTRICT,64,Female,4865,1008,5873
VEHARI DISTRICT,64,Transgender,2,0,2
VEHARI DISTRICT,65,Male,3776,700,4476
VEHARI DISTRICT,65,Female,3838,709,4547
VEHARI DISTRICT,65,Transgender,2,0,2
VEHARI DISTRICT,66,Male,4547,789,5336
VEHARI DISTRICT,66,Female,4423,822,5245
VEHARI DISTRICT,66,Transgender,1,1,2
VEHARI DISTRICT,67,Male,3808,624,4432
VEHARI DISTRICT,67,Female,3494,620,4114
VEHARI DISTRICT,67,Transgender,3,0,3
VEHARI DISTRICT,68,Male,3630,660,4290
VEHARI DISTRICT,68,Female,3333,618,3951
VEHARI DISTRICT,68,Transgender,1,0,1
VEHARI DISTRICT,69,Male,3907,626,4533
VEHARI DISTRICT,69,Female,3545,663,4208
VEHARI DISTRICT,69,Transgender,0,0,0
VEHARI DISTRICT,70,Male,2951,532,3483
VEHARI DISTRICT,70,Female,3021,527,3548
VEHARI DISTRICT,70,Transgender,1,0,1
VEHARI DISTRICT,71,Male,3688,628,4316
VEHARI DISTRICT,71,Female,3356,620,3976
VEHARI DISTRICT,71,Transgender,0,0,0
VEHARI DISTRICT,72,Male,2970,564,3534
VEHARI DISTRICT,72,Female,2707,495,3202
VEHARI DISTRICT,72,Transgender,0,2,2
VEHARI DISTRICT,73,Male,2775,519,3294
VEHARI DISTRICT,73,Female,2394,494,2888
VEHARI DISTRICT,73,Transgender,1,0,1
VEHARI DISTRICT,74,Male,2692,479,3171
VEHARI DISTRICT,74,Female,2399,398,2797
VEHARI DISTRICT,74,Transgender,0,0,0
VEHARI DISTRICT,>=75,Male,17975,2812,20787
VEHARI DISTRICT,>=75,Female,16506,2934,19440
VEHARI DISTRICT,>=75,Transgender,12,3,15
WASHUK DISTRICT,<1,Male,3340,663,4003
WASHUK DISTRICT,<1,Female,2901,616,3517
WASHUK DISTRICT,<1,Transgender,0,0,0
WASHUK DISTRICT,1,Male,2839,499,3338
WASHUK DISTRICT,1,Female,2818,427,3245
WASHUK DISTRICT,1,Transgender,0,0,0
WASHUK DISTRICT,2,Male,3570,652,4222
WASHUK DISTRICT,2,Female,3252,512,3764
WASHUK DISTRICT,2,Transgender,0,0,0
WASHUK DISTRICT,3,Male,3162,560,3722
WASHUK DISTRICT,3,Female,2691,433,3124
WASHUK DISTRICT,3,Transgender,0,0,0
WASHUK DISTRICT,4,Male,3552,641,4193
WASHUK DISTRICT,4,Female,3247,529,3776
WASHUK DISTRICT,4,Transgender,0,0,0
WASHUK DISTRICT,5,Male,2999,393,3392
WASHUK DISTRICT,5,Female,2667,335,3002
WASHUK DISTRICT,5,Transgender,0,0,0
WASHUK DISTRICT,6,Male,3447,433,3880
WASHUK DISTRICT,6,Female,2974,412,3386
WASHUK DISTRICT,6,Transgender,0,0,0
WASHUK DISTRICT,7,Male,2897,361,3258
WASHUK DISTRICT,7,Female,2428,289,2717
WASHUK DISTRICT,7,Transgender,0,0,0
WASHUK DISTRICT,8,Male,3452,446,3898
WASHUK DISTRICT,8,Female,2896,393,3289
WASHUK DISTRICT,8,Transgender,0,0,0
WASHUK DISTRICT,9,Male,3146,389,3535
WASHUK DISTRICT,9,Female,2445,320,2765
WASHUK DISTRICT,9,Transgender,0,0,0
WASHUK DISTRICT,10,Male,3160,410,3570
WASHUK DISTRICT,10,Female,2775,322,3097
WASHUK DISTRICT,10,Transgender,0,0,0
WASHUK DISTRICT,11,Male,2388,302,2690
WASHUK DISTRICT,11,Female,1885,233,2118
WASHUK DISTRICT,11,Transgender,0,0,0
WASHUK DISTRICT,12,Male,2305,237,2542
WASHUK DISTRICT,12,Female,1910,229,2139
WASHUK DISTRICT,12,Transgender,0,0,0
WASHUK DISTRICT,13,Male,1897,232,2129
WASHUK DISTRICT,13,Female,1525,202,1727
WASHUK DISTRICT,13,Transgender,0,0,0
WASHUK DISTRICT,14,Male,1919,286,2205
WASHUK DISTRICT,14,Female,1546,223,1769
WASHUK DISTRICT,14,Transgender,0,0,0
WASHUK DISTRICT,15,Male,1840,210,2050
WASHUK DISTRICT,15,Female,1398,170,1568
WASHUK DISTRICT,15,Transgender,0,0,0
WASHUK DISTRICT,16,Male,1507,237,1744
WASHUK DISTRICT,16,Female,1307,196,1503
WASHUK DISTRICT,16,Transgender,0,0,0
WASHUK DISTRICT,17,Male,1549,215,1764
WASHUK DISTRICT,17,Female,1506,206,1712
WASHUK DISTRICT,17,Transgender,0,0,0
WASHUK DISTRICT,18,Male,1352,195,1547
WASHUK DISTRICT,18,Female,1384,185,1569
WASHUK DISTRICT,18,Transgender,1,0,1
WASHUK DISTRICT,19,Male,1209,184,1393
WASHUK DISTRICT,19,Female,1298,217,1515
WASHUK DISTRICT,19,Transgender,0,0,0
WASHUK DISTRICT,20,Male,1506,206,1712
WASHUK DISTRICT,20,Female,1712,222,1934
WASHUK DISTRICT,20,Transgender,0,0,0
WASHUK DISTRICT,21,Male,998,145,1143
WASHUK DISTRICT,21,Female,1234,196,1430
WASHUK DISTRICT,21,Transgender,0,0,0
WASHUK DISTRICT,22,Male,822,133,955
WASHUK DISTRICT,22,Female,963,111,1074
WASHUK DISTRICT,22,Transgender,0,0,0
WASHUK DISTRICT,23,Male,733,121,854
WASHUK DISTRICT,23,Female,970,150,1120
WASHUK DISTRICT,23,Transgender,0,0,0
WASHUK DISTRICT,24,Male,647,84,731
WASHUK DISTRICT,24,Female,801,105,906
WASHUK DISTRICT,24,Transgender,0,0,0
WASHUK DISTRICT,25,Male,1314,182,1496
WASHUK DISTRICT,25,Female,1241,167,1408
WASHUK DISTRICT,25,Transgender,0,0,0
WASHUK DISTRICT,26,Male,733,129,862
WASHUK DISTRICT,26,Female,799,155,954
WASHUK DISTRICT,26,Transgender,0,0,0
WASHUK DISTRICT,27,Male,910,133,1043
WASHUK DISTRICT,27,Female,1147,145,1292
WASHUK DISTRICT,27,Transgender,0,0,0
WASHUK DISTRICT,28,Male,989,131,1120
WASHUK DISTRICT,28,Female,1140,147,1287
WASHUK DISTRICT,28,Transgender,0,0,0
WASHUK DISTRICT,29,Male,1003,120,1123
WASHUK DISTRICT,29,Female,1170,178,1348
WASHUK DISTRICT,29,Transgender,0,0,0
WASHUK DISTRICT,30,Male,1424,150,1574
WASHUK DISTRICT,30,Female,1311,140,1451
WASHUK DISTRICT,30,Transgender,0,0,0
WASHUK DISTRICT,31,Male,879,131,1010
WASHUK DISTRICT,31,Female,922,114,1036
WASHUK DISTRICT,31,Transgender,0,0,0
WASHUK DISTRICT,32,Male,651,94,745
WASHUK DISTRICT,32,Female,711,93,804
WASHUK DISTRICT,32,Transgender,0,0,0
WASHUK DISTRICT,33,Male,768,75,843
WASHUK DISTRICT,33,Female,956,130,1086
WASHUK DISTRICT,33,Transgender,0,0,0
WASHUK DISTRICT,34,Male,602,74,676
WASHUK DISTRICT,34,Female,687,78,765
WASHUK DISTRICT,34,Transgender,0,0,0
WASHUK DISTRICT,35,Male,1084,98,1182
WASHUK DISTRICT,35,Female,862,108,970
WASHUK DISTRICT,35,Transgender,0,0,0
WASHUK DISTRICT,36,Male,509,71,580
WASHUK DISTRICT,36,Female,469,70,539
WASHUK DISTRICT,36,Transgender,0,0,0
WASHUK DISTRICT,37,Male,783,110,893
WASHUK DISTRICT,37,Female,671,85,756
WASHUK DISTRICT,37,Transgender,0,0,0
WASHUK DISTRICT,38,Male,678,88,766
WASHUK DISTRICT,38,Female,809,78,887
WASHUK DISTRICT,38,Transgender,0,0,0
WASHUK DISTRICT,39,Male,718,84,802
WASHUK DISTRICT,39,Female,667,92,759
WASHUK DISTRICT,39,Transgender,0,0,0
WASHUK DISTRICT,40,Male,1169,89,1258
WASHUK DISTRICT,40,Female,911,116,1027
WASHUK DISTRICT,40,Transgender,0,0,0
WASHUK DISTRICT,41,Male,605,81,686
WASHUK DISTRICT,41,Female,595,63,658
WASHUK DISTRICT,41,Transgender,0,0,0
WASHUK DISTRICT,42,Male,440,62,502
WASHUK DISTRICT,42,Female,369,76,445
WASHUK DISTRICT,42,Transgender,0,0,0
WASHUK DISTRICT,43,Male,497,71,568
WASHUK DISTRICT,43,Female,511,65,576
WASHUK DISTRICT,43,Transgender,0,0,0
WASHUK DISTRICT,44,Male,328,46,374
WASHUK DISTRICT,44,Female,426,52,478
WASHUK DISTRICT,44,Transgender,0,0,0
WASHUK DISTRICT,45,Male,618,65,683
WASHUK DISTRICT,45,Female,484,60,544
WASHUK DISTRICT,45,Transgender,0,0,0
WASHUK DISTRICT,46,Male,244,44,288
WASHUK DISTRICT,46,Female,252,58,310
WASHUK DISTRICT,46,Transgender,0,0,0
WASHUK DISTRICT,47,Male,381,62,443
WASHUK DISTRICT,47,Female,345,71,416
WASHUK DISTRICT,47,Transgender,0,0,0
WASHUK DISTRICT,48,Male,348,54,402
WASHUK DISTRICT,48,Female,374,50,424
WASHUK DISTRICT,48,Transgender,0,0,0
WASHUK DISTRICT,49,Male,414,62,476
WASHUK DISTRICT,49,Female,417,56,473
WASHUK DISTRICT,49,Transgender,0,0,0
WASHUK DISTRICT,50,Male,604,66,670
WASHUK DISTRICT,50,Female,477,53,530
WASHUK DISTRICT,50,Transgender,0,0,0
WASHUK DISTRICT,51,Male,296,48,344
WASHUK DISTRICT,51,Female,302,46,348
WASHUK DISTRICT,51,Transgender,0,0,0
WASHUK DISTRICT,52,Male,265,42,307
WASHUK DISTRICT,52,Female,228,31,259
WASHUK DISTRICT,52,Transgender,0,0,0
WASHUK DISTRICT,53,Male,312,33,345
WASHUK DISTRICT,53,Female,269,33,302
WASHUK DISTRICT,53,Transgender,0,0,0
WASHUK DISTRICT,54,Male,291,36,327
WASHUK DISTRICT,54,Female,259,32,291
WASHUK DISTRICT,54,Transgender,0,0,0
WASHUK DISTRICT,55,Male,333,20,353
WASHUK DISTRICT,55,Female,249,29,278
WASHUK DISTRICT,55,Transgender,0,0,0
WASHUK DISTRICT,56,Male,205,25,230
WASHUK DISTRICT,56,Female,139,26,165
WASHUK DISTRICT,56,Transgender,0,0,0
WASHUK DISTRICT,57,Male,284,38,322
WASHUK DISTRICT,57,Female,159,33,192
WASHUK DISTRICT,57,Transgender,0,0,0
WASHUK DISTRICT,58,Male,193,21,214
WASHUK DISTRICT,58,Female,150,28,178
WASHUK DISTRICT,58,Transgender,0,0,0
WASHUK DISTRICT,59,Male,232,36,268
WASHUK DISTRICT,59,Female,190,38,228
WASHUK DISTRICT,59,Transgender,0,0,0
WASHUK DISTRICT,60,Male,377,49,426
WASHUK DISTRICT,60,Female,232,35,267
WASHUK DISTRICT,60,Transgender,0,0,0
WASHUK DISTRICT,61,Male,183,32,215
WASHUK DISTRICT,61,Female,161,22,183
WASHUK DISTRICT,61,Transgender,0,0,0
WASHUK DISTRICT,62,Male,176,32,208
WASHUK DISTRICT,62,Female,129,27,156
WASHUK DISTRICT,62,Transgender,0,0,0
WASHUK DISTRICT,63,Male,184,17,201
WASHUK DISTRICT,63,Female,152,20,172
WASHUK DISTRICT,63,Transgender,0,0,0
WASHUK DISTRICT,64,Male,204,27,231
WASHUK DISTRICT,64,Female,139,15,154
WASHUK DISTRICT,64,Transgender,0,0,0
WASHUK DISTRICT,65,Male,162,30,192
WASHUK DISTRICT,65,Female,139,32,171
WASHUK DISTRICT,65,Transgender,0,0,0
WASHUK DISTRICT,66,Male,111,19,130
WASHUK DISTRICT,66,Female,83,18,101
WASHUK DISTRICT,66,Transgender,0,0,0
WASHUK DISTRICT,67,Male,119,18,137
WASHUK DISTRICT,67,Female,100,22,122
WASHUK DISTRICT,67,Transgender,0,0,0
WASHUK DISTRICT,68,Male,120,28,148
WASHUK DISTRICT,68,Female,101,27,128
WASHUK DISTRICT,68,Transgender,0,0,0
WASHUK DISTRICT,69,Male,180,34,214
WASHUK DISTRICT,69,Female,129,24,153
WASHUK DISTRICT,69,Transgender,0,0,0
WASHUK DISTRICT,70,Male,188,29,217
WASHUK DISTRICT,70,Female,127,24,151
WASHUK DISTRICT,70,Transgender,0,0,0
WASHUK DISTRICT,71,Male,74,15,89
WASHUK DISTRICT,71,Female,86,22,108
WASHUK DISTRICT,71,Transgender,0,0,0
WASHUK DISTRICT,72,Male,92,15,107
WASHUK DISTRICT,72,Female,67,11,78
WASHUK DISTRICT,72,Transgender,0,0,0
WASHUK DISTRICT,73,Male,101,16,117
WASHUK DISTRICT,73,Female,70,19,89
WASHUK DISTRICT,73,Transgender,0,0,0
WASHUK DISTRICT,74,Male,119,11,130
WASHUK DISTRICT,74,Female,69,14,83
WASHUK DISTRICT,74,Transgender,0,0,0
WASHUK DISTRICT,>=75,Male,704,130,834
WASHUK DISTRICT,>=75,Female,457,67,524
WASHUK DISTRICT,>=75,Transgender,0,0,0
ZHOB DISTRICT,<1,Male,4696,570,5266
ZHOB DISTRICT,<1,Female,4070,493,4563
ZHOB DISTRICT,<1,Transgender,0,0,0
ZHOB DISTRICT,1,Male,5515,732,6247
ZHOB DISTRICT,1,Female,4865,630,5495
ZHOB DISTRICT,1,Transgender,0,0,0
ZHOB DISTRICT,2,Male,6550,785,7335
ZHOB DISTRICT,2,Female,5456,729,6185
ZHOB DISTRICT,2,Transgender,0,0,0
ZHOB DISTRICT,3,Male,6026,827,6853
ZHOB DISTRICT,3,Female,5297,753,6050
ZHOB DISTRICT,3,Transgender,0,0,0
ZHOB DISTRICT,4,Male,6084,776,6860
ZHOB DISTRICT,4,Female,5355,705,6060
ZHOB DISTRICT,4,Transgender,0,0,0
ZHOB DISTRICT,5,Male,5733,741,6474
ZHOB DISTRICT,5,Female,4858,706,5564
ZHOB DISTRICT,5,Transgender,0,0,0
ZHOB DISTRICT,6,Male,6075,718,6793
ZHOB DISTRICT,6,Female,4897,683,5580
ZHOB DISTRICT,6,Transgender,0,0,0
ZHOB DISTRICT,7,Male,5459,791,6250
ZHOB DISTRICT,7,Female,4390,668,5058
ZHOB DISTRICT,7,Transgender,0,0,0
ZHOB DISTRICT,8,Male,5965,743,6708
ZHOB DISTRICT,8,Female,4482,572,5054
ZHOB DISTRICT,8,Transgender,0,0,0
ZHOB DISTRICT,9,Male,5134,769,5903
ZHOB DISTRICT,9,Female,4081,607,4688
ZHOB DISTRICT,9,Transgender,0,0,0
ZHOB DISTRICT,10,Male,4979,662,5641
ZHOB DISTRICT,10,Female,3842,574,4416
ZHOB DISTRICT,10,Transgender,0,0,0
ZHOB DISTRICT,11,Male,4109,663,4772
ZHOB DISTRICT,11,Female,3062,526,3588
ZHOB DISTRICT,11,Transgender,0,0,0
ZHOB DISTRICT,12,Male,4078,542,4620
ZHOB DISTRICT,12,Female,2746,492,3238
ZHOB DISTRICT,12,Transgender,0,0,0
ZHOB DISTRICT,13,Male,3576,610,4186
ZHOB DISTRICT,13,Female,2525,477,3002
ZHOB DISTRICT,13,Transgender,0,0,0
ZHOB DISTRICT,14,Male,3401,534,3935
ZHOB DISTRICT,14,Female,2254,476,2730
ZHOB DISTRICT,14,Transgender,0,0,0
ZHOB DISTRICT,15,Male,3296,540,3836
ZHOB DISTRICT,15,Female,2219,448,2667
ZHOB DISTRICT,15,Transgender,0,0,0
ZHOB DISTRICT,16,Male,2815,460,3275
ZHOB DISTRICT,16,Female,1919,430,2349
ZHOB DISTRICT,16,Transgender,0,0,0
ZHOB DISTRICT,17,Male,2484,539,3023
ZHOB DISTRICT,17,Female,1906,427,2333
ZHOB DISTRICT,17,Transgender,0,0,0
ZHOB DISTRICT,18,Male,2721,534,3255
ZHOB DISTRICT,18,Female,2261,380,2641
ZHOB DISTRICT,18,Transgender,0,0,0
ZHOB DISTRICT,19,Male,2287,564,2851
ZHOB DISTRICT,19,Female,2152,424,2576
ZHOB DISTRICT,19,Transgender,0,0,0
ZHOB DISTRICT,20,Male,2577,496,3073
ZHOB DISTRICT,20,Female,2323,363,2686
ZHOB DISTRICT,20,Transgender,0,0,0
ZHOB DISTRICT,21,Male,2168,585,2753
ZHOB DISTRICT,21,Female,1998,432,2430
ZHOB DISTRICT,21,Transgender,0,0,0
ZHOB DISTRICT,22,Male,1782,504,2286
ZHOB DISTRICT,22,Female,1647,325,1972
ZHOB DISTRICT,22,Transgender,0,0,0
ZHOB DISTRICT,23,Male,1727,533,2260
ZHOB DISTRICT,23,Female,1630,369,1999
ZHOB DISTRICT,23,Transgender,0,0,0
ZHOB DISTRICT,24,Male,1771,485,2256
ZHOB DISTRICT,24,Female,1646,336,1982
ZHOB DISTRICT,24,Transgender,0,0,0
ZHOB DISTRICT,25,Male,2001,468,2469
ZHOB DISTRICT,25,Female,2330,389,2719
ZHOB DISTRICT,25,Transgender,0,0,0
ZHOB DISTRICT,26,Male,1568,429,1997
ZHOB DISTRICT,26,Female,2049,335,2384
ZHOB DISTRICT,26,Transgender,0,0,0
ZHOB DISTRICT,27,Male,1743,460,2203
ZHOB DISTRICT,27,Female,2311,421,2732
ZHOB DISTRICT,27,Transgender,0,0,0
ZHOB DISTRICT,28,Male,1699,480,2179
ZHOB DISTRICT,28,Female,1822,352,2174
ZHOB DISTRICT,28,Transgender,0,0,0
ZHOB DISTRICT,29,Male,1798,474,2272
ZHOB DISTRICT,29,Female,2023,356,2379
ZHOB DISTRICT,29,Transgender,0,0,0
ZHOB DISTRICT,30,Male,1854,396,2250
ZHOB DISTRICT,30,Female,1720,322,2042
ZHOB DISTRICT,30,Transgender,0,0,0
ZHOB DISTRICT,31,Male,1674,426,2100
ZHOB DISTRICT,31,Female,1597,267,1864
ZHOB DISTRICT,31,Transgender,0,0,0
ZHOB DISTRICT,32,Male,1506,366,1872
ZHOB DISTRICT,32,Female,1324,275,1599
ZHOB DISTRICT,32,Transgender,0,0,0
ZHOB DISTRICT,33,Male,1289,394,1683
ZHOB DISTRICT,33,Female,1170,278,1448
ZHOB DISTRICT,33,Transgender,0,0,0
ZHOB DISTRICT,34,Male,1085,354,1439
ZHOB DISTRICT,34,Female,928,228,1156
ZHOB DISTRICT,34,Transgender,0,0,0
ZHOB DISTRICT,35,Male,1237,280,1517
ZHOB DISTRICT,35,Female,1185,180,1365
ZHOB DISTRICT,35,Transgender,0,0,0
ZHOB DISTRICT,36,Male,990,292,1282
ZHOB DISTRICT,36,Female,908,199,1107
ZHOB DISTRICT,36,Transgender,0,0,0
ZHOB DISTRICT,37,Male,1241,317,1558
ZHOB DISTRICT,37,Female,1106,256,1362
ZHOB DISTRICT,37,Transgender,0,0,0
ZHOB DISTRICT,38,Male,1088,314,1402
ZHOB DISTRICT,38,Female,969,211,1180
ZHOB DISTRICT,38,Transgender,0,0,0
ZHOB DISTRICT,39,Male,1008,290,1298
ZHOB DISTRICT,39,Female,963,195,1158
ZHOB DISTRICT,39,Transgender,0,0,0
ZHOB DISTRICT,40,Male,1086,249,1335
ZHOB DISTRICT,40,Female,1141,201,1342
ZHOB DISTRICT,40,Transgender,0,0,0
ZHOB DISTRICT,41,Male,885,230,1115
ZHOB DISTRICT,41,Female,892,178,1070
ZHOB DISTRICT,41,Transgender,0,0,0
ZHOB DISTRICT,42,Male,693,141,834
ZHOB DISTRICT,42,Female,865,161,1026
ZHOB DISTRICT,42,Transgender,0,0,0
ZHOB DISTRICT,43,Male,683,181,864
ZHOB DISTRICT,43,Female,756,156,912
ZHOB DISTRICT,43,Transgender,0,0,0
ZHOB DISTRICT,44,Male,634,138,772
ZHOB DISTRICT,44,Female,682,148,830
ZHOB DISTRICT,44,Transgender,0,0,0
ZHOB DISTRICT,45,Male,786,149,935
ZHOB DISTRICT,45,Female,745,143,888
ZHOB DISTRICT,45,Transgender,0,0,0
ZHOB DISTRICT,46,Male,723,157,880
ZHOB DISTRICT,46,Female,643,119,762
ZHOB DISTRICT,46,Transgender,0,0,0
ZHOB DISTRICT,47,Male,894,157,1051
ZHOB DISTRICT,47,Female,823,185,1008
ZHOB DISTRICT,47,Transgender,0,0,0
ZHOB DISTRICT,48,Male,843,152,995
ZHOB DISTRICT,48,Female,612,129,741
ZHOB DISTRICT,48,Transgender,0,0,0
ZHOB DISTRICT,49,Male,819,192,1011
ZHOB DISTRICT,49,Female,622,146,768
ZHOB DISTRICT,49,Transgender,0,0,0
ZHOB DISTRICT,50,Male,789,156,945
ZHOB DISTRICT,50,Female,694,147,841
ZHOB DISTRICT,50,Transgender,0,0,0
ZHOB DISTRICT,51,Male,708,165,873
ZHOB DISTRICT,51,Female,523,112,635
ZHOB DISTRICT,51,Transgender,0,0,0
ZHOB DISTRICT,52,Male,584,125,709
ZHOB DISTRICT,52,Female,502,108,610
ZHOB DISTRICT,52,Transgender,0,0,0
ZHOB DISTRICT,53,Male,663,168,831
ZHOB DISTRICT,53,Female,428,85,513
ZHOB DISTRICT,53,Transgender,0,0,0
ZHOB DISTRICT,54,Male,504,138,642
ZHOB DISTRICT,54,Female,448,91,539
ZHOB DISTRICT,54,Transgender,0,0,0
ZHOB DISTRICT,55,Male,502,95,597
ZHOB DISTRICT,55,Female,427,82,509
ZHOB DISTRICT,55,Transgender,1,0,1
ZHOB DISTRICT,56,Male,475,120,595
ZHOB DISTRICT,56,Female,369,81,450
ZHOB DISTRICT,56,Transgender,0,0,0
ZHOB DISTRICT,57,Male,522,136,658
ZHOB DISTRICT,57,Female,510,97,607
ZHOB DISTRICT,57,Transgender,0,0,0
ZHOB DISTRICT,58,Male,455,92,547
ZHOB DISTRICT,58,Female,329,64,393
ZHOB DISTRICT,58,Transgender,0,0,0
ZHOB DISTRICT,59,Male,496,115,611
ZHOB DISTRICT,59,Female,380,67,447
ZHOB DISTRICT,59,Transgender,0,0,0
ZHOB DISTRICT,60,Male,468,72,540
ZHOB DISTRICT,60,Female,385,73,458
ZHOB DISTRICT,60,Transgender,0,0,0
ZHOB DISTRICT,61,Male,410,86,496
ZHOB DISTRICT,61,Female,328,59,387
ZHOB DISTRICT,61,Transgender,0,0,0
ZHOB DISTRICT,62,Male,351,64,415
ZHOB DISTRICT,62,Female,301,63,364
ZHOB DISTRICT,62,Transgender,0,0,0
ZHOB DISTRICT,63,Male,364,59,423
ZHOB DISTRICT,63,Female,308,51,359
ZHOB DISTRICT,63,Transgender,0,0,0
ZHOB DISTRICT,64,Male,463,74,537
ZHOB DISTRICT,64,Female,352,63,415
ZHOB DISTRICT,64,Transgender,0,0,0
ZHOB DISTRICT,65,Male,337,40,377
ZHOB DISTRICT,65,Female,262,52,314
ZHOB DISTRICT,65,Transgender,0,0,0
ZHOB DISTRICT,66,Male,268,50,318
ZHOB DISTRICT,66,Female,252,30,282
ZHOB DISTRICT,66,Transgender,0,0,0
ZHOB DISTRICT,67,Male,312,54,366
ZHOB DISTRICT,67,Female,323,61,384
ZHOB DISTRICT,67,Transgender,0,0,0
ZHOB DISTRICT,68,Male,303,37,340
ZHOB DISTRICT,68,Female,192,38,230
ZHOB DISTRICT,68,Transgender,0,0,0
ZHOB DISTRICT,69,Male,465,58,523
ZHOB DISTRICT,69,Female,303,52,355
ZHOB DISTRICT,69,Transgender,0,0,0
ZHOB DISTRICT,70,Male,239,35,274
ZHOB DISTRICT,70,Female,179,32,211
ZHOB DISTRICT,70,Transgender,0,0,0
ZHOB DISTRICT,71,Male,225,44,269
ZHOB DISTRICT,71,Female,161,30,191
ZHOB DISTRICT,71,Transgender,0,0,0
ZHOB DISTRICT,72,Male,182,22,204
ZHOB DISTRICT,72,Female,180,38,218
ZHOB DISTRICT,72,Transgender,0,0,0
ZHOB DISTRICT,73,Male,197,31,228
ZHOB DISTRICT,73,Female,114,17,131
ZHOB DISTRICT,73,Transgender,0,0,0
ZHOB DISTRICT,74,Male,267,37,304
ZHOB DISTRICT,74,Female,173,37,210
ZHOB DISTRICT,74,Transgender,0,0,0
ZHOB DISTRICT,>=75,Male,1380,213,1593
ZHOB DISTRICT,>=75,Female,935,204,1139
ZHOB DISTRICT,>=75,Transgender,0,0,0
ZIARAT DISTRICT,<1,Male,2399,35,2434
ZIARAT DISTRICT,<1,Female,2194,38,2232
ZIARAT DISTRICT,<1,Transgender,0,0,0
ZIARAT DISTRICT,1,Male,2713,68,2781
ZIARAT DISTRICT,1,Female,2570,63,2633
ZIARAT DISTRICT,1,Transgender,0,0,0
ZIARAT DISTRICT,2,Male,2812,54,2866
ZIARAT DISTRICT,2,Female,2796,39,2835
ZIARAT DISTRICT,2,Transgender,0,0,0
ZIARAT DISTRICT,3,Male,2958,50,3008
ZIARAT DISTRICT,3,Female,2747,58,2805
ZIARAT DISTRICT,3,Transgender,0,0,0
ZIARAT DISTRICT,4,Male,2824,54,2878
ZIARAT DISTRICT,4,Female,2704,58,2762
ZIARAT DISTRICT,4,Transgender,0,0,0
ZIARAT DISTRICT,5,Male,2905,53,2958
ZIARAT DISTRICT,5,Female,2737,60,2797
ZIARAT DISTRICT,5,Transgender,0,0,0
ZIARAT DISTRICT,6,Male,2905,53,2958
ZIARAT DISTRICT,6,Female,2596,51,2647
ZIARAT DISTRICT,6,Transgender,0,0,0
ZIARAT DISTRICT,7,Male,3050,71,3121
ZIARAT DISTRICT,7,Female,2590,48,2638
ZIARAT DISTRICT,7,Transgender,0,0,0
ZIARAT DISTRICT,8,Male,2785,49,2834
ZIARAT DISTRICT,8,Female,2394,30,2424
ZIARAT DISTRICT,8,Transgender,0,0,0
ZIARAT DISTRICT,9,Male,2835,54,2889
ZIARAT DISTRICT,9,Female,2416,51,2467
ZIARAT DISTRICT,9,Transgender,0,0,0
ZIARAT DISTRICT,10,Male,2326,41,2367
ZIARAT DISTRICT,10,Female,2062,42,2104
ZIARAT DISTRICT,10,Transgender,0,0,0
ZIARAT DISTRICT,11,Male,2148,48,2196
ZIARAT DISTRICT,11,Female,1801,32,1833
ZIARAT DISTRICT,11,Transgender,0,0,0
ZIARAT DISTRICT,12,Male,1824,36,1860
ZIARAT DISTRICT,12,Female,1635,36,1671
ZIARAT DISTRICT,12,Transgender,0,0,0
ZIARAT DISTRICT,13,Male,1828,48,1876
ZIARAT DISTRICT,13,Female,1524,45,1569
ZIARAT DISTRICT,13,Transgender,0,0,0
ZIARAT DISTRICT,14,Male,1668,29,1697
ZIARAT DISTRICT,14,Female,1351,35,1386
ZIARAT DISTRICT,14,Transgender,0,0,0
ZIARAT DISTRICT,15,Male,1649,31,1680
ZIARAT DISTRICT,15,Female,1434,45,1479
ZIARAT DISTRICT,15,Transgender,0,0,0
ZIARAT DISTRICT,16,Male,1475,29,1504
ZIARAT DISTRICT,16,Female,1373,28,1401
ZIARAT DISTRICT,16,Transgender,0,0,0
ZIARAT DISTRICT,17,Male,1359,32,1391
ZIARAT DISTRICT,17,Female,1367,50,1417
ZIARAT DISTRICT,17,Transgender,1,0,1
ZIARAT DISTRICT,18,Male,1561,30,1591
ZIARAT DISTRICT,18,Female,1517,33,1550
ZIARAT DISTRICT,18,Transgender,1,0,1
ZIARAT DISTRICT,19,Male,1522,33,1555
ZIARAT DISTRICT,19,Female,1486,30,1516
ZIARAT DISTRICT,19,Transgender,2,0,2
ZIARAT DISTRICT,20,Male,1493,27,1520
ZIARAT DISTRICT,20,Female,1433,42,1475
ZIARAT DISTRICT,20,Transgender,1,0,1
ZIARAT DISTRICT,21,Male,1545,40,1585
ZIARAT DISTRICT,21,Female,1470,35,1505
ZIARAT DISTRICT,21,Transgender,1,0,1
ZIARAT DISTRICT,22,Male,1165,16,1181
ZIARAT DISTRICT,22,Female,1110,21,1131
ZIARAT DISTRICT,22,Transgender,0,0,0
ZIARAT DISTRICT,23,Male,1173,23,1196
ZIARAT DISTRICT,23,Female,1258,32,1290
ZIARAT DISTRICT,23,Transgender,1,0,1
ZIARAT DISTRICT,24,Male,983,22,1005
ZIARAT DISTRICT,24,Female,1189,24,1213
ZIARAT DISTRICT,24,Transgender,1,0,1
ZIARAT DISTRICT,25,Male,1202,21,1223
ZIARAT DISTRICT,25,Female,1438,40,1478
ZIARAT DISTRICT,25,Transgender,0,0,0
ZIARAT DISTRICT,26,Male,1067,11,1078
ZIARAT DISTRICT,26,Female,1308,29,1337
ZIARAT DISTRICT,26,Transgender,0,0,0
ZIARAT DISTRICT,27,Male,1336,23,1359
ZIARAT DISTRICT,27,Female,1644,30,1674
ZIARAT DISTRICT,27,Transgender,0,0,0
ZIARAT DISTRICT,28,Male,1065,14,1079
ZIARAT DISTRICT,28,Female,1160,29,1189
ZIARAT DISTRICT,28,Transgender,0,0,0
ZIARAT DISTRICT,29,Male,1212,25,1237
ZIARAT DISTRICT,29,Female,1480,21,1501
ZIARAT DISTRICT,29,Transgender,0,0,0
ZIARAT DISTRICT,30,Male,1115,29,1144
ZIARAT DISTRICT,30,Female,1101,31,1132
ZIARAT DISTRICT,30,Transgender,1,0,1
ZIARAT DISTRICT,31,Male,1129,20,1149
ZIARAT DISTRICT,31,Female,1251,26,1277
ZIARAT DISTRICT,31,Transgender,1,0,1
ZIARAT DISTRICT,32,Male,942,20,962
ZIARAT DISTRICT,32,Female,989,22,1011
ZIARAT DISTRICT,32,Transgender,0,0,0
ZIARAT DISTRICT,33,Male,934,25,959
ZIARAT DISTRICT,33,Female,957,21,978
ZIARAT DISTRICT,33,Transgender,0,0,0
ZIARAT DISTRICT,34,Male,884,21,905
ZIARAT DISTRICT,34,Female,834,19,853
ZIARAT DISTRICT,34,Transgender,0,0,0
ZIARAT DISTRICT,35,Male,831,24,855
ZIARAT DISTRICT,35,Female,815,34,849
ZIARAT DISTRICT,35,Transgender,1,0,1
ZIARAT DISTRICT,36,Male,903,12,915
ZIARAT DISTRICT,36,Female,798,24,822
ZIARAT DISTRICT,36,Transgender,0,0,0
ZIARAT DISTRICT,37,Male,1139,33,1172
ZIARAT DISTRICT,37,Female,966,35,1001
ZIARAT DISTRICT,37,Transgender,2,0,2
ZIARAT DISTRICT,38,Male,836,22,858
ZIARAT DISTRICT,38,Female,705,26,731
ZIARAT DISTRICT,38,Transgender,0,0,0
ZIARAT DISTRICT,39,Male,877,18,895
ZIARAT DISTRICT,39,Female,764,22,786
ZIARAT DISTRICT,39,Transgender,0,0,0
ZIARAT DISTRICT,40,Male,589,20,609
ZIARAT DISTRICT,40,Female,638,13,651
ZIARAT DISTRICT,40,Transgender,1,0,1
ZIARAT DISTRICT,41,Male,697,25,722
ZIARAT DISTRICT,41,Female,687,12,699
ZIARAT DISTRICT,41,Transgender,0,0,0
ZIARAT DISTRICT,42,Male,519,18,537
ZIARAT DISTRICT,42,Female,570,26,596
ZIARAT DISTRICT,42,Transgender,0,0,0
ZIARAT DISTRICT,43,Male,510,19,529
ZIARAT DISTRICT,43,Female,523,7,530
ZIARAT DISTRICT,43,Transgender,0,0,0
ZIARAT DISTRICT,44,Male,448,14,462
ZIARAT DISTRICT,44,Female,484,12,496
ZIARAT DISTRICT,44,Transgender,1,0,1
ZIARAT DISTRICT,45,Male,467,15,482
ZIARAT DISTRICT,45,Female,481,10,491
ZIARAT DISTRICT,45,Transgender,0,0,0
ZIARAT DISTRICT,46,Male,503,8,511
ZIARAT DISTRICT,46,Female,482,9,491
ZIARAT DISTRICT,46,Transgender,0,0,0
ZIARAT DISTRICT,47,Male,632,17,649
ZIARAT DISTRICT,47,Female,624,13,637
ZIARAT DISTRICT,47,Transgender,1,0,1
ZIARAT DISTRICT,48,Male,528,13,541
ZIARAT DISTRICT,48,Female,473,12,485
ZIARAT DISTRICT,48,Transgender,0,0,0
ZIARAT DISTRICT,49,Male,519,13,532
ZIARAT DISTRICT,49,Female,497,14,511
ZIARAT DISTRICT,49,Transgender,0,0,0
ZIARAT DISTRICT,50,Male,482,8,490
ZIARAT DISTRICT,50,Female,425,5,430
ZIARAT DISTRICT,50,Transgender,1,0,1
ZIARAT DISTRICT,51,Male,508,14,522
ZIARAT DISTRICT,51,Female,420,12,432
ZIARAT DISTRICT,51,Transgender,0,0,0
ZIARAT DISTRICT,52,Male,466,18,484
ZIARAT DISTRICT,52,Female,357,9,366
ZIARAT DISTRICT,52,Transgender,0,0,0
ZIARAT DISTRICT,53,Male,424,13,437
ZIARAT DISTRICT,53,Female,286,11,297
ZIARAT DISTRICT,53,Transgender,0,0,0
ZIARAT DISTRICT,54,Male,363,5,368
ZIARAT DISTRICT,54,Female,278,7,285
ZIARAT DISTRICT,54,Transgender,0,0,0
ZIARAT DISTRICT,55,Male,295,10,305
ZIARAT DISTRICT,55,Female,313,8,321
ZIARAT DISTRICT,55,Transgender,1,0,1
ZIARAT DISTRICT,56,Male,300,11,311
ZIARAT DISTRICT,56,Female,276,4,280
ZIARAT DISTRICT,56,Transgender,0,0,0
ZIARAT DISTRICT,57,Male,304,13,317
ZIARAT DISTRICT,57,Female,393,7,400
ZIARAT DISTRICT,57,Transgender,0,0,0
ZIARAT DISTRICT,58,Male,300,10,310
ZIARAT DISTRICT,58,Female,226,7,233
ZIARAT DISTRICT,58,Transgender,0,0,0
ZIARAT DISTRICT,59,Male,299,10,309
ZIARAT DISTRICT,59,Female,305,8,313
ZIARAT DISTRICT,59,Transgender,0,0,0
ZIARAT DISTRICT,60,Male,299,3,302
ZIARAT DISTRICT,60,Female,299,4,303
ZIARAT DISTRICT,60,Transgender,0,0,0
ZIARAT DISTRICT,61,Male,355,9,364
ZIARAT DISTRICT,61,Female,257,2,259
ZIARAT DISTRICT,61,Transgender,0,0,0
ZIARAT DISTRICT,62,Male,244,9,253
ZIARAT DISTRICT,62,Female,270,6,276
ZIARAT DISTRICT,62,Transgender,0,0,0
ZIARAT DISTRICT,63,Male,294,5,299
ZIARAT DISTRICT,63,Female,234,4,238
ZIARAT DISTRICT,63,Transgender,0,0,0
ZIARAT DISTRICT,64,Male,300,8,308
ZIARAT DISTRICT,64,Female,258,5,263
ZIARAT DISTRICT,64,Transgender,1,0,1
ZIARAT DISTRICT,65,Male,208,1,209
ZIARAT DISTRICT,65,Female,184,5,189
ZIARAT DISTRICT,65,Transgender,1,0,1
ZIARAT DISTRICT,66,Male,204,0,204
ZIARAT DISTRICT,66,Female,196,3,199
ZIARAT DISTRICT,66,Transgender,0,0,0
ZIARAT DISTRICT,67,Male,213,7,220
ZIARAT DISTRICT,67,Female,222,5,227
ZIARAT DISTRICT,67,Transgender,0,0,0
ZIARAT DISTRICT,68,Male,186,1,187
ZIARAT DISTRICT,68,Female,159,2,161
ZIARAT DISTRICT,68,Transgender,0,0,0
ZIARAT DISTRICT,69,Male,189,2,191
ZIARAT DISTRICT,69,Female,181,6,187
ZIARAT DISTRICT,69,Transgender,0,0,0
ZIARAT DISTRICT,70,Male,151,3,154
ZIARAT DISTRICT,70,Female,126,2,128
ZIARAT DISTRICT,70,Transgender,0,0,0
ZIARAT DISTRICT,71,Male,160,4,164
ZIARAT DISTRICT,71,Female,152,5,157
ZIARAT DISTRICT,71,Transgender,0,0,0
ZIARAT DISTRICT,72,Male,140,1,141
ZIARAT DISTRICT,72,Female,128,3,131
ZIARAT DISTRICT,72,Transgender,0,0,0
ZIARAT DISTRICT,73,Male,113,3,116
ZIARAT DISTRICT,73,Female,87,2,89
ZIARAT DISTRICT,73,Transgender,0,0,0
ZIARAT DISTRICT,74,Male,119,1,120
ZIARAT DISTRICT,74,Female,90,1,91
ZIARAT DISTRICT,74,Transgender,1,0,1
ZIARAT DISTRICT,>=75,Male,770,11,781
ZIARAT DISTRICT,>=75,Female,661,10,671
ZIARAT DISTRICT,>=75,Transgender,1,0,1
ISLAMABAD DISTRICT,<1,Male,11616,10229,21845
ISLAMABAD DISTRICT,<1,Female,10962,9799,20761
ISLAMABAD DISTRICT,<1,Transgender,0,0,0
ISLAMABAD DISTRICT,1,Male,12767,11904,24671
ISLAMABAD DISTRICT,1,Female,11799,11152,22951
ISLAMABAD DISTRICT,1,Transgender,0,0,0
ISLAMABAD DISTRICT,2,Male,12849,11466,24315
ISLAMABAD DISTRICT,2,Female,11993,10683,22676
ISLAMABAD DISTRICT,2,Transgender,0,0,0
ISLAMABAD DISTRICT,3,Male,13788,12806,26594
ISLAMABAD DISTRICT,3,Female,12997,12019,25016
ISLAMABAD DISTRICT,3,Transgender,0,0,0
ISLAMABAD DISTRICT,4,Male,12192,11633,23825
ISLAMABAD DISTRICT,4,Female,11734,10882,22616
ISLAMABAD DISTRICT,4,Transgender,0,0,0
ISLAMABAD DISTRICT,5,Male,12672,11742,24414
ISLAMABAD DISTRICT,5,Female,12191,11347,23538
ISLAMABAD DISTRICT,5,Transgender,0,0,0
ISLAMABAD DISTRICT,6,Male,12197,11611,23808
ISLAMABAD DISTRICT,6,Female,11477,10475,21952
ISLAMABAD DISTRICT,6,Transgender,0,0,0
ISLAMABAD DISTRICT,7,Male,13371,12200,25571
ISLAMABAD DISTRICT,7,Female,12533,11447,23980
ISLAMABAD DISTRICT,7,Transgender,0,0,0
ISLAMABAD DISTRICT,8,Male,11413,11045,22458
ISLAMABAD DISTRICT,8,Female,10553,10068,20621
ISLAMABAD DISTRICT,8,Transgender,0,0,0
ISLAMABAD DISTRICT,9,Male,13061,12672,25733
ISLAMABAD DISTRICT,9,Female,12303,11549,23852
ISLAMABAD DISTRICT,9,Transgender,0,0,0
ISLAMABAD DISTRICT,10,Male,10396,10206,20602
ISLAMABAD DISTRICT,10,Female,9517,9628,19145
ISLAMABAD DISTRICT,10,Transgender,0,0,0
ISLAMABAD DISTRICT,11,Male,12546,12757,25303
ISLAMABAD DISTRICT,11,Female,11505,11351,22856
ISLAMABAD DISTRICT,11,Transgender,0,0,0
ISLAMABAD DISTRICT,12,Male,10053,10500,20553
ISLAMABAD DISTRICT,12,Female,9152,9057,18209
ISLAMABAD DISTRICT,12,Transgender,0,0,0
ISLAMABAD DISTRICT,13,Male,11033,11548,22581
ISLAMABAD DISTRICT,13,Female,9863,10098,19961
ISLAMABAD DISTRICT,13,Transgender,0,0,0
ISLAMABAD DISTRICT,14,Male,9996,10359,20355
ISLAMABAD DISTRICT,14,Female,8648,9043,17691
ISLAMABAD DISTRICT,14,Transgender,0,0,0
ISLAMABAD DISTRICT,15,Male,9565,10370,19935
ISLAMABAD DISTRICT,15,Female,8950,9444,18394
ISLAMABAD DISTRICT,15,Transgender,4,5,9
ISLAMABAD DISTRICT,16,Male,9894,10574,20468
ISLAMABAD DISTRICT,16,Female,8694,9008,17702
ISLAMABAD DISTRICT,16,Transgender,2,9,11
ISLAMABAD DISTRICT,17,Male,10772,11363,22135
ISLAMABAD DISTRICT,17,Female,9355,9862,19217
ISLAMABAD DISTRICT,17,Transgender,5,8,13
ISLAMABAD DISTRICT,18,Male,9266,9977,19243
ISLAMABAD DISTRICT,18,Female,7740,8519,16259
ISLAMABAD DISTRICT,18,Transgender,0,7,7
ISLAMABAD DISTRICT,19,Male,10943,11844,22787
ISLAMABAD DISTRICT,19,Female,9658,10135,19793
ISLAMABAD DISTRICT,19,Transgender,3,5,8
ISLAMABAD DISTRICT,20,Male,9104,10462,19566
ISLAMABAD DISTRICT,20,Female,7406,7894,15300
ISLAMABAD DISTRICT,20,Transgender,4,5,9
ISLAMABAD DISTRICT,21,Male,10930,13137,24067
ISLAMABAD DISTRICT,21,Female,9885,10579,20464
ISLAMABAD DISTRICT,21,Transgender,0,7,7
ISLAMABAD DISTRICT,22,Male,9574,11501,21075
ISLAMABAD DISTRICT,22,Female,8663,9275,17938
ISLAMABAD DISTRICT,22,Transgender,2,4,6
ISLAMABAD DISTRICT,23,Male,10323,11817,22140
ISLAMABAD DISTRICT,23,Female,9687,10300,19987
ISLAMABAD DISTRICT,23,Transgender,2,5,7
ISLAMABAD DISTRICT,24,Male,10055,11109,21164
ISLAMABAD DISTRICT,24,Female,9506,9506,19012
ISLAMABAD DISTRICT,24,Transgender,5,5,10
ISLAMABAD DISTRICT,25,Male,8453,9562,18015
ISLAMABAD DISTRICT,25,Female,7877,7753,15630
ISLAMABAD DISTRICT,25,Transgender,2,10,12
ISLAMABAD DISTRICT,26,Male,9336,10062,19398
ISLAMABAD DISTRICT,26,Female,9867,9439,19306
ISLAMABAD DISTRICT,26,Transgender,4,3,7
ISLAMABAD DISTRICT,27,Male,9302,9638,18940
ISLAMABAD DISTRICT,27,Female,9849,9254,19103
ISLAMABAD DISTRICT,27,Transgender,2,7,9
ISLAMABAD DISTRICT,28,Male,8415,9218,17633
ISLAMABAD DISTRICT,28,Female,9156,8581,17737
ISLAMABAD DISTRICT,28,Transgender,5,6,11
ISLAMABAD DISTRICT,29,Male,8810,9153,17963
ISLAMABAD DISTRICT,29,Female,9333,8746,18079
ISLAMABAD DISTRICT,29,Transgender,2,3,5
ISLAMABAD DISTRICT,30,Male,8262,8677,16939
ISLAMABAD DISTRICT,30,Female,7977,7550,15527
ISLAMABAD DISTRICT,30,Transgender,12,8,20
ISLAMABAD DISTRICT,31,Male,8664,8545,17209
ISLAMABAD DISTRICT,31,Female,9172,8481,17653
ISLAMABAD DISTRICT,31,Transgender,6,1,7
ISLAMABAD DISTRICT,32,Male,8456,8599,17055
ISLAMABAD DISTRICT,32,Female,8475,7976,16451
ISLAMABAD DISTRICT,32,Transgender,4,2,6
ISLAMABAD DISTRICT,33,Male,8268,8185,16453
ISLAMABAD DISTRICT,33,Female,8475,7747,16222
ISLAMABAD DISTRICT,33,Transgender,4,3,7
ISLAMABAD DISTRICT,34,Male,7978,7671,15649
ISLAMABAD DISTRICT,34,Female,7614,7052,14666
ISLAMABAD DISTRICT,34,Transgender,2,2,4
ISLAMABAD DISTRICT,35,Male,6691,6965,13656
ISLAMABAD DISTRICT,35,Female,5992,6132,12124
ISLAMABAD DISTRICT,35,Transgender,6,4,10
ISLAMABAD DISTRICT,36,Male,7244,6790,14034
ISLAMABAD DISTRICT,36,Female,6732,6492,13224
ISLAMABAD DISTRICT,36,Transgender,0,2,2
ISLAMABAD DISTRICT,37,Male,6676,6433,13109
ISLAMABAD DISTRICT,37,Female,6114,5871,11985
ISLAMABAD DISTRICT,37,Transgender,2,4,6
ISLAMABAD DISTRICT,38,Male,7254,7182,14436
ISLAMABAD DISTRICT,38,Female,6683,6773,13456
ISLAMABAD DISTRICT,38,Transgender,4,4,8
ISLAMABAD DISTRICT,39,Male,6859,6634,13493
ISLAMABAD DISTRICT,39,Female,6243,6123,12366
ISLAMABAD DISTRICT,39,Transgender,3,2,5
ISLAMABAD DISTRICT,40,Male,6178,7204,13382
ISLAMABAD DISTRICT,40,Female,5227,5762,10989
ISLAMABAD DISTRICT,40,Transgender,7,4,11
ISLAMABAD DISTRICT,41,Male,5974,6255,12229
ISLAMABAD DISTRICT,41,Female,5196,5205,10401
ISLAMABAD DISTRICT,41,Transgender,0,0,0
ISLAMABAD DISTRICT,42,Male,5511,6167,11678
ISLAMABAD DISTRICT,42,Female,4686,5061,9747
ISLAMABAD DISTRICT,42,Transgender,2,3,5
ISLAMABAD DISTRICT,43,Male,5398,5870,11268
ISLAMABAD DISTRICT,43,Female,5008,5420,10428
ISLAMABAD DISTRICT,43,Transgender,0,1,1
ISLAMABAD DISTRICT,44,Male,4764,5044,9808
ISLAMABAD DISTRICT,44,Female,4511,4701,9212
ISLAMABAD DISTRICT,44,Transgender,1,0,1
ISLAMABAD DISTRICT,45,Male,4476,5093,9569
ISLAMABAD DISTRICT,45,Female,4060,4434,8494
ISLAMABAD DISTRICT,45,Transgender,4,2,6
ISLAMABAD DISTRICT,46,Male,4394,4411,8805
ISLAMABAD DISTRICT,46,Female,4013,4073,8086
ISLAMABAD DISTRICT,46,Transgender,3,0,3
ISLAMABAD DISTRICT,47,Male,3969,4280,8249
ISLAMABAD DISTRICT,47,Female,3400,3453,6853
ISLAMABAD DISTRICT,47,Transgender,0,2,2
ISLAMABAD DISTRICT,48,Male,4329,4872,9201
ISLAMABAD DISTRICT,48,Female,4280,4573,8853
ISLAMABAD DISTRICT,48,Transgender,1,0,1
ISLAMABAD DISTRICT,49,Male,4024,4595,8619
ISLAMABAD DISTRICT,49,Female,3954,4195,8149
ISLAMABAD DISTRICT,49,Transgender,2,1,3
ISLAMABAD DISTRICT,50,Male,4197,4880,9077
ISLAMABAD DISTRICT,50,Female,3815,4215,8030
ISLAMABAD DISTRICT,50,Transgender,3,4,7
ISLAMABAD DISTRICT,51,Male,3759,4462,8221
ISLAMABAD DISTRICT,51,Female,3531,3708,7239
ISLAMABAD DISTRICT,51,Transgender,2,0,2
ISLAMABAD DISTRICT,52,Male,3849,4776,8625
ISLAMABAD DISTRICT,52,Female,3475,3611,7086
ISLAMABAD DISTRICT,52,Transgender,1,2,3
ISLAMABAD DISTRICT,53,Male,3910,4477,8387
ISLAMABAD DISTRICT,53,Female,3579,3757,7336
ISLAMABAD DISTRICT,53,Transgender,0,0,0
ISLAMABAD DISTRICT,54,Male,3635,4266,7901
ISLAMABAD DISTRICT,54,Female,3276,3463,6739
ISLAMABAD DISTRICT,54,Transgender,1,0,1
ISLAMABAD DISTRICT,55,Male,3419,4081,7500
ISLAMABAD DISTRICT,55,Female,2958,2898,5856
ISLAMABAD DISTRICT,55,Transgender,0,5,5
ISLAMABAD DISTRICT,56,Male,2988,3680,6668
ISLAMABAD DISTRICT,56,Female,2597,2674,5271
ISLAMABAD DISTRICT,56,Transgender,1,0,1
ISLAMABAD DISTRICT,57,Male,2798,3222,6020
ISLAMABAD DISTRICT,57,Female,2087,1974,4061
ISLAMABAD DISTRICT,57,Transgender,1,2,3
ISLAMABAD DISTRICT,58,Male,2988,3362,6350
ISLAMABAD DISTRICT,58,Female,2593,2619,5212
ISLAMABAD DISTRICT,58,Transgender,1,0,1
ISLAMABAD DISTRICT,59,Male,2742,3134,5876
ISLAMABAD DISTRICT,59,Female,2435,2433,4868
ISLAMABAD DISTRICT,59,Transgender,0,0,0
ISLAMABAD DISTRICT,60,Male,2508,2685,5193
ISLAMABAD DISTRICT,60,Female,2245,2277,4522
ISLAMABAD DISTRICT,60,Transgender,1,0,1
ISLAMABAD DISTRICT,61,Male,2676,2564,5240
ISLAMABAD DISTRICT,61,Female,2225,2078,4303
ISLAMABAD DISTRICT,61,Transgender,0,0,0
ISLAMABAD DISTRICT,62,Male,2715,2592,5307
ISLAMABAD DISTRICT,62,Female,2080,2111,4191
ISLAMABAD DISTRICT,62,Transgender,0,0,0
ISLAMABAD DISTRICT,63,Male,2682,2680,5362
ISLAMABAD DISTRICT,63,Female,2160,2156,4316
ISLAMABAD DISTRICT,63,Transgender,0,1,1
ISLAMABAD DISTRICT,64,Male,2332,2295,4627
ISLAMABAD DISTRICT,64,Female,1827,1876,3703
ISLAMABAD DISTRICT,64,Transgender,0,0,0
ISLAMABAD DISTRICT,65,Male,2037,1983,4020
ISLAMABAD DISTRICT,65,Female,1656,1683,3339
ISLAMABAD DISTRICT,65,Transgender,2,0,2
ISLAMABAD DISTRICT,66,Male,1718,1597,3315
ISLAMABAD DISTRICT,66,Female,1211,1206,2417
ISLAMABAD DISTRICT,66,Transgender,0,1,1
ISLAMABAD DISTRICT,67,Male,1693,1488,3181
ISLAMABAD DISTRICT,67,Female,1153,1125,2278
ISLAMABAD DISTRICT,67,Transgender,1,0,1
ISLAMABAD DISTRICT,68,Male,1642,1610,3252
ISLAMABAD DISTRICT,68,Female,1253,1282,2535
ISLAMABAD DISTRICT,68,Transgender,0,0,0
ISLAMABAD DISTRICT,69,Male,1480,1352,2832
ISLAMABAD DISTRICT,69,Female,1141,1187,2328
ISLAMABAD DISTRICT,69,Transgender,0,1,1
ISLAMABAD DISTRICT,70,Male,1226,1246,2472
ISLAMABAD DISTRICT,70,Female,981,1160,2141
ISLAMABAD DISTRICT,70,Transgender,2,2,4
ISLAMABAD DISTRICT,71,Male,1088,1145,2233
ISLAMABAD DISTRICT,71,Female,872,951,1823
ISLAMABAD DISTRICT,71,Transgender,0,0,0
ISLAMABAD DISTRICT,72,Male,1146,1267,2413
ISLAMABAD DISTRICT,72,Female,851,971,1822
ISLAMABAD DISTRICT,72,Transgender,0,1,1
ISLAMABAD DISTRICT,73,Male,1005,1115,2120
ISLAMABAD DISTRICT,73,Female,810,941,1751
ISLAMABAD DISTRICT,73,Transgender,1,0,1
ISLAMABAD DISTRICT,74,Male,854,910,1764
ISLAMABAD DISTRICT,74,Female,656,754,1410
ISLAMABAD DISTRICT,74,Transgender,0,0,0
ISLAMABAD DISTRICT,>=75,Male,5575,6799,12374
ISLAMABAD DISTRICT,>=75,Female,5386,6165,11551
ISLAMABAD DISTRICT,>=75,Transgender,2,3,5
