district,tehsil_subdiv,age,rural,urban,total
ABBOTTABAD DISTRICT,ABBOTTABAD TEHSIL,<1,19158,5298,24456
ABBOTTABAD DISTRICT,ABBOTTABAD TEHSIL,1,18492,5454,23946
ABBOTTABAD DISTRICT,ABBOTTABAD TEHSIL,2,18336,5511,23847
ABBOTTABAD DISTRICT,ABBOTTABAD TEHSIL,3,19518,5871,25389
ABBOTTABAD DISTRICT,ABBOTTABAD TEHSIL,4,18542,5535,24077
ABBOTTABAD DISTRICT,ABBOTTABAD TEHSIL,5,18717,5513,24230
ABBOTTABAD DISTRICT,ABBOTTABAD TEHSIL,6,18006,5551,23557
ABBOTTABAD DISTRICT,ABBOTTABAD TEHSIL,7,20158,6022,26180
ABBOTTABAD DISTRICT,ABBOTTABAD TEHSIL,8,17653,5075,22728
ABBOTTABAD DISTRICT,ABBOTTABAD TEHSIL,9,19651,6068,25719
ABBOTTABAD DISTRICT,ABBOTTABAD TEHSIL,10,15410,4753,20163
ABBOTTABAD DISTRICT,ABBOTTABAD TEHSIL,11,18241,5763,24004
ABBOTTABAD DISTRICT,ABBOTTABAD TEHSIL,12,15404,5002,20406
ABBOTTABAD DISTRICT,ABBOTTABAD TEHSIL,13,16458,5604,22062
ABBOTTABAD DISTRICT,ABBOTTABAD TEHSIL,14,15114,5086,20200
ABBOTTABAD DISTRICT,ABBOTTABAD TEHSIL,15,15357,5141,20498
ABBOTTABAD DISTRICT,ABBOTTABAD TEHSIL,16,15398,5234,20632
ABBOTTABAD DISTRICT,ABBOTTABAD TEHSIL,17,15902,5648,21550
ABBOTTABAD DISTRICT,ABBOTTABAD TEHSIL,18,13693,4725,18418
ABBOTTABAD DISTRICT,ABBOTTABAD TEHSIL,19,15272,5909,21181
ABBOTTABAD DISTRICT,ABBOTTABAD TEHSIL,20,12561,5113,17674
ABBOTTABAD DISTRICT,ABBOTTABAD TEHSIL,21,14601,6286,20887
ABBOTTABAD DISTRICT,ABBOTTABAD TEHSIL,22,13556,5359,18915
ABBOTTABAD DISTRICT,ABBOTTABAD TEHSIL,23,14150,5222,19372
ABBOTTABAD DISTRICT,ABBOTTABAD TEHSIL,24,13752,4927,18679
ABBOTTABAD DISTRICT,ABBOTTABAD TEHSIL,25,11301,4037,15338
ABBOTTABAD DISTRICT,ABBOTTABAD TEHSIL,26,12599,4510,17109
ABBOTTABAD DISTRICT,ABBOTTABAD TEHSIL,27,12030,4334,16364
ABBOTTABAD DISTRICT,ABBOTTABAD TEHSIL,28,11594,4224,15818
ABBOTTABAD DISTRICT,ABBOTTABAD TEHSIL,29,11330,4160,15490
ABBOTTABAD DISTRICT,ABBOTTABAD TEHSIL,30,10538,3843,14381
ABBOTTABAD DISTRICT,ABBOTTABAD TEHSIL,31,11463,4044,15507
ABBOTTABAD DISTRICT,ABBOTTABAD TEHSIL,32,10966,4020,14986
ABBOTTABAD DISTRICT,ABBOTTABAD TEHSIL,33,10549,3661,14210
ABBOTTABAD DISTRICT,ABBOTTABAD TEHSIL,34,10135,3397,13532
ABBOTTABAD DISTRICT,ABBOTTABAD TEHSIL,35,8466,3151,11617
ABBOTTABAD DISTRICT,ABBOTTABAD TEHSIL,36,9402,3228,12630
ABBOTTABAD DISTRICT,ABBOTTABAD TEHSIL,37,8486,2770,11256
ABBOTTABAD DISTRICT,ABBOTTABAD TEHSIL,38,9309,3548,12857
ABBOTTABAD DISTRICT,ABBOTTABAD TEHSIL,39,8645,2875,11520
ABBOTTABAD DISTRICT,ABBOTTABAD TEHSIL,40,7704,3091,10795
ABBOTTABAD DISTRICT,ABBOTTABAD TEHSIL,41,7352,2517,9869
ABBOTTABAD DISTRICT,ABBOTTABAD TEHSIL,42,6862,2638,9500
ABBOTTABAD DISTRICT,ABBOTTABAD TEHSIL,43,6895,2512,9407
ABBOTTABAD DISTRICT,ABBOTTABAD TEHSIL,44,6667,2331,8998
ABBOTTABAD DISTRICT,ABBOTTABAD TEHSIL,45,5890,2396,8286
ABBOTTABAD DISTRICT,ABBOTTABAD TEHSIL,46,6249,2043,8292
ABBOTTABAD DISTRICT,ABBOTTABAD TEHSIL,47,5530,1725,7255
ABBOTTABAD DISTRICT,ABBOTTABAD TEHSIL,48,6715,2206,8921
ABBOTTABAD DISTRICT,ABBOTTABAD TEHSIL,49,6244,1952,8196
ABBOTTABAD DISTRICT,ABBOTTABAD TEHSIL,50,5730,2199,7929
ABBOTTABAD DISTRICT,ABBOTTABAD TEHSIL,51,5680,1743,7423
ABBOTTABAD DISTRICT,ABBOTTABAD TEHSIL,52,5685,1917,7602
ABBOTTABAD DISTRICT,ABBOTTABAD TEHSIL,53,5667,1820,7487
ABBOTTABAD DISTRICT,ABBOTTABAD TEHSIL,54,5374,1711,7085
ABBOTTABAD DISTRICT,ABBOTTABAD TEHSIL,55,4691,1704,6395
ABBOTTABAD DISTRICT,ABBOTTABAD TEHSIL,56,4408,1357,5765
ABBOTTABAD DISTRICT,ABBOTTABAD TEHSIL,57,3690,1100,4790
ABBOTTABAD DISTRICT,ABBOTTABAD TEHSIL,58,4177,1321,5498
ABBOTTABAD DISTRICT,ABBOTTABAD TEHSIL,59,3608,1063,4671
ABBOTTABAD DISTRICT,ABBOTTABAD TEHSIL,60,3658,1409,5067
ABBOTTABAD DISTRICT,ABBOTTABAD TEHSIL,61,3798,1073,4871
ABBOTTABAD DISTRICT,ABBOTTABAD TEHSIL,62,3760,1162,4922
ABBOTTABAD DISTRICT,ABBOTTABAD TEHSIL,63,3757,1060,4817
ABBOTTABAD DISTRICT,ABBOTTABAD TEHSIL,64,3331,992,4323
ABBOTTABAD DISTRICT,ABBOTTABAD TEHSIL,65,2911,957,3868
ABBOTTABAD DISTRICT,ABBOTTABAD TEHSIL,66,2617,679,3296
ABBOTTABAD DISTRICT,ABBOTTABAD TEHSIL,67,2599,588,3187
ABBOTTABAD DISTRICT,ABBOTTABAD TEHSIL,68,2897,734,3631
ABBOTTABAD DISTRICT,ABBOTTABAD TEHSIL,69,2315,560,2875
ABBOTTABAD DISTRICT,ABBOTTABAD TEHSIL,70,2052,653,2705
ABBOTTABAD DISTRICT,ABBOTTABAD TEHSIL,71,2099,520,2619
ABBOTTABAD DISTRICT,ABBOTTABAD TEHSIL,72,2017,530,2547
ABBOTTABAD DISTRICT,ABBOTTABAD TEHSIL,73,1987,488,2475
ABBOTTABAD DISTRICT,ABBOTTABAD TEHSIL,74,1525,413,1938
ABBOTTABAD DISTRICT,ABBOTTABAD TEHSIL,>=75,11113,3034,14147
ABBOTTABAD DISTRICT,HAVELIAN TEHSIL,<1,7703,1136,8839
ABBOTTABAD DISTRICT,HAVELIAN TEHSIL,1,7201,1189,8390
ABBOTTABAD DISTRICT,HAVELIAN TEHSIL,2,7408,1191,8599
ABBOTTABAD DISTRICT,HAVELIAN TEHSIL,3,7777,1250,9027
ABBOTTABAD DISTRICT,HAVELIAN TEHSIL,4,7343,1181,8524
ABBOTTABAD DISTRICT,HAVELIAN TEHSIL,5,7515,1199,8714
ABBOTTABAD DISTRICT,HAVELIAN TEHSIL,6,7298,1209,8507
ABBOTTABAD DISTRICT,HAVELIAN TEHSIL,7,7986,1295,9281
ABBOTTABAD DISTRICT,HAVELIAN TEHSIL,8,7227,1123,8350
ABBOTTABAD DISTRICT,HAVELIAN TEHSIL,9,7841,1313,9154
ABBOTTABAD DISTRICT,HAVELIAN TEHSIL,10,6285,1018,7303
ABBOTTABAD DISTRICT,HAVELIAN TEHSIL,11,7263,1221,8484
ABBOTTABAD DISTRICT,HAVELIAN TEHSIL,12,6216,1060,7276
ABBOTTABAD DISTRICT,HAVELIAN TEHSIL,13,6447,1152,7599
ABBOTTABAD DISTRICT,HAVELIAN TEHSIL,14,6080,1030,7110
ABBOTTABAD DISTRICT,HAVELIAN TEHSIL,15,6155,1030,7185
ABBOTTABAD DISTRICT,HAVELIAN TEHSIL,16,6293,1033,7326
ABBOTTABAD DISTRICT,HAVELIAN TEHSIL,17,6642,1056,7698
ABBOTTABAD DISTRICT,HAVELIAN TEHSIL,18,5650,876,6526
ABBOTTABAD DISTRICT,HAVELIAN TEHSIL,19,6161,1008,7169
ABBOTTABAD DISTRICT,HAVELIAN TEHSIL,20,5207,857,6064
ABBOTTABAD DISTRICT,HAVELIAN TEHSIL,21,5973,930,6903
ABBOTTABAD DISTRICT,HAVELIAN TEHSIL,22,5750,880,6630
ABBOTTABAD DISTRICT,HAVELIAN TEHSIL,23,5809,946,6755
ABBOTTABAD DISTRICT,HAVELIAN TEHSIL,24,5805,943,6748
ABBOTTABAD DISTRICT,HAVELIAN TEHSIL,25,4968,702,5670
ABBOTTABAD DISTRICT,HAVELIAN TEHSIL,26,5303,824,6127
ABBOTTABAD DISTRICT,HAVELIAN TEHSIL,27,4802,809,5611
ABBOTTABAD DISTRICT,HAVELIAN TEHSIL,28,5160,779,5939
ABBOTTABAD DISTRICT,HAVELIAN TEHSIL,29,4529,768,5297
ABBOTTABAD DISTRICT,HAVELIAN TEHSIL,30,4680,698,5378
ABBOTTABAD DISTRICT,HAVELIAN TEHSIL,31,4444,720,5164
ABBOTTABAD DISTRICT,HAVELIAN TEHSIL,32,4518,785,5303
ABBOTTABAD DISTRICT,HAVELIAN TEHSIL,33,4092,791,4883
ABBOTTABAD DISTRICT,HAVELIAN TEHSIL,34,4091,652,4743
ABBOTTABAD DISTRICT,HAVELIAN TEHSIL,35,3818,622,4440
ABBOTTABAD DISTRICT,HAVELIAN TEHSIL,36,3771,667,4438
ABBOTTABAD DISTRICT,HAVELIAN TEHSIL,37,3159,557,3716
ABBOTTABAD DISTRICT,HAVELIAN TEHSIL,38,3918,653,4571
ABBOTTABAD DISTRICT,HAVELIAN TEHSIL,39,3384,594,3978
ABBOTTABAD DISTRICT,HAVELIAN TEHSIL,40,3396,589,3985
ABBOTTABAD DISTRICT,HAVELIAN TEHSIL,41,3009,511,3520
ABBOTTABAD DISTRICT,HAVELIAN TEHSIL,42,2888,501,3389
ABBOTTABAD DISTRICT,HAVELIAN TEHSIL,43,2808,477,3285
ABBOTTABAD DISTRICT,HAVELIAN TEHSIL,44,2666,438,3104
ABBOTTABAD DISTRICT,HAVELIAN TEHSIL,45,2611,411,3022
ABBOTTABAD DISTRICT,HAVELIAN TEHSIL,46,2541,415,2956
ABBOTTABAD DISTRICT,HAVELIAN TEHSIL,47,2112,343,2455
ABBOTTABAD DISTRICT,HAVELIAN TEHSIL,48,2826,372,3198
ABBOTTABAD DISTRICT,HAVELIAN TEHSIL,49,2440,376,2816
ABBOTTABAD DISTRICT,HAVELIAN TEHSIL,50,2666,441,3107
ABBOTTABAD DISTRICT,HAVELIAN TEHSIL,51,2252,392,2644
ABBOTTABAD DISTRICT,HAVELIAN TEHSIL,52,2284,392,2676
ABBOTTABAD DISTRICT,HAVELIAN TEHSIL,53,2323,335,2658
ABBOTTABAD DISTRICT,HAVELIAN TEHSIL,54,2158,363,2521
ABBOTTABAD DISTRICT,HAVELIAN TEHSIL,55,2170,311,2481
ABBOTTABAD DISTRICT,HAVELIAN TEHSIL,56,1801,324,2125
ABBOTTABAD DISTRICT,HAVELIAN TEHSIL,57,1354,236,1590
ABBOTTABAD DISTRICT,HAVELIAN TEHSIL,58,1709,260,1969
ABBOTTABAD DISTRICT,HAVELIAN TEHSIL,59,1529,249,1778
ABBOTTABAD DISTRICT,HAVELIAN TEHSIL,60,1791,247,2038
ABBOTTABAD DISTRICT,HAVELIAN TEHSIL,61,1595,221,1816
ABBOTTABAD DISTRICT,HAVELIAN TEHSIL,62,1630,222,1852
ABBOTTABAD DISTRICT,HAVELIAN TEHSIL,63,1625,227,1852
ABBOTTABAD DISTRICT,HAVELIAN TEHSIL,64,1388,197,1585
ABBOTTABAD DISTRICT,HAVELIAN TEHSIL,65,1443,197,1640
ABBOTTABAD DISTRICT,HAVELIAN TEHSIL,66,1164,116,1280
ABBOTTABAD DISTRICT,HAVELIAN TEHSIL,67,1007,109,1116
ABBOTTABAD DISTRICT,HAVELIAN TEHSIL,68,1107,138,1245
ABBOTTABAD DISTRICT,HAVELIAN TEHSIL,69,925,111,1036
ABBOTTABAD DISTRICT,HAVELIAN TEHSIL,70,1011,132,1143
ABBOTTABAD DISTRICT,HAVELIAN TEHSIL,71,844,100,944
ABBOTTABAD DISTRICT,HAVELIAN TEHSIL,72,868,86,954
ABBOTTABAD DISTRICT,HAVELIAN TEHSIL,73,770,85,855
ABBOTTABAD DISTRICT,HAVELIAN TEHSIL,74,653,64,717
ABBOTTABAD DISTRICT,HAVELIAN TEHSIL,>=75,4901,580,5481
ATTOCK DISTRICT,ATTOCK TEHSIL,<1,5079,4114,9193
ATTOCK DISTRICT,ATTOCK TEHSIL,1,5457,4656,10113
ATTOCK DISTRICT,ATTOCK TEHSIL,2,5249,4594,9843
ATTOCK DISTRICT,ATTOCK TEHSIL,3,5758,5129,10887
ATTOCK DISTRICT,ATTOCK TEHSIL,4,5370,4722,10092
ATTOCK DISTRICT,ATTOCK TEHSIL,5,5098,4846,9944
ATTOCK DISTRICT,ATTOCK TEHSIL,6,5169,4758,9927
ATTOCK DISTRICT,ATTOCK TEHSIL,7,5418,5058,10476
ATTOCK DISTRICT,ATTOCK TEHSIL,8,4823,4545,9368
ATTOCK DISTRICT,ATTOCK TEHSIL,9,5578,5409,10987
ATTOCK DISTRICT,ATTOCK TEHSIL,10,4332,4197,8529
ATTOCK DISTRICT,ATTOCK TEHSIL,11,5351,5298,10649
ATTOCK DISTRICT,ATTOCK TEHSIL,12,4306,4138,8444
ATTOCK DISTRICT,ATTOCK TEHSIL,13,4945,4675,9620
ATTOCK DISTRICT,ATTOCK TEHSIL,14,4256,4220,8476
ATTOCK DISTRICT,ATTOCK TEHSIL,15,4635,4206,8841
ATTOCK DISTRICT,ATTOCK TEHSIL,16,4680,4309,8989
ATTOCK DISTRICT,ATTOCK TEHSIL,17,4962,4592,9554
ATTOCK DISTRICT,ATTOCK TEHSIL,18,3857,3833,7690
ATTOCK DISTRICT,ATTOCK TEHSIL,19,4767,4902,9669
ATTOCK DISTRICT,ATTOCK TEHSIL,20,3669,3805,7474
ATTOCK DISTRICT,ATTOCK TEHSIL,21,4552,5205,9757
ATTOCK DISTRICT,ATTOCK TEHSIL,22,3854,4140,7994
ATTOCK DISTRICT,ATTOCK TEHSIL,23,4255,4340,8595
ATTOCK DISTRICT,ATTOCK TEHSIL,24,4182,3932,8114
ATTOCK DISTRICT,ATTOCK TEHSIL,25,3402,3091,6493
ATTOCK DISTRICT,ATTOCK TEHSIL,26,4103,3757,7860
ATTOCK DISTRICT,ATTOCK TEHSIL,27,3902,3859,7761
ATTOCK DISTRICT,ATTOCK TEHSIL,28,3524,3581,7105
ATTOCK DISTRICT,ATTOCK TEHSIL,29,3878,3810,7688
ATTOCK DISTRICT,ATTOCK TEHSIL,30,3234,3225,6459
ATTOCK DISTRICT,ATTOCK TEHSIL,31,3838,3807,7645
ATTOCK DISTRICT,ATTOCK TEHSIL,32,3241,3442,6683
ATTOCK DISTRICT,ATTOCK TEHSIL,33,3429,3526,6955
ATTOCK DISTRICT,ATTOCK TEHSIL,34,3371,3409,6780
ATTOCK DISTRICT,ATTOCK TEHSIL,35,2592,2720,5312
ATTOCK DISTRICT,ATTOCK TEHSIL,36,3188,3309,6497
ATTOCK DISTRICT,ATTOCK TEHSIL,37,2739,2958,5697
ATTOCK DISTRICT,ATTOCK TEHSIL,38,2987,3257,6244
ATTOCK DISTRICT,ATTOCK TEHSIL,39,2778,3137,5915
ATTOCK DISTRICT,ATTOCK TEHSIL,40,2336,2679,5015
ATTOCK DISTRICT,ATTOCK TEHSIL,41,2509,2761,5270
ATTOCK DISTRICT,ATTOCK TEHSIL,42,2080,2535,4615
ATTOCK DISTRICT,ATTOCK TEHSIL,43,2363,2547,4910
ATTOCK DISTRICT,ATTOCK TEHSIL,44,2224,2175,4399
ATTOCK DISTRICT,ATTOCK TEHSIL,45,1791,1853,3644
ATTOCK DISTRICT,ATTOCK TEHSIL,46,2107,1855,3962
ATTOCK DISTRICT,ATTOCK TEHSIL,47,1802,1683,3485
ATTOCK DISTRICT,ATTOCK TEHSIL,48,2053,1988,4041
ATTOCK DISTRICT,ATTOCK TEHSIL,49,1982,1877,3859
ATTOCK DISTRICT,ATTOCK TEHSIL,50,1801,1780,3581
ATTOCK DISTRICT,ATTOCK TEHSIL,51,1857,1745,3602
ATTOCK DISTRICT,ATTOCK TEHSIL,52,1737,1677,3414
ATTOCK DISTRICT,ATTOCK TEHSIL,53,1877,1721,3598
ATTOCK DISTRICT,ATTOCK TEHSIL,54,1783,1548,3331
ATTOCK DISTRICT,ATTOCK TEHSIL,55,1217,1342,2559
ATTOCK DISTRICT,ATTOCK TEHSIL,56,1431,1312,2743
ATTOCK DISTRICT,ATTOCK TEHSIL,57,1206,1107,2313
ATTOCK DISTRICT,ATTOCK TEHSIL,58,1251,1096,2347
ATTOCK DISTRICT,ATTOCK TEHSIL,59,1066,1072,2138
ATTOCK DISTRICT,ATTOCK TEHSIL,60,1088,902,1990
ATTOCK DISTRICT,ATTOCK TEHSIL,61,1260,984,2244
ATTOCK DISTRICT,ATTOCK TEHSIL,62,1140,920,2060
ATTOCK DISTRICT,ATTOCK TEHSIL,63,1165,908,2073
ATTOCK DISTRICT,ATTOCK TEHSIL,64,1063,783,1846
ATTOCK DISTRICT,ATTOCK TEHSIL,65,809,663,1472
ATTOCK DISTRICT,ATTOCK TEHSIL,66,836,585,1421
ATTOCK DISTRICT,ATTOCK TEHSIL,67,835,530,1365
ATTOCK DISTRICT,ATTOCK TEHSIL,68,898,550,1448
ATTOCK DISTRICT,ATTOCK TEHSIL,69,707,512,1219
ATTOCK DISTRICT,ATTOCK TEHSIL,70,657,480,1137
ATTOCK DISTRICT,ATTOCK TEHSIL,71,698,437,1135
ATTOCK DISTRICT,ATTOCK TEHSIL,72,703,448,1151
ATTOCK DISTRICT,ATTOCK TEHSIL,73,626,375,1001
ATTOCK DISTRICT,ATTOCK TEHSIL,74,472,278,750
ATTOCK DISTRICT,ATTOCK TEHSIL,>=75,3472,2274,5746
ATTOCK DISTRICT,FATEH JANG TEHSIL,<1,5737,1500,7237
ATTOCK DISTRICT,FATEH JANG TEHSIL,1,6145,1492,7637
ATTOCK DISTRICT,FATEH JANG TEHSIL,2,6106,1647,7753
ATTOCK DISTRICT,FATEH JANG TEHSIL,3,6395,1742,8137
ATTOCK DISTRICT,FATEH JANG TEHSIL,4,6024,1609,7633
ATTOCK DISTRICT,FATEH JANG TEHSIL,5,5936,1657,7593
ATTOCK DISTRICT,FATEH JANG TEHSIL,6,5724,1603,7327
ATTOCK DISTRICT,FATEH JANG TEHSIL,7,6195,1712,7907
ATTOCK DISTRICT,FATEH JANG TEHSIL,8,5403,1509,6912
ATTOCK DISTRICT,FATEH JANG TEHSIL,9,6166,1716,7882
ATTOCK DISTRICT,FATEH JANG TEHSIL,10,4968,1297,6265
ATTOCK DISTRICT,FATEH JANG TEHSIL,11,5799,1658,7457
ATTOCK DISTRICT,FATEH JANG TEHSIL,12,4666,1236,5902
ATTOCK DISTRICT,FATEH JANG TEHSIL,13,5280,1517,6797
ATTOCK DISTRICT,FATEH JANG TEHSIL,14,4585,1345,5930
ATTOCK DISTRICT,FATEH JANG TEHSIL,15,4723,1365,6088
ATTOCK DISTRICT,FATEH JANG TEHSIL,16,4902,1315,6217
ATTOCK DISTRICT,FATEH JANG TEHSIL,17,4886,1349,6235
ATTOCK DISTRICT,FATEH JANG TEHSIL,18,4310,1037,5347
ATTOCK DISTRICT,FATEH JANG TEHSIL,19,5052,1286,6338
ATTOCK DISTRICT,FATEH JANG TEHSIL,20,4140,1024,5164
ATTOCK DISTRICT,FATEH JANG TEHSIL,21,5263,1312,6575
ATTOCK DISTRICT,FATEH JANG TEHSIL,22,4348,1084,5432
ATTOCK DISTRICT,FATEH JANG TEHSIL,23,4698,1191,5889
ATTOCK DISTRICT,FATEH JANG TEHSIL,24,4766,1158,5924
ATTOCK DISTRICT,FATEH JANG TEHSIL,25,3759,986,4745
ATTOCK DISTRICT,FATEH JANG TEHSIL,26,4492,1164,5656
ATTOCK DISTRICT,FATEH JANG TEHSIL,27,4352,1169,5521
ATTOCK DISTRICT,FATEH JANG TEHSIL,28,4063,994,5057
ATTOCK DISTRICT,FATEH JANG TEHSIL,29,4570,1146,5716
ATTOCK DISTRICT,FATEH JANG TEHSIL,30,3668,906,4574
ATTOCK DISTRICT,FATEH JANG TEHSIL,31,4396,1166,5562
ATTOCK DISTRICT,FATEH JANG TEHSIL,32,3956,1015,4971
ATTOCK DISTRICT,FATEH JANG TEHSIL,33,4157,1058,5215
ATTOCK DISTRICT,FATEH JANG TEHSIL,34,3900,1080,4980
ATTOCK DISTRICT,FATEH JANG TEHSIL,35,3062,788,3850
ATTOCK DISTRICT,FATEH JANG TEHSIL,36,3600,940,4540
ATTOCK DISTRICT,FATEH JANG TEHSIL,37,3108,956,4064
ATTOCK DISTRICT,FATEH JANG TEHSIL,38,3380,894,4274
ATTOCK DISTRICT,FATEH JANG TEHSIL,39,3310,892,4202
ATTOCK DISTRICT,FATEH JANG TEHSIL,40,2541,716,3257
ATTOCK DISTRICT,FATEH JANG TEHSIL,41,2942,840,3782
ATTOCK DISTRICT,FATEH JANG TEHSIL,42,2652,661,3313
ATTOCK DISTRICT,FATEH JANG TEHSIL,43,2924,774,3698
ATTOCK DISTRICT,FATEH JANG TEHSIL,44,2661,689,3350
ATTOCK DISTRICT,FATEH JANG TEHSIL,45,2187,471,2658
ATTOCK DISTRICT,FATEH JANG TEHSIL,46,2505,619,3124
ATTOCK DISTRICT,FATEH JANG TEHSIL,47,2351,603,2954
ATTOCK DISTRICT,FATEH JANG TEHSIL,48,2659,632,3291
ATTOCK DISTRICT,FATEH JANG TEHSIL,49,2717,634,3351
ATTOCK DISTRICT,FATEH JANG TEHSIL,50,2148,487,2635
ATTOCK DISTRICT,FATEH JANG TEHSIL,51,2549,585,3134
ATTOCK DISTRICT,FATEH JANG TEHSIL,52,2310,558,2868
ATTOCK DISTRICT,FATEH JANG TEHSIL,53,2508,601,3109
ATTOCK DISTRICT,FATEH JANG TEHSIL,54,2182,494,2676
ATTOCK DISTRICT,FATEH JANG TEHSIL,55,1713,370,2083
ATTOCK DISTRICT,FATEH JANG TEHSIL,56,1692,416,2108
ATTOCK DISTRICT,FATEH JANG TEHSIL,57,1478,367,1845
ATTOCK DISTRICT,FATEH JANG TEHSIL,58,1588,351,1939
ATTOCK DISTRICT,FATEH JANG TEHSIL,59,1621,361,1982
ATTOCK DISTRICT,FATEH JANG TEHSIL,60,1357,284,1641
ATTOCK DISTRICT,FATEH JANG TEHSIL,61,1772,407,2179
ATTOCK DISTRICT,FATEH JANG TEHSIL,62,1573,358,1931
ATTOCK DISTRICT,FATEH JANG TEHSIL,63,1636,378,2014
ATTOCK DISTRICT,FATEH JANG TEHSIL,64,1532,309,1841
ATTOCK DISTRICT,FATEH JANG TEHSIL,65,1210,246,1456
ATTOCK DISTRICT,FATEH JANG TEHSIL,66,1260,250,1510
ATTOCK DISTRICT,FATEH JANG TEHSIL,67,1207,246,1453
ATTOCK DISTRICT,FATEH JANG TEHSIL,68,1216,229,1445
ATTOCK DISTRICT,FATEH JANG TEHSIL,69,1021,212,1233
ATTOCK DISTRICT,FATEH JANG TEHSIL,70,840,150,990
ATTOCK DISTRICT,FATEH JANG TEHSIL,71,1098,192,1290
ATTOCK DISTRICT,FATEH JANG TEHSIL,72,946,170,1116
ATTOCK DISTRICT,FATEH JANG TEHSIL,73,795,182,977
ATTOCK DISTRICT,FATEH JANG TEHSIL,74,700,111,811
ATTOCK DISTRICT,FATEH JANG TEHSIL,>=75,5852,1032,6884
ATTOCK DISTRICT,HASAN ABDAL TEHSIL,<1,3663,1443,5106
ATTOCK DISTRICT,HASAN ABDAL TEHSIL,1,3999,2456,6455
ATTOCK DISTRICT,HASAN ABDAL TEHSIL,2,3989,1506,5495
ATTOCK DISTRICT,HASAN ABDAL TEHSIL,3,4273,1653,5926
ATTOCK DISTRICT,HASAN ABDAL TEHSIL,4,4013,1419,5432
ATTOCK DISTRICT,HASAN ABDAL TEHSIL,5,3979,1495,5474
ATTOCK DISTRICT,HASAN ABDAL TEHSIL,6,3961,1478,5439
ATTOCK DISTRICT,HASAN ABDAL TEHSIL,7,4301,1639,5940
ATTOCK DISTRICT,HASAN ABDAL TEHSIL,8,3674,1387,5061
ATTOCK DISTRICT,HASAN ABDAL TEHSIL,9,4127,1631,5758
ATTOCK DISTRICT,HASAN ABDAL TEHSIL,10,3167,1243,4410
ATTOCK DISTRICT,HASAN ABDAL TEHSIL,11,3789,1605,5394
ATTOCK DISTRICT,HASAN ABDAL TEHSIL,12,3027,1321,4348
ATTOCK DISTRICT,HASAN ABDAL TEHSIL,13,3342,1430,4772
ATTOCK DISTRICT,HASAN ABDAL TEHSIL,14,2870,1303,4173
ATTOCK DISTRICT,HASAN ABDAL TEHSIL,15,3056,1323,4379
ATTOCK DISTRICT,HASAN ABDAL TEHSIL,16,3096,1249,4345
ATTOCK DISTRICT,HASAN ABDAL TEHSIL,17,3149,1227,4376
ATTOCK DISTRICT,HASAN ABDAL TEHSIL,18,2688,1131,3819
ATTOCK DISTRICT,HASAN ABDAL TEHSIL,19,3129,1322,4451
ATTOCK DISTRICT,HASAN ABDAL TEHSIL,20,2716,1056,3772
ATTOCK DISTRICT,HASAN ABDAL TEHSIL,21,3131,1297,4428
ATTOCK DISTRICT,HASAN ABDAL TEHSIL,22,2677,1124,3801
ATTOCK DISTRICT,HASAN ABDAL TEHSIL,23,2806,1190,3996
ATTOCK DISTRICT,HASAN ABDAL TEHSIL,24,2737,1181,3918
ATTOCK DISTRICT,HASAN ABDAL TEHSIL,25,2295,939,3234
ATTOCK DISTRICT,HASAN ABDAL TEHSIL,26,2641,1141,3782
ATTOCK DISTRICT,HASAN ABDAL TEHSIL,27,2613,1042,3655
ATTOCK DISTRICT,HASAN ABDAL TEHSIL,28,2432,1040,3472
ATTOCK DISTRICT,HASAN ABDAL TEHSIL,29,2564,1042,3606
ATTOCK DISTRICT,HASAN ABDAL TEHSIL,30,2101,920,3021
ATTOCK DISTRICT,HASAN ABDAL TEHSIL,31,2531,1012,3543
ATTOCK DISTRICT,HASAN ABDAL TEHSIL,32,2178,995,3173
ATTOCK DISTRICT,HASAN ABDAL TEHSIL,33,2254,927,3181
ATTOCK DISTRICT,HASAN ABDAL TEHSIL,34,2131,892,3023
ATTOCK DISTRICT,HASAN ABDAL TEHSIL,35,1648,741,2389
ATTOCK DISTRICT,HASAN ABDAL TEHSIL,36,2034,853,2887
ATTOCK DISTRICT,HASAN ABDAL TEHSIL,37,1809,764,2573
ATTOCK DISTRICT,HASAN ABDAL TEHSIL,38,1930,795,2725
ATTOCK DISTRICT,HASAN ABDAL TEHSIL,39,1902,828,2730
ATTOCK DISTRICT,HASAN ABDAL TEHSIL,40,1526,709,2235
ATTOCK DISTRICT,HASAN ABDAL TEHSIL,41,1737,689,2426
ATTOCK DISTRICT,HASAN ABDAL TEHSIL,42,1434,637,2071
ATTOCK DISTRICT,HASAN ABDAL TEHSIL,43,1553,698,2251
ATTOCK DISTRICT,HASAN ABDAL TEHSIL,44,1486,637,2123
ATTOCK DISTRICT,HASAN ABDAL TEHSIL,45,1177,535,1712
ATTOCK DISTRICT,HASAN ABDAL TEHSIL,46,1411,578,1989
ATTOCK DISTRICT,HASAN ABDAL TEHSIL,47,1150,516,1666
ATTOCK DISTRICT,HASAN ABDAL TEHSIL,48,1346,549,1895
ATTOCK DISTRICT,HASAN ABDAL TEHSIL,49,1319,578,1897
ATTOCK DISTRICT,HASAN ABDAL TEHSIL,50,1110,471,1581
ATTOCK DISTRICT,HASAN ABDAL TEHSIL,51,1282,527,1809
ATTOCK DISTRICT,HASAN ABDAL TEHSIL,52,1111,443,1554
ATTOCK DISTRICT,HASAN ABDAL TEHSIL,53,1211,533,1744
ATTOCK DISTRICT,HASAN ABDAL TEHSIL,54,1101,426,1527
ATTOCK DISTRICT,HASAN ABDAL TEHSIL,55,806,371,1177
ATTOCK DISTRICT,HASAN ABDAL TEHSIL,56,948,364,1312
ATTOCK DISTRICT,HASAN ABDAL TEHSIL,57,754,332,1086
ATTOCK DISTRICT,HASAN ABDAL TEHSIL,58,790,330,1120
ATTOCK DISTRICT,HASAN ABDAL TEHSIL,59,854,309,1163
ATTOCK DISTRICT,HASAN ABDAL TEHSIL,60,728,287,1015
ATTOCK DISTRICT,HASAN ABDAL TEHSIL,61,858,373,1231
ATTOCK DISTRICT,HASAN ABDAL TEHSIL,62,833,312,1145
ATTOCK DISTRICT,HASAN ABDAL TEHSIL,63,816,275,1091
ATTOCK DISTRICT,HASAN ABDAL TEHSIL,64,761,262,1023
ATTOCK DISTRICT,HASAN ABDAL TEHSIL,65,522,197,719
ATTOCK DISTRICT,HASAN ABDAL TEHSIL,66,630,209,839
ATTOCK DISTRICT,HASAN ABDAL TEHSIL,67,603,204,807
ATTOCK DISTRICT,HASAN ABDAL TEHSIL,68,551,194,745
ATTOCK DISTRICT,HASAN ABDAL TEHSIL,69,517,184,701
ATTOCK DISTRICT,HASAN ABDAL TEHSIL,70,422,146,568
ATTOCK DISTRICT,HASAN ABDAL TEHSIL,71,472,157,629
ATTOCK DISTRICT,HASAN ABDAL TEHSIL,72,499,168,667
ATTOCK DISTRICT,HASAN ABDAL TEHSIL,73,371,137,508
ATTOCK DISTRICT,HASAN ABDAL TEHSIL,74,302,107,409
ATTOCK DISTRICT,HASAN ABDAL TEHSIL,>=75,2478,734,3212
ATTOCK DISTRICT,HAZRO TEHSIL,<1,6302,1160,7462
ATTOCK DISTRICT,HAZRO TEHSIL,1,6594,1102,7696
ATTOCK DISTRICT,HAZRO TEHSIL,2,6675,1262,7937
ATTOCK DISTRICT,HAZRO TEHSIL,3,7145,1314,8459
ATTOCK DISTRICT,HAZRO TEHSIL,4,7167,1339,8506
ATTOCK DISTRICT,HAZRO TEHSIL,5,6853,1306,8159
ATTOCK DISTRICT,HAZRO TEHSIL,6,6840,1260,8100
ATTOCK DISTRICT,HAZRO TEHSIL,7,7269,1411,8680
ATTOCK DISTRICT,HAZRO TEHSIL,8,6425,1151,7576
ATTOCK DISTRICT,HAZRO TEHSIL,9,7137,1313,8450
ATTOCK DISTRICT,HAZRO TEHSIL,10,6059,1090,7149
ATTOCK DISTRICT,HAZRO TEHSIL,11,7036,1270,8306
ATTOCK DISTRICT,HAZRO TEHSIL,12,5884,1068,6952
ATTOCK DISTRICT,HAZRO TEHSIL,13,6622,1274,7896
ATTOCK DISTRICT,HAZRO TEHSIL,14,6233,1127,7360
ATTOCK DISTRICT,HAZRO TEHSIL,15,6343,1197,7540
ATTOCK DISTRICT,HAZRO TEHSIL,16,6315,1191,7506
ATTOCK DISTRICT,HAZRO TEHSIL,17,6712,1283,7995
ATTOCK DISTRICT,HAZRO TEHSIL,18,5300,1014,6314
ATTOCK DISTRICT,HAZRO TEHSIL,19,6213,1182,7395
ATTOCK DISTRICT,HAZRO TEHSIL,20,4956,917,5873
ATTOCK DISTRICT,HAZRO TEHSIL,21,5936,1188,7124
ATTOCK DISTRICT,HAZRO TEHSIL,22,4946,989,5935
ATTOCK DISTRICT,HAZRO TEHSIL,23,5048,1043,6091
ATTOCK DISTRICT,HAZRO TEHSIL,24,5009,993,6002
ATTOCK DISTRICT,HAZRO TEHSIL,25,4199,872,5071
ATTOCK DISTRICT,HAZRO TEHSIL,26,4918,954,5872
ATTOCK DISTRICT,HAZRO TEHSIL,27,4593,975,5568
ATTOCK DISTRICT,HAZRO TEHSIL,28,4263,817,5080
ATTOCK DISTRICT,HAZRO TEHSIL,29,4333,834,5167
ATTOCK DISTRICT,HAZRO TEHSIL,30,3993,775,4768
ATTOCK DISTRICT,HAZRO TEHSIL,31,4363,851,5214
ATTOCK DISTRICT,HAZRO TEHSIL,32,3894,791,4685
ATTOCK DISTRICT,HAZRO TEHSIL,33,3882,783,4665
ATTOCK DISTRICT,HAZRO TEHSIL,34,3909,725,4634
ATTOCK DISTRICT,HAZRO TEHSIL,35,3167,647,3814
ATTOCK DISTRICT,HAZRO TEHSIL,36,3583,667,4250
ATTOCK DISTRICT,HAZRO TEHSIL,37,3152,588,3740
ATTOCK DISTRICT,HAZRO TEHSIL,38,3284,743,4027
ATTOCK DISTRICT,HAZRO TEHSIL,39,3318,646,3964
ATTOCK DISTRICT,HAZRO TEHSIL,40,3119,644,3763
ATTOCK DISTRICT,HAZRO TEHSIL,41,3113,543,3656
ATTOCK DISTRICT,HAZRO TEHSIL,42,2740,593,3333
ATTOCK DISTRICT,HAZRO TEHSIL,43,2891,606,3497
ATTOCK DISTRICT,HAZRO TEHSIL,44,2723,546,3269
ATTOCK DISTRICT,HAZRO TEHSIL,45,2265,497,2762
ATTOCK DISTRICT,HAZRO TEHSIL,46,2516,495,3011
ATTOCK DISTRICT,HAZRO TEHSIL,47,2177,428,2605
ATTOCK DISTRICT,HAZRO TEHSIL,48,2357,544,2901
ATTOCK DISTRICT,HAZRO TEHSIL,49,2362,492,2854
ATTOCK DISTRICT,HAZRO TEHSIL,50,2373,487,2860
ATTOCK DISTRICT,HAZRO TEHSIL,51,2296,501,2797
ATTOCK DISTRICT,HAZRO TEHSIL,52,2029,437,2466
ATTOCK DISTRICT,HAZRO TEHSIL,53,2341,478,2819
ATTOCK DISTRICT,HAZRO TEHSIL,54,2036,406,2442
ATTOCK DISTRICT,HAZRO TEHSIL,55,1733,413,2146
ATTOCK DISTRICT,HAZRO TEHSIL,56,1745,336,2081
ATTOCK DISTRICT,HAZRO TEHSIL,57,1418,297,1715
ATTOCK DISTRICT,HAZRO TEHSIL,58,1634,342,1976
ATTOCK DISTRICT,HAZRO TEHSIL,59,1737,327,2064
ATTOCK DISTRICT,HAZRO TEHSIL,60,1670,361,2031
ATTOCK DISTRICT,HAZRO TEHSIL,61,1873,393,2266
ATTOCK DISTRICT,HAZRO TEHSIL,62,1665,352,2017
ATTOCK DISTRICT,HAZRO TEHSIL,63,1611,397,2008
ATTOCK DISTRICT,HAZRO TEHSIL,64,1577,286,1863
ATTOCK DISTRICT,HAZRO TEHSIL,65,1227,309,1536
ATTOCK DISTRICT,HAZRO TEHSIL,66,1264,216,1480
ATTOCK DISTRICT,HAZRO TEHSIL,67,1151,212,1363
ATTOCK DISTRICT,HAZRO TEHSIL,68,1185,230,1415
ATTOCK DISTRICT,HAZRO TEHSIL,69,963,195,1158
ATTOCK DISTRICT,HAZRO TEHSIL,70,911,200,1111
ATTOCK DISTRICT,HAZRO TEHSIL,71,1007,154,1161
ATTOCK DISTRICT,HAZRO TEHSIL,72,849,152,1001
ATTOCK DISTRICT,HAZRO TEHSIL,73,850,172,1022
ATTOCK DISTRICT,HAZRO TEHSIL,74,626,132,758
ATTOCK DISTRICT,HAZRO TEHSIL,>=75,4977,1023,6000
ATTOCK DISTRICT,JAND TEHSIL,<1,5481,1176,6657
ATTOCK DISTRICT,JAND TEHSIL,1,5632,1246,6878
ATTOCK DISTRICT,JAND TEHSIL,2,5658,1134,6792
ATTOCK DISTRICT,JAND TEHSIL,3,5955,1285,7240
ATTOCK DISTRICT,JAND TEHSIL,4,5699,1070,6769
ATTOCK DISTRICT,JAND TEHSIL,5,5339,1077,6416
ATTOCK DISTRICT,JAND TEHSIL,6,5124,1086,6210
ATTOCK DISTRICT,JAND TEHSIL,7,5364,1145,6509
ATTOCK DISTRICT,JAND TEHSIL,8,4722,1021,5743
ATTOCK DISTRICT,JAND TEHSIL,9,5621,1183,6804
ATTOCK DISTRICT,JAND TEHSIL,10,4295,947,5242
ATTOCK DISTRICT,JAND TEHSIL,11,5638,1148,6786
ATTOCK DISTRICT,JAND TEHSIL,12,4321,906,5227
ATTOCK DISTRICT,JAND TEHSIL,13,5031,1075,6106
ATTOCK DISTRICT,JAND TEHSIL,14,4396,912,5308
ATTOCK DISTRICT,JAND TEHSIL,15,4669,935,5604
ATTOCK DISTRICT,JAND TEHSIL,16,5141,1067,6208
ATTOCK DISTRICT,JAND TEHSIL,17,5134,1110,6244
ATTOCK DISTRICT,JAND TEHSIL,18,3893,838,4731
ATTOCK DISTRICT,JAND TEHSIL,19,4992,977,5969
ATTOCK DISTRICT,JAND TEHSIL,20,3804,793,4597
ATTOCK DISTRICT,JAND TEHSIL,21,5112,994,6106
ATTOCK DISTRICT,JAND TEHSIL,22,3960,759,4719
ATTOCK DISTRICT,JAND TEHSIL,23,4358,854,5212
ATTOCK DISTRICT,JAND TEHSIL,24,4225,838,5063
ATTOCK DISTRICT,JAND TEHSIL,25,3107,613,3720
ATTOCK DISTRICT,JAND TEHSIL,26,3969,853,4822
ATTOCK DISTRICT,JAND TEHSIL,27,3963,858,4821
ATTOCK DISTRICT,JAND TEHSIL,28,3602,789,4391
ATTOCK DISTRICT,JAND TEHSIL,29,3965,776,4741
ATTOCK DISTRICT,JAND TEHSIL,30,2938,628,3566
ATTOCK DISTRICT,JAND TEHSIL,31,4057,789,4846
ATTOCK DISTRICT,JAND TEHSIL,32,3504,672,4176
ATTOCK DISTRICT,JAND TEHSIL,33,3671,769,4440
ATTOCK DISTRICT,JAND TEHSIL,34,3742,779,4521
ATTOCK DISTRICT,JAND TEHSIL,35,2597,508,3105
ATTOCK DISTRICT,JAND TEHSIL,36,3372,689,4061
ATTOCK DISTRICT,JAND TEHSIL,37,3048,609,3657
ATTOCK DISTRICT,JAND TEHSIL,38,3351,637,3988
ATTOCK DISTRICT,JAND TEHSIL,39,3224,658,3882
ATTOCK DISTRICT,JAND TEHSIL,40,2405,428,2833
ATTOCK DISTRICT,JAND TEHSIL,41,2935,569,3504
ATTOCK DISTRICT,JAND TEHSIL,42,2493,465,2958
ATTOCK DISTRICT,JAND TEHSIL,43,2764,530,3294
ATTOCK DISTRICT,JAND TEHSIL,44,2611,505,3116
ATTOCK DISTRICT,JAND TEHSIL,45,1889,319,2208
ATTOCK DISTRICT,JAND TEHSIL,46,2548,527,3075
ATTOCK DISTRICT,JAND TEHSIL,47,2303,388,2691
ATTOCK DISTRICT,JAND TEHSIL,48,2665,515,3180
ATTOCK DISTRICT,JAND TEHSIL,49,2692,478,3170
ATTOCK DISTRICT,JAND TEHSIL,50,1948,322,2270
ATTOCK DISTRICT,JAND TEHSIL,51,2741,504,3245
ATTOCK DISTRICT,JAND TEHSIL,52,2316,373,2689
ATTOCK DISTRICT,JAND TEHSIL,53,2500,401,2901
ATTOCK DISTRICT,JAND TEHSIL,54,2295,392,2687
ATTOCK DISTRICT,JAND TEHSIL,55,1540,258,1798
ATTOCK DISTRICT,JAND TEHSIL,56,1902,332,2234
ATTOCK DISTRICT,JAND TEHSIL,57,1671,271,1942
ATTOCK DISTRICT,JAND TEHSIL,58,1673,304,1977
ATTOCK DISTRICT,JAND TEHSIL,59,1523,273,1796
ATTOCK DISTRICT,JAND TEHSIL,60,1135,170,1305
ATTOCK DISTRICT,JAND TEHSIL,61,1813,291,2104
ATTOCK DISTRICT,JAND TEHSIL,62,1667,274,1941
ATTOCK DISTRICT,JAND TEHSIL,63,1813,279,2092
ATTOCK DISTRICT,JAND TEHSIL,64,1683,243,1926
ATTOCK DISTRICT,JAND TEHSIL,65,1173,175,1348
ATTOCK DISTRICT,JAND TEHSIL,66,1275,198,1473
ATTOCK DISTRICT,JAND TEHSIL,67,1479,188,1667
ATTOCK DISTRICT,JAND TEHSIL,68,1523,242,1765
ATTOCK DISTRICT,JAND TEHSIL,69,1237,191,1428
ATTOCK DISTRICT,JAND TEHSIL,70,869,117,986
ATTOCK DISTRICT,JAND TEHSIL,71,1135,195,1330
ATTOCK DISTRICT,JAND TEHSIL,72,1092,167,1259
ATTOCK DISTRICT,JAND TEHSIL,73,1037,143,1180
ATTOCK DISTRICT,JAND TEHSIL,74,764,101,865
ATTOCK DISTRICT,JAND TEHSIL,>=75,6536,863,7399
ATTOCK DISTRICT,PINDI GHEB TEHSIL,<1,5039,988,6027
ATTOCK DISTRICT,PINDI GHEB TEHSIL,1,5144,1218,6362
ATTOCK DISTRICT,PINDI GHEB TEHSIL,2,5033,957,5990
ATTOCK DISTRICT,PINDI GHEB TEHSIL,3,5235,1128,6363
ATTOCK DISTRICT,PINDI GHEB TEHSIL,4,4959,989,5948
ATTOCK DISTRICT,PINDI GHEB TEHSIL,5,4728,1002,5730
ATTOCK DISTRICT,PINDI GHEB TEHSIL,6,4777,987,5764
ATTOCK DISTRICT,PINDI GHEB TEHSIL,7,5041,1016,6057
ATTOCK DISTRICT,PINDI GHEB TEHSIL,8,4444,869,5313
ATTOCK DISTRICT,PINDI GHEB TEHSIL,9,5263,1047,6310
ATTOCK DISTRICT,PINDI GHEB TEHSIL,10,4092,805,4897
ATTOCK DISTRICT,PINDI GHEB TEHSIL,11,5170,1028,6198
ATTOCK DISTRICT,PINDI GHEB TEHSIL,12,4128,801,4929
ATTOCK DISTRICT,PINDI GHEB TEHSIL,13,4652,925,5577
ATTOCK DISTRICT,PINDI GHEB TEHSIL,14,4001,821,4822
ATTOCK DISTRICT,PINDI GHEB TEHSIL,15,4507,823,5330
ATTOCK DISTRICT,PINDI GHEB TEHSIL,16,4655,810,5465
ATTOCK DISTRICT,PINDI GHEB TEHSIL,17,4613,949,5562
ATTOCK DISTRICT,PINDI GHEB TEHSIL,18,3528,650,4178
ATTOCK DISTRICT,PINDI GHEB TEHSIL,19,4530,865,5395
ATTOCK DISTRICT,PINDI GHEB TEHSIL,20,3447,655,4102
ATTOCK DISTRICT,PINDI GHEB TEHSIL,21,4616,909,5525
ATTOCK DISTRICT,PINDI GHEB TEHSIL,22,3636,736,4372
ATTOCK DISTRICT,PINDI GHEB TEHSIL,23,3972,828,4800
ATTOCK DISTRICT,PINDI GHEB TEHSIL,24,4107,812,4919
ATTOCK DISTRICT,PINDI GHEB TEHSIL,25,2978,649,3627
ATTOCK DISTRICT,PINDI GHEB TEHSIL,26,3853,811,4664
ATTOCK DISTRICT,PINDI GHEB TEHSIL,27,3927,879,4806
ATTOCK DISTRICT,PINDI GHEB TEHSIL,28,3524,786,4310
ATTOCK DISTRICT,PINDI GHEB TEHSIL,29,3867,824,4691
ATTOCK DISTRICT,PINDI GHEB TEHSIL,30,2763,666,3429
ATTOCK DISTRICT,PINDI GHEB TEHSIL,31,3981,849,4830
ATTOCK DISTRICT,PINDI GHEB TEHSIL,32,3166,660,3826
ATTOCK DISTRICT,PINDI GHEB TEHSIL,33,3399,770,4169
ATTOCK DISTRICT,PINDI GHEB TEHSIL,34,3508,672,4180
ATTOCK DISTRICT,PINDI GHEB TEHSIL,35,2387,515,2902
ATTOCK DISTRICT,PINDI GHEB TEHSIL,36,3306,660,3966
ATTOCK DISTRICT,PINDI GHEB TEHSIL,37,2875,573,3448
ATTOCK DISTRICT,PINDI GHEB TEHSIL,38,2968,654,3622
ATTOCK DISTRICT,PINDI GHEB TEHSIL,39,3059,642,3701
ATTOCK DISTRICT,PINDI GHEB TEHSIL,40,2118,531,2649
ATTOCK DISTRICT,PINDI GHEB TEHSIL,41,2739,562,3301
ATTOCK DISTRICT,PINDI GHEB TEHSIL,42,2357,452,2809
ATTOCK DISTRICT,PINDI GHEB TEHSIL,43,2609,525,3134
ATTOCK DISTRICT,PINDI GHEB TEHSIL,44,2519,491,3010
ATTOCK DISTRICT,PINDI GHEB TEHSIL,45,1732,387,2119
ATTOCK DISTRICT,PINDI GHEB TEHSIL,46,2354,407,2761
ATTOCK DISTRICT,PINDI GHEB TEHSIL,47,2157,356,2513
ATTOCK DISTRICT,PINDI GHEB TEHSIL,48,2333,418,2751
ATTOCK DISTRICT,PINDI GHEB TEHSIL,49,2388,470,2858
ATTOCK DISTRICT,PINDI GHEB TEHSIL,50,1776,385,2161
ATTOCK DISTRICT,PINDI GHEB TEHSIL,51,2389,423,2812
ATTOCK DISTRICT,PINDI GHEB TEHSIL,52,2147,371,2518
ATTOCK DISTRICT,PINDI GHEB TEHSIL,53,2266,399,2665
ATTOCK DISTRICT,PINDI GHEB TEHSIL,54,1986,435,2421
ATTOCK DISTRICT,PINDI GHEB TEHSIL,55,1361,289,1650
ATTOCK DISTRICT,PINDI GHEB TEHSIL,56,1711,320,2031
ATTOCK DISTRICT,PINDI GHEB TEHSIL,57,1440,281,1721
ATTOCK DISTRICT,PINDI GHEB TEHSIL,58,1581,309,1890
ATTOCK DISTRICT,PINDI GHEB TEHSIL,59,1398,263,1661
ATTOCK DISTRICT,PINDI GHEB TEHSIL,60,1054,245,1299
ATTOCK DISTRICT,PINDI GHEB TEHSIL,61,1576,319,1895
ATTOCK DISTRICT,PINDI GHEB TEHSIL,62,1564,309,1873
ATTOCK DISTRICT,PINDI GHEB TEHSIL,63,1494,283,1777
ATTOCK DISTRICT,PINDI GHEB TEHSIL,64,1442,314,1756
ATTOCK DISTRICT,PINDI GHEB TEHSIL,65,925,201,1126
ATTOCK DISTRICT,PINDI GHEB TEHSIL,66,1179,182,1361
ATTOCK DISTRICT,PINDI GHEB TEHSIL,67,1246,194,1440
ATTOCK DISTRICT,PINDI GHEB TEHSIL,68,1266,190,1456
ATTOCK DISTRICT,PINDI GHEB TEHSIL,69,1043,161,1204
ATTOCK DISTRICT,PINDI GHEB TEHSIL,70,738,133,871
ATTOCK DISTRICT,PINDI GHEB TEHSIL,71,941,158,1099
ATTOCK DISTRICT,PINDI GHEB TEHSIL,72,901,162,1063
ATTOCK DISTRICT,PINDI GHEB TEHSIL,73,835,129,964
ATTOCK DISTRICT,PINDI GHEB TEHSIL,74,722,96,818
ATTOCK DISTRICT,PINDI GHEB TEHSIL,>=75,5571,817,6388
AWARAN DISTRICT,AWARAN TEHSIL,<1,192,495,687
AWARAN DISTRICT,AWARAN TEHSIL,1,260,625,885
AWARAN DISTRICT,AWARAN TEHSIL,2,320,760,1080
AWARAN DISTRICT,AWARAN TEHSIL,3,279,812,1091
AWARAN DISTRICT,AWARAN TEHSIL,4,378,857,1235
AWARAN DISTRICT,AWARAN TEHSIL,5,313,797,1110
AWARAN DISTRICT,AWARAN TEHSIL,6,361,798,1159
AWARAN DISTRICT,AWARAN TEHSIL,7,302,729,1031
AWARAN DISTRICT,AWARAN TEHSIL,8,413,908,1321
AWARAN DISTRICT,AWARAN TEHSIL,9,260,581,841
AWARAN DISTRICT,AWARAN TEHSIL,10,358,784,1142
AWARAN DISTRICT,AWARAN TEHSIL,11,199,508,707
AWARAN DISTRICT,AWARAN TEHSIL,12,241,584,825
AWARAN DISTRICT,AWARAN TEHSIL,13,160,494,654
AWARAN DISTRICT,AWARAN TEHSIL,14,183,506,689
AWARAN DISTRICT,AWARAN TEHSIL,15,160,390,550
AWARAN DISTRICT,AWARAN TEHSIL,16,125,368,493
AWARAN DISTRICT,AWARAN TEHSIL,17,118,325,443
AWARAN DISTRICT,AWARAN TEHSIL,18,130,412,542
AWARAN DISTRICT,AWARAN TEHSIL,19,128,330,458
AWARAN DISTRICT,AWARAN TEHSIL,20,174,403,577
AWARAN DISTRICT,AWARAN TEHSIL,21,141,354,495
AWARAN DISTRICT,AWARAN TEHSIL,22,98,375,473
AWARAN DISTRICT,AWARAN TEHSIL,23,85,272,357
AWARAN DISTRICT,AWARAN TEHSIL,24,84,269,353
AWARAN DISTRICT,AWARAN TEHSIL,25,107,316,423
AWARAN DISTRICT,AWARAN TEHSIL,26,105,268,373
AWARAN DISTRICT,AWARAN TEHSIL,27,121,358,479
AWARAN DISTRICT,AWARAN TEHSIL,28,98,345,443
AWARAN DISTRICT,AWARAN TEHSIL,29,137,328,465
AWARAN DISTRICT,AWARAN TEHSIL,30,140,335,475
AWARAN DISTRICT,AWARAN TEHSIL,31,132,334,466
AWARAN DISTRICT,AWARAN TEHSIL,32,90,309,399
AWARAN DISTRICT,AWARAN TEHSIL,33,100,258,358
AWARAN DISTRICT,AWARAN TEHSIL,34,98,263,361
AWARAN DISTRICT,AWARAN TEHSIL,35,98,264,362
AWARAN DISTRICT,AWARAN TEHSIL,36,137,282,419
AWARAN DISTRICT,AWARAN TEHSIL,37,86,304,390
AWARAN DISTRICT,AWARAN TEHSIL,38,88,229,317
AWARAN DISTRICT,AWARAN TEHSIL,39,81,196,277
AWARAN DISTRICT,AWARAN TEHSIL,40,68,168,236
AWARAN DISTRICT,AWARAN TEHSIL,41,82,195,277
AWARAN DISTRICT,AWARAN TEHSIL,42,49,176,225
AWARAN DISTRICT,AWARAN TEHSIL,43,76,147,223
AWARAN DISTRICT,AWARAN TEHSIL,44,71,157,228
AWARAN DISTRICT,AWARAN TEHSIL,45,55,107,162
AWARAN DISTRICT,AWARAN TEHSIL,46,70,133,203
AWARAN DISTRICT,AWARAN TEHSIL,47,57,142,199
AWARAN DISTRICT,AWARAN TEHSIL,48,62,106,168
AWARAN DISTRICT,AWARAN TEHSIL,49,54,129,183
AWARAN DISTRICT,AWARAN TEHSIL,50,59,128,187
AWARAN DISTRICT,AWARAN TEHSIL,51,58,144,202
AWARAN DISTRICT,AWARAN TEHSIL,52,34,117,151
AWARAN DISTRICT,AWARAN TEHSIL,53,34,110,144
AWARAN DISTRICT,AWARAN TEHSIL,54,31,114,145
AWARAN DISTRICT,AWARAN TEHSIL,55,33,77,110
AWARAN DISTRICT,AWARAN TEHSIL,56,37,82,119
AWARAN DISTRICT,AWARAN TEHSIL,57,31,92,123
AWARAN DISTRICT,AWARAN TEHSIL,58,36,90,126
AWARAN DISTRICT,AWARAN TEHSIL,59,49,92,141
AWARAN DISTRICT,AWARAN TEHSIL,60,24,86,110
AWARAN DISTRICT,AWARAN TEHSIL,61,44,65,109
AWARAN DISTRICT,AWARAN TEHSIL,62,20,66,86
AWARAN DISTRICT,AWARAN TEHSIL,63,33,87,120
AWARAN DISTRICT,AWARAN TEHSIL,64,47,97,144
AWARAN DISTRICT,AWARAN TEHSIL,65,26,71,97
AWARAN DISTRICT,AWARAN TEHSIL,66,22,54,76
AWARAN DISTRICT,AWARAN TEHSIL,67,15,55,70
AWARAN DISTRICT,AWARAN TEHSIL,68,17,52,69
AWARAN DISTRICT,AWARAN TEHSIL,69,41,75,116
AWARAN DISTRICT,AWARAN TEHSIL,70,22,46,68
AWARAN DISTRICT,AWARAN TEHSIL,71,12,30,42
AWARAN DISTRICT,AWARAN TEHSIL,72,11,29,40
AWARAN DISTRICT,AWARAN TEHSIL,73,17,33,50
AWARAN DISTRICT,AWARAN TEHSIL,74,27,41,68
AWARAN DISTRICT,AWARAN TEHSIL,>=75,80,243,323
AWARAN DISTRICT,GISHKORE SUB-TEHSIL,<1,527,0,527
AWARAN DISTRICT,GISHKORE SUB-TEHSIL,1,398,0,398
AWARAN DISTRICT,GISHKORE SUB-TEHSIL,2,553,0,553
AWARAN DISTRICT,GISHKORE SUB-TEHSIL,3,597,0,597
AWARAN DISTRICT,GISHKORE SUB-TEHSIL,4,753,0,753
AWARAN DISTRICT,GISHKORE SUB-TEHSIL,5,587,0,587
AWARAN DISTRICT,GISHKORE SUB-TEHSIL,6,734,0,734
AWARAN DISTRICT,GISHKORE SUB-TEHSIL,7,542,0,542
AWARAN DISTRICT,GISHKORE SUB-TEHSIL,8,708,0,708
AWARAN DISTRICT,GISHKORE SUB-TEHSIL,9,587,0,587
AWARAN DISTRICT,GISHKORE SUB-TEHSIL,10,753,0,753
AWARAN DISTRICT,GISHKORE SUB-TEHSIL,11,437,0,437
AWARAN DISTRICT,GISHKORE SUB-TEHSIL,12,526,0,526
AWARAN DISTRICT,GISHKORE SUB-TEHSIL,13,362,0,362
AWARAN DISTRICT,GISHKORE SUB-TEHSIL,14,446,0,446
AWARAN DISTRICT,GISHKORE SUB-TEHSIL,15,419,0,419
AWARAN DISTRICT,GISHKORE SUB-TEHSIL,16,340,0,340
AWARAN DISTRICT,GISHKORE SUB-TEHSIL,17,286,0,286
AWARAN DISTRICT,GISHKORE SUB-TEHSIL,18,173,0,173
AWARAN DISTRICT,GISHKORE SUB-TEHSIL,19,223,0,223
AWARAN DISTRICT,GISHKORE SUB-TEHSIL,20,316,0,316
AWARAN DISTRICT,GISHKORE SUB-TEHSIL,21,242,0,242
AWARAN DISTRICT,GISHKORE SUB-TEHSIL,22,262,0,262
AWARAN DISTRICT,GISHKORE SUB-TEHSIL,23,161,0,161
AWARAN DISTRICT,GISHKORE SUB-TEHSIL,24,160,0,160
AWARAN DISTRICT,GISHKORE SUB-TEHSIL,25,217,0,217
AWARAN DISTRICT,GISHKORE SUB-TEHSIL,26,190,0,190
AWARAN DISTRICT,GISHKORE SUB-TEHSIL,27,241,0,241
AWARAN DISTRICT,GISHKORE SUB-TEHSIL,28,195,0,195
AWARAN DISTRICT,GISHKORE SUB-TEHSIL,29,254,0,254
AWARAN DISTRICT,GISHKORE SUB-TEHSIL,30,294,0,294
AWARAN DISTRICT,GISHKORE SUB-TEHSIL,31,282,0,282
AWARAN DISTRICT,GISHKORE SUB-TEHSIL,32,246,0,246
AWARAN DISTRICT,GISHKORE SUB-TEHSIL,33,216,0,216
AWARAN DISTRICT,GISHKORE SUB-TEHSIL,34,229,0,229
AWARAN DISTRICT,GISHKORE SUB-TEHSIL,35,259,0,259
AWARAN DISTRICT,GISHKORE SUB-TEHSIL,36,222,0,222
AWARAN DISTRICT,GISHKORE SUB-TEHSIL,37,245,0,245
AWARAN DISTRICT,GISHKORE SUB-TEHSIL,38,162,0,162
AWARAN DISTRICT,GISHKORE SUB-TEHSIL,39,202,0,202
AWARAN DISTRICT,GISHKORE SUB-TEHSIL,40,246,0,246
AWARAN DISTRICT,GISHKORE SUB-TEHSIL,41,203,0,203
AWARAN DISTRICT,GISHKORE SUB-TEHSIL,42,185,0,185
AWARAN DISTRICT,GISHKORE SUB-TEHSIL,43,164,0,164
AWARAN DISTRICT,GISHKORE SUB-TEHSIL,44,139,0,139
AWARAN DISTRICT,GISHKORE SUB-TEHSIL,45,137,0,137
AWARAN DISTRICT,GISHKORE SUB-TEHSIL,46,130,0,130
AWARAN DISTRICT,GISHKORE SUB-TEHSIL,47,142,0,142
AWARAN DISTRICT,GISHKORE SUB-TEHSIL,48,145,0,145
AWARAN DISTRICT,GISHKORE SUB-TEHSIL,49,167,0,167
AWARAN DISTRICT,GISHKORE SUB-TEHSIL,50,167,0,167
AWARAN DISTRICT,GISHKORE SUB-TEHSIL,51,127,0,127
AWARAN DISTRICT,GISHKORE SUB-TEHSIL,52,104,0,104
AWARAN DISTRICT,GISHKORE SUB-TEHSIL,53,94,0,94
AWARAN DISTRICT,GISHKORE SUB-TEHSIL,54,91,0,91
AWARAN DISTRICT,GISHKORE SUB-TEHSIL,55,112,0,112
AWARAN DISTRICT,GISHKORE SUB-TEHSIL,56,97,0,97
AWARAN DISTRICT,GISHKORE SUB-TEHSIL,57,77,0,77
AWARAN DISTRICT,GISHKORE SUB-TEHSIL,58,76,0,76
AWARAN DISTRICT,GISHKORE SUB-TEHSIL,59,86,0,86
AWARAN DISTRICT,GISHKORE SUB-TEHSIL,60,127,0,127
AWARAN DISTRICT,GISHKORE SUB-TEHSIL,61,88,0,88
AWARAN DISTRICT,GISHKORE SUB-TEHSIL,62,69,0,69
AWARAN DISTRICT,GISHKORE SUB-TEHSIL,63,77,0,77
AWARAN DISTRICT,GISHKORE SUB-TEHSIL,64,99,0,99
AWARAN DISTRICT,GISHKORE SUB-TEHSIL,65,78,0,78
AWARAN DISTRICT,GISHKORE SUB-TEHSIL,66,61,0,61
AWARAN DISTRICT,GISHKORE SUB-TEHSIL,67,47,0,47
AWARAN DISTRICT,GISHKORE SUB-TEHSIL,68,60,0,60
AWARAN DISTRICT,GISHKORE SUB-TEHSIL,69,57,0,57
AWARAN DISTRICT,GISHKORE SUB-TEHSIL,70,51,0,51
AWARAN DISTRICT,GISHKORE SUB-TEHSIL,71,41,0,41
AWARAN DISTRICT,GISHKORE SUB-TEHSIL,72,34,0,34
AWARAN DISTRICT,GISHKORE SUB-TEHSIL,73,36,0,36
AWARAN DISTRICT,GISHKORE SUB-TEHSIL,74,44,0,44
AWARAN DISTRICT,GISHKORE SUB-TEHSIL,>=75,186,0,186
AWARAN DISTRICT,JHAL JAO SUB-TEHSIL,<1,1226,0,1226
AWARAN DISTRICT,JHAL JAO SUB-TEHSIL,1,1067,0,1067
AWARAN DISTRICT,JHAL JAO SUB-TEHSIL,2,1489,0,1489
AWARAN DISTRICT,JHAL JAO SUB-TEHSIL,3,1090,0,1090
AWARAN DISTRICT,JHAL JAO SUB-TEHSIL,4,1759,0,1759
AWARAN DISTRICT,JHAL JAO SUB-TEHSIL,5,1267,0,1267
AWARAN DISTRICT,JHAL JAO SUB-TEHSIL,6,1900,0,1900
AWARAN DISTRICT,JHAL JAO SUB-TEHSIL,7,1161,0,1161
AWARAN DISTRICT,JHAL JAO SUB-TEHSIL,8,1920,0,1920
AWARAN DISTRICT,JHAL JAO SUB-TEHSIL,9,1123,0,1123
AWARAN DISTRICT,JHAL JAO SUB-TEHSIL,10,1908,0,1908
AWARAN DISTRICT,JHAL JAO SUB-TEHSIL,11,780,0,780
AWARAN DISTRICT,JHAL JAO SUB-TEHSIL,12,1284,0,1284
AWARAN DISTRICT,JHAL JAO SUB-TEHSIL,13,703,0,703
AWARAN DISTRICT,JHAL JAO SUB-TEHSIL,14,920,0,920
AWARAN DISTRICT,JHAL JAO SUB-TEHSIL,15,604,0,604
AWARAN DISTRICT,JHAL JAO SUB-TEHSIL,16,635,0,635
AWARAN DISTRICT,JHAL JAO SUB-TEHSIL,17,413,0,413
AWARAN DISTRICT,JHAL JAO SUB-TEHSIL,18,736,0,736
AWARAN DISTRICT,JHAL JAO SUB-TEHSIL,19,534,0,534
AWARAN DISTRICT,JHAL JAO SUB-TEHSIL,20,929,0,929
AWARAN DISTRICT,JHAL JAO SUB-TEHSIL,21,544,0,544
AWARAN DISTRICT,JHAL JAO SUB-TEHSIL,22,596,0,596
AWARAN DISTRICT,JHAL JAO SUB-TEHSIL,23,420,0,420
AWARAN DISTRICT,JHAL JAO SUB-TEHSIL,24,407,0,407
AWARAN DISTRICT,JHAL JAO SUB-TEHSIL,25,699,0,699
AWARAN DISTRICT,JHAL JAO SUB-TEHSIL,26,421,0,421
AWARAN DISTRICT,JHAL JAO SUB-TEHSIL,27,516,0,516
AWARAN DISTRICT,JHAL JAO SUB-TEHSIL,28,628,0,628
AWARAN DISTRICT,JHAL JAO SUB-TEHSIL,29,479,0,479
AWARAN DISTRICT,JHAL JAO SUB-TEHSIL,30,846,0,846
AWARAN DISTRICT,JHAL JAO SUB-TEHSIL,31,624,0,624
AWARAN DISTRICT,JHAL JAO SUB-TEHSIL,32,441,0,441
AWARAN DISTRICT,JHAL JAO SUB-TEHSIL,33,470,0,470
AWARAN DISTRICT,JHAL JAO SUB-TEHSIL,34,354,0,354
AWARAN DISTRICT,JHAL JAO SUB-TEHSIL,35,548,0,548
AWARAN DISTRICT,JHAL JAO SUB-TEHSIL,36,366,0,366
AWARAN DISTRICT,JHAL JAO SUB-TEHSIL,37,382,0,382
AWARAN DISTRICT,JHAL JAO SUB-TEHSIL,38,408,0,408
AWARAN DISTRICT,JHAL JAO SUB-TEHSIL,39,343,0,343
AWARAN DISTRICT,JHAL JAO SUB-TEHSIL,40,547,0,547
AWARAN DISTRICT,JHAL JAO SUB-TEHSIL,41,322,0,322
AWARAN DISTRICT,JHAL JAO SUB-TEHSIL,42,304,0,304
AWARAN DISTRICT,JHAL JAO SUB-TEHSIL,43,351,0,351
AWARAN DISTRICT,JHAL JAO SUB-TEHSIL,44,314,0,314
AWARAN DISTRICT,JHAL JAO SUB-TEHSIL,45,346,0,346
AWARAN DISTRICT,JHAL JAO SUB-TEHSIL,46,244,0,244
AWARAN DISTRICT,JHAL JAO SUB-TEHSIL,47,309,0,309
AWARAN DISTRICT,JHAL JAO SUB-TEHSIL,48,245,0,245
AWARAN DISTRICT,JHAL JAO SUB-TEHSIL,49,301,0,301
AWARAN DISTRICT,JHAL JAO SUB-TEHSIL,50,346,0,346
AWARAN DISTRICT,JHAL JAO SUB-TEHSIL,51,232,0,232
AWARAN DISTRICT,JHAL JAO SUB-TEHSIL,52,161,0,161
AWARAN DISTRICT,JHAL JAO SUB-TEHSIL,53,213,0,213
AWARAN DISTRICT,JHAL JAO SUB-TEHSIL,54,199,0,199
AWARAN DISTRICT,JHAL JAO SUB-TEHSIL,55,198,0,198
AWARAN DISTRICT,JHAL JAO SUB-TEHSIL,56,138,0,138
AWARAN DISTRICT,JHAL JAO SUB-TEHSIL,57,176,0,176
AWARAN DISTRICT,JHAL JAO SUB-TEHSIL,58,125,0,125
AWARAN DISTRICT,JHAL JAO SUB-TEHSIL,59,140,0,140
AWARAN DISTRICT,JHAL JAO SUB-TEHSIL,60,226,0,226
AWARAN DISTRICT,JHAL JAO SUB-TEHSIL,61,127,0,127
AWARAN DISTRICT,JHAL JAO SUB-TEHSIL,62,116,0,116
AWARAN DISTRICT,JHAL JAO SUB-TEHSIL,63,121,0,121
AWARAN DISTRICT,JHAL JAO SUB-TEHSIL,64,160,0,160
AWARAN DISTRICT,JHAL JAO SUB-TEHSIL,65,116,0,116
AWARAN DISTRICT,JHAL JAO SUB-TEHSIL,66,69,0,69
AWARAN DISTRICT,JHAL JAO SUB-TEHSIL,67,104,0,104
AWARAN DISTRICT,JHAL JAO SUB-TEHSIL,68,95,0,95
AWARAN DISTRICT,JHAL JAO SUB-TEHSIL,69,112,0,112
AWARAN DISTRICT,JHAL JAO SUB-TEHSIL,70,86,0,86
AWARAN DISTRICT,JHAL JAO SUB-TEHSIL,71,52,0,52
AWARAN DISTRICT,JHAL JAO SUB-TEHSIL,72,40,0,40
AWARAN DISTRICT,JHAL JAO SUB-TEHSIL,73,59,0,59
AWARAN DISTRICT,JHAL JAO SUB-TEHSIL,74,64,0,64
AWARAN DISTRICT,JHAL JAO SUB-TEHSIL,>=75,312,0,312
AWARAN DISTRICT,MASHKAI TEHSIL,<1,605,170,775
AWARAN DISTRICT,MASHKAI TEHSIL,1,630,413,1043
AWARAN DISTRICT,MASHKAI TEHSIL,2,814,373,1187
AWARAN DISTRICT,MASHKAI TEHSIL,3,670,406,1076
AWARAN DISTRICT,MASHKAI TEHSIL,4,919,420,1339
AWARAN DISTRICT,MASHKAI TEHSIL,5,679,455,1134
AWARAN DISTRICT,MASHKAI TEHSIL,6,792,389,1181
AWARAN DISTRICT,MASHKAI TEHSIL,7,664,412,1076
AWARAN DISTRICT,MASHKAI TEHSIL,8,885,423,1308
AWARAN DISTRICT,MASHKAI TEHSIL,9,578,346,924
AWARAN DISTRICT,MASHKAI TEHSIL,10,818,406,1224
AWARAN DISTRICT,MASHKAI TEHSIL,11,425,305,730
AWARAN DISTRICT,MASHKAI TEHSIL,12,600,341,941
AWARAN DISTRICT,MASHKAI TEHSIL,13,353,271,624
AWARAN DISTRICT,MASHKAI TEHSIL,14,460,293,753
AWARAN DISTRICT,MASHKAI TEHSIL,15,367,284,651
AWARAN DISTRICT,MASHKAI TEHSIL,16,361,251,612
AWARAN DISTRICT,MASHKAI TEHSIL,17,316,257,573
AWARAN DISTRICT,MASHKAI TEHSIL,18,416,198,614
AWARAN DISTRICT,MASHKAI TEHSIL,19,334,209,543
AWARAN DISTRICT,MASHKAI TEHSIL,20,541,291,832
AWARAN DISTRICT,MASHKAI TEHSIL,21,335,229,564
AWARAN DISTRICT,MASHKAI TEHSIL,22,330,236,566
AWARAN DISTRICT,MASHKAI TEHSIL,23,225,176,401
AWARAN DISTRICT,MASHKAI TEHSIL,24,210,186,396
AWARAN DISTRICT,MASHKAI TEHSIL,25,434,204,638
AWARAN DISTRICT,MASHKAI TEHSIL,26,244,185,429
AWARAN DISTRICT,MASHKAI TEHSIL,27,230,208,438
AWARAN DISTRICT,MASHKAI TEHSIL,28,302,207,509
AWARAN DISTRICT,MASHKAI TEHSIL,29,264,188,452
AWARAN DISTRICT,MASHKAI TEHSIL,30,389,256,645
AWARAN DISTRICT,MASHKAI TEHSIL,31,317,247,564
AWARAN DISTRICT,MASHKAI TEHSIL,32,215,181,396
AWARAN DISTRICT,MASHKAI TEHSIL,33,205,179,384
AWARAN DISTRICT,MASHKAI TEHSIL,34,171,117,288
AWARAN DISTRICT,MASHKAI TEHSIL,35,209,130,339
AWARAN DISTRICT,MASHKAI TEHSIL,36,155,99,254
AWARAN DISTRICT,MASHKAI TEHSIL,37,144,186,330
AWARAN DISTRICT,MASHKAI TEHSIL,38,217,110,327
AWARAN DISTRICT,MASHKAI TEHSIL,39,154,151,305
AWARAN DISTRICT,MASHKAI TEHSIL,40,246,110,356
AWARAN DISTRICT,MASHKAI TEHSIL,41,151,90,241
AWARAN DISTRICT,MASHKAI TEHSIL,42,127,102,229
AWARAN DISTRICT,MASHKAI TEHSIL,43,149,91,240
AWARAN DISTRICT,MASHKAI TEHSIL,44,136,78,214
AWARAN DISTRICT,MASHKAI TEHSIL,45,170,85,255
AWARAN DISTRICT,MASHKAI TEHSIL,46,160,49,209
AWARAN DISTRICT,MASHKAI TEHSIL,47,86,96,182
AWARAN DISTRICT,MASHKAI TEHSIL,48,147,64,211
AWARAN DISTRICT,MASHKAI TEHSIL,49,113,79,192
AWARAN DISTRICT,MASHKAI TEHSIL,50,155,74,229
AWARAN DISTRICT,MASHKAI TEHSIL,51,97,73,170
AWARAN DISTRICT,MASHKAI TEHSIL,52,73,59,132
AWARAN DISTRICT,MASHKAI TEHSIL,53,112,45,157
AWARAN DISTRICT,MASHKAI TEHSIL,54,108,72,180
AWARAN DISTRICT,MASHKAI TEHSIL,55,94,43,137
AWARAN DISTRICT,MASHKAI TEHSIL,56,74,29,103
AWARAN DISTRICT,MASHKAI TEHSIL,57,56,58,114
AWARAN DISTRICT,MASHKAI TEHSIL,58,103,48,151
AWARAN DISTRICT,MASHKAI TEHSIL,59,94,73,167
AWARAN DISTRICT,MASHKAI TEHSIL,60,103,55,158
AWARAN DISTRICT,MASHKAI TEHSIL,61,82,52,134
AWARAN DISTRICT,MASHKAI TEHSIL,62,47,36,83
AWARAN DISTRICT,MASHKAI TEHSIL,63,82,30,112
AWARAN DISTRICT,MASHKAI TEHSIL,64,87,50,137
AWARAN DISTRICT,MASHKAI TEHSIL,65,71,33,104
AWARAN DISTRICT,MASHKAI TEHSIL,66,76,55,131
AWARAN DISTRICT,MASHKAI TEHSIL,67,37,32,69
AWARAN DISTRICT,MASHKAI TEHSIL,68,59,35,94
AWARAN DISTRICT,MASHKAI TEHSIL,69,46,27,73
AWARAN DISTRICT,MASHKAI TEHSIL,70,72,27,99
AWARAN DISTRICT,MASHKAI TEHSIL,71,38,43,81
AWARAN DISTRICT,MASHKAI TEHSIL,72,32,28,60
AWARAN DISTRICT,MASHKAI TEHSIL,73,55,14,69
AWARAN DISTRICT,MASHKAI TEHSIL,74,29,11,40
AWARAN DISTRICT,MASHKAI TEHSIL,>=75,256,142,398
BADIN DISTRICT,BADIN TALUKA,<1,7565,3128,10693
BADIN DISTRICT,BADIN TALUKA,1,9341,3426,12767
BADIN DISTRICT,BADIN TALUKA,2,11723,4079,15802
BADIN DISTRICT,BADIN TALUKA,3,11848,4444,16292
BADIN DISTRICT,BADIN TALUKA,4,12673,4228,16901
BADIN DISTRICT,BADIN TALUKA,5,12205,4564,16769
BADIN DISTRICT,BADIN TALUKA,6,12028,4193,16221
BADIN DISTRICT,BADIN TALUKA,7,9790,3989,13779
BADIN DISTRICT,BADIN TALUKA,8,12599,4224,16823
BADIN DISTRICT,BADIN TALUKA,9,8551,3615,12166
BADIN DISTRICT,BADIN TALUKA,10,11279,3654,14933
BADIN DISTRICT,BADIN TALUKA,11,6982,2893,9875
BADIN DISTRICT,BADIN TALUKA,12,8489,3111,11600
BADIN DISTRICT,BADIN TALUKA,13,6156,2701,8857
BADIN DISTRICT,BADIN TALUKA,14,6575,2678,9253
BADIN DISTRICT,BADIN TALUKA,15,6627,2849,9476
BADIN DISTRICT,BADIN TALUKA,16,6235,2615,8850
BADIN DISTRICT,BADIN TALUKA,17,5292,2719,8011
BADIN DISTRICT,BADIN TALUKA,18,7744,2899,10643
BADIN DISTRICT,BADIN TALUKA,19,5264,2522,7786
BADIN DISTRICT,BADIN TALUKA,20,6828,2533,9361
BADIN DISTRICT,BADIN TALUKA,21,4221,2230,6451
BADIN DISTRICT,BADIN TALUKA,22,4788,2143,6931
BADIN DISTRICT,BADIN TALUKA,23,3928,2141,6069
BADIN DISTRICT,BADIN TALUKA,24,3627,1816,5443
BADIN DISTRICT,BADIN TALUKA,25,5322,2230,7552
BADIN DISTRICT,BADIN TALUKA,26,3926,1945,5871
BADIN DISTRICT,BADIN TALUKA,27,4397,2185,6582
BADIN DISTRICT,BADIN TALUKA,28,4889,2112,7001
BADIN DISTRICT,BADIN TALUKA,29,4620,2135,6755
BADIN DISTRICT,BADIN TALUKA,30,5019,2044,7063
BADIN DISTRICT,BADIN TALUKA,31,4479,2315,6794
BADIN DISTRICT,BADIN TALUKA,32,4450,2049,6499
BADIN DISTRICT,BADIN TALUKA,33,3698,1826,5524
BADIN DISTRICT,BADIN TALUKA,34,3497,1696,5193
BADIN DISTRICT,BADIN TALUKA,35,4337,1697,6034
BADIN DISTRICT,BADIN TALUKA,36,3599,1583,5182
BADIN DISTRICT,BADIN TALUKA,37,4787,1746,6533
BADIN DISTRICT,BADIN TALUKA,38,3575,1480,5055
BADIN DISTRICT,BADIN TALUKA,39,3485,1549,5034
BADIN DISTRICT,BADIN TALUKA,40,3470,1353,4823
BADIN DISTRICT,BADIN TALUKA,41,2798,1226,4024
BADIN DISTRICT,BADIN TALUKA,42,2770,1189,3959
BADIN DISTRICT,BADIN TALUKA,43,2526,1125,3651
BADIN DISTRICT,BADIN TALUKA,44,2321,1058,3379
BADIN DISTRICT,BADIN TALUKA,45,2414,1011,3425
BADIN DISTRICT,BADIN TALUKA,46,1990,907,2897
BADIN DISTRICT,BADIN TALUKA,47,2546,1143,3689
BADIN DISTRICT,BADIN TALUKA,48,2312,971,3283
BADIN DISTRICT,BADIN TALUKA,49,2171,985,3156
BADIN DISTRICT,BADIN TALUKA,50,2244,880,3124
BADIN DISTRICT,BADIN TALUKA,51,1763,870,2633
BADIN DISTRICT,BADIN TALUKA,52,1697,792,2489
BADIN DISTRICT,BADIN TALUKA,53,1461,710,2171
BADIN DISTRICT,BADIN TALUKA,54,1325,654,1979
BADIN DISTRICT,BADIN TALUKA,55,1422,579,2001
BADIN DISTRICT,BADIN TALUKA,56,1033,482,1515
BADIN DISTRICT,BADIN TALUKA,57,1281,527,1808
BADIN DISTRICT,BADIN TALUKA,58,1200,486,1686
BADIN DISTRICT,BADIN TALUKA,59,1203,548,1751
BADIN DISTRICT,BADIN TALUKA,60,1476,449,1925
BADIN DISTRICT,BADIN TALUKA,61,1140,495,1635
BADIN DISTRICT,BADIN TALUKA,62,1136,489,1625
BADIN DISTRICT,BADIN TALUKA,63,1133,467,1600
BADIN DISTRICT,BADIN TALUKA,64,1133,443,1576
BADIN DISTRICT,BADIN TALUKA,65,1032,363,1395
BADIN DISTRICT,BADIN TALUKA,66,871,352,1223
BADIN DISTRICT,BADIN TALUKA,67,765,320,1085
BADIN DISTRICT,BADIN TALUKA,68,709,267,976
BADIN DISTRICT,BADIN TALUKA,69,875,284,1159
BADIN DISTRICT,BADIN TALUKA,70,833,242,1075
BADIN DISTRICT,BADIN TALUKA,71,652,239,891
BADIN DISTRICT,BADIN TALUKA,72,499,177,676
BADIN DISTRICT,BADIN TALUKA,73,490,188,678
BADIN DISTRICT,BADIN TALUKA,74,531,164,695
BADIN DISTRICT,BADIN TALUKA,>=75,3297,1198,4495
BADIN DISTRICT,GOLARCHI (S.F.RAHU) TALUKA,<1,7849,1282,9131
BADIN DISTRICT,GOLARCHI (S.F.RAHU) TALUKA,1,8349,1415,9764
BADIN DISTRICT,GOLARCHI (S.F.RAHU) TALUKA,2,10602,1729,12331
BADIN DISTRICT,GOLARCHI (S.F.RAHU) TALUKA,3,11020,1826,12846
BADIN DISTRICT,GOLARCHI (S.F.RAHU) TALUKA,4,12033,1906,13939
BADIN DISTRICT,GOLARCHI (S.F.RAHU) TALUKA,5,11060,1864,12924
BADIN DISTRICT,GOLARCHI (S.F.RAHU) TALUKA,6,11063,1902,12965
BADIN DISTRICT,GOLARCHI (S.F.RAHU) TALUKA,7,9235,1695,10930
BADIN DISTRICT,GOLARCHI (S.F.RAHU) TALUKA,8,11171,1972,13143
BADIN DISTRICT,GOLARCHI (S.F.RAHU) TALUKA,9,7699,1490,9189
BADIN DISTRICT,GOLARCHI (S.F.RAHU) TALUKA,10,9517,1648,11165
BADIN DISTRICT,GOLARCHI (S.F.RAHU) TALUKA,11,5700,1217,6917
BADIN DISTRICT,GOLARCHI (S.F.RAHU) TALUKA,12,6871,1386,8257
BADIN DISTRICT,GOLARCHI (S.F.RAHU) TALUKA,13,4890,1092,5982
BADIN DISTRICT,GOLARCHI (S.F.RAHU) TALUKA,14,4983,1105,6088
BADIN DISTRICT,GOLARCHI (S.F.RAHU) TALUKA,15,5274,1148,6422
BADIN DISTRICT,GOLARCHI (S.F.RAHU) TALUKA,16,4784,978,5762
BADIN DISTRICT,GOLARCHI (S.F.RAHU) TALUKA,17,4361,1076,5437
BADIN DISTRICT,GOLARCHI (S.F.RAHU) TALUKA,18,6377,1192,7569
BADIN DISTRICT,GOLARCHI (S.F.RAHU) TALUKA,19,4661,1044,5705
BADIN DISTRICT,GOLARCHI (S.F.RAHU) TALUKA,20,5798,970,6768
BADIN DISTRICT,GOLARCHI (S.F.RAHU) TALUKA,21,3751,869,4620
BADIN DISTRICT,GOLARCHI (S.F.RAHU) TALUKA,22,4153,877,5030
BADIN DISTRICT,GOLARCHI (S.F.RAHU) TALUKA,23,3517,843,4360
BADIN DISTRICT,GOLARCHI (S.F.RAHU) TALUKA,24,3326,737,4063
BADIN DISTRICT,GOLARCHI (S.F.RAHU) TALUKA,25,4592,768,5360
BADIN DISTRICT,GOLARCHI (S.F.RAHU) TALUKA,26,3573,807,4380
BADIN DISTRICT,GOLARCHI (S.F.RAHU) TALUKA,27,3997,844,4841
BADIN DISTRICT,GOLARCHI (S.F.RAHU) TALUKA,28,4220,825,5045
BADIN DISTRICT,GOLARCHI (S.F.RAHU) TALUKA,29,4180,787,4967
BADIN DISTRICT,GOLARCHI (S.F.RAHU) TALUKA,30,4223,708,4931
BADIN DISTRICT,GOLARCHI (S.F.RAHU) TALUKA,31,3963,784,4747
BADIN DISTRICT,GOLARCHI (S.F.RAHU) TALUKA,32,3741,830,4571
BADIN DISTRICT,GOLARCHI (S.F.RAHU) TALUKA,33,3379,736,4115
BADIN DISTRICT,GOLARCHI (S.F.RAHU) TALUKA,34,3216,678,3894
BADIN DISTRICT,GOLARCHI (S.F.RAHU) TALUKA,35,3365,643,4008
BADIN DISTRICT,GOLARCHI (S.F.RAHU) TALUKA,36,3198,626,3824
BADIN DISTRICT,GOLARCHI (S.F.RAHU) TALUKA,37,4160,863,5023
BADIN DISTRICT,GOLARCHI (S.F.RAHU) TALUKA,38,3033,649,3682
BADIN DISTRICT,GOLARCHI (S.F.RAHU) TALUKA,39,3147,647,3794
BADIN DISTRICT,GOLARCHI (S.F.RAHU) TALUKA,40,2509,504,3013
BADIN DISTRICT,GOLARCHI (S.F.RAHU) TALUKA,41,2466,452,2918
BADIN DISTRICT,GOLARCHI (S.F.RAHU) TALUKA,42,2489,509,2998
BADIN DISTRICT,GOLARCHI (S.F.RAHU) TALUKA,43,2128,502,2630
BADIN DISTRICT,GOLARCHI (S.F.RAHU) TALUKA,44,2013,436,2449
BADIN DISTRICT,GOLARCHI (S.F.RAHU) TALUKA,45,1881,383,2264
BADIN DISTRICT,GOLARCHI (S.F.RAHU) TALUKA,46,1957,360,2317
BADIN DISTRICT,GOLARCHI (S.F.RAHU) TALUKA,47,2255,486,2741
BADIN DISTRICT,GOLARCHI (S.F.RAHU) TALUKA,48,1804,339,2143
BADIN DISTRICT,GOLARCHI (S.F.RAHU) TALUKA,49,1918,374,2292
BADIN DISTRICT,GOLARCHI (S.F.RAHU) TALUKA,50,1637,286,1923
BADIN DISTRICT,GOLARCHI (S.F.RAHU) TALUKA,51,1562,249,1811
BADIN DISTRICT,GOLARCHI (S.F.RAHU) TALUKA,52,1421,249,1670
BADIN DISTRICT,GOLARCHI (S.F.RAHU) TALUKA,53,1163,249,1412
BADIN DISTRICT,GOLARCHI (S.F.RAHU) TALUKA,54,1062,197,1259
BADIN DISTRICT,GOLARCHI (S.F.RAHU) TALUKA,55,1010,204,1214
BADIN DISTRICT,GOLARCHI (S.F.RAHU) TALUKA,56,922,144,1066
BADIN DISTRICT,GOLARCHI (S.F.RAHU) TALUKA,57,1162,197,1359
BADIN DISTRICT,GOLARCHI (S.F.RAHU) TALUKA,58,950,173,1123
BADIN DISTRICT,GOLARCHI (S.F.RAHU) TALUKA,59,1078,201,1279
BADIN DISTRICT,GOLARCHI (S.F.RAHU) TALUKA,60,1057,152,1209
BADIN DISTRICT,GOLARCHI (S.F.RAHU) TALUKA,61,986,168,1154
BADIN DISTRICT,GOLARCHI (S.F.RAHU) TALUKA,62,974,172,1146
BADIN DISTRICT,GOLARCHI (S.F.RAHU) TALUKA,63,896,175,1071
BADIN DISTRICT,GOLARCHI (S.F.RAHU) TALUKA,64,974,160,1134
BADIN DISTRICT,GOLARCHI (S.F.RAHU) TALUKA,65,795,130,925
BADIN DISTRICT,GOLARCHI (S.F.RAHU) TALUKA,66,771,120,891
BADIN DISTRICT,GOLARCHI (S.F.RAHU) TALUKA,67,715,139,854
BADIN DISTRICT,GOLARCHI (S.F.RAHU) TALUKA,68,621,122,743
BADIN DISTRICT,GOLARCHI (S.F.RAHU) TALUKA,69,715,128,843
BADIN DISTRICT,GOLARCHI (S.F.RAHU) TALUKA,70,567,107,674
BADIN DISTRICT,GOLARCHI (S.F.RAHU) TALUKA,71,542,93,635
BADIN DISTRICT,GOLARCHI (S.F.RAHU) TALUKA,72,416,72,488
BADIN DISTRICT,GOLARCHI (S.F.RAHU) TALUKA,73,392,91,483
BADIN DISTRICT,GOLARCHI (S.F.RAHU) TALUKA,74,397,66,463
BADIN DISTRICT,GOLARCHI (S.F.RAHU) TALUKA,>=75,2851,506,3357
BADIN DISTRICT,MATLI TALUKA,<1,7790,1843,9633
BADIN DISTRICT,MATLI TALUKA,1,10181,2485,12666
BADIN DISTRICT,MATLI TALUKA,2,11883,2779,14662
BADIN DISTRICT,MATLI TALUKA,3,12559,3051,15610
BADIN DISTRICT,MATLI TALUKA,4,13001,2978,15979
BADIN DISTRICT,MATLI TALUKA,5,12898,3040,15938
BADIN DISTRICT,MATLI TALUKA,6,12367,2840,15207
BADIN DISTRICT,MATLI TALUKA,7,11407,2721,14128
BADIN DISTRICT,MATLI TALUKA,8,12587,2837,15424
BADIN DISTRICT,MATLI TALUKA,9,9587,2586,12173
BADIN DISTRICT,MATLI TALUKA,10,11008,2541,13549
BADIN DISTRICT,MATLI TALUKA,11,7600,2205,9805
BADIN DISTRICT,MATLI TALUKA,12,8613,2332,10945
BADIN DISTRICT,MATLI TALUKA,13,6678,2052,8730
BADIN DISTRICT,MATLI TALUKA,14,6540,2082,8622
BADIN DISTRICT,MATLI TALUKA,15,7097,2205,9302
BADIN DISTRICT,MATLI TALUKA,16,6510,2152,8662
BADIN DISTRICT,MATLI TALUKA,17,5895,2202,8097
BADIN DISTRICT,MATLI TALUKA,18,7944,2141,10085
BADIN DISTRICT,MATLI TALUKA,19,6220,2015,8235
BADIN DISTRICT,MATLI TALUKA,20,7665,2117,9782
BADIN DISTRICT,MATLI TALUKA,21,5193,1871,7064
BADIN DISTRICT,MATLI TALUKA,22,5340,1736,7076
BADIN DISTRICT,MATLI TALUKA,23,4561,1603,6164
BADIN DISTRICT,MATLI TALUKA,24,4271,1560,5831
BADIN DISTRICT,MATLI TALUKA,25,5809,1664,7473
BADIN DISTRICT,MATLI TALUKA,26,4699,1581,6280
BADIN DISTRICT,MATLI TALUKA,27,5249,1633,6882
BADIN DISTRICT,MATLI TALUKA,28,5208,1613,6821
BADIN DISTRICT,MATLI TALUKA,29,5400,1588,6988
BADIN DISTRICT,MATLI TALUKA,30,5074,1536,6610
BADIN DISTRICT,MATLI TALUKA,31,5041,1525,6566
BADIN DISTRICT,MATLI TALUKA,32,4817,1547,6364
BADIN DISTRICT,MATLI TALUKA,33,4236,1301,5537
BADIN DISTRICT,MATLI TALUKA,34,4013,1297,5310
BADIN DISTRICT,MATLI TALUKA,35,4372,1249,5621
BADIN DISTRICT,MATLI TALUKA,36,4238,1366,5604
BADIN DISTRICT,MATLI TALUKA,37,5529,1349,6878
BADIN DISTRICT,MATLI TALUKA,38,3619,1164,4783
BADIN DISTRICT,MATLI TALUKA,39,4087,1210,5297
BADIN DISTRICT,MATLI TALUKA,40,3223,1088,4311
BADIN DISTRICT,MATLI TALUKA,41,3226,1058,4284
BADIN DISTRICT,MATLI TALUKA,42,3391,1023,4414
BADIN DISTRICT,MATLI TALUKA,43,2652,822,3474
BADIN DISTRICT,MATLI TALUKA,44,2608,817,3425
BADIN DISTRICT,MATLI TALUKA,45,2460,774,3234
BADIN DISTRICT,MATLI TALUKA,46,2524,820,3344
BADIN DISTRICT,MATLI TALUKA,47,3138,796,3934
BADIN DISTRICT,MATLI TALUKA,48,2229,732,2961
BADIN DISTRICT,MATLI TALUKA,49,2417,727,3144
BADIN DISTRICT,MATLI TALUKA,50,1977,700,2677
BADIN DISTRICT,MATLI TALUKA,51,1851,646,2497
BADIN DISTRICT,MATLI TALUKA,52,1780,581,2361
BADIN DISTRICT,MATLI TALUKA,53,1558,522,2080
BADIN DISTRICT,MATLI TALUKA,54,1366,455,1821
BADIN DISTRICT,MATLI TALUKA,55,1188,439,1627
BADIN DISTRICT,MATLI TALUKA,56,1156,427,1583
BADIN DISTRICT,MATLI TALUKA,57,1592,459,2051
BADIN DISTRICT,MATLI TALUKA,58,1204,429,1633
BADIN DISTRICT,MATLI TALUKA,59,1311,435,1746
BADIN DISTRICT,MATLI TALUKA,60,1321,392,1713
BADIN DISTRICT,MATLI TALUKA,61,1203,406,1609
BADIN DISTRICT,MATLI TALUKA,62,1262,387,1649
BADIN DISTRICT,MATLI TALUKA,63,1164,372,1536
BADIN DISTRICT,MATLI TALUKA,64,1224,347,1571
BADIN DISTRICT,MATLI TALUKA,65,1034,280,1314
BADIN DISTRICT,MATLI TALUKA,66,846,277,1123
BADIN DISTRICT,MATLI TALUKA,67,914,250,1164
BADIN DISTRICT,MATLI TALUKA,68,758,273,1031
BADIN DISTRICT,MATLI TALUKA,69,856,211,1067
BADIN DISTRICT,MATLI TALUKA,70,713,198,911
BADIN DISTRICT,MATLI TALUKA,71,576,182,758
BADIN DISTRICT,MATLI TALUKA,72,513,147,660
BADIN DISTRICT,MATLI TALUKA,73,484,159,643
BADIN DISTRICT,MATLI TALUKA,74,537,140,677
BADIN DISTRICT,MATLI TALUKA,>=75,3371,919,4290
BADIN DISTRICT,TALHAR TALUKA,<1,2731,1024,3755
BADIN DISTRICT,TALHAR TALUKA,1,3358,1165,4523
BADIN DISTRICT,TALHAR TALUKA,2,4315,1367,5682
BADIN DISTRICT,TALHAR TALUKA,3,4369,1550,5919
BADIN DISTRICT,TALHAR TALUKA,4,4569,1507,6076
BADIN DISTRICT,TALHAR TALUKA,5,4541,1597,6138
BADIN DISTRICT,TALHAR TALUKA,6,4558,1523,6081
BADIN DISTRICT,TALHAR TALUKA,7,3907,1434,5341
BADIN DISTRICT,TALHAR TALUKA,8,4710,1658,6368
BADIN DISTRICT,TALHAR TALUKA,9,3439,1242,4681
BADIN DISTRICT,TALHAR TALUKA,10,4261,1449,5710
BADIN DISTRICT,TALHAR TALUKA,11,2747,1085,3832
BADIN DISTRICT,TALHAR TALUKA,12,3268,1215,4483
BADIN DISTRICT,TALHAR TALUKA,13,2325,954,3279
BADIN DISTRICT,TALHAR TALUKA,14,2476,1000,3476
BADIN DISTRICT,TALHAR TALUKA,15,2464,1055,3519
BADIN DISTRICT,TALHAR TALUKA,16,2332,969,3301
BADIN DISTRICT,TALHAR TALUKA,17,2145,909,3054
BADIN DISTRICT,TALHAR TALUKA,18,2999,1090,4089
BADIN DISTRICT,TALHAR TALUKA,19,2281,937,3218
BADIN DISTRICT,TALHAR TALUKA,20,2719,1012,3731
BADIN DISTRICT,TALHAR TALUKA,21,1845,820,2665
BADIN DISTRICT,TALHAR TALUKA,22,1931,786,2717
BADIN DISTRICT,TALHAR TALUKA,23,1657,803,2460
BADIN DISTRICT,TALHAR TALUKA,24,1572,681,2253
BADIN DISTRICT,TALHAR TALUKA,25,2066,811,2877
BADIN DISTRICT,TALHAR TALUKA,26,1684,770,2454
BADIN DISTRICT,TALHAR TALUKA,27,1925,887,2812
BADIN DISTRICT,TALHAR TALUKA,28,1777,792,2569
BADIN DISTRICT,TALHAR TALUKA,29,1932,862,2794
BADIN DISTRICT,TALHAR TALUKA,30,1731,662,2393
BADIN DISTRICT,TALHAR TALUKA,31,1824,816,2640
BADIN DISTRICT,TALHAR TALUKA,32,1744,838,2582
BADIN DISTRICT,TALHAR TALUKA,33,1439,678,2117
BADIN DISTRICT,TALHAR TALUKA,34,1344,588,1932
BADIN DISTRICT,TALHAR TALUKA,35,1532,603,2135
BADIN DISTRICT,TALHAR TALUKA,36,1342,549,1891
BADIN DISTRICT,TALHAR TALUKA,37,1921,807,2728
BADIN DISTRICT,TALHAR TALUKA,38,1201,493,1694
BADIN DISTRICT,TALHAR TALUKA,39,1329,599,1928
BADIN DISTRICT,TALHAR TALUKA,40,1119,452,1571
BADIN DISTRICT,TALHAR TALUKA,41,1010,466,1476
BADIN DISTRICT,TALHAR TALUKA,42,1080,509,1589
BADIN DISTRICT,TALHAR TALUKA,43,1013,395,1408
BADIN DISTRICT,TALHAR TALUKA,44,853,361,1214
BADIN DISTRICT,TALHAR TALUKA,45,870,362,1232
BADIN DISTRICT,TALHAR TALUKA,46,825,340,1165
BADIN DISTRICT,TALHAR TALUKA,47,1100,472,1572
BADIN DISTRICT,TALHAR TALUKA,48,837,311,1148
BADIN DISTRICT,TALHAR TALUKA,49,850,378,1228
BADIN DISTRICT,TALHAR TALUKA,50,744,287,1031
BADIN DISTRICT,TALHAR TALUKA,51,608,348,956
BADIN DISTRICT,TALHAR TALUKA,52,656,316,972
BADIN DISTRICT,TALHAR TALUKA,53,491,245,736
BADIN DISTRICT,TALHAR TALUKA,54,400,193,593
BADIN DISTRICT,TALHAR TALUKA,55,475,198,673
BADIN DISTRICT,TALHAR TALUKA,56,415,177,592
BADIN DISTRICT,TALHAR TALUKA,57,549,260,809
BADIN DISTRICT,TALHAR TALUKA,58,470,178,648
BADIN DISTRICT,TALHAR TALUKA,59,544,211,755
BADIN DISTRICT,TALHAR TALUKA,60,479,175,654
BADIN DISTRICT,TALHAR TALUKA,61,435,248,683
BADIN DISTRICT,TALHAR TALUKA,62,455,193,648
BADIN DISTRICT,TALHAR TALUKA,63,416,196,612
BADIN DISTRICT,TALHAR TALUKA,64,453,202,655
BADIN DISTRICT,TALHAR TALUKA,65,403,151,554
BADIN DISTRICT,TALHAR TALUKA,66,293,163,456
BADIN DISTRICT,TALHAR TALUKA,67,331,160,491
BADIN DISTRICT,TALHAR TALUKA,68,261,114,375
BADIN DISTRICT,TALHAR TALUKA,69,340,148,488
BADIN DISTRICT,TALHAR TALUKA,70,278,87,365
BADIN DISTRICT,TALHAR TALUKA,71,198,96,294
BADIN DISTRICT,TALHAR TALUKA,72,168,95,263
BADIN DISTRICT,TALHAR TALUKA,73,170,83,253
BADIN DISTRICT,TALHAR TALUKA,74,196,76,272
BADIN DISTRICT,TALHAR TALUKA,>=75,1234,452,1686
BADIN DISTRICT,TANDO BAGO TALUKA,<1,8560,1555,10115
BADIN DISTRICT,TANDO BAGO TALUKA,1,9218,1396,10614
BADIN DISTRICT,TANDO BAGO TALUKA,2,12117,1904,14021
BADIN DISTRICT,TANDO BAGO TALUKA,3,12549,1895,14444
BADIN DISTRICT,TANDO BAGO TALUKA,4,13141,2018,15159
BADIN DISTRICT,TANDO BAGO TALUKA,5,12817,2043,14860
BADIN DISTRICT,TANDO BAGO TALUKA,6,12673,1905,14578
BADIN DISTRICT,TANDO BAGO TALUKA,7,10822,1741,12563
BADIN DISTRICT,TANDO BAGO TALUKA,8,13264,1990,15254
BADIN DISTRICT,TANDO BAGO TALUKA,9,9219,1558,10777
BADIN DISTRICT,TANDO BAGO TALUKA,10,11785,1733,13518
BADIN DISTRICT,TANDO BAGO TALUKA,11,7337,1272,8609
BADIN DISTRICT,TANDO BAGO TALUKA,12,9146,1319,10465
BADIN DISTRICT,TANDO BAGO TALUKA,13,6362,1128,7490
BADIN DISTRICT,TANDO BAGO TALUKA,14,6578,1126,7704
BADIN DISTRICT,TANDO BAGO TALUKA,15,6710,1182,7892
BADIN DISTRICT,TANDO BAGO TALUKA,16,6425,1059,7484
BADIN DISTRICT,TANDO BAGO TALUKA,17,5228,1078,6306
BADIN DISTRICT,TANDO BAGO TALUKA,18,7844,1322,9166
BADIN DISTRICT,TANDO BAGO TALUKA,19,5581,1040,6621
BADIN DISTRICT,TANDO BAGO TALUKA,20,7508,1214,8722
BADIN DISTRICT,TANDO BAGO TALUKA,21,4779,919,5698
BADIN DISTRICT,TANDO BAGO TALUKA,22,4971,893,5864
BADIN DISTRICT,TANDO BAGO TALUKA,23,4602,846,5448
BADIN DISTRICT,TANDO BAGO TALUKA,24,4119,893,5012
BADIN DISTRICT,TANDO BAGO TALUKA,25,5750,930,6680
BADIN DISTRICT,TANDO BAGO TALUKA,26,4313,968,5281
BADIN DISTRICT,TANDO BAGO TALUKA,27,5255,1085,6340
BADIN DISTRICT,TANDO BAGO TALUKA,28,5195,911,6106
BADIN DISTRICT,TANDO BAGO TALUKA,29,5286,1017,6303
BADIN DISTRICT,TANDO BAGO TALUKA,30,5188,897,6085
BADIN DISTRICT,TANDO BAGO TALUKA,31,5077,986,6063
BADIN DISTRICT,TANDO BAGO TALUKA,32,5022,926,5948
BADIN DISTRICT,TANDO BAGO TALUKA,33,4415,797,5212
BADIN DISTRICT,TANDO BAGO TALUKA,34,3812,784,4596
BADIN DISTRICT,TANDO BAGO TALUKA,35,4358,667,5025
BADIN DISTRICT,TANDO BAGO TALUKA,36,3608,785,4393
BADIN DISTRICT,TANDO BAGO TALUKA,37,5478,882,6360
BADIN DISTRICT,TANDO BAGO TALUKA,38,3370,632,4002
BADIN DISTRICT,TANDO BAGO TALUKA,39,3738,659,4397
BADIN DISTRICT,TANDO BAGO TALUKA,40,3337,537,3874
BADIN DISTRICT,TANDO BAGO TALUKA,41,2820,560,3380
BADIN DISTRICT,TANDO BAGO TALUKA,42,2822,510,3332
BADIN DISTRICT,TANDO BAGO TALUKA,43,2589,470,3059
BADIN DISTRICT,TANDO BAGO TALUKA,44,2333,464,2797
BADIN DISTRICT,TANDO BAGO TALUKA,45,2505,409,2914
BADIN DISTRICT,TANDO BAGO TALUKA,46,2159,490,2649
BADIN DISTRICT,TANDO BAGO TALUKA,47,2967,532,3499
BADIN DISTRICT,TANDO BAGO TALUKA,48,2136,392,2528
BADIN DISTRICT,TANDO BAGO TALUKA,49,2246,448,2694
BADIN DISTRICT,TANDO BAGO TALUKA,50,2205,384,2589
BADIN DISTRICT,TANDO BAGO TALUKA,51,1788,357,2145
BADIN DISTRICT,TANDO BAGO TALUKA,52,1678,307,1985
BADIN DISTRICT,TANDO BAGO TALUKA,53,1377,273,1650
BADIN DISTRICT,TANDO BAGO TALUKA,54,1307,249,1556
BADIN DISTRICT,TANDO BAGO TALUKA,55,1427,205,1632
BADIN DISTRICT,TANDO BAGO TALUKA,56,1083,193,1276
BADIN DISTRICT,TANDO BAGO TALUKA,57,1573,264,1837
BADIN DISTRICT,TANDO BAGO TALUKA,58,1147,266,1413
BADIN DISTRICT,TANDO BAGO TALUKA,59,1326,270,1596
BADIN DISTRICT,TANDO BAGO TALUKA,60,1448,211,1659
BADIN DISTRICT,TANDO BAGO TALUKA,61,1117,260,1377
BADIN DISTRICT,TANDO BAGO TALUKA,62,1147,224,1371
BADIN DISTRICT,TANDO BAGO TALUKA,63,1088,211,1299
BADIN DISTRICT,TANDO BAGO TALUKA,64,1254,210,1464
BADIN DISTRICT,TANDO BAGO TALUKA,65,1112,166,1278
BADIN DISTRICT,TANDO BAGO TALUKA,66,742,154,896
BADIN DISTRICT,TANDO BAGO TALUKA,67,896,152,1048
BADIN DISTRICT,TANDO BAGO TALUKA,68,758,134,892
BADIN DISTRICT,TANDO BAGO TALUKA,69,876,139,1015
BADIN DISTRICT,TANDO BAGO TALUKA,70,826,108,934
BADIN DISTRICT,TANDO BAGO TALUKA,71,521,89,610
BADIN DISTRICT,TANDO BAGO TALUKA,72,536,77,613
BADIN DISTRICT,TANDO BAGO TALUKA,73,493,84,577
BADIN DISTRICT,TANDO BAGO TALUKA,74,576,85,661
BADIN DISTRICT,TANDO BAGO TALUKA,>=75,3393,561,3954
BAHAWALNAGAR DISTRICT,BAHAWALNAGAR TEHSIL,<1,15125,4334,19459
BAHAWALNAGAR DISTRICT,BAHAWALNAGAR TEHSIL,1,17569,4887,22456
BAHAWALNAGAR DISTRICT,BAHAWALNAGAR TEHSIL,2,18114,4773,22887
BAHAWALNAGAR DISTRICT,BAHAWALNAGAR TEHSIL,3,18891,5096,23987
BAHAWALNAGAR DISTRICT,BAHAWALNAGAR TEHSIL,4,19547,5046,24593
BAHAWALNAGAR DISTRICT,BAHAWALNAGAR TEHSIL,5,19335,4929,24264
BAHAWALNAGAR DISTRICT,BAHAWALNAGAR TEHSIL,6,18780,4769,23549
BAHAWALNAGAR DISTRICT,BAHAWALNAGAR TEHSIL,7,19896,5141,25037
BAHAWALNAGAR DISTRICT,BAHAWALNAGAR TEHSIL,8,19481,4685,24166
BAHAWALNAGAR DISTRICT,BAHAWALNAGAR TEHSIL,9,17784,5143,22927
BAHAWALNAGAR DISTRICT,BAHAWALNAGAR TEHSIL,10,17627,4295,21922
BAHAWALNAGAR DISTRICT,BAHAWALNAGAR TEHSIL,11,15366,4943,20309
BAHAWALNAGAR DISTRICT,BAHAWALNAGAR TEHSIL,12,15051,4108,19159
BAHAWALNAGAR DISTRICT,BAHAWALNAGAR TEHSIL,13,12974,4443,17417
BAHAWALNAGAR DISTRICT,BAHAWALNAGAR TEHSIL,14,13257,4156,17413
BAHAWALNAGAR DISTRICT,BAHAWALNAGAR TEHSIL,15,12461,4097,16558
BAHAWALNAGAR DISTRICT,BAHAWALNAGAR TEHSIL,16,12756,4214,16970
BAHAWALNAGAR DISTRICT,BAHAWALNAGAR TEHSIL,17,11607,4013,15620
BAHAWALNAGAR DISTRICT,BAHAWALNAGAR TEHSIL,18,12764,3920,16684
BAHAWALNAGAR DISTRICT,BAHAWALNAGAR TEHSIL,19,10710,4142,14852
BAHAWALNAGAR DISTRICT,BAHAWALNAGAR TEHSIL,20,12079,3657,15736
BAHAWALNAGAR DISTRICT,BAHAWALNAGAR TEHSIL,21,10308,4005,14313
BAHAWALNAGAR DISTRICT,BAHAWALNAGAR TEHSIL,22,10718,3668,14386
BAHAWALNAGAR DISTRICT,BAHAWALNAGAR TEHSIL,23,8932,3401,12333
BAHAWALNAGAR DISTRICT,BAHAWALNAGAR TEHSIL,24,8383,3528,11911
BAHAWALNAGAR DISTRICT,BAHAWALNAGAR TEHSIL,25,10194,3126,13320
BAHAWALNAGAR DISTRICT,BAHAWALNAGAR TEHSIL,26,8711,3541,12252
BAHAWALNAGAR DISTRICT,BAHAWALNAGAR TEHSIL,27,8605,3291,11896
BAHAWALNAGAR DISTRICT,BAHAWALNAGAR TEHSIL,28,9184,3306,12490
BAHAWALNAGAR DISTRICT,BAHAWALNAGAR TEHSIL,29,9087,3227,12314
BAHAWALNAGAR DISTRICT,BAHAWALNAGAR TEHSIL,30,9318,2906,12224
BAHAWALNAGAR DISTRICT,BAHAWALNAGAR TEHSIL,31,8761,3166,11927
BAHAWALNAGAR DISTRICT,BAHAWALNAGAR TEHSIL,32,8132,2842,10974
BAHAWALNAGAR DISTRICT,BAHAWALNAGAR TEHSIL,33,7254,2695,9949
BAHAWALNAGAR DISTRICT,BAHAWALNAGAR TEHSIL,34,6990,2622,9612
BAHAWALNAGAR DISTRICT,BAHAWALNAGAR TEHSIL,35,7538,2216,9754
BAHAWALNAGAR DISTRICT,BAHAWALNAGAR TEHSIL,36,7350,2488,9838
BAHAWALNAGAR DISTRICT,BAHAWALNAGAR TEHSIL,37,7283,2096,9379
BAHAWALNAGAR DISTRICT,BAHAWALNAGAR TEHSIL,38,6295,2394,8689
BAHAWALNAGAR DISTRICT,BAHAWALNAGAR TEHSIL,39,6699,2216,8915
BAHAWALNAGAR DISTRICT,BAHAWALNAGAR TEHSIL,40,6062,2062,8124
BAHAWALNAGAR DISTRICT,BAHAWALNAGAR TEHSIL,41,6314,2142,8456
BAHAWALNAGAR DISTRICT,BAHAWALNAGAR TEHSIL,42,5769,1902,7671
BAHAWALNAGAR DISTRICT,BAHAWALNAGAR TEHSIL,43,4950,1797,6747
BAHAWALNAGAR DISTRICT,BAHAWALNAGAR TEHSIL,44,5158,1927,7085
BAHAWALNAGAR DISTRICT,BAHAWALNAGAR TEHSIL,45,4997,1594,6591
BAHAWALNAGAR DISTRICT,BAHAWALNAGAR TEHSIL,46,5514,1907,7421
BAHAWALNAGAR DISTRICT,BAHAWALNAGAR TEHSIL,47,5345,1571,6916
BAHAWALNAGAR DISTRICT,BAHAWALNAGAR TEHSIL,48,4969,1719,6688
BAHAWALNAGAR DISTRICT,BAHAWALNAGAR TEHSIL,49,5313,1730,7043
BAHAWALNAGAR DISTRICT,BAHAWALNAGAR TEHSIL,50,4728,1587,6315
BAHAWALNAGAR DISTRICT,BAHAWALNAGAR TEHSIL,51,5245,1658,6903
BAHAWALNAGAR DISTRICT,BAHAWALNAGAR TEHSIL,52,4632,1563,6195
BAHAWALNAGAR DISTRICT,BAHAWALNAGAR TEHSIL,53,4267,1479,5746
BAHAWALNAGAR DISTRICT,BAHAWALNAGAR TEHSIL,54,3757,1365,5122
BAHAWALNAGAR DISTRICT,BAHAWALNAGAR TEHSIL,55,3294,1107,4401
BAHAWALNAGAR DISTRICT,BAHAWALNAGAR TEHSIL,56,3153,1189,4342
BAHAWALNAGAR DISTRICT,BAHAWALNAGAR TEHSIL,57,2823,860,3683
BAHAWALNAGAR DISTRICT,BAHAWALNAGAR TEHSIL,58,2300,959,3259
BAHAWALNAGAR DISTRICT,BAHAWALNAGAR TEHSIL,59,2526,932,3458
BAHAWALNAGAR DISTRICT,BAHAWALNAGAR TEHSIL,60,2507,782,3289
BAHAWALNAGAR DISTRICT,BAHAWALNAGAR TEHSIL,61,2674,1009,3683
BAHAWALNAGAR DISTRICT,BAHAWALNAGAR TEHSIL,62,2436,881,3317
BAHAWALNAGAR DISTRICT,BAHAWALNAGAR TEHSIL,63,2269,770,3039
BAHAWALNAGAR DISTRICT,BAHAWALNAGAR TEHSIL,64,2109,692,2801
BAHAWALNAGAR DISTRICT,BAHAWALNAGAR TEHSIL,65,2165,612,2777
BAHAWALNAGAR DISTRICT,BAHAWALNAGAR TEHSIL,66,2055,585,2640
BAHAWALNAGAR DISTRICT,BAHAWALNAGAR TEHSIL,67,1960,485,2445
BAHAWALNAGAR DISTRICT,BAHAWALNAGAR TEHSIL,68,1763,570,2333
BAHAWALNAGAR DISTRICT,BAHAWALNAGAR TEHSIL,69,1679,476,2155
BAHAWALNAGAR DISTRICT,BAHAWALNAGAR TEHSIL,70,1764,458,2222
BAHAWALNAGAR DISTRICT,BAHAWALNAGAR TEHSIL,71,1705,471,2176
BAHAWALNAGAR DISTRICT,BAHAWALNAGAR TEHSIL,72,1509,439,1948
BAHAWALNAGAR DISTRICT,BAHAWALNAGAR TEHSIL,73,1360,442,1802
BAHAWALNAGAR DISTRICT,BAHAWALNAGAR TEHSIL,74,1074,302,1376
BAHAWALNAGAR DISTRICT,BAHAWALNAGAR TEHSIL,>=75,8489,2291,10780
BAHAWALNAGAR DISTRICT,CHISHTIAN TEHSIL,<1,12478,3217,15695
BAHAWALNAGAR DISTRICT,CHISHTIAN TEHSIL,1,14645,3699,18344
BAHAWALNAGAR DISTRICT,CHISHTIAN TEHSIL,2,14460,3641,18101
BAHAWALNAGAR DISTRICT,CHISHTIAN TEHSIL,3,16087,3947,20034
BAHAWALNAGAR DISTRICT,CHISHTIAN TEHSIL,4,15913,3781,19694
BAHAWALNAGAR DISTRICT,CHISHTIAN TEHSIL,5,15466,3700,19166
BAHAWALNAGAR DISTRICT,CHISHTIAN TEHSIL,6,14968,3666,18634
BAHAWALNAGAR DISTRICT,CHISHTIAN TEHSIL,7,15971,3966,19937
BAHAWALNAGAR DISTRICT,CHISHTIAN TEHSIL,8,14952,3417,18369
BAHAWALNAGAR DISTRICT,CHISHTIAN TEHSIL,9,14516,3788,18304
BAHAWALNAGAR DISTRICT,CHISHTIAN TEHSIL,10,13612,3239,16851
BAHAWALNAGAR DISTRICT,CHISHTIAN TEHSIL,11,13031,3681,16712
BAHAWALNAGAR DISTRICT,CHISHTIAN TEHSIL,12,12195,3197,15392
BAHAWALNAGAR DISTRICT,CHISHTIAN TEHSIL,13,11601,3598,15199
BAHAWALNAGAR DISTRICT,CHISHTIAN TEHSIL,14,11075,3208,14283
BAHAWALNAGAR DISTRICT,CHISHTIAN TEHSIL,15,11089,3251,14340
BAHAWALNAGAR DISTRICT,CHISHTIAN TEHSIL,16,10862,3124,13986
BAHAWALNAGAR DISTRICT,CHISHTIAN TEHSIL,17,10488,3327,13815
BAHAWALNAGAR DISTRICT,CHISHTIAN TEHSIL,18,10451,2859,13310
BAHAWALNAGAR DISTRICT,CHISHTIAN TEHSIL,19,9922,3139,13061
BAHAWALNAGAR DISTRICT,CHISHTIAN TEHSIL,20,10311,2672,12983
BAHAWALNAGAR DISTRICT,CHISHTIAN TEHSIL,21,9238,3070,12308
BAHAWALNAGAR DISTRICT,CHISHTIAN TEHSIL,22,9648,2859,12507
BAHAWALNAGAR DISTRICT,CHISHTIAN TEHSIL,23,8708,2698,11406
BAHAWALNAGAR DISTRICT,CHISHTIAN TEHSIL,24,8164,2569,10733
BAHAWALNAGAR DISTRICT,CHISHTIAN TEHSIL,25,8796,2363,11159
BAHAWALNAGAR DISTRICT,CHISHTIAN TEHSIL,26,7846,2451,10297
BAHAWALNAGAR DISTRICT,CHISHTIAN TEHSIL,27,7958,2599,10557
BAHAWALNAGAR DISTRICT,CHISHTIAN TEHSIL,28,7960,2424,10384
BAHAWALNAGAR DISTRICT,CHISHTIAN TEHSIL,29,8429,2534,10963
BAHAWALNAGAR DISTRICT,CHISHTIAN TEHSIL,30,8207,2134,10341
BAHAWALNAGAR DISTRICT,CHISHTIAN TEHSIL,31,7835,2252,10087
BAHAWALNAGAR DISTRICT,CHISHTIAN TEHSIL,32,7325,2242,9567
BAHAWALNAGAR DISTRICT,CHISHTIAN TEHSIL,33,6841,2092,8933
BAHAWALNAGAR DISTRICT,CHISHTIAN TEHSIL,34,6385,1961,8346
BAHAWALNAGAR DISTRICT,CHISHTIAN TEHSIL,35,6720,1749,8469
BAHAWALNAGAR DISTRICT,CHISHTIAN TEHSIL,36,5873,1655,7528
BAHAWALNAGAR DISTRICT,CHISHTIAN TEHSIL,37,6331,1847,8178
BAHAWALNAGAR DISTRICT,CHISHTIAN TEHSIL,38,5576,1762,7338
BAHAWALNAGAR DISTRICT,CHISHTIAN TEHSIL,39,6047,1765,7812
BAHAWALNAGAR DISTRICT,CHISHTIAN TEHSIL,40,5809,1556,7365
BAHAWALNAGAR DISTRICT,CHISHTIAN TEHSIL,41,5499,1671,7170
BAHAWALNAGAR DISTRICT,CHISHTIAN TEHSIL,42,5249,1570,6819
BAHAWALNAGAR DISTRICT,CHISHTIAN TEHSIL,43,4850,1541,6391
BAHAWALNAGAR DISTRICT,CHISHTIAN TEHSIL,44,4794,1488,6282
BAHAWALNAGAR DISTRICT,CHISHTIAN TEHSIL,45,4613,1302,5915
BAHAWALNAGAR DISTRICT,CHISHTIAN TEHSIL,46,4666,1330,5996
BAHAWALNAGAR DISTRICT,CHISHTIAN TEHSIL,47,4721,1445,6166
BAHAWALNAGAR DISTRICT,CHISHTIAN TEHSIL,48,4556,1459,6015
BAHAWALNAGAR DISTRICT,CHISHTIAN TEHSIL,49,4877,1431,6308
BAHAWALNAGAR DISTRICT,CHISHTIAN TEHSIL,50,4525,1292,5817
BAHAWALNAGAR DISTRICT,CHISHTIAN TEHSIL,51,4568,1385,5953
BAHAWALNAGAR DISTRICT,CHISHTIAN TEHSIL,52,4245,1357,5602
BAHAWALNAGAR DISTRICT,CHISHTIAN TEHSIL,53,4064,1243,5307
BAHAWALNAGAR DISTRICT,CHISHTIAN TEHSIL,54,3678,1158,4836
BAHAWALNAGAR DISTRICT,CHISHTIAN TEHSIL,55,3200,935,4135
BAHAWALNAGAR DISTRICT,CHISHTIAN TEHSIL,56,2949,926,3875
BAHAWALNAGAR DISTRICT,CHISHTIAN TEHSIL,57,2871,739,3610
BAHAWALNAGAR DISTRICT,CHISHTIAN TEHSIL,58,2421,737,3158
BAHAWALNAGAR DISTRICT,CHISHTIAN TEHSIL,59,2593,822,3415
BAHAWALNAGAR DISTRICT,CHISHTIAN TEHSIL,60,2635,667,3302
BAHAWALNAGAR DISTRICT,CHISHTIAN TEHSIL,61,2615,746,3361
BAHAWALNAGAR DISTRICT,CHISHTIAN TEHSIL,62,2514,714,3228
BAHAWALNAGAR DISTRICT,CHISHTIAN TEHSIL,63,2316,683,2999
BAHAWALNAGAR DISTRICT,CHISHTIAN TEHSIL,64,2170,574,2744
BAHAWALNAGAR DISTRICT,CHISHTIAN TEHSIL,65,2083,448,2531
BAHAWALNAGAR DISTRICT,CHISHTIAN TEHSIL,66,1917,458,2375
BAHAWALNAGAR DISTRICT,CHISHTIAN TEHSIL,67,1882,433,2315
BAHAWALNAGAR DISTRICT,CHISHTIAN TEHSIL,68,1710,345,2055
BAHAWALNAGAR DISTRICT,CHISHTIAN TEHSIL,69,1652,389,2041
BAHAWALNAGAR DISTRICT,CHISHTIAN TEHSIL,70,1739,330,2069
BAHAWALNAGAR DISTRICT,CHISHTIAN TEHSIL,71,1617,395,2012
BAHAWALNAGAR DISTRICT,CHISHTIAN TEHSIL,72,1560,348,1908
BAHAWALNAGAR DISTRICT,CHISHTIAN TEHSIL,73,1281,312,1593
BAHAWALNAGAR DISTRICT,CHISHTIAN TEHSIL,74,1094,244,1338
BAHAWALNAGAR DISTRICT,CHISHTIAN TEHSIL,>=75,8829,1808,10637
BAHAWALNAGAR DISTRICT,FORT ABBAS TEHSIL,<1,8893,1512,10405
BAHAWALNAGAR DISTRICT,FORT ABBAS TEHSIL,1,9801,1611,11412
BAHAWALNAGAR DISTRICT,FORT ABBAS TEHSIL,2,10097,1655,11752
BAHAWALNAGAR DISTRICT,FORT ABBAS TEHSIL,3,10398,1770,12168
BAHAWALNAGAR DISTRICT,FORT ABBAS TEHSIL,4,10504,1676,12180
BAHAWALNAGAR DISTRICT,FORT ABBAS TEHSIL,5,10290,1730,12020
BAHAWALNAGAR DISTRICT,FORT ABBAS TEHSIL,6,10065,1637,11702
BAHAWALNAGAR DISTRICT,FORT ABBAS TEHSIL,7,10359,1745,12104
BAHAWALNAGAR DISTRICT,FORT ABBAS TEHSIL,8,9653,1594,11247
BAHAWALNAGAR DISTRICT,FORT ABBAS TEHSIL,9,10056,1743,11799
BAHAWALNAGAR DISTRICT,FORT ABBAS TEHSIL,10,8851,1460,10311
BAHAWALNAGAR DISTRICT,FORT ABBAS TEHSIL,11,9150,1727,10877
BAHAWALNAGAR DISTRICT,FORT ABBAS TEHSIL,12,7933,1404,9337
BAHAWALNAGAR DISTRICT,FORT ABBAS TEHSIL,13,8140,1506,9646
BAHAWALNAGAR DISTRICT,FORT ABBAS TEHSIL,14,7557,1432,8989
BAHAWALNAGAR DISTRICT,FORT ABBAS TEHSIL,15,7432,1346,8778
BAHAWALNAGAR DISTRICT,FORT ABBAS TEHSIL,16,7484,1382,8866
BAHAWALNAGAR DISTRICT,FORT ABBAS TEHSIL,17,7329,1346,8675
BAHAWALNAGAR DISTRICT,FORT ABBAS TEHSIL,18,6584,1279,7863
BAHAWALNAGAR DISTRICT,FORT ABBAS TEHSIL,19,6596,1296,7892
BAHAWALNAGAR DISTRICT,FORT ABBAS TEHSIL,20,6441,1070,7511
BAHAWALNAGAR DISTRICT,FORT ABBAS TEHSIL,21,6643,1177,7820
BAHAWALNAGAR DISTRICT,FORT ABBAS TEHSIL,22,6256,1130,7386
BAHAWALNAGAR DISTRICT,FORT ABBAS TEHSIL,23,5806,1063,6869
BAHAWALNAGAR DISTRICT,FORT ABBAS TEHSIL,24,5341,1046,6387
BAHAWALNAGAR DISTRICT,FORT ABBAS TEHSIL,25,5249,926,6175
BAHAWALNAGAR DISTRICT,FORT ABBAS TEHSIL,26,5442,992,6434
BAHAWALNAGAR DISTRICT,FORT ABBAS TEHSIL,27,5247,943,6190
BAHAWALNAGAR DISTRICT,FORT ABBAS TEHSIL,28,5442,940,6382
BAHAWALNAGAR DISTRICT,FORT ABBAS TEHSIL,29,5402,872,6274
BAHAWALNAGAR DISTRICT,FORT ABBAS TEHSIL,30,4960,857,5817
BAHAWALNAGAR DISTRICT,FORT ABBAS TEHSIL,31,5170,864,6034
BAHAWALNAGAR DISTRICT,FORT ABBAS TEHSIL,32,4830,836,5666
BAHAWALNAGAR DISTRICT,FORT ABBAS TEHSIL,33,4560,768,5328
BAHAWALNAGAR DISTRICT,FORT ABBAS TEHSIL,34,4580,738,5318
BAHAWALNAGAR DISTRICT,FORT ABBAS TEHSIL,35,4036,700,4736
BAHAWALNAGAR DISTRICT,FORT ABBAS TEHSIL,36,4759,747,5506
BAHAWALNAGAR DISTRICT,FORT ABBAS TEHSIL,37,4229,736,4965
BAHAWALNAGAR DISTRICT,FORT ABBAS TEHSIL,38,4127,632,4759
BAHAWALNAGAR DISTRICT,FORT ABBAS TEHSIL,39,4124,688,4812
BAHAWALNAGAR DISTRICT,FORT ABBAS TEHSIL,40,3398,626,4024
BAHAWALNAGAR DISTRICT,FORT ABBAS TEHSIL,41,4032,650,4682
BAHAWALNAGAR DISTRICT,FORT ABBAS TEHSIL,42,3314,616,3930
BAHAWALNAGAR DISTRICT,FORT ABBAS TEHSIL,43,3323,632,3955
BAHAWALNAGAR DISTRICT,FORT ABBAS TEHSIL,44,3370,559,3929
BAHAWALNAGAR DISTRICT,FORT ABBAS TEHSIL,45,2634,472,3106
BAHAWALNAGAR DISTRICT,FORT ABBAS TEHSIL,46,3474,595,4069
BAHAWALNAGAR DISTRICT,FORT ABBAS TEHSIL,47,3148,542,3690
BAHAWALNAGAR DISTRICT,FORT ABBAS TEHSIL,48,3185,553,3738
BAHAWALNAGAR DISTRICT,FORT ABBAS TEHSIL,49,3096,606,3702
BAHAWALNAGAR DISTRICT,FORT ABBAS TEHSIL,50,2598,458,3056
BAHAWALNAGAR DISTRICT,FORT ABBAS TEHSIL,51,3268,537,3805
BAHAWALNAGAR DISTRICT,FORT ABBAS TEHSIL,52,2658,436,3094
BAHAWALNAGAR DISTRICT,FORT ABBAS TEHSIL,53,2790,436,3226
BAHAWALNAGAR DISTRICT,FORT ABBAS TEHSIL,54,2498,390,2888
BAHAWALNAGAR DISTRICT,FORT ABBAS TEHSIL,55,1870,303,2173
BAHAWALNAGAR DISTRICT,FORT ABBAS TEHSIL,56,2077,333,2410
BAHAWALNAGAR DISTRICT,FORT ABBAS TEHSIL,57,1812,289,2101
BAHAWALNAGAR DISTRICT,FORT ABBAS TEHSIL,58,1714,242,1956
BAHAWALNAGAR DISTRICT,FORT ABBAS TEHSIL,59,1751,275,2026
BAHAWALNAGAR DISTRICT,FORT ABBAS TEHSIL,60,1574,241,1815
BAHAWALNAGAR DISTRICT,FORT ABBAS TEHSIL,61,1856,240,2096
BAHAWALNAGAR DISTRICT,FORT ABBAS TEHSIL,62,1542,231,1773
BAHAWALNAGAR DISTRICT,FORT ABBAS TEHSIL,63,1627,252,1879
BAHAWALNAGAR DISTRICT,FORT ABBAS TEHSIL,64,1450,206,1656
BAHAWALNAGAR DISTRICT,FORT ABBAS TEHSIL,65,1351,179,1530
BAHAWALNAGAR DISTRICT,FORT ABBAS TEHSIL,66,1527,202,1729
BAHAWALNAGAR DISTRICT,FORT ABBAS TEHSIL,67,1160,152,1312
BAHAWALNAGAR DISTRICT,FORT ABBAS TEHSIL,68,1263,155,1418
BAHAWALNAGAR DISTRICT,FORT ABBAS TEHSIL,69,1159,136,1295
BAHAWALNAGAR DISTRICT,FORT ABBAS TEHSIL,70,1040,145,1185
BAHAWALNAGAR DISTRICT,FORT ABBAS TEHSIL,71,1198,159,1357
BAHAWALNAGAR DISTRICT,FORT ABBAS TEHSIL,72,992,111,1103
BAHAWALNAGAR DISTRICT,FORT ABBAS TEHSIL,73,816,140,956
BAHAWALNAGAR DISTRICT,FORT ABBAS TEHSIL,74,733,92,825
BAHAWALNAGAR DISTRICT,FORT ABBAS TEHSIL,>=75,6126,761,6887
BAHAWALNAGAR DISTRICT,HAROONABAD TEHSIL,<1,8917,3289,12206
BAHAWALNAGAR DISTRICT,HAROONABAD TEHSIL,1,10157,3833,13990
BAHAWALNAGAR DISTRICT,HAROONABAD TEHSIL,2,9979,3501,13480
BAHAWALNAGAR DISTRICT,HAROONABAD TEHSIL,3,10550,3607,14157
BAHAWALNAGAR DISTRICT,HAROONABAD TEHSIL,4,10154,3602,13756
BAHAWALNAGAR DISTRICT,HAROONABAD TEHSIL,5,10628,3662,14290
BAHAWALNAGAR DISTRICT,HAROONABAD TEHSIL,6,9875,3662,13537
BAHAWALNAGAR DISTRICT,HAROONABAD TEHSIL,7,10817,3768,14585
BAHAWALNAGAR DISTRICT,HAROONABAD TEHSIL,8,9645,3299,12944
BAHAWALNAGAR DISTRICT,HAROONABAD TEHSIL,9,10440,3898,14338
BAHAWALNAGAR DISTRICT,HAROONABAD TEHSIL,10,8934,3128,12062
BAHAWALNAGAR DISTRICT,HAROONABAD TEHSIL,11,9904,3926,13830
BAHAWALNAGAR DISTRICT,HAROONABAD TEHSIL,12,8346,3041,11387
BAHAWALNAGAR DISTRICT,HAROONABAD TEHSIL,13,8495,3495,11990
BAHAWALNAGAR DISTRICT,HAROONABAD TEHSIL,14,7913,3018,10931
BAHAWALNAGAR DISTRICT,HAROONABAD TEHSIL,15,7744,3229,10973
BAHAWALNAGAR DISTRICT,HAROONABAD TEHSIL,16,7899,3030,10929
BAHAWALNAGAR DISTRICT,HAROONABAD TEHSIL,17,7528,3070,10598
BAHAWALNAGAR DISTRICT,HAROONABAD TEHSIL,18,6854,2606,9460
BAHAWALNAGAR DISTRICT,HAROONABAD TEHSIL,19,7260,3107,10367
BAHAWALNAGAR DISTRICT,HAROONABAD TEHSIL,20,6614,2403,9017
BAHAWALNAGAR DISTRICT,HAROONABAD TEHSIL,21,7110,2902,10012
BAHAWALNAGAR DISTRICT,HAROONABAD TEHSIL,22,6520,2482,9002
BAHAWALNAGAR DISTRICT,HAROONABAD TEHSIL,23,6353,2597,8950
BAHAWALNAGAR DISTRICT,HAROONABAD TEHSIL,24,6094,2422,8516
BAHAWALNAGAR DISTRICT,HAROONABAD TEHSIL,25,5414,1967,7381
BAHAWALNAGAR DISTRICT,HAROONABAD TEHSIL,26,5803,2392,8195
BAHAWALNAGAR DISTRICT,HAROONABAD TEHSIL,27,5858,2224,8082
BAHAWALNAGAR DISTRICT,HAROONABAD TEHSIL,28,5492,2113,7605
BAHAWALNAGAR DISTRICT,HAROONABAD TEHSIL,29,5971,2409,8380
BAHAWALNAGAR DISTRICT,HAROONABAD TEHSIL,30,5067,1806,6873
BAHAWALNAGAR DISTRICT,HAROONABAD TEHSIL,31,5800,2268,8068
BAHAWALNAGAR DISTRICT,HAROONABAD TEHSIL,32,4996,1919,6915
BAHAWALNAGAR DISTRICT,HAROONABAD TEHSIL,33,5018,1795,6813
BAHAWALNAGAR DISTRICT,HAROONABAD TEHSIL,34,5112,1911,7023
BAHAWALNAGAR DISTRICT,HAROONABAD TEHSIL,35,3948,1378,5326
BAHAWALNAGAR DISTRICT,HAROONABAD TEHSIL,36,4801,1890,6691
BAHAWALNAGAR DISTRICT,HAROONABAD TEHSIL,37,4730,1698,6428
BAHAWALNAGAR DISTRICT,HAROONABAD TEHSIL,38,4157,1705,5862
BAHAWALNAGAR DISTRICT,HAROONABAD TEHSIL,39,4525,1680,6205
BAHAWALNAGAR DISTRICT,HAROONABAD TEHSIL,40,3222,1336,4558
BAHAWALNAGAR DISTRICT,HAROONABAD TEHSIL,41,4367,1767,6134
BAHAWALNAGAR DISTRICT,HAROONABAD TEHSIL,42,3694,1610,5304
BAHAWALNAGAR DISTRICT,HAROONABAD TEHSIL,43,3601,1488,5089
BAHAWALNAGAR DISTRICT,HAROONABAD TEHSIL,44,3638,1556,5194
BAHAWALNAGAR DISTRICT,HAROONABAD TEHSIL,45,2605,1025,3630
BAHAWALNAGAR DISTRICT,HAROONABAD TEHSIL,46,3768,1493,5261
BAHAWALNAGAR DISTRICT,HAROONABAD TEHSIL,47,3504,1319,4823
BAHAWALNAGAR DISTRICT,HAROONABAD TEHSIL,48,3424,1333,4757
BAHAWALNAGAR DISTRICT,HAROONABAD TEHSIL,49,3561,1404,4965
BAHAWALNAGAR DISTRICT,HAROONABAD TEHSIL,50,2742,1010,3752
BAHAWALNAGAR DISTRICT,HAROONABAD TEHSIL,51,3648,1374,5022
BAHAWALNAGAR DISTRICT,HAROONABAD TEHSIL,52,3222,1232,4454
BAHAWALNAGAR DISTRICT,HAROONABAD TEHSIL,53,3002,1220,4222
BAHAWALNAGAR DISTRICT,HAROONABAD TEHSIL,54,2825,1111,3936
BAHAWALNAGAR DISTRICT,HAROONABAD TEHSIL,55,1970,782,2752
BAHAWALNAGAR DISTRICT,HAROONABAD TEHSIL,56,2484,872,3356
BAHAWALNAGAR DISTRICT,HAROONABAD TEHSIL,57,2183,675,2858
BAHAWALNAGAR DISTRICT,HAROONABAD TEHSIL,58,2003,765,2768
BAHAWALNAGAR DISTRICT,HAROONABAD TEHSIL,59,2135,764,2899
BAHAWALNAGAR DISTRICT,HAROONABAD TEHSIL,60,1658,550,2208
BAHAWALNAGAR DISTRICT,HAROONABAD TEHSIL,61,2166,797,2963
BAHAWALNAGAR DISTRICT,HAROONABAD TEHSIL,62,2098,677,2775
BAHAWALNAGAR DISTRICT,HAROONABAD TEHSIL,63,1864,628,2492
BAHAWALNAGAR DISTRICT,HAROONABAD TEHSIL,64,1825,522,2347
BAHAWALNAGAR DISTRICT,HAROONABAD TEHSIL,65,1405,406,1811
BAHAWALNAGAR DISTRICT,HAROONABAD TEHSIL,66,1662,468,2130
BAHAWALNAGAR DISTRICT,HAROONABAD TEHSIL,67,1435,408,1843
BAHAWALNAGAR DISTRICT,HAROONABAD TEHSIL,68,1436,439,1875
BAHAWALNAGAR DISTRICT,HAROONABAD TEHSIL,69,1369,389,1758
BAHAWALNAGAR DISTRICT,HAROONABAD TEHSIL,70,1109,307,1416
BAHAWALNAGAR DISTRICT,HAROONABAD TEHSIL,71,1357,387,1744
BAHAWALNAGAR DISTRICT,HAROONABAD TEHSIL,72,1150,349,1499
BAHAWALNAGAR DISTRICT,HAROONABAD TEHSIL,73,1010,286,1296
BAHAWALNAGAR DISTRICT,HAROONABAD TEHSIL,74,833,245,1078
BAHAWALNAGAR DISTRICT,HAROONABAD TEHSIL,>=75,6718,1874,8592
BAHAWALNAGAR DISTRICT,MINCHINABAD TEHSIL,<1,10619,1680,12299
BAHAWALNAGAR DISTRICT,MINCHINABAD TEHSIL,1,12794,1953,14747
BAHAWALNAGAR DISTRICT,MINCHINABAD TEHSIL,2,13463,1913,15376
BAHAWALNAGAR DISTRICT,MINCHINABAD TEHSIL,3,14228,2102,16330
BAHAWALNAGAR DISTRICT,MINCHINABAD TEHSIL,4,15473,2099,17572
BAHAWALNAGAR DISTRICT,MINCHINABAD TEHSIL,5,14349,2053,16402
BAHAWALNAGAR DISTRICT,MINCHINABAD TEHSIL,6,14047,2100,16147
BAHAWALNAGAR DISTRICT,MINCHINABAD TEHSIL,7,15377,2207,17584
BAHAWALNAGAR DISTRICT,MINCHINABAD TEHSIL,8,14797,2037,16834
BAHAWALNAGAR DISTRICT,MINCHINABAD TEHSIL,9,13372,2139,15511
BAHAWALNAGAR DISTRICT,MINCHINABAD TEHSIL,10,13178,1882,15060
BAHAWALNAGAR DISTRICT,MINCHINABAD TEHSIL,11,10909,1936,12845
BAHAWALNAGAR DISTRICT,MINCHINABAD TEHSIL,12,10930,1575,12505
BAHAWALNAGAR DISTRICT,MINCHINABAD TEHSIL,13,9033,1732,10765
BAHAWALNAGAR DISTRICT,MINCHINABAD TEHSIL,14,9441,1596,11037
BAHAWALNAGAR DISTRICT,MINCHINABAD TEHSIL,15,8871,1550,10421
BAHAWALNAGAR DISTRICT,MINCHINABAD TEHSIL,16,8828,1548,10376
BAHAWALNAGAR DISTRICT,MINCHINABAD TEHSIL,17,8038,1504,9542
BAHAWALNAGAR DISTRICT,MINCHINABAD TEHSIL,18,8975,1409,10384
BAHAWALNAGAR DISTRICT,MINCHINABAD TEHSIL,19,7654,1475,9129
BAHAWALNAGAR DISTRICT,MINCHINABAD TEHSIL,20,8739,1333,10072
BAHAWALNAGAR DISTRICT,MINCHINABAD TEHSIL,21,6841,1377,8218
BAHAWALNAGAR DISTRICT,MINCHINABAD TEHSIL,22,7355,1291,8646
BAHAWALNAGAR DISTRICT,MINCHINABAD TEHSIL,23,6138,1200,7338
BAHAWALNAGAR DISTRICT,MINCHINABAD TEHSIL,24,6048,1163,7211
BAHAWALNAGAR DISTRICT,MINCHINABAD TEHSIL,25,7044,1127,8171
BAHAWALNAGAR DISTRICT,MINCHINABAD TEHSIL,26,6226,1060,7286
BAHAWALNAGAR DISTRICT,MINCHINABAD TEHSIL,27,5895,1122,7017
BAHAWALNAGAR DISTRICT,MINCHINABAD TEHSIL,28,6460,1073,7533
BAHAWALNAGAR DISTRICT,MINCHINABAD TEHSIL,29,6730,1142,7872
BAHAWALNAGAR DISTRICT,MINCHINABAD TEHSIL,30,6711,999,7710
BAHAWALNAGAR DISTRICT,MINCHINABAD TEHSIL,31,6518,1045,7563
BAHAWALNAGAR DISTRICT,MINCHINABAD TEHSIL,32,5749,971,6720
BAHAWALNAGAR DISTRICT,MINCHINABAD TEHSIL,33,5328,942,6270
BAHAWALNAGAR DISTRICT,MINCHINABAD TEHSIL,34,5388,949,6337
BAHAWALNAGAR DISTRICT,MINCHINABAD TEHSIL,35,5162,769,5931
BAHAWALNAGAR DISTRICT,MINCHINABAD TEHSIL,36,5664,806,6470
BAHAWALNAGAR DISTRICT,MINCHINABAD TEHSIL,37,5274,780,6054
BAHAWALNAGAR DISTRICT,MINCHINABAD TEHSIL,38,4714,730,5444
BAHAWALNAGAR DISTRICT,MINCHINABAD TEHSIL,39,4879,844,5723
BAHAWALNAGAR DISTRICT,MINCHINABAD TEHSIL,40,4209,687,4896
BAHAWALNAGAR DISTRICT,MINCHINABAD TEHSIL,41,4650,716,5366
BAHAWALNAGAR DISTRICT,MINCHINABAD TEHSIL,42,4139,671,4810
BAHAWALNAGAR DISTRICT,MINCHINABAD TEHSIL,43,3586,653,4239
BAHAWALNAGAR DISTRICT,MINCHINABAD TEHSIL,44,3754,668,4422
BAHAWALNAGAR DISTRICT,MINCHINABAD TEHSIL,45,3355,570,3925
BAHAWALNAGAR DISTRICT,MINCHINABAD TEHSIL,46,4140,698,4838
BAHAWALNAGAR DISTRICT,MINCHINABAD TEHSIL,47,3826,586,4412
BAHAWALNAGAR DISTRICT,MINCHINABAD TEHSIL,48,3739,616,4355
BAHAWALNAGAR DISTRICT,MINCHINABAD TEHSIL,49,3856,626,4482
BAHAWALNAGAR DISTRICT,MINCHINABAD TEHSIL,50,3348,527,3875
BAHAWALNAGAR DISTRICT,MINCHINABAD TEHSIL,51,3975,658,4633
BAHAWALNAGAR DISTRICT,MINCHINABAD TEHSIL,52,3309,561,3870
BAHAWALNAGAR DISTRICT,MINCHINABAD TEHSIL,53,3034,553,3587
BAHAWALNAGAR DISTRICT,MINCHINABAD TEHSIL,54,2569,497,3066
BAHAWALNAGAR DISTRICT,MINCHINABAD TEHSIL,55,2312,349,2661
BAHAWALNAGAR DISTRICT,MINCHINABAD TEHSIL,56,2402,395,2797
BAHAWALNAGAR DISTRICT,MINCHINABAD TEHSIL,57,2039,367,2406
BAHAWALNAGAR DISTRICT,MINCHINABAD TEHSIL,58,1797,299,2096
BAHAWALNAGAR DISTRICT,MINCHINABAD TEHSIL,59,1773,350,2123
BAHAWALNAGAR DISTRICT,MINCHINABAD TEHSIL,60,1812,241,2053
BAHAWALNAGAR DISTRICT,MINCHINABAD TEHSIL,61,2102,337,2439
BAHAWALNAGAR DISTRICT,MINCHINABAD TEHSIL,62,1889,274,2163
BAHAWALNAGAR DISTRICT,MINCHINABAD TEHSIL,63,1623,284,1907
BAHAWALNAGAR DISTRICT,MINCHINABAD TEHSIL,64,1652,287,1939
BAHAWALNAGAR DISTRICT,MINCHINABAD TEHSIL,65,1681,206,1887
BAHAWALNAGAR DISTRICT,MINCHINABAD TEHSIL,66,1712,219,1931
BAHAWALNAGAR DISTRICT,MINCHINABAD TEHSIL,67,1578,205,1783
BAHAWALNAGAR DISTRICT,MINCHINABAD TEHSIL,68,1554,210,1764
BAHAWALNAGAR DISTRICT,MINCHINABAD TEHSIL,69,1330,168,1498
BAHAWALNAGAR DISTRICT,MINCHINABAD TEHSIL,70,1303,165,1468
BAHAWALNAGAR DISTRICT,MINCHINABAD TEHSIL,71,1374,181,1555
BAHAWALNAGAR DISTRICT,MINCHINABAD TEHSIL,72,1287,160,1447
BAHAWALNAGAR DISTRICT,MINCHINABAD TEHSIL,73,1083,152,1235
BAHAWALNAGAR DISTRICT,MINCHINABAD TEHSIL,74,855,115,970
BAHAWALNAGAR DISTRICT,MINCHINABAD TEHSIL,>=75,6837,830,7667
BAHAWALPUR DISTRICT,AHMADPUR EAST TEHSIL,<1,23664,4138,27802
BAHAWALPUR DISTRICT,AHMADPUR EAST TEHSIL,1,25666,4409,30075
BAHAWALPUR DISTRICT,AHMADPUR EAST TEHSIL,2,27873,4376,32249
BAHAWALPUR DISTRICT,AHMADPUR EAST TEHSIL,3,31440,4774,36214
BAHAWALPUR DISTRICT,AHMADPUR EAST TEHSIL,4,32550,4813,37363
BAHAWALPUR DISTRICT,AHMADPUR EAST TEHSIL,5,31594,4710,36304
BAHAWALPUR DISTRICT,AHMADPUR EAST TEHSIL,6,29693,4614,34307
BAHAWALPUR DISTRICT,AHMADPUR EAST TEHSIL,7,33062,5079,38141
BAHAWALPUR DISTRICT,AHMADPUR EAST TEHSIL,8,32811,4504,37315
BAHAWALPUR DISTRICT,AHMADPUR EAST TEHSIL,9,27759,4785,32544
BAHAWALPUR DISTRICT,AHMADPUR EAST TEHSIL,10,28356,4126,32482
BAHAWALPUR DISTRICT,AHMADPUR EAST TEHSIL,11,20640,4666,25306
BAHAWALPUR DISTRICT,AHMADPUR EAST TEHSIL,12,23317,4008,27325
BAHAWALPUR DISTRICT,AHMADPUR EAST TEHSIL,13,17775,4253,22028
BAHAWALPUR DISTRICT,AHMADPUR EAST TEHSIL,14,18054,3792,21846
BAHAWALPUR DISTRICT,AHMADPUR EAST TEHSIL,15,17095,3825,20920
BAHAWALPUR DISTRICT,AHMADPUR EAST TEHSIL,16,16656,3567,20223
BAHAWALPUR DISTRICT,AHMADPUR EAST TEHSIL,17,14346,3451,17797
BAHAWALPUR DISTRICT,AHMADPUR EAST TEHSIL,18,19507,3657,23164
BAHAWALPUR DISTRICT,AHMADPUR EAST TEHSIL,19,15518,3677,19195
BAHAWALPUR DISTRICT,AHMADPUR EAST TEHSIL,20,18780,3409,22189
BAHAWALPUR DISTRICT,AHMADPUR EAST TEHSIL,21,13768,3475,17243
BAHAWALPUR DISTRICT,AHMADPUR EAST TEHSIL,22,15139,3214,18353
BAHAWALPUR DISTRICT,AHMADPUR EAST TEHSIL,23,12165,3150,15315
BAHAWALPUR DISTRICT,AHMADPUR EAST TEHSIL,24,12223,2963,15186
BAHAWALPUR DISTRICT,AHMADPUR EAST TEHSIL,25,15979,2974,18953
BAHAWALPUR DISTRICT,AHMADPUR EAST TEHSIL,26,12521,2959,15480
BAHAWALPUR DISTRICT,AHMADPUR EAST TEHSIL,27,12814,3102,15916
BAHAWALPUR DISTRICT,AHMADPUR EAST TEHSIL,28,12950,2865,15815
BAHAWALPUR DISTRICT,AHMADPUR EAST TEHSIL,29,13046,3067,16113
BAHAWALPUR DISTRICT,AHMADPUR EAST TEHSIL,30,12996,2624,15620
BAHAWALPUR DISTRICT,AHMADPUR EAST TEHSIL,31,11942,2702,14644
BAHAWALPUR DISTRICT,AHMADPUR EAST TEHSIL,32,10678,2477,13155
BAHAWALPUR DISTRICT,AHMADPUR EAST TEHSIL,33,9605,2331,11936
BAHAWALPUR DISTRICT,AHMADPUR EAST TEHSIL,34,9788,2341,12129
BAHAWALPUR DISTRICT,AHMADPUR EAST TEHSIL,35,10661,2121,12782
BAHAWALPUR DISTRICT,AHMADPUR EAST TEHSIL,36,11306,2269,13575
BAHAWALPUR DISTRICT,AHMADPUR EAST TEHSIL,37,11118,2263,13381
BAHAWALPUR DISTRICT,AHMADPUR EAST TEHSIL,38,9132,2059,11191
BAHAWALPUR DISTRICT,AHMADPUR EAST TEHSIL,39,9173,2108,11281
BAHAWALPUR DISTRICT,AHMADPUR EAST TEHSIL,40,8302,1789,10091
BAHAWALPUR DISTRICT,AHMADPUR EAST TEHSIL,41,9283,1869,11152
BAHAWALPUR DISTRICT,AHMADPUR EAST TEHSIL,42,8658,1751,10409
BAHAWALPUR DISTRICT,AHMADPUR EAST TEHSIL,43,6454,1638,8092
BAHAWALPUR DISTRICT,AHMADPUR EAST TEHSIL,44,6527,1564,8091
BAHAWALPUR DISTRICT,AHMADPUR EAST TEHSIL,45,6355,1484,7839
BAHAWALPUR DISTRICT,AHMADPUR EAST TEHSIL,46,7274,1446,8720
BAHAWALPUR DISTRICT,AHMADPUR EAST TEHSIL,47,7342,1472,8814
BAHAWALPUR DISTRICT,AHMADPUR EAST TEHSIL,48,5989,1409,7398
BAHAWALPUR DISTRICT,AHMADPUR EAST TEHSIL,49,6001,1497,7498
BAHAWALPUR DISTRICT,AHMADPUR EAST TEHSIL,50,6058,1302,7360
BAHAWALPUR DISTRICT,AHMADPUR EAST TEHSIL,51,6147,1333,7480
BAHAWALPUR DISTRICT,AHMADPUR EAST TEHSIL,52,5526,1249,6775
BAHAWALPUR DISTRICT,AHMADPUR EAST TEHSIL,53,4474,1226,5700
BAHAWALPUR DISTRICT,AHMADPUR EAST TEHSIL,54,3978,1046,5024
BAHAWALPUR DISTRICT,AHMADPUR EAST TEHSIL,55,4026,950,4976
BAHAWALPUR DISTRICT,AHMADPUR EAST TEHSIL,56,4092,922,5014
BAHAWALPUR DISTRICT,AHMADPUR EAST TEHSIL,57,4334,846,5180
BAHAWALPUR DISTRICT,AHMADPUR EAST TEHSIL,58,3197,827,4024
BAHAWALPUR DISTRICT,AHMADPUR EAST TEHSIL,59,3399,815,4214
BAHAWALPUR DISTRICT,AHMADPUR EAST TEHSIL,60,3964,841,4805
BAHAWALPUR DISTRICT,AHMADPUR EAST TEHSIL,61,3892,927,4819
BAHAWALPUR DISTRICT,AHMADPUR EAST TEHSIL,62,3452,801,4253
BAHAWALPUR DISTRICT,AHMADPUR EAST TEHSIL,63,3178,755,3933
BAHAWALPUR DISTRICT,AHMADPUR EAST TEHSIL,64,2895,658,3553
BAHAWALPUR DISTRICT,AHMADPUR EAST TEHSIL,65,3113,585,3698
BAHAWALPUR DISTRICT,AHMADPUR EAST TEHSIL,66,3352,548,3900
BAHAWALPUR DISTRICT,AHMADPUR EAST TEHSIL,67,2868,532,3400
BAHAWALPUR DISTRICT,AHMADPUR EAST TEHSIL,68,2207,485,2692
BAHAWALPUR DISTRICT,AHMADPUR EAST TEHSIL,69,2101,397,2498
BAHAWALPUR DISTRICT,AHMADPUR EAST TEHSIL,70,2384,392,2776
BAHAWALPUR DISTRICT,AHMADPUR EAST TEHSIL,71,2395,406,2801
BAHAWALPUR DISTRICT,AHMADPUR EAST TEHSIL,72,1828,343,2171
BAHAWALPUR DISTRICT,AHMADPUR EAST TEHSIL,73,1603,324,1927
BAHAWALPUR DISTRICT,AHMADPUR EAST TEHSIL,74,1321,218,1539
BAHAWALPUR DISTRICT,AHMADPUR EAST TEHSIL,>=75,11347,1766,13113
BAHAWALPUR DISTRICT,BAHAWALPUR CITY TEHSIL,<1,0,15614,15614
BAHAWALPUR DISTRICT,BAHAWALPUR CITY TEHSIL,1,0,16662,16662
BAHAWALPUR DISTRICT,BAHAWALPUR CITY TEHSIL,2,0,16365,16365
BAHAWALPUR DISTRICT,BAHAWALPUR CITY TEHSIL,3,0,18195,18195
BAHAWALPUR DISTRICT,BAHAWALPUR CITY TEHSIL,4,0,17681,17681
BAHAWALPUR DISTRICT,BAHAWALPUR CITY TEHSIL,5,0,17381,17381
BAHAWALPUR DISTRICT,BAHAWALPUR CITY TEHSIL,6,0,16870,16870
BAHAWALPUR DISTRICT,BAHAWALPUR CITY TEHSIL,7,0,18553,18553
BAHAWALPUR DISTRICT,BAHAWALPUR CITY TEHSIL,8,0,16930,16930
BAHAWALPUR DISTRICT,BAHAWALPUR CITY TEHSIL,9,0,17905,17905
BAHAWALPUR DISTRICT,BAHAWALPUR CITY TEHSIL,10,0,15576,15576
BAHAWALPUR DISTRICT,BAHAWALPUR CITY TEHSIL,11,0,16479,16479
BAHAWALPUR DISTRICT,BAHAWALPUR CITY TEHSIL,12,0,14880,14880
BAHAWALPUR DISTRICT,BAHAWALPUR CITY TEHSIL,13,0,15011,15011
BAHAWALPUR DISTRICT,BAHAWALPUR CITY TEHSIL,14,0,14079,14079
BAHAWALPUR DISTRICT,BAHAWALPUR CITY TEHSIL,15,0,14170,14170
BAHAWALPUR DISTRICT,BAHAWALPUR CITY TEHSIL,16,0,14398,14398
BAHAWALPUR DISTRICT,BAHAWALPUR CITY TEHSIL,17,0,14916,14916
BAHAWALPUR DISTRICT,BAHAWALPUR CITY TEHSIL,18,0,14887,14887
BAHAWALPUR DISTRICT,BAHAWALPUR CITY TEHSIL,19,0,15578,15578
BAHAWALPUR DISTRICT,BAHAWALPUR CITY TEHSIL,20,0,14310,14310
BAHAWALPUR DISTRICT,BAHAWALPUR CITY TEHSIL,21,0,15295,15295
BAHAWALPUR DISTRICT,BAHAWALPUR CITY TEHSIL,22,0,14176,14176
BAHAWALPUR DISTRICT,BAHAWALPUR CITY TEHSIL,23,0,13293,13293
BAHAWALPUR DISTRICT,BAHAWALPUR CITY TEHSIL,24,0,12287,12287
BAHAWALPUR DISTRICT,BAHAWALPUR CITY TEHSIL,25,0,11448,11448
BAHAWALPUR DISTRICT,BAHAWALPUR CITY TEHSIL,26,0,11739,11739
BAHAWALPUR DISTRICT,BAHAWALPUR CITY TEHSIL,27,0,11303,11303
BAHAWALPUR DISTRICT,BAHAWALPUR CITY TEHSIL,28,0,11390,11390
BAHAWALPUR DISTRICT,BAHAWALPUR CITY TEHSIL,29,0,11207,11207
BAHAWALPUR DISTRICT,BAHAWALPUR CITY TEHSIL,30,0,10648,10648
BAHAWALPUR DISTRICT,BAHAWALPUR CITY TEHSIL,31,0,10399,10399
BAHAWALPUR DISTRICT,BAHAWALPUR CITY TEHSIL,32,0,9692,9692
BAHAWALPUR DISTRICT,BAHAWALPUR CITY TEHSIL,33,0,9403,9403
BAHAWALPUR DISTRICT,BAHAWALPUR CITY TEHSIL,34,0,8866,8866
BAHAWALPUR DISTRICT,BAHAWALPUR CITY TEHSIL,35,0,8810,8810
BAHAWALPUR DISTRICT,BAHAWALPUR CITY TEHSIL,36,0,8766,8766
BAHAWALPUR DISTRICT,BAHAWALPUR CITY TEHSIL,37,0,7632,7632
BAHAWALPUR DISTRICT,BAHAWALPUR CITY TEHSIL,38,0,8694,8694
BAHAWALPUR DISTRICT,BAHAWALPUR CITY TEHSIL,39,0,7912,7912
BAHAWALPUR DISTRICT,BAHAWALPUR CITY TEHSIL,40,0,7845,7845
BAHAWALPUR DISTRICT,BAHAWALPUR CITY TEHSIL,41,0,7365,7365
BAHAWALPUR DISTRICT,BAHAWALPUR CITY TEHSIL,42,0,6795,6795
BAHAWALPUR DISTRICT,BAHAWALPUR CITY TEHSIL,43,0,6545,6545
BAHAWALPUR DISTRICT,BAHAWALPUR CITY TEHSIL,44,0,6187,6187
BAHAWALPUR DISTRICT,BAHAWALPUR CITY TEHSIL,45,0,6024,6024
BAHAWALPUR DISTRICT,BAHAWALPUR CITY TEHSIL,46,0,5817,5817
BAHAWALPUR DISTRICT,BAHAWALPUR CITY TEHSIL,47,0,5150,5150
BAHAWALPUR DISTRICT,BAHAWALPUR CITY TEHSIL,48,0,6013,6013
BAHAWALPUR DISTRICT,BAHAWALPUR CITY TEHSIL,49,0,5711,5711
BAHAWALPUR DISTRICT,BAHAWALPUR CITY TEHSIL,50,0,5769,5769
BAHAWALPUR DISTRICT,BAHAWALPUR CITY TEHSIL,51,0,5376,5376
BAHAWALPUR DISTRICT,BAHAWALPUR CITY TEHSIL,52,0,5070,5070
BAHAWALPUR DISTRICT,BAHAWALPUR CITY TEHSIL,53,0,4907,4907
BAHAWALPUR DISTRICT,BAHAWALPUR CITY TEHSIL,54,0,4404,4404
BAHAWALPUR DISTRICT,BAHAWALPUR CITY TEHSIL,55,0,3953,3953
BAHAWALPUR DISTRICT,BAHAWALPUR CITY TEHSIL,56,0,3764,3764
BAHAWALPUR DISTRICT,BAHAWALPUR CITY TEHSIL,57,0,3135,3135
BAHAWALPUR DISTRICT,BAHAWALPUR CITY TEHSIL,58,0,3371,3371
BAHAWALPUR DISTRICT,BAHAWALPUR CITY TEHSIL,59,0,3040,3040
BAHAWALPUR DISTRICT,BAHAWALPUR CITY TEHSIL,60,0,3200,3200
BAHAWALPUR DISTRICT,BAHAWALPUR CITY TEHSIL,61,0,2999,2999
BAHAWALPUR DISTRICT,BAHAWALPUR CITY TEHSIL,62,0,2868,2868
BAHAWALPUR DISTRICT,BAHAWALPUR CITY TEHSIL,63,0,2862,2862
BAHAWALPUR DISTRICT,BAHAWALPUR CITY TEHSIL,64,0,2355,2355
BAHAWALPUR DISTRICT,BAHAWALPUR CITY TEHSIL,65,0,2300,2300
BAHAWALPUR DISTRICT,BAHAWALPUR CITY TEHSIL,66,0,1744,1744
BAHAWALPUR DISTRICT,BAHAWALPUR CITY TEHSIL,67,0,1602,1602
BAHAWALPUR DISTRICT,BAHAWALPUR CITY TEHSIL,68,0,1717,1717
BAHAWALPUR DISTRICT,BAHAWALPUR CITY TEHSIL,69,0,1501,1501
BAHAWALPUR DISTRICT,BAHAWALPUR CITY TEHSIL,70,0,1483,1483
BAHAWALPUR DISTRICT,BAHAWALPUR CITY TEHSIL,71,0,1319,1319
BAHAWALPUR DISTRICT,BAHAWALPUR CITY TEHSIL,72,0,1291,1291
BAHAWALPUR DISTRICT,BAHAWALPUR CITY TEHSIL,73,0,1235,1235
BAHAWALPUR DISTRICT,BAHAWALPUR CITY TEHSIL,74,0,929,929
BAHAWALPUR DISTRICT,BAHAWALPUR CITY TEHSIL,>=75,0,7070,7070
BAHAWALPUR DISTRICT,BAHAWALPUR SADDAR TEHSIL,<1,12287,2436,14723
BAHAWALPUR DISTRICT,BAHAWALPUR SADDAR TEHSIL,1,12851,2506,15357
BAHAWALPUR DISTRICT,BAHAWALPUR SADDAR TEHSIL,2,12925,2473,15398
BAHAWALPUR DISTRICT,BAHAWALPUR SADDAR TEHSIL,3,14452,2769,17221
BAHAWALPUR DISTRICT,BAHAWALPUR SADDAR TEHSIL,4,14448,2745,17193
BAHAWALPUR DISTRICT,BAHAWALPUR SADDAR TEHSIL,5,14459,2727,17186
BAHAWALPUR DISTRICT,BAHAWALPUR SADDAR TEHSIL,6,13594,2596,16190
BAHAWALPUR DISTRICT,BAHAWALPUR SADDAR TEHSIL,7,14855,2884,17739
BAHAWALPUR DISTRICT,BAHAWALPUR SADDAR TEHSIL,8,14520,2698,17218
BAHAWALPUR DISTRICT,BAHAWALPUR SADDAR TEHSIL,9,13595,2714,16309
BAHAWALPUR DISTRICT,BAHAWALPUR SADDAR TEHSIL,10,12914,2419,15333
BAHAWALPUR DISTRICT,BAHAWALPUR SADDAR TEHSIL,11,11168,2596,13764
BAHAWALPUR DISTRICT,BAHAWALPUR SADDAR TEHSIL,12,11256,2234,13490
BAHAWALPUR DISTRICT,BAHAWALPUR SADDAR TEHSIL,13,10060,2354,12414
BAHAWALPUR DISTRICT,BAHAWALPUR SADDAR TEHSIL,14,9693,2067,11760
BAHAWALPUR DISTRICT,BAHAWALPUR SADDAR TEHSIL,15,9525,2037,11562
BAHAWALPUR DISTRICT,BAHAWALPUR SADDAR TEHSIL,16,9466,2002,11468
BAHAWALPUR DISTRICT,BAHAWALPUR SADDAR TEHSIL,17,8718,2084,10802
BAHAWALPUR DISTRICT,BAHAWALPUR SADDAR TEHSIL,18,9740,1833,11573
BAHAWALPUR DISTRICT,BAHAWALPUR SADDAR TEHSIL,19,8847,1916,10763
BAHAWALPUR DISTRICT,BAHAWALPUR SADDAR TEHSIL,20,9502,1920,11422
BAHAWALPUR DISTRICT,BAHAWALPUR SADDAR TEHSIL,21,7909,2007,9916
BAHAWALPUR DISTRICT,BAHAWALPUR SADDAR TEHSIL,22,8396,2082,10478
BAHAWALPUR DISTRICT,BAHAWALPUR SADDAR TEHSIL,23,7409,2264,9673
BAHAWALPUR DISTRICT,BAHAWALPUR SADDAR TEHSIL,24,6888,2121,9009
BAHAWALPUR DISTRICT,BAHAWALPUR SADDAR TEHSIL,25,8171,2123,10294
BAHAWALPUR DISTRICT,BAHAWALPUR SADDAR TEHSIL,26,6740,2354,9094
BAHAWALPUR DISTRICT,BAHAWALPUR SADDAR TEHSIL,27,6944,2305,9249
BAHAWALPUR DISTRICT,BAHAWALPUR SADDAR TEHSIL,28,7272,2318,9590
BAHAWALPUR DISTRICT,BAHAWALPUR SADDAR TEHSIL,29,7173,2572,9745
BAHAWALPUR DISTRICT,BAHAWALPUR SADDAR TEHSIL,30,6983,1855,8838
BAHAWALPUR DISTRICT,BAHAWALPUR SADDAR TEHSIL,31,6671,2403,9074
BAHAWALPUR DISTRICT,BAHAWALPUR SADDAR TEHSIL,32,5969,2009,7978
BAHAWALPUR DISTRICT,BAHAWALPUR SADDAR TEHSIL,33,5665,1938,7603
BAHAWALPUR DISTRICT,BAHAWALPUR SADDAR TEHSIL,34,5992,1944,7936
BAHAWALPUR DISTRICT,BAHAWALPUR SADDAR TEHSIL,35,6144,1547,7691
BAHAWALPUR DISTRICT,BAHAWALPUR SADDAR TEHSIL,36,6273,1842,8115
BAHAWALPUR DISTRICT,BAHAWALPUR SADDAR TEHSIL,37,5453,1589,7042
BAHAWALPUR DISTRICT,BAHAWALPUR SADDAR TEHSIL,38,5368,1720,7088
BAHAWALPUR DISTRICT,BAHAWALPUR SADDAR TEHSIL,39,5352,1500,6852
BAHAWALPUR DISTRICT,BAHAWALPUR SADDAR TEHSIL,40,4559,1201,5760
BAHAWALPUR DISTRICT,BAHAWALPUR SADDAR TEHSIL,41,4891,1249,6140
BAHAWALPUR DISTRICT,BAHAWALPUR SADDAR TEHSIL,42,4287,1129,5416
BAHAWALPUR DISTRICT,BAHAWALPUR SADDAR TEHSIL,43,3810,1070,4880
BAHAWALPUR DISTRICT,BAHAWALPUR SADDAR TEHSIL,44,3831,998,4829
BAHAWALPUR DISTRICT,BAHAWALPUR SADDAR TEHSIL,45,3606,844,4450
BAHAWALPUR DISTRICT,BAHAWALPUR SADDAR TEHSIL,46,3807,849,4656
BAHAWALPUR DISTRICT,BAHAWALPUR SADDAR TEHSIL,47,3664,773,4437
BAHAWALPUR DISTRICT,BAHAWALPUR SADDAR TEHSIL,48,3538,861,4399
BAHAWALPUR DISTRICT,BAHAWALPUR SADDAR TEHSIL,49,3519,837,4356
BAHAWALPUR DISTRICT,BAHAWALPUR SADDAR TEHSIL,50,3473,646,4119
BAHAWALPUR DISTRICT,BAHAWALPUR SADDAR TEHSIL,51,3601,778,4379
BAHAWALPUR DISTRICT,BAHAWALPUR SADDAR TEHSIL,52,3163,617,3780
BAHAWALPUR DISTRICT,BAHAWALPUR SADDAR TEHSIL,53,2890,611,3501
BAHAWALPUR DISTRICT,BAHAWALPUR SADDAR TEHSIL,54,2509,502,3011
BAHAWALPUR DISTRICT,BAHAWALPUR SADDAR TEHSIL,55,2371,458,2829
BAHAWALPUR DISTRICT,BAHAWALPUR SADDAR TEHSIL,56,2231,457,2688
BAHAWALPUR DISTRICT,BAHAWALPUR SADDAR TEHSIL,57,1903,348,2251
BAHAWALPUR DISTRICT,BAHAWALPUR SADDAR TEHSIL,58,1864,403,2267
BAHAWALPUR DISTRICT,BAHAWALPUR SADDAR TEHSIL,59,1862,369,2231
BAHAWALPUR DISTRICT,BAHAWALPUR SADDAR TEHSIL,60,1947,335,2282
BAHAWALPUR DISTRICT,BAHAWALPUR SADDAR TEHSIL,61,2148,406,2554
BAHAWALPUR DISTRICT,BAHAWALPUR SADDAR TEHSIL,62,1891,324,2215
BAHAWALPUR DISTRICT,BAHAWALPUR SADDAR TEHSIL,63,1823,354,2177
BAHAWALPUR DISTRICT,BAHAWALPUR SADDAR TEHSIL,64,1573,301,1874
BAHAWALPUR DISTRICT,BAHAWALPUR SADDAR TEHSIL,65,1555,219,1774
BAHAWALPUR DISTRICT,BAHAWALPUR SADDAR TEHSIL,66,1493,222,1715
BAHAWALPUR DISTRICT,BAHAWALPUR SADDAR TEHSIL,67,1435,222,1657
BAHAWALPUR DISTRICT,BAHAWALPUR SADDAR TEHSIL,68,1290,226,1516
BAHAWALPUR DISTRICT,BAHAWALPUR SADDAR TEHSIL,69,1145,176,1321
BAHAWALPUR DISTRICT,BAHAWALPUR SADDAR TEHSIL,70,1148,182,1330
BAHAWALPUR DISTRICT,BAHAWALPUR SADDAR TEHSIL,71,1055,157,1212
BAHAWALPUR DISTRICT,BAHAWALPUR SADDAR TEHSIL,72,1029,179,1208
BAHAWALPUR DISTRICT,BAHAWALPUR SADDAR TEHSIL,73,923,151,1074
BAHAWALPUR DISTRICT,BAHAWALPUR SADDAR TEHSIL,74,722,108,830
BAHAWALPUR DISTRICT,BAHAWALPUR SADDAR TEHSIL,>=75,5735,883,6618
BAHAWALPUR DISTRICT,HASILPUR TEHSIL,<1,8913,3092,12005
BAHAWALPUR DISTRICT,HASILPUR TEHSIL,1,9871,3254,13125
BAHAWALPUR DISTRICT,HASILPUR TEHSIL,2,9200,2874,12074
BAHAWALPUR DISTRICT,HASILPUR TEHSIL,3,9899,3053,12952
BAHAWALPUR DISTRICT,HASILPUR TEHSIL,4,10260,3214,13474
BAHAWALPUR DISTRICT,HASILPUR TEHSIL,5,9827,3043,12870
BAHAWALPUR DISTRICT,HASILPUR TEHSIL,6,9719,2846,12565
BAHAWALPUR DISTRICT,HASILPUR TEHSIL,7,10242,3227,13469
BAHAWALPUR DISTRICT,HASILPUR TEHSIL,8,9611,2799,12410
BAHAWALPUR DISTRICT,HASILPUR TEHSIL,9,9653,3230,12883
BAHAWALPUR DISTRICT,HASILPUR TEHSIL,10,8798,2611,11409
BAHAWALPUR DISTRICT,HASILPUR TEHSIL,11,8636,3221,11857
BAHAWALPUR DISTRICT,HASILPUR TEHSIL,12,7799,2361,10160
BAHAWALPUR DISTRICT,HASILPUR TEHSIL,13,7562,2854,10416
BAHAWALPUR DISTRICT,HASILPUR TEHSIL,14,7140,2585,9725
BAHAWALPUR DISTRICT,HASILPUR TEHSIL,15,6656,2583,9239
BAHAWALPUR DISTRICT,HASILPUR TEHSIL,16,6808,2438,9246
BAHAWALPUR DISTRICT,HASILPUR TEHSIL,17,6480,2659,9139
BAHAWALPUR DISTRICT,HASILPUR TEHSIL,18,6098,1863,7961
BAHAWALPUR DISTRICT,HASILPUR TEHSIL,19,6136,2418,8554
BAHAWALPUR DISTRICT,HASILPUR TEHSIL,20,6083,2029,8112
BAHAWALPUR DISTRICT,HASILPUR TEHSIL,21,6051,2367,8418
BAHAWALPUR DISTRICT,HASILPUR TEHSIL,22,5670,1968,7638
BAHAWALPUR DISTRICT,HASILPUR TEHSIL,23,5165,2059,7224
BAHAWALPUR DISTRICT,HASILPUR TEHSIL,24,4880,1933,6813
BAHAWALPUR DISTRICT,HASILPUR TEHSIL,25,4643,1556,6199
BAHAWALPUR DISTRICT,HASILPUR TEHSIL,26,5094,1871,6965
BAHAWALPUR DISTRICT,HASILPUR TEHSIL,27,4985,1860,6845
BAHAWALPUR DISTRICT,HASILPUR TEHSIL,28,4888,1667,6555
BAHAWALPUR DISTRICT,HASILPUR TEHSIL,29,5237,1990,7227
BAHAWALPUR DISTRICT,HASILPUR TEHSIL,30,4461,1410,5871
BAHAWALPUR DISTRICT,HASILPUR TEHSIL,31,5116,1963,7079
BAHAWALPUR DISTRICT,HASILPUR TEHSIL,32,4324,1507,5831
BAHAWALPUR DISTRICT,HASILPUR TEHSIL,33,4344,1636,5980
BAHAWALPUR DISTRICT,HASILPUR TEHSIL,34,4561,1618,6179
BAHAWALPUR DISTRICT,HASILPUR TEHSIL,35,3663,1103,4766
BAHAWALPUR DISTRICT,HASILPUR TEHSIL,36,4666,1557,6223
BAHAWALPUR DISTRICT,HASILPUR TEHSIL,37,4082,1399,5481
BAHAWALPUR DISTRICT,HASILPUR TEHSIL,38,3760,1320,5080
BAHAWALPUR DISTRICT,HASILPUR TEHSIL,39,3743,1340,5083
BAHAWALPUR DISTRICT,HASILPUR TEHSIL,40,3098,909,4007
BAHAWALPUR DISTRICT,HASILPUR TEHSIL,41,3735,1374,5109
BAHAWALPUR DISTRICT,HASILPUR TEHSIL,42,3303,1141,4444
BAHAWALPUR DISTRICT,HASILPUR TEHSIL,43,2967,1098,4065
BAHAWALPUR DISTRICT,HASILPUR TEHSIL,44,2883,1180,4063
BAHAWALPUR DISTRICT,HASILPUR TEHSIL,45,2330,724,3054
BAHAWALPUR DISTRICT,HASILPUR TEHSIL,46,3117,1230,4347
BAHAWALPUR DISTRICT,HASILPUR TEHSIL,47,2979,1035,4014
BAHAWALPUR DISTRICT,HASILPUR TEHSIL,48,2847,1034,3881
BAHAWALPUR DISTRICT,HASILPUR TEHSIL,49,3010,1113,4123
BAHAWALPUR DISTRICT,HASILPUR TEHSIL,50,2354,760,3114
BAHAWALPUR DISTRICT,HASILPUR TEHSIL,51,3099,1072,4171
BAHAWALPUR DISTRICT,HASILPUR TEHSIL,52,2645,912,3557
BAHAWALPUR DISTRICT,HASILPUR TEHSIL,53,2542,890,3432
BAHAWALPUR DISTRICT,HASILPUR TEHSIL,54,2201,850,3051
BAHAWALPUR DISTRICT,HASILPUR TEHSIL,55,1720,520,2240
BAHAWALPUR DISTRICT,HASILPUR TEHSIL,56,2004,770,2774
BAHAWALPUR DISTRICT,HASILPUR TEHSIL,57,1666,604,2270
BAHAWALPUR DISTRICT,HASILPUR TEHSIL,58,1628,606,2234
BAHAWALPUR DISTRICT,HASILPUR TEHSIL,59,1620,559,2179
BAHAWALPUR DISTRICT,HASILPUR TEHSIL,60,1478,430,1908
BAHAWALPUR DISTRICT,HASILPUR TEHSIL,61,1990,658,2648
BAHAWALPUR DISTRICT,HASILPUR TEHSIL,62,1662,539,2201
BAHAWALPUR DISTRICT,HASILPUR TEHSIL,63,1514,489,2003
BAHAWALPUR DISTRICT,HASILPUR TEHSIL,64,1411,427,1838
BAHAWALPUR DISTRICT,HASILPUR TEHSIL,65,1178,322,1500
BAHAWALPUR DISTRICT,HASILPUR TEHSIL,66,1521,386,1907
BAHAWALPUR DISTRICT,HASILPUR TEHSIL,67,1278,360,1638
BAHAWALPUR DISTRICT,HASILPUR TEHSIL,68,1128,344,1472
BAHAWALPUR DISTRICT,HASILPUR TEHSIL,69,1076,269,1345
BAHAWALPUR DISTRICT,HASILPUR TEHSIL,70,956,207,1163
BAHAWALPUR DISTRICT,HASILPUR TEHSIL,71,1213,318,1531
BAHAWALPUR DISTRICT,HASILPUR TEHSIL,72,993,266,1259
BAHAWALPUR DISTRICT,HASILPUR TEHSIL,73,788,224,1012
BAHAWALPUR DISTRICT,HASILPUR TEHSIL,74,677,214,891
BAHAWALPUR DISTRICT,HASILPUR TEHSIL,>=75,5412,1401,6813
BAHAWALPUR DISTRICT,KHAIRPUR TAMEWALI TEHSIL,<1,5446,996,6442
BAHAWALPUR DISTRICT,KHAIRPUR TAMEWALI TEHSIL,1,5926,1031,6957
BAHAWALPUR DISTRICT,KHAIRPUR TAMEWALI TEHSIL,2,6235,1078,7313
BAHAWALPUR DISTRICT,KHAIRPUR TAMEWALI TEHSIL,3,6551,1100,7651
BAHAWALPUR DISTRICT,KHAIRPUR TAMEWALI TEHSIL,4,7248,1165,8413
BAHAWALPUR DISTRICT,KHAIRPUR TAMEWALI TEHSIL,5,6893,1110,8003
BAHAWALPUR DISTRICT,KHAIRPUR TAMEWALI TEHSIL,6,6783,1097,7880
BAHAWALPUR DISTRICT,KHAIRPUR TAMEWALI TEHSIL,7,7008,1261,8269
BAHAWALPUR DISTRICT,KHAIRPUR TAMEWALI TEHSIL,8,7252,1082,8334
BAHAWALPUR DISTRICT,KHAIRPUR TAMEWALI TEHSIL,9,6277,1230,7507
BAHAWALPUR DISTRICT,KHAIRPUR TAMEWALI TEHSIL,10,6390,1057,7447
BAHAWALPUR DISTRICT,KHAIRPUR TAMEWALI TEHSIL,11,5244,1157,6401
BAHAWALPUR DISTRICT,KHAIRPUR TAMEWALI TEHSIL,12,5526,978,6504
BAHAWALPUR DISTRICT,KHAIRPUR TAMEWALI TEHSIL,13,4509,1009,5518
BAHAWALPUR DISTRICT,KHAIRPUR TAMEWALI TEHSIL,14,4840,964,5804
BAHAWALPUR DISTRICT,KHAIRPUR TAMEWALI TEHSIL,15,4226,881,5107
BAHAWALPUR DISTRICT,KHAIRPUR TAMEWALI TEHSIL,16,4327,868,5195
BAHAWALPUR DISTRICT,KHAIRPUR TAMEWALI TEHSIL,17,3668,884,4552
BAHAWALPUR DISTRICT,KHAIRPUR TAMEWALI TEHSIL,18,4742,763,5505
BAHAWALPUR DISTRICT,KHAIRPUR TAMEWALI TEHSIL,19,3958,837,4795
BAHAWALPUR DISTRICT,KHAIRPUR TAMEWALI TEHSIL,20,4272,724,4996
BAHAWALPUR DISTRICT,KHAIRPUR TAMEWALI TEHSIL,21,3451,837,4288
BAHAWALPUR DISTRICT,KHAIRPUR TAMEWALI TEHSIL,22,3885,758,4643
BAHAWALPUR DISTRICT,KHAIRPUR TAMEWALI TEHSIL,23,3190,754,3944
BAHAWALPUR DISTRICT,KHAIRPUR TAMEWALI TEHSIL,24,3161,663,3824
BAHAWALPUR DISTRICT,KHAIRPUR TAMEWALI TEHSIL,25,3396,607,4003
BAHAWALPUR DISTRICT,KHAIRPUR TAMEWALI TEHSIL,26,3338,669,4007
BAHAWALPUR DISTRICT,KHAIRPUR TAMEWALI TEHSIL,27,2979,657,3636
BAHAWALPUR DISTRICT,KHAIRPUR TAMEWALI TEHSIL,28,3368,571,3939
BAHAWALPUR DISTRICT,KHAIRPUR TAMEWALI TEHSIL,29,3239,686,3925
BAHAWALPUR DISTRICT,KHAIRPUR TAMEWALI TEHSIL,30,3290,541,3831
BAHAWALPUR DISTRICT,KHAIRPUR TAMEWALI TEHSIL,31,3356,713,4069
BAHAWALPUR DISTRICT,KHAIRPUR TAMEWALI TEHSIL,32,2880,553,3433
BAHAWALPUR DISTRICT,KHAIRPUR TAMEWALI TEHSIL,33,2624,523,3147
BAHAWALPUR DISTRICT,KHAIRPUR TAMEWALI TEHSIL,34,2943,535,3478
BAHAWALPUR DISTRICT,KHAIRPUR TAMEWALI TEHSIL,35,2574,468,3042
BAHAWALPUR DISTRICT,KHAIRPUR TAMEWALI TEHSIL,36,3186,542,3728
BAHAWALPUR DISTRICT,KHAIRPUR TAMEWALI TEHSIL,37,2730,484,3214
BAHAWALPUR DISTRICT,KHAIRPUR TAMEWALI TEHSIL,38,2505,421,2926
BAHAWALPUR DISTRICT,KHAIRPUR TAMEWALI TEHSIL,39,2417,507,2924
BAHAWALPUR DISTRICT,KHAIRPUR TAMEWALI TEHSIL,40,2045,356,2401
BAHAWALPUR DISTRICT,KHAIRPUR TAMEWALI TEHSIL,41,2549,471,3020
BAHAWALPUR DISTRICT,KHAIRPUR TAMEWALI TEHSIL,42,1993,383,2376
BAHAWALPUR DISTRICT,KHAIRPUR TAMEWALI TEHSIL,43,1721,401,2122
BAHAWALPUR DISTRICT,KHAIRPUR TAMEWALI TEHSIL,44,1856,379,2235
BAHAWALPUR DISTRICT,KHAIRPUR TAMEWALI TEHSIL,45,1583,295,1878
BAHAWALPUR DISTRICT,KHAIRPUR TAMEWALI TEHSIL,46,2013,355,2368
BAHAWALPUR DISTRICT,KHAIRPUR TAMEWALI TEHSIL,47,1845,356,2201
BAHAWALPUR DISTRICT,KHAIRPUR TAMEWALI TEHSIL,48,1696,326,2022
BAHAWALPUR DISTRICT,KHAIRPUR TAMEWALI TEHSIL,49,1769,359,2128
BAHAWALPUR DISTRICT,KHAIRPUR TAMEWALI TEHSIL,50,1474,281,1755
BAHAWALPUR DISTRICT,KHAIRPUR TAMEWALI TEHSIL,51,1829,377,2206
BAHAWALPUR DISTRICT,KHAIRPUR TAMEWALI TEHSIL,52,1513,311,1824
BAHAWALPUR DISTRICT,KHAIRPUR TAMEWALI TEHSIL,53,1362,321,1683
BAHAWALPUR DISTRICT,KHAIRPUR TAMEWALI TEHSIL,54,1275,320,1595
BAHAWALPUR DISTRICT,KHAIRPUR TAMEWALI TEHSIL,55,980,187,1167
BAHAWALPUR DISTRICT,KHAIRPUR TAMEWALI TEHSIL,56,1088,249,1337
BAHAWALPUR DISTRICT,KHAIRPUR TAMEWALI TEHSIL,57,889,177,1066
BAHAWALPUR DISTRICT,KHAIRPUR TAMEWALI TEHSIL,58,809,160,969
BAHAWALPUR DISTRICT,KHAIRPUR TAMEWALI TEHSIL,59,888,204,1092
BAHAWALPUR DISTRICT,KHAIRPUR TAMEWALI TEHSIL,60,824,154,978
BAHAWALPUR DISTRICT,KHAIRPUR TAMEWALI TEHSIL,61,1032,225,1257
BAHAWALPUR DISTRICT,KHAIRPUR TAMEWALI TEHSIL,62,978,198,1176
BAHAWALPUR DISTRICT,KHAIRPUR TAMEWALI TEHSIL,63,808,184,992
BAHAWALPUR DISTRICT,KHAIRPUR TAMEWALI TEHSIL,64,794,164,958
BAHAWALPUR DISTRICT,KHAIRPUR TAMEWALI TEHSIL,65,768,101,869
BAHAWALPUR DISTRICT,KHAIRPUR TAMEWALI TEHSIL,66,921,142,1063
BAHAWALPUR DISTRICT,KHAIRPUR TAMEWALI TEHSIL,67,878,150,1028
BAHAWALPUR DISTRICT,KHAIRPUR TAMEWALI TEHSIL,68,667,130,797
BAHAWALPUR DISTRICT,KHAIRPUR TAMEWALI TEHSIL,69,628,104,732
BAHAWALPUR DISTRICT,KHAIRPUR TAMEWALI TEHSIL,70,570,95,665
BAHAWALPUR DISTRICT,KHAIRPUR TAMEWALI TEHSIL,71,706,102,808
BAHAWALPUR DISTRICT,KHAIRPUR TAMEWALI TEHSIL,72,622,108,730
BAHAWALPUR DISTRICT,KHAIRPUR TAMEWALI TEHSIL,73,465,84,549
BAHAWALPUR DISTRICT,KHAIRPUR TAMEWALI TEHSIL,74,393,43,436
BAHAWALPUR DISTRICT,KHAIRPUR TAMEWALI TEHSIL,>=75,3367,479,3846
BAHAWALPUR DISTRICT,YAZMAN TEHSIL,<1,14775,1244,16019
BAHAWALPUR DISTRICT,YAZMAN TEHSIL,1,16465,1340,17805
BAHAWALPUR DISTRICT,YAZMAN TEHSIL,2,16143,1271,17414
BAHAWALPUR DISTRICT,YAZMAN TEHSIL,3,16976,1338,18314
BAHAWALPUR DISTRICT,YAZMAN TEHSIL,4,17554,1297,18851
BAHAWALPUR DISTRICT,YAZMAN TEHSIL,5,16766,1305,18071
BAHAWALPUR DISTRICT,YAZMAN TEHSIL,6,16614,1257,17871
BAHAWALPUR DISTRICT,YAZMAN TEHSIL,7,17100,1330,18430
BAHAWALPUR DISTRICT,YAZMAN TEHSIL,8,16805,1227,18032
BAHAWALPUR DISTRICT,YAZMAN TEHSIL,9,16424,1373,17797
BAHAWALPUR DISTRICT,YAZMAN TEHSIL,10,15244,1083,16327
BAHAWALPUR DISTRICT,YAZMAN TEHSIL,11,14484,1329,15813
BAHAWALPUR DISTRICT,YAZMAN TEHSIL,12,13563,1101,14664
BAHAWALPUR DISTRICT,YAZMAN TEHSIL,13,12521,1194,13715
BAHAWALPUR DISTRICT,YAZMAN TEHSIL,14,12040,1076,13116
BAHAWALPUR DISTRICT,YAZMAN TEHSIL,15,11693,1061,12754
BAHAWALPUR DISTRICT,YAZMAN TEHSIL,16,11257,1018,12275
BAHAWALPUR DISTRICT,YAZMAN TEHSIL,17,10499,1015,11514
BAHAWALPUR DISTRICT,YAZMAN TEHSIL,18,10597,826,11423
BAHAWALPUR DISTRICT,YAZMAN TEHSIL,19,10036,1055,11091
BAHAWALPUR DISTRICT,YAZMAN TEHSIL,20,10193,881,11074
BAHAWALPUR DISTRICT,YAZMAN TEHSIL,21,9651,1031,10682
BAHAWALPUR DISTRICT,YAZMAN TEHSIL,22,9052,870,9922
BAHAWALPUR DISTRICT,YAZMAN TEHSIL,23,8467,871,9338
BAHAWALPUR DISTRICT,YAZMAN TEHSIL,24,8423,799,9222
BAHAWALPUR DISTRICT,YAZMAN TEHSIL,25,8184,709,8893
BAHAWALPUR DISTRICT,YAZMAN TEHSIL,26,8535,799,9334
BAHAWALPUR DISTRICT,YAZMAN TEHSIL,27,8136,851,8987
BAHAWALPUR DISTRICT,YAZMAN TEHSIL,28,8285,694,8979
BAHAWALPUR DISTRICT,YAZMAN TEHSIL,29,8279,810,9089
BAHAWALPUR DISTRICT,YAZMAN TEHSIL,30,7585,663,8248
BAHAWALPUR DISTRICT,YAZMAN TEHSIL,31,8177,795,8972
BAHAWALPUR DISTRICT,YAZMAN TEHSIL,32,7171,652,7823
BAHAWALPUR DISTRICT,YAZMAN TEHSIL,33,7072,677,7749
BAHAWALPUR DISTRICT,YAZMAN TEHSIL,34,8171,712,8883
BAHAWALPUR DISTRICT,YAZMAN TEHSIL,35,6464,488,6952
BAHAWALPUR DISTRICT,YAZMAN TEHSIL,36,8581,702,9283
BAHAWALPUR DISTRICT,YAZMAN TEHSIL,37,7149,615,7764
BAHAWALPUR DISTRICT,YAZMAN TEHSIL,38,6739,596,7335
BAHAWALPUR DISTRICT,YAZMAN TEHSIL,39,6640,652,7292
BAHAWALPUR DISTRICT,YAZMAN TEHSIL,40,5107,392,5499
BAHAWALPUR DISTRICT,YAZMAN TEHSIL,41,6535,582,7117
BAHAWALPUR DISTRICT,YAZMAN TEHSIL,42,5276,460,5736
BAHAWALPUR DISTRICT,YAZMAN TEHSIL,43,4757,461,5218
BAHAWALPUR DISTRICT,YAZMAN TEHSIL,44,5014,455,5469
BAHAWALPUR DISTRICT,YAZMAN TEHSIL,45,3719,304,4023
BAHAWALPUR DISTRICT,YAZMAN TEHSIL,46,5298,479,5777
BAHAWALPUR DISTRICT,YAZMAN TEHSIL,47,4466,430,4896
BAHAWALPUR DISTRICT,YAZMAN TEHSIL,48,4263,437,4700
BAHAWALPUR DISTRICT,YAZMAN TEHSIL,49,4258,462,4720
BAHAWALPUR DISTRICT,YAZMAN TEHSIL,50,3578,280,3858
BAHAWALPUR DISTRICT,YAZMAN TEHSIL,51,4789,423,5212
BAHAWALPUR DISTRICT,YAZMAN TEHSIL,52,3724,372,4096
BAHAWALPUR DISTRICT,YAZMAN TEHSIL,53,3591,377,3968
BAHAWALPUR DISTRICT,YAZMAN TEHSIL,54,3208,367,3575
BAHAWALPUR DISTRICT,YAZMAN TEHSIL,55,2467,210,2677
BAHAWALPUR DISTRICT,YAZMAN TEHSIL,56,3189,298,3487
BAHAWALPUR DISTRICT,YAZMAN TEHSIL,57,2687,290,2977
BAHAWALPUR DISTRICT,YAZMAN TEHSIL,58,2388,209,2597
BAHAWALPUR DISTRICT,YAZMAN TEHSIL,59,2310,236,2546
BAHAWALPUR DISTRICT,YAZMAN TEHSIL,60,2107,171,2278
BAHAWALPUR DISTRICT,YAZMAN TEHSIL,61,2850,231,3081
BAHAWALPUR DISTRICT,YAZMAN TEHSIL,62,2451,189,2640
BAHAWALPUR DISTRICT,YAZMAN TEHSIL,63,2312,219,2531
BAHAWALPUR DISTRICT,YAZMAN TEHSIL,64,2129,192,2321
BAHAWALPUR DISTRICT,YAZMAN TEHSIL,65,1805,127,1932
BAHAWALPUR DISTRICT,YAZMAN TEHSIL,66,2069,156,2225
BAHAWALPUR DISTRICT,YAZMAN TEHSIL,67,1901,163,2064
BAHAWALPUR DISTRICT,YAZMAN TEHSIL,68,1673,121,1794
BAHAWALPUR DISTRICT,YAZMAN TEHSIL,69,1530,108,1638
BAHAWALPUR DISTRICT,YAZMAN TEHSIL,70,1346,93,1439
BAHAWALPUR DISTRICT,YAZMAN TEHSIL,71,1664,141,1805
BAHAWALPUR DISTRICT,YAZMAN TEHSIL,72,1382,106,1488
BAHAWALPUR DISTRICT,YAZMAN TEHSIL,73,1166,101,1267
BAHAWALPUR DISTRICT,YAZMAN TEHSIL,74,939,63,1002
BAHAWALPUR DISTRICT,YAZMAN TEHSIL,>=75,7964,571,8535
BAJAUR AGENCY,BAR CHAMER KAND TEHSIL,<1,74,0,74
BAJAUR AGENCY,BAR CHAMER KAND TEHSIL,1,80,0,80
BAJAUR AGENCY,BAR CHAMER KAND TEHSIL,2,105,0,105
BAJAUR AGENCY,BAR CHAMER KAND TEHSIL,3,104,0,104
BAJAUR AGENCY,BAR CHAMER KAND TEHSIL,4,121,0,121
BAJAUR AGENCY,BAR CHAMER KAND TEHSIL,5,103,0,103
BAJAUR AGENCY,BAR CHAMER KAND TEHSIL,6,114,0,114
BAJAUR AGENCY,BAR CHAMER KAND TEHSIL,7,104,0,104
BAJAUR AGENCY,BAR CHAMER KAND TEHSIL,8,129,0,129
BAJAUR AGENCY,BAR CHAMER KAND TEHSIL,9,100,0,100
BAJAUR AGENCY,BAR CHAMER KAND TEHSIL,10,109,0,109
BAJAUR AGENCY,BAR CHAMER KAND TEHSIL,11,81,0,81
BAJAUR AGENCY,BAR CHAMER KAND TEHSIL,12,77,0,77
BAJAUR AGENCY,BAR CHAMER KAND TEHSIL,13,69,0,69
BAJAUR AGENCY,BAR CHAMER KAND TEHSIL,14,59,0,59
BAJAUR AGENCY,BAR CHAMER KAND TEHSIL,15,67,0,67
BAJAUR AGENCY,BAR CHAMER KAND TEHSIL,16,51,0,51
BAJAUR AGENCY,BAR CHAMER KAND TEHSIL,17,35,0,35
BAJAUR AGENCY,BAR CHAMER KAND TEHSIL,18,73,0,73
BAJAUR AGENCY,BAR CHAMER KAND TEHSIL,19,34,0,34
BAJAUR AGENCY,BAR CHAMER KAND TEHSIL,20,65,0,65
BAJAUR AGENCY,BAR CHAMER KAND TEHSIL,21,55,0,55
BAJAUR AGENCY,BAR CHAMER KAND TEHSIL,22,43,0,43
BAJAUR AGENCY,BAR CHAMER KAND TEHSIL,23,58,0,58
BAJAUR AGENCY,BAR CHAMER KAND TEHSIL,24,36,0,36
BAJAUR AGENCY,BAR CHAMER KAND TEHSIL,25,58,0,58
BAJAUR AGENCY,BAR CHAMER KAND TEHSIL,26,29,0,29
BAJAUR AGENCY,BAR CHAMER KAND TEHSIL,27,23,0,23
BAJAUR AGENCY,BAR CHAMER KAND TEHSIL,28,31,0,31
BAJAUR AGENCY,BAR CHAMER KAND TEHSIL,29,28,0,28
BAJAUR AGENCY,BAR CHAMER KAND TEHSIL,30,47,0,47
BAJAUR AGENCY,BAR CHAMER KAND TEHSIL,31,24,0,24
BAJAUR AGENCY,BAR CHAMER KAND TEHSIL,32,19,0,19
BAJAUR AGENCY,BAR CHAMER KAND TEHSIL,33,27,0,27
BAJAUR AGENCY,BAR CHAMER KAND TEHSIL,34,27,0,27
BAJAUR AGENCY,BAR CHAMER KAND TEHSIL,35,30,0,30
BAJAUR AGENCY,BAR CHAMER KAND TEHSIL,36,17,0,17
BAJAUR AGENCY,BAR CHAMER KAND TEHSIL,37,26,0,26
BAJAUR AGENCY,BAR CHAMER KAND TEHSIL,38,18,0,18
BAJAUR AGENCY,BAR CHAMER KAND TEHSIL,39,25,0,25
BAJAUR AGENCY,BAR CHAMER KAND TEHSIL,40,30,0,30
BAJAUR AGENCY,BAR CHAMER KAND TEHSIL,41,25,0,25
BAJAUR AGENCY,BAR CHAMER KAND TEHSIL,42,21,0,21
BAJAUR AGENCY,BAR CHAMER KAND TEHSIL,43,15,0,15
BAJAUR AGENCY,BAR CHAMER KAND TEHSIL,44,20,0,20
BAJAUR AGENCY,BAR CHAMER KAND TEHSIL,45,15,0,15
BAJAUR AGENCY,BAR CHAMER KAND TEHSIL,46,10,0,10
BAJAUR AGENCY,BAR CHAMER KAND TEHSIL,47,26,0,26
BAJAUR AGENCY,BAR CHAMER KAND TEHSIL,48,12,0,12
BAJAUR AGENCY,BAR CHAMER KAND TEHSIL,49,14,0,14
BAJAUR AGENCY,BAR CHAMER KAND TEHSIL,50,21,0,21
BAJAUR AGENCY,BAR CHAMER KAND TEHSIL,51,16,0,16
BAJAUR AGENCY,BAR CHAMER KAND TEHSIL,52,15,0,15
BAJAUR AGENCY,BAR CHAMER KAND TEHSIL,53,19,0,19
BAJAUR AGENCY,BAR CHAMER KAND TEHSIL,54,21,0,21
BAJAUR AGENCY,BAR CHAMER KAND TEHSIL,55,13,0,13
BAJAUR AGENCY,BAR CHAMER KAND TEHSIL,56,12,0,12
BAJAUR AGENCY,BAR CHAMER KAND TEHSIL,57,16,0,16
BAJAUR AGENCY,BAR CHAMER KAND TEHSIL,58,10,0,10
BAJAUR AGENCY,BAR CHAMER KAND TEHSIL,59,12,0,12
BAJAUR AGENCY,BAR CHAMER KAND TEHSIL,60,15,0,15
BAJAUR AGENCY,BAR CHAMER KAND TEHSIL,61,13,0,13
BAJAUR AGENCY,BAR CHAMER KAND TEHSIL,62,9,0,9
BAJAUR AGENCY,BAR CHAMER KAND TEHSIL,63,10,0,10
BAJAUR AGENCY,BAR CHAMER KAND TEHSIL,64,13,0,13
BAJAUR AGENCY,BAR CHAMER KAND TEHSIL,65,5,0,5
BAJAUR AGENCY,BAR CHAMER KAND TEHSIL,66,7,0,7
BAJAUR AGENCY,BAR CHAMER KAND TEHSIL,67,5,0,5
BAJAUR AGENCY,BAR CHAMER KAND TEHSIL,68,5,0,5
BAJAUR AGENCY,BAR CHAMER KAND TEHSIL,69,8,0,8
BAJAUR AGENCY,BAR CHAMER KAND TEHSIL,70,10,0,10
BAJAUR AGENCY,BAR CHAMER KAND TEHSIL,71,4,0,4
BAJAUR AGENCY,BAR CHAMER KAND TEHSIL,72,4,0,4
BAJAUR AGENCY,BAR CHAMER KAND TEHSIL,73,7,0,7
BAJAUR AGENCY,BAR CHAMER KAND TEHSIL,74,6,0,6
BAJAUR AGENCY,BAR CHAMER KAND TEHSIL,>=75,29,0,29
BAJAUR AGENCY,BARANG TEHSIL,<1,2268,0,2268
BAJAUR AGENCY,BARANG TEHSIL,1,3165,0,3165
BAJAUR AGENCY,BARANG TEHSIL,2,3586,0,3586
BAJAUR AGENCY,BARANG TEHSIL,3,3174,0,3174
BAJAUR AGENCY,BARANG TEHSIL,4,3763,0,3763
BAJAUR AGENCY,BARANG TEHSIL,5,3065,0,3065
BAJAUR AGENCY,BARANG TEHSIL,6,3514,0,3514
BAJAUR AGENCY,BARANG TEHSIL,7,2924,0,2924
BAJAUR AGENCY,BARANG TEHSIL,8,3367,0,3367
BAJAUR AGENCY,BARANG TEHSIL,9,2563,0,2563
BAJAUR AGENCY,BARANG TEHSIL,10,2860,0,2860
BAJAUR AGENCY,BARANG TEHSIL,11,2045,0,2045
BAJAUR AGENCY,BARANG TEHSIL,12,2205,0,2205
BAJAUR AGENCY,BARANG TEHSIL,13,1596,0,1596
BAJAUR AGENCY,BARANG TEHSIL,14,1818,0,1818
BAJAUR AGENCY,BARANG TEHSIL,15,1460,0,1460
BAJAUR AGENCY,BARANG TEHSIL,16,1365,0,1365
BAJAUR AGENCY,BARANG TEHSIL,17,1069,0,1069
BAJAUR AGENCY,BARANG TEHSIL,18,1401,0,1401
BAJAUR AGENCY,BARANG TEHSIL,19,1186,0,1186
BAJAUR AGENCY,BARANG TEHSIL,20,1513,0,1513
BAJAUR AGENCY,BARANG TEHSIL,21,1223,0,1223
BAJAUR AGENCY,BARANG TEHSIL,22,1078,0,1078
BAJAUR AGENCY,BARANG TEHSIL,23,1065,0,1065
BAJAUR AGENCY,BARANG TEHSIL,24,1108,0,1108
BAJAUR AGENCY,BARANG TEHSIL,25,1268,0,1268
BAJAUR AGENCY,BARANG TEHSIL,26,1158,0,1158
BAJAUR AGENCY,BARANG TEHSIL,27,1148,0,1148
BAJAUR AGENCY,BARANG TEHSIL,28,808,0,808
BAJAUR AGENCY,BARANG TEHSIL,29,1089,0,1089
BAJAUR AGENCY,BARANG TEHSIL,30,807,0,807
BAJAUR AGENCY,BARANG TEHSIL,31,834,0,834
BAJAUR AGENCY,BARANG TEHSIL,32,707,0,707
BAJAUR AGENCY,BARANG TEHSIL,33,690,0,690
BAJAUR AGENCY,BARANG TEHSIL,34,704,0,704
BAJAUR AGENCY,BARANG TEHSIL,35,611,0,611
BAJAUR AGENCY,BARANG TEHSIL,36,571,0,571
BAJAUR AGENCY,BARANG TEHSIL,37,655,0,655
BAJAUR AGENCY,BARANG TEHSIL,38,585,0,585
BAJAUR AGENCY,BARANG TEHSIL,39,646,0,646
BAJAUR AGENCY,BARANG TEHSIL,40,593,0,593
BAJAUR AGENCY,BARANG TEHSIL,41,573,0,573
BAJAUR AGENCY,BARANG TEHSIL,42,450,0,450
BAJAUR AGENCY,BARANG TEHSIL,43,443,0,443
BAJAUR AGENCY,BARANG TEHSIL,44,438,0,438
BAJAUR AGENCY,BARANG TEHSIL,45,359,0,359
BAJAUR AGENCY,BARANG TEHSIL,46,368,0,368
BAJAUR AGENCY,BARANG TEHSIL,47,436,0,436
BAJAUR AGENCY,BARANG TEHSIL,48,334,0,334
BAJAUR AGENCY,BARANG TEHSIL,49,373,0,373
BAJAUR AGENCY,BARANG TEHSIL,50,379,0,379
BAJAUR AGENCY,BARANG TEHSIL,51,322,0,322
BAJAUR AGENCY,BARANG TEHSIL,52,319,0,319
BAJAUR AGENCY,BARANG TEHSIL,53,276,0,276
BAJAUR AGENCY,BARANG TEHSIL,54,286,0,286
BAJAUR AGENCY,BARANG TEHSIL,55,228,0,228
BAJAUR AGENCY,BARANG TEHSIL,56,225,0,225
BAJAUR AGENCY,BARANG TEHSIL,57,300,0,300
BAJAUR AGENCY,BARANG TEHSIL,58,237,0,237
BAJAUR AGENCY,BARANG TEHSIL,59,202,0,202
BAJAUR AGENCY,BARANG TEHSIL,60,191,0,191
BAJAUR AGENCY,BARANG TEHSIL,61,193,0,193
BAJAUR AGENCY,BARANG TEHSIL,62,212,0,212
BAJAUR AGENCY,BARANG TEHSIL,63,155,0,155
BAJAUR AGENCY,BARANG TEHSIL,64,170,0,170
BAJAUR AGENCY,BARANG TEHSIL,65,174,0,174
BAJAUR AGENCY,BARANG TEHSIL,66,136,0,136
BAJAUR AGENCY,BARANG TEHSIL,67,192,0,192
BAJAUR AGENCY,BARANG TEHSIL,68,109,0,109
BAJAUR AGENCY,BARANG TEHSIL,69,123,0,123
BAJAUR AGENCY,BARANG TEHSIL,70,128,0,128
BAJAUR AGENCY,BARANG TEHSIL,71,85,0,85
BAJAUR AGENCY,BARANG TEHSIL,72,108,0,108
BAJAUR AGENCY,BARANG TEHSIL,73,58,0,58
BAJAUR AGENCY,BARANG TEHSIL,74,64,0,64
BAJAUR AGENCY,BARANG TEHSIL,>=75,592,0,592
BAJAUR AGENCY,KHAR BAJAUR TEHSIL,<1,6784,0,6784
BAJAUR AGENCY,KHAR BAJAUR TEHSIL,1,8407,0,8407
BAJAUR AGENCY,KHAR BAJAUR TEHSIL,2,9311,0,9311
BAJAUR AGENCY,KHAR BAJAUR TEHSIL,3,9423,0,9423
BAJAUR AGENCY,KHAR BAJAUR TEHSIL,4,10015,0,10015
BAJAUR AGENCY,KHAR BAJAUR TEHSIL,5,9319,0,9319
BAJAUR AGENCY,KHAR BAJAUR TEHSIL,6,9481,0,9481
BAJAUR AGENCY,KHAR BAJAUR TEHSIL,7,8832,0,8832
BAJAUR AGENCY,KHAR BAJAUR TEHSIL,8,9889,0,9889
BAJAUR AGENCY,KHAR BAJAUR TEHSIL,9,8426,0,8426
BAJAUR AGENCY,KHAR BAJAUR TEHSIL,10,8835,0,8835
BAJAUR AGENCY,KHAR BAJAUR TEHSIL,11,7150,0,7150
BAJAUR AGENCY,KHAR BAJAUR TEHSIL,12,7407,0,7407
BAJAUR AGENCY,KHAR BAJAUR TEHSIL,13,6431,0,6431
BAJAUR AGENCY,KHAR BAJAUR TEHSIL,14,6451,0,6451
BAJAUR AGENCY,KHAR BAJAUR TEHSIL,15,5682,0,5682
BAJAUR AGENCY,KHAR BAJAUR TEHSIL,16,5376,0,5376
BAJAUR AGENCY,KHAR BAJAUR TEHSIL,17,4373,0,4373
BAJAUR AGENCY,KHAR BAJAUR TEHSIL,18,5125,0,5125
BAJAUR AGENCY,KHAR BAJAUR TEHSIL,19,4215,0,4215
BAJAUR AGENCY,KHAR BAJAUR TEHSIL,20,4743,0,4743
BAJAUR AGENCY,KHAR BAJAUR TEHSIL,21,3932,0,3932
BAJAUR AGENCY,KHAR BAJAUR TEHSIL,22,3781,0,3781
BAJAUR AGENCY,KHAR BAJAUR TEHSIL,23,3920,0,3920
BAJAUR AGENCY,KHAR BAJAUR TEHSIL,24,3382,0,3382
BAJAUR AGENCY,KHAR BAJAUR TEHSIL,25,3920,0,3920
BAJAUR AGENCY,KHAR BAJAUR TEHSIL,26,3556,0,3556
BAJAUR AGENCY,KHAR BAJAUR TEHSIL,27,4257,0,4257
BAJAUR AGENCY,KHAR BAJAUR TEHSIL,28,3356,0,3356
BAJAUR AGENCY,KHAR BAJAUR TEHSIL,29,3484,0,3484
BAJAUR AGENCY,KHAR BAJAUR TEHSIL,30,3073,0,3073
BAJAUR AGENCY,KHAR BAJAUR TEHSIL,31,2935,0,2935
BAJAUR AGENCY,KHAR BAJAUR TEHSIL,32,2693,0,2693
BAJAUR AGENCY,KHAR BAJAUR TEHSIL,33,2730,0,2730
BAJAUR AGENCY,KHAR BAJAUR TEHSIL,34,2150,0,2150
BAJAUR AGENCY,KHAR BAJAUR TEHSIL,35,2116,0,2116
BAJAUR AGENCY,KHAR BAJAUR TEHSIL,36,1713,0,1713
BAJAUR AGENCY,KHAR BAJAUR TEHSIL,37,2084,0,2084
BAJAUR AGENCY,KHAR BAJAUR TEHSIL,38,2003,0,2003
BAJAUR AGENCY,KHAR BAJAUR TEHSIL,39,1935,0,1935
BAJAUR AGENCY,KHAR BAJAUR TEHSIL,40,2120,0,2120
BAJAUR AGENCY,KHAR BAJAUR TEHSIL,41,1744,0,1744
BAJAUR AGENCY,KHAR BAJAUR TEHSIL,42,1657,0,1657
BAJAUR AGENCY,KHAR BAJAUR TEHSIL,43,1637,0,1637
BAJAUR AGENCY,KHAR BAJAUR TEHSIL,44,1374,0,1374
BAJAUR AGENCY,KHAR BAJAUR TEHSIL,45,1502,0,1502
BAJAUR AGENCY,KHAR BAJAUR TEHSIL,46,1184,0,1184
BAJAUR AGENCY,KHAR BAJAUR TEHSIL,47,1388,0,1388
BAJAUR AGENCY,KHAR BAJAUR TEHSIL,48,1271,0,1271
BAJAUR AGENCY,KHAR BAJAUR TEHSIL,49,1200,0,1200
BAJAUR AGENCY,KHAR BAJAUR TEHSIL,50,1475,0,1475
BAJAUR AGENCY,KHAR BAJAUR TEHSIL,51,1126,0,1126
BAJAUR AGENCY,KHAR BAJAUR TEHSIL,52,1064,0,1064
BAJAUR AGENCY,KHAR BAJAUR TEHSIL,53,1120,0,1120
BAJAUR AGENCY,KHAR BAJAUR TEHSIL,54,1061,0,1061
BAJAUR AGENCY,KHAR BAJAUR TEHSIL,55,1062,0,1062
BAJAUR AGENCY,KHAR BAJAUR TEHSIL,56,736,0,736
BAJAUR AGENCY,KHAR BAJAUR TEHSIL,57,1000,0,1000
BAJAUR AGENCY,KHAR BAJAUR TEHSIL,58,713,0,713
BAJAUR AGENCY,KHAR BAJAUR TEHSIL,59,740,0,740
BAJAUR AGENCY,KHAR BAJAUR TEHSIL,60,819,0,819
BAJAUR AGENCY,KHAR BAJAUR TEHSIL,61,604,0,604
BAJAUR AGENCY,KHAR BAJAUR TEHSIL,62,642,0,642
BAJAUR AGENCY,KHAR BAJAUR TEHSIL,63,623,0,623
BAJAUR AGENCY,KHAR BAJAUR TEHSIL,64,557,0,557
BAJAUR AGENCY,KHAR BAJAUR TEHSIL,65,495,0,495
BAJAUR AGENCY,KHAR BAJAUR TEHSIL,66,445,0,445
BAJAUR AGENCY,KHAR BAJAUR TEHSIL,67,627,0,627
BAJAUR AGENCY,KHAR BAJAUR TEHSIL,68,353,0,353
BAJAUR AGENCY,KHAR BAJAUR TEHSIL,69,430,0,430
BAJAUR AGENCY,KHAR BAJAUR TEHSIL,70,394,0,394
BAJAUR AGENCY,KHAR BAJAUR TEHSIL,71,276,0,276
BAJAUR AGENCY,KHAR BAJAUR TEHSIL,72,330,0,330
BAJAUR AGENCY,KHAR BAJAUR TEHSIL,73,255,0,255
BAJAUR AGENCY,KHAR BAJAUR TEHSIL,74,226,0,226
BAJAUR AGENCY,KHAR BAJAUR TEHSIL,>=75,1930,0,1930
BAJAUR AGENCY,MAMUND TEHSIL,<1,8847,0,8847
BAJAUR AGENCY,MAMUND TEHSIL,1,9762,0,9762
BAJAUR AGENCY,MAMUND TEHSIL,2,12338,0,12338
BAJAUR AGENCY,MAMUND TEHSIL,3,11830,0,11830
BAJAUR AGENCY,MAMUND TEHSIL,4,12681,0,12681
BAJAUR AGENCY,MAMUND TEHSIL,5,11703,0,11703
BAJAUR AGENCY,MAMUND TEHSIL,6,12535,0,12535
BAJAUR AGENCY,MAMUND TEHSIL,7,11481,0,11481
BAJAUR AGENCY,MAMUND TEHSIL,8,12374,0,12374
BAJAUR AGENCY,MAMUND TEHSIL,9,11077,0,11077
BAJAUR AGENCY,MAMUND TEHSIL,10,10791,0,10791
BAJAUR AGENCY,MAMUND TEHSIL,11,8851,0,8851
BAJAUR AGENCY,MAMUND TEHSIL,12,8897,0,8897
BAJAUR AGENCY,MAMUND TEHSIL,13,7634,0,7634
BAJAUR AGENCY,MAMUND TEHSIL,14,7281,0,7281
BAJAUR AGENCY,MAMUND TEHSIL,15,6892,0,6892
BAJAUR AGENCY,MAMUND TEHSIL,16,5924,0,5924
BAJAUR AGENCY,MAMUND TEHSIL,17,4697,0,4697
BAJAUR AGENCY,MAMUND TEHSIL,18,6011,0,6011
BAJAUR AGENCY,MAMUND TEHSIL,19,5057,0,5057
BAJAUR AGENCY,MAMUND TEHSIL,20,5988,0,5988
BAJAUR AGENCY,MAMUND TEHSIL,21,4863,0,4863
BAJAUR AGENCY,MAMUND TEHSIL,22,4768,0,4768
BAJAUR AGENCY,MAMUND TEHSIL,23,5506,0,5506
BAJAUR AGENCY,MAMUND TEHSIL,24,4622,0,4622
BAJAUR AGENCY,MAMUND TEHSIL,25,5589,0,5589
BAJAUR AGENCY,MAMUND TEHSIL,26,4756,0,4756
BAJAUR AGENCY,MAMUND TEHSIL,27,5479,0,5479
BAJAUR AGENCY,MAMUND TEHSIL,28,4235,0,4235
BAJAUR AGENCY,MAMUND TEHSIL,29,4197,0,4197
BAJAUR AGENCY,MAMUND TEHSIL,30,3819,0,3819
BAJAUR AGENCY,MAMUND TEHSIL,31,3516,0,3516
BAJAUR AGENCY,MAMUND TEHSIL,32,3369,0,3369
BAJAUR AGENCY,MAMUND TEHSIL,33,3316,0,3316
BAJAUR AGENCY,MAMUND TEHSIL,34,2570,0,2570
BAJAUR AGENCY,MAMUND TEHSIL,35,2757,0,2757
BAJAUR AGENCY,MAMUND TEHSIL,36,2256,0,2256
BAJAUR AGENCY,MAMUND TEHSIL,37,2950,0,2950
BAJAUR AGENCY,MAMUND TEHSIL,38,2744,0,2744
BAJAUR AGENCY,MAMUND TEHSIL,39,2375,0,2375
BAJAUR AGENCY,MAMUND TEHSIL,40,2734,0,2734
BAJAUR AGENCY,MAMUND TEHSIL,41,2214,0,2214
BAJAUR AGENCY,MAMUND TEHSIL,42,2041,0,2041
BAJAUR AGENCY,MAMUND TEHSIL,43,2164,0,2164
BAJAUR AGENCY,MAMUND TEHSIL,44,1794,0,1794
BAJAUR AGENCY,MAMUND TEHSIL,45,1924,0,1924
BAJAUR AGENCY,MAMUND TEHSIL,46,1481,0,1481
BAJAUR AGENCY,MAMUND TEHSIL,47,1782,0,1782
BAJAUR AGENCY,MAMUND TEHSIL,48,1695,0,1695
BAJAUR AGENCY,MAMUND TEHSIL,49,1649,0,1649
BAJAUR AGENCY,MAMUND TEHSIL,50,1946,0,1946
BAJAUR AGENCY,MAMUND TEHSIL,51,1340,0,1340
BAJAUR AGENCY,MAMUND TEHSIL,52,1398,0,1398
BAJAUR AGENCY,MAMUND TEHSIL,53,1390,0,1390
BAJAUR AGENCY,MAMUND TEHSIL,54,1216,0,1216
BAJAUR AGENCY,MAMUND TEHSIL,55,1406,0,1406
BAJAUR AGENCY,MAMUND TEHSIL,56,969,0,969
BAJAUR AGENCY,MAMUND TEHSIL,57,1255,0,1255
BAJAUR AGENCY,MAMUND TEHSIL,58,1036,0,1036
BAJAUR AGENCY,MAMUND TEHSIL,59,914,0,914
BAJAUR AGENCY,MAMUND TEHSIL,60,1171,0,1171
BAJAUR AGENCY,MAMUND TEHSIL,61,721,0,721
BAJAUR AGENCY,MAMUND TEHSIL,62,942,0,942
BAJAUR AGENCY,MAMUND TEHSIL,63,830,0,830
BAJAUR AGENCY,MAMUND TEHSIL,64,731,0,731
BAJAUR AGENCY,MAMUND TEHSIL,65,814,0,814
BAJAUR AGENCY,MAMUND TEHSIL,66,617,0,617
BAJAUR AGENCY,MAMUND TEHSIL,67,844,0,844
BAJAUR AGENCY,MAMUND TEHSIL,68,539,0,539
BAJAUR AGENCY,MAMUND TEHSIL,69,446,0,446
BAJAUR AGENCY,MAMUND TEHSIL,70,598,0,598
BAJAUR AGENCY,MAMUND TEHSIL,71,410,0,410
BAJAUR AGENCY,MAMUND TEHSIL,72,452,0,452
BAJAUR AGENCY,MAMUND TEHSIL,73,356,0,356
BAJAUR AGENCY,MAMUND TEHSIL,74,340,0,340
BAJAUR AGENCY,MAMUND TEHSIL,>=75,2876,0,2876
BAJAUR AGENCY,NAWAGAI TEHSIL,<1,2302,0,2302
BAJAUR AGENCY,NAWAGAI TEHSIL,1,2829,0,2829
BAJAUR AGENCY,NAWAGAI TEHSIL,2,3239,0,3239
BAJAUR AGENCY,NAWAGAI TEHSIL,3,3239,0,3239
BAJAUR AGENCY,NAWAGAI TEHSIL,4,3388,0,3388
BAJAUR AGENCY,NAWAGAI TEHSIL,5,2923,0,2923
BAJAUR AGENCY,NAWAGAI TEHSIL,6,3176,0,3176
BAJAUR AGENCY,NAWAGAI TEHSIL,7,2901,0,2901
BAJAUR AGENCY,NAWAGAI TEHSIL,8,3206,0,3206
BAJAUR AGENCY,NAWAGAI TEHSIL,9,2760,0,2760
BAJAUR AGENCY,NAWAGAI TEHSIL,10,2819,0,2819
BAJAUR AGENCY,NAWAGAI TEHSIL,11,2343,0,2343
BAJAUR AGENCY,NAWAGAI TEHSIL,12,2274,0,2274
BAJAUR AGENCY,NAWAGAI TEHSIL,13,2018,0,2018
BAJAUR AGENCY,NAWAGAI TEHSIL,14,1947,0,1947
BAJAUR AGENCY,NAWAGAI TEHSIL,15,1799,0,1799
BAJAUR AGENCY,NAWAGAI TEHSIL,16,1470,0,1470
BAJAUR AGENCY,NAWAGAI TEHSIL,17,1202,0,1202
BAJAUR AGENCY,NAWAGAI TEHSIL,18,1419,0,1419
BAJAUR AGENCY,NAWAGAI TEHSIL,19,1202,0,1202
BAJAUR AGENCY,NAWAGAI TEHSIL,20,1512,0,1512
BAJAUR AGENCY,NAWAGAI TEHSIL,21,1156,0,1156
BAJAUR AGENCY,NAWAGAI TEHSIL,22,1077,0,1077
BAJAUR AGENCY,NAWAGAI TEHSIL,23,1227,0,1227
BAJAUR AGENCY,NAWAGAI TEHSIL,24,1022,0,1022
BAJAUR AGENCY,NAWAGAI TEHSIL,25,1342,0,1342
BAJAUR AGENCY,NAWAGAI TEHSIL,26,939,0,939
BAJAUR AGENCY,NAWAGAI TEHSIL,27,1082,0,1082
BAJAUR AGENCY,NAWAGAI TEHSIL,28,1016,0,1016
BAJAUR AGENCY,NAWAGAI TEHSIL,29,837,0,837
BAJAUR AGENCY,NAWAGAI TEHSIL,30,1134,0,1134
BAJAUR AGENCY,NAWAGAI TEHSIL,31,861,0,861
BAJAUR AGENCY,NAWAGAI TEHSIL,32,801,0,801
BAJAUR AGENCY,NAWAGAI TEHSIL,33,862,0,862
BAJAUR AGENCY,NAWAGAI TEHSIL,34,700,0,700
BAJAUR AGENCY,NAWAGAI TEHSIL,35,846,0,846
BAJAUR AGENCY,NAWAGAI TEHSIL,36,617,0,617
BAJAUR AGENCY,NAWAGAI TEHSIL,37,675,0,675
BAJAUR AGENCY,NAWAGAI TEHSIL,38,646,0,646
BAJAUR AGENCY,NAWAGAI TEHSIL,39,617,0,617
BAJAUR AGENCY,NAWAGAI TEHSIL,40,739,0,739
BAJAUR AGENCY,NAWAGAI TEHSIL,41,534,0,534
BAJAUR AGENCY,NAWAGAI TEHSIL,42,449,0,449
BAJAUR AGENCY,NAWAGAI TEHSIL,43,517,0,517
BAJAUR AGENCY,NAWAGAI TEHSIL,44,432,0,432
BAJAUR AGENCY,NAWAGAI TEHSIL,45,443,0,443
BAJAUR AGENCY,NAWAGAI TEHSIL,46,294,0,294
BAJAUR AGENCY,NAWAGAI TEHSIL,47,348,0,348
BAJAUR AGENCY,NAWAGAI TEHSIL,48,380,0,380
BAJAUR AGENCY,NAWAGAI TEHSIL,49,316,0,316
BAJAUR AGENCY,NAWAGAI TEHSIL,50,566,0,566
BAJAUR AGENCY,NAWAGAI TEHSIL,51,274,0,274
BAJAUR AGENCY,NAWAGAI TEHSIL,52,305,0,305
BAJAUR AGENCY,NAWAGAI TEHSIL,53,336,0,336
BAJAUR AGENCY,NAWAGAI TEHSIL,54,323,0,323
BAJAUR AGENCY,NAWAGAI TEHSIL,55,381,0,381
BAJAUR AGENCY,NAWAGAI TEHSIL,56,234,0,234
BAJAUR AGENCY,NAWAGAI TEHSIL,57,329,0,329
BAJAUR AGENCY,NAWAGAI TEHSIL,58,287,0,287
BAJAUR AGENCY,NAWAGAI TEHSIL,59,243,0,243
BAJAUR AGENCY,NAWAGAI TEHSIL,60,376,0,376
BAJAUR AGENCY,NAWAGAI TEHSIL,61,184,0,184
BAJAUR AGENCY,NAWAGAI TEHSIL,62,181,0,181
BAJAUR AGENCY,NAWAGAI TEHSIL,63,247,0,247
BAJAUR AGENCY,NAWAGAI TEHSIL,64,213,0,213
BAJAUR AGENCY,NAWAGAI TEHSIL,65,217,0,217
BAJAUR AGENCY,NAWAGAI TEHSIL,66,162,0,162
BAJAUR AGENCY,NAWAGAI TEHSIL,67,185,0,185
BAJAUR AGENCY,NAWAGAI TEHSIL,68,150,0,150
BAJAUR AGENCY,NAWAGAI TEHSIL,69,136,0,136
BAJAUR AGENCY,NAWAGAI TEHSIL,70,167,0,167
BAJAUR AGENCY,NAWAGAI TEHSIL,71,96,0,96
BAJAUR AGENCY,NAWAGAI TEHSIL,72,90,0,90
BAJAUR AGENCY,NAWAGAI TEHSIL,73,117,0,117
BAJAUR AGENCY,NAWAGAI TEHSIL,74,101,0,101
BAJAUR AGENCY,NAWAGAI TEHSIL,>=75,717,0,717
BAJAUR AGENCY,SALARZAI TEHSIL,<1,7399,0,7399
BAJAUR AGENCY,SALARZAI TEHSIL,1,9095,0,9095
BAJAUR AGENCY,SALARZAI TEHSIL,2,11205,0,11205
BAJAUR AGENCY,SALARZAI TEHSIL,3,10373,0,10373
BAJAUR AGENCY,SALARZAI TEHSIL,4,12045,0,12045
BAJAUR AGENCY,SALARZAI TEHSIL,5,10124,0,10124
BAJAUR AGENCY,SALARZAI TEHSIL,6,11687,0,11687
BAJAUR AGENCY,SALARZAI TEHSIL,7,9440,0,9440
BAJAUR AGENCY,SALARZAI TEHSIL,8,11673,0,11673
BAJAUR AGENCY,SALARZAI TEHSIL,9,9016,0,9016
BAJAUR AGENCY,SALARZAI TEHSIL,10,10126,0,10126
BAJAUR AGENCY,SALARZAI TEHSIL,11,7052,0,7052
BAJAUR AGENCY,SALARZAI TEHSIL,12,7938,0,7938
BAJAUR AGENCY,SALARZAI TEHSIL,13,6041,0,6041
BAJAUR AGENCY,SALARZAI TEHSIL,14,6212,0,6212
BAJAUR AGENCY,SALARZAI TEHSIL,15,5398,0,5398
BAJAUR AGENCY,SALARZAI TEHSIL,16,4870,0,4870
BAJAUR AGENCY,SALARZAI TEHSIL,17,3829,0,3829
BAJAUR AGENCY,SALARZAI TEHSIL,18,4921,0,4921
BAJAUR AGENCY,SALARZAI TEHSIL,19,4275,0,4275
BAJAUR AGENCY,SALARZAI TEHSIL,20,5468,0,5468
BAJAUR AGENCY,SALARZAI TEHSIL,21,4026,0,4026
BAJAUR AGENCY,SALARZAI TEHSIL,22,4195,0,4195
BAJAUR AGENCY,SALARZAI TEHSIL,23,4415,0,4415
BAJAUR AGENCY,SALARZAI TEHSIL,24,3900,0,3900
BAJAUR AGENCY,SALARZAI TEHSIL,25,4465,0,4465
BAJAUR AGENCY,SALARZAI TEHSIL,26,3905,0,3905
BAJAUR AGENCY,SALARZAI TEHSIL,27,3853,0,3853
BAJAUR AGENCY,SALARZAI TEHSIL,28,3883,0,3883
BAJAUR AGENCY,SALARZAI TEHSIL,29,3578,0,3578
BAJAUR AGENCY,SALARZAI TEHSIL,30,3553,0,3553
BAJAUR AGENCY,SALARZAI TEHSIL,31,3116,0,3116
BAJAUR AGENCY,SALARZAI TEHSIL,32,2681,0,2681
BAJAUR AGENCY,SALARZAI TEHSIL,33,2979,0,2979
BAJAUR AGENCY,SALARZAI TEHSIL,34,2176,0,2176
BAJAUR AGENCY,SALARZAI TEHSIL,35,2325,0,2325
BAJAUR AGENCY,SALARZAI TEHSIL,36,1873,0,1873
BAJAUR AGENCY,SALARZAI TEHSIL,37,2010,0,2010
BAJAUR AGENCY,SALARZAI TEHSIL,38,2287,0,2287
BAJAUR AGENCY,SALARZAI TEHSIL,39,1987,0,1987
BAJAUR AGENCY,SALARZAI TEHSIL,40,2342,0,2342
BAJAUR AGENCY,SALARZAI TEHSIL,41,1809,0,1809
BAJAUR AGENCY,SALARZAI TEHSIL,42,1760,0,1760
BAJAUR AGENCY,SALARZAI TEHSIL,43,1804,0,1804
BAJAUR AGENCY,SALARZAI TEHSIL,44,1614,0,1614
BAJAUR AGENCY,SALARZAI TEHSIL,45,1719,0,1719
BAJAUR AGENCY,SALARZAI TEHSIL,46,1397,0,1397
BAJAUR AGENCY,SALARZAI TEHSIL,47,1484,0,1484
BAJAUR AGENCY,SALARZAI TEHSIL,48,1564,0,1564
BAJAUR AGENCY,SALARZAI TEHSIL,49,1254,0,1254
BAJAUR AGENCY,SALARZAI TEHSIL,50,1717,0,1717
BAJAUR AGENCY,SALARZAI TEHSIL,51,1240,0,1240
BAJAUR AGENCY,SALARZAI TEHSIL,52,1124,0,1124
BAJAUR AGENCY,SALARZAI TEHSIL,53,1186,0,1186
BAJAUR AGENCY,SALARZAI TEHSIL,54,1023,0,1023
BAJAUR AGENCY,SALARZAI TEHSIL,55,1164,0,1164
BAJAUR AGENCY,SALARZAI TEHSIL,56,847,0,847
BAJAUR AGENCY,SALARZAI TEHSIL,57,879,0,879
BAJAUR AGENCY,SALARZAI TEHSIL,58,915,0,915
BAJAUR AGENCY,SALARZAI TEHSIL,59,712,0,712
BAJAUR AGENCY,SALARZAI TEHSIL,60,1052,0,1052
BAJAUR AGENCY,SALARZAI TEHSIL,61,722,0,722
BAJAUR AGENCY,SALARZAI TEHSIL,62,717,0,717
BAJAUR AGENCY,SALARZAI TEHSIL,63,730,0,730
BAJAUR AGENCY,SALARZAI TEHSIL,64,646,0,646
BAJAUR AGENCY,SALARZAI TEHSIL,65,688,0,688
BAJAUR AGENCY,SALARZAI TEHSIL,66,524,0,524
BAJAUR AGENCY,SALARZAI TEHSIL,67,634,0,634
BAJAUR AGENCY,SALARZAI TEHSIL,68,579,0,579
BAJAUR AGENCY,SALARZAI TEHSIL,69,420,0,420
BAJAUR AGENCY,SALARZAI TEHSIL,70,539,0,539
BAJAUR AGENCY,SALARZAI TEHSIL,71,328,0,328
BAJAUR AGENCY,SALARZAI TEHSIL,72,342,0,342
BAJAUR AGENCY,SALARZAI TEHSIL,73,317,0,317
BAJAUR AGENCY,SALARZAI TEHSIL,74,305,0,305
BAJAUR AGENCY,SALARZAI TEHSIL,>=75,2145,0,2145
BAJAUR AGENCY,UTMAN KHEL TEHSIL,<1,3011,0,3011
BAJAUR AGENCY,UTMAN KHEL TEHSIL,1,3383,0,3383
BAJAUR AGENCY,UTMAN KHEL TEHSIL,2,4280,0,4280
BAJAUR AGENCY,UTMAN KHEL TEHSIL,3,4112,0,4112
BAJAUR AGENCY,UTMAN KHEL TEHSIL,4,4849,0,4849
BAJAUR AGENCY,UTMAN KHEL TEHSIL,5,3908,0,3908
BAJAUR AGENCY,UTMAN KHEL TEHSIL,6,4287,0,4287
BAJAUR AGENCY,UTMAN KHEL TEHSIL,7,3735,0,3735
BAJAUR AGENCY,UTMAN KHEL TEHSIL,8,4427,0,4427
BAJAUR AGENCY,UTMAN KHEL TEHSIL,9,3800,0,3800
BAJAUR AGENCY,UTMAN KHEL TEHSIL,10,3949,0,3949
BAJAUR AGENCY,UTMAN KHEL TEHSIL,11,3127,0,3127
BAJAUR AGENCY,UTMAN KHEL TEHSIL,12,3143,0,3143
BAJAUR AGENCY,UTMAN KHEL TEHSIL,13,2816,0,2816
BAJAUR AGENCY,UTMAN KHEL TEHSIL,14,2752,0,2752
BAJAUR AGENCY,UTMAN KHEL TEHSIL,15,2545,0,2545
BAJAUR AGENCY,UTMAN KHEL TEHSIL,16,2249,0,2249
BAJAUR AGENCY,UTMAN KHEL TEHSIL,17,1858,0,1858
BAJAUR AGENCY,UTMAN KHEL TEHSIL,18,2113,0,2113
BAJAUR AGENCY,UTMAN KHEL TEHSIL,19,1731,0,1731
BAJAUR AGENCY,UTMAN KHEL TEHSIL,20,2018,0,2018
BAJAUR AGENCY,UTMAN KHEL TEHSIL,21,1693,0,1693
BAJAUR AGENCY,UTMAN KHEL TEHSIL,22,1642,0,1642
BAJAUR AGENCY,UTMAN KHEL TEHSIL,23,1633,0,1633
BAJAUR AGENCY,UTMAN KHEL TEHSIL,24,1474,0,1474
BAJAUR AGENCY,UTMAN KHEL TEHSIL,25,1661,0,1661
BAJAUR AGENCY,UTMAN KHEL TEHSIL,26,1630,0,1630
BAJAUR AGENCY,UTMAN KHEL TEHSIL,27,1646,0,1646
BAJAUR AGENCY,UTMAN KHEL TEHSIL,28,1421,0,1421
BAJAUR AGENCY,UTMAN KHEL TEHSIL,29,1546,0,1546
BAJAUR AGENCY,UTMAN KHEL TEHSIL,30,1280,0,1280
BAJAUR AGENCY,UTMAN KHEL TEHSIL,31,1273,0,1273
BAJAUR AGENCY,UTMAN KHEL TEHSIL,32,1012,0,1012
BAJAUR AGENCY,UTMAN KHEL TEHSIL,33,1154,0,1154
BAJAUR AGENCY,UTMAN KHEL TEHSIL,34,968,0,968
BAJAUR AGENCY,UTMAN KHEL TEHSIL,35,918,0,918
BAJAUR AGENCY,UTMAN KHEL TEHSIL,36,820,0,820
BAJAUR AGENCY,UTMAN KHEL TEHSIL,37,890,0,890
BAJAUR AGENCY,UTMAN KHEL TEHSIL,38,839,0,839
BAJAUR AGENCY,UTMAN KHEL TEHSIL,39,883,0,883
BAJAUR AGENCY,UTMAN KHEL TEHSIL,40,865,0,865
BAJAUR AGENCY,UTMAN KHEL TEHSIL,41,770,0,770
BAJAUR AGENCY,UTMAN KHEL TEHSIL,42,723,0,723
BAJAUR AGENCY,UTMAN KHEL TEHSIL,43,735,0,735
BAJAUR AGENCY,UTMAN KHEL TEHSIL,44,723,0,723
BAJAUR AGENCY,UTMAN KHEL TEHSIL,45,588,0,588
BAJAUR AGENCY,UTMAN KHEL TEHSIL,46,526,0,526
BAJAUR AGENCY,UTMAN KHEL TEHSIL,47,574,0,574
BAJAUR AGENCY,UTMAN KHEL TEHSIL,48,530,0,530
BAJAUR AGENCY,UTMAN KHEL TEHSIL,49,572,0,572
BAJAUR AGENCY,UTMAN KHEL TEHSIL,50,573,0,573
BAJAUR AGENCY,UTMAN KHEL TEHSIL,51,460,0,460
BAJAUR AGENCY,UTMAN KHEL TEHSIL,52,403,0,403
BAJAUR AGENCY,UTMAN KHEL TEHSIL,53,421,0,421
BAJAUR AGENCY,UTMAN KHEL TEHSIL,54,367,0,367
BAJAUR AGENCY,UTMAN KHEL TEHSIL,55,408,0,408
BAJAUR AGENCY,UTMAN KHEL TEHSIL,56,310,0,310
BAJAUR AGENCY,UTMAN KHEL TEHSIL,57,399,0,399
BAJAUR AGENCY,UTMAN KHEL TEHSIL,58,330,0,330
BAJAUR AGENCY,UTMAN KHEL TEHSIL,59,351,0,351
BAJAUR AGENCY,UTMAN KHEL TEHSIL,60,357,0,357
BAJAUR AGENCY,UTMAN KHEL TEHSIL,61,287,0,287
BAJAUR AGENCY,UTMAN KHEL TEHSIL,62,333,0,333
BAJAUR AGENCY,UTMAN KHEL TEHSIL,63,261,0,261
BAJAUR AGENCY,UTMAN KHEL TEHSIL,64,307,0,307
BAJAUR AGENCY,UTMAN KHEL TEHSIL,65,271,0,271
BAJAUR AGENCY,UTMAN KHEL TEHSIL,66,180,0,180
BAJAUR AGENCY,UTMAN KHEL TEHSIL,67,250,0,250
BAJAUR AGENCY,UTMAN KHEL TEHSIL,68,193,0,193
BAJAUR AGENCY,UTMAN KHEL TEHSIL,69,185,0,185
BAJAUR AGENCY,UTMAN KHEL TEHSIL,70,158,0,158
BAJAUR AGENCY,UTMAN KHEL TEHSIL,71,152,0,152
BAJAUR AGENCY,UTMAN KHEL TEHSIL,72,143,0,143
BAJAUR AGENCY,UTMAN KHEL TEHSIL,73,125,0,125
BAJAUR AGENCY,UTMAN KHEL TEHSIL,74,102,0,102
BAJAUR AGENCY,UTMAN KHEL TEHSIL,>=75,840,0,840
BANNU DISTRICT,BANNU TEHSIL,<1,24403,1008,25411
BANNU DISTRICT,BANNU TEHSIL,1,27159,1043,28202
BANNU DISTRICT,BANNU TEHSIL,2,32331,1232,33563
BANNU DISTRICT,BANNU TEHSIL,3,33785,1308,35093
BANNU DISTRICT,BANNU TEHSIL,4,34736,1275,36011
BANNU DISTRICT,BANNU TEHSIL,5,33481,1307,34788
BANNU DISTRICT,BANNU TEHSIL,6,32838,1230,34068
BANNU DISTRICT,BANNU TEHSIL,7,30953,1376,32329
BANNU DISTRICT,BANNU TEHSIL,8,32415,1194,33609
BANNU DISTRICT,BANNU TEHSIL,9,27709,1260,28969
BANNU DISTRICT,BANNU TEHSIL,10,28468,1157,29625
BANNU DISTRICT,BANNU TEHSIL,11,22655,1217,23872
BANNU DISTRICT,BANNU TEHSIL,12,23726,1100,24826
BANNU DISTRICT,BANNU TEHSIL,13,20996,1186,22182
BANNU DISTRICT,BANNU TEHSIL,14,20493,1103,21596
BANNU DISTRICT,BANNU TEHSIL,15,20127,1094,21221
BANNU DISTRICT,BANNU TEHSIL,16,18748,1092,19840
BANNU DISTRICT,BANNU TEHSIL,17,16626,1160,17786
BANNU DISTRICT,BANNU TEHSIL,18,19283,1036,20319
BANNU DISTRICT,BANNU TEHSIL,19,15924,1070,16994
BANNU DISTRICT,BANNU TEHSIL,20,19157,1013,20170
BANNU DISTRICT,BANNU TEHSIL,21,14789,1067,15856
BANNU DISTRICT,BANNU TEHSIL,22,15571,1028,16599
BANNU DISTRICT,BANNU TEHSIL,23,14429,1005,15434
BANNU DISTRICT,BANNU TEHSIL,24,13230,940,14170
BANNU DISTRICT,BANNU TEHSIL,25,17349,1065,18414
BANNU DISTRICT,BANNU TEHSIL,26,12984,956,13940
BANNU DISTRICT,BANNU TEHSIL,27,13102,989,14091
BANNU DISTRICT,BANNU TEHSIL,28,13836,963,14799
BANNU DISTRICT,BANNU TEHSIL,29,12222,950,13172
BANNU DISTRICT,BANNU TEHSIL,30,14968,926,15894
BANNU DISTRICT,BANNU TEHSIL,31,10732,822,11554
BANNU DISTRICT,BANNU TEHSIL,32,9342,757,10099
BANNU DISTRICT,BANNU TEHSIL,33,9345,812,10157
BANNU DISTRICT,BANNU TEHSIL,34,7649,629,8278
BANNU DISTRICT,BANNU TEHSIL,35,10483,712,11195
BANNU DISTRICT,BANNU TEHSIL,36,6629,571,7200
BANNU DISTRICT,BANNU TEHSIL,37,6782,578,7360
BANNU DISTRICT,BANNU TEHSIL,38,7957,643,8600
BANNU DISTRICT,BANNU TEHSIL,39,7293,552,7845
BANNU DISTRICT,BANNU TEHSIL,40,10700,679,11379
BANNU DISTRICT,BANNU TEHSIL,41,6939,469,7408
BANNU DISTRICT,BANNU TEHSIL,42,6197,495,6692
BANNU DISTRICT,BANNU TEHSIL,43,6656,458,7114
BANNU DISTRICT,BANNU TEHSIL,44,5572,394,5966
BANNU DISTRICT,BANNU TEHSIL,45,7272,453,7725
BANNU DISTRICT,BANNU TEHSIL,46,5015,301,5316
BANNU DISTRICT,BANNU TEHSIL,47,5358,368,5726
BANNU DISTRICT,BANNU TEHSIL,48,5400,330,5730
BANNU DISTRICT,BANNU TEHSIL,49,5083,337,5420
BANNU DISTRICT,BANNU TEHSIL,50,7771,474,8245
BANNU DISTRICT,BANNU TEHSIL,51,4640,296,4936
BANNU DISTRICT,BANNU TEHSIL,52,4468,308,4776
BANNU DISTRICT,BANNU TEHSIL,53,4832,290,5122
BANNU DISTRICT,BANNU TEHSIL,54,4252,286,4538
BANNU DISTRICT,BANNU TEHSIL,55,5543,304,5847
BANNU DISTRICT,BANNU TEHSIL,56,3577,210,3787
BANNU DISTRICT,BANNU TEHSIL,57,3596,213,3809
BANNU DISTRICT,BANNU TEHSIL,58,3812,212,4024
BANNU DISTRICT,BANNU TEHSIL,59,3480,235,3715
BANNU DISTRICT,BANNU TEHSIL,60,4893,233,5126
BANNU DISTRICT,BANNU TEHSIL,61,3549,206,3755
BANNU DISTRICT,BANNU TEHSIL,62,3358,160,3518
BANNU DISTRICT,BANNU TEHSIL,63,3440,207,3647
BANNU DISTRICT,BANNU TEHSIL,64,2875,173,3048
BANNU DISTRICT,BANNU TEHSIL,65,2954,148,3102
BANNU DISTRICT,BANNU TEHSIL,66,1958,123,2081
BANNU DISTRICT,BANNU TEHSIL,67,2093,134,2227
BANNU DISTRICT,BANNU TEHSIL,68,1889,104,1993
BANNU DISTRICT,BANNU TEHSIL,69,1660,108,1768
BANNU DISTRICT,BANNU TEHSIL,70,1919,102,2021
BANNU DISTRICT,BANNU TEHSIL,71,1377,66,1443
BANNU DISTRICT,BANNU TEHSIL,72,1294,57,1351
BANNU DISTRICT,BANNU TEHSIL,73,1313,78,1391
BANNU DISTRICT,BANNU TEHSIL,74,975,49,1024
BANNU DISTRICT,BANNU TEHSIL,>=75,7740,462,8202
BANNU DISTRICT,DOMEL TEHSIL,<1,4846,0,4846
BANNU DISTRICT,DOMEL TEHSIL,1,5998,0,5998
BANNU DISTRICT,DOMEL TEHSIL,2,7218,0,7218
BANNU DISTRICT,DOMEL TEHSIL,3,7299,0,7299
BANNU DISTRICT,DOMEL TEHSIL,4,7589,0,7589
BANNU DISTRICT,DOMEL TEHSIL,5,7664,0,7664
BANNU DISTRICT,DOMEL TEHSIL,6,7338,0,7338
BANNU DISTRICT,DOMEL TEHSIL,7,7168,0,7168
BANNU DISTRICT,DOMEL TEHSIL,8,7435,0,7435
BANNU DISTRICT,DOMEL TEHSIL,9,6477,0,6477
BANNU DISTRICT,DOMEL TEHSIL,10,6590,0,6590
BANNU DISTRICT,DOMEL TEHSIL,11,5617,0,5617
BANNU DISTRICT,DOMEL TEHSIL,12,5809,0,5809
BANNU DISTRICT,DOMEL TEHSIL,13,5246,0,5246
BANNU DISTRICT,DOMEL TEHSIL,14,5209,0,5209
BANNU DISTRICT,DOMEL TEHSIL,15,5229,0,5229
BANNU DISTRICT,DOMEL TEHSIL,16,4996,0,4996
BANNU DISTRICT,DOMEL TEHSIL,17,4472,0,4472
BANNU DISTRICT,DOMEL TEHSIL,18,4920,0,4920
BANNU DISTRICT,DOMEL TEHSIL,19,4059,0,4059
BANNU DISTRICT,DOMEL TEHSIL,20,4461,0,4461
BANNU DISTRICT,DOMEL TEHSIL,21,3520,0,3520
BANNU DISTRICT,DOMEL TEHSIL,22,3843,0,3843
BANNU DISTRICT,DOMEL TEHSIL,23,3409,0,3409
BANNU DISTRICT,DOMEL TEHSIL,24,3050,0,3050
BANNU DISTRICT,DOMEL TEHSIL,25,4055,0,4055
BANNU DISTRICT,DOMEL TEHSIL,26,2920,0,2920
BANNU DISTRICT,DOMEL TEHSIL,27,2927,0,2927
BANNU DISTRICT,DOMEL TEHSIL,28,3064,0,3064
BANNU DISTRICT,DOMEL TEHSIL,29,2451,0,2451
BANNU DISTRICT,DOMEL TEHSIL,30,3164,0,3164
BANNU DISTRICT,DOMEL TEHSIL,31,2120,0,2120
BANNU DISTRICT,DOMEL TEHSIL,32,2022,0,2022
BANNU DISTRICT,DOMEL TEHSIL,33,1991,0,1991
BANNU DISTRICT,DOMEL TEHSIL,34,1452,0,1452
BANNU DISTRICT,DOMEL TEHSIL,35,2378,0,2378
BANNU DISTRICT,DOMEL TEHSIL,36,1334,0,1334
BANNU DISTRICT,DOMEL TEHSIL,37,1349,0,1349
BANNU DISTRICT,DOMEL TEHSIL,38,1702,0,1702
BANNU DISTRICT,DOMEL TEHSIL,39,1439,0,1439
BANNU DISTRICT,DOMEL TEHSIL,40,2525,0,2525
BANNU DISTRICT,DOMEL TEHSIL,41,1439,0,1439
BANNU DISTRICT,DOMEL TEHSIL,42,1314,0,1314
BANNU DISTRICT,DOMEL TEHSIL,43,1441,0,1441
BANNU DISTRICT,DOMEL TEHSIL,44,1033,0,1033
BANNU DISTRICT,DOMEL TEHSIL,45,1836,0,1836
BANNU DISTRICT,DOMEL TEHSIL,46,934,0,934
BANNU DISTRICT,DOMEL TEHSIL,47,998,0,998
BANNU DISTRICT,DOMEL TEHSIL,48,1212,0,1212
BANNU DISTRICT,DOMEL TEHSIL,49,1012,0,1012
BANNU DISTRICT,DOMEL TEHSIL,50,1832,0,1832
BANNU DISTRICT,DOMEL TEHSIL,51,889,0,889
BANNU DISTRICT,DOMEL TEHSIL,52,914,0,914
BANNU DISTRICT,DOMEL TEHSIL,53,1068,0,1068
BANNU DISTRICT,DOMEL TEHSIL,54,948,0,948
BANNU DISTRICT,DOMEL TEHSIL,55,1333,0,1333
BANNU DISTRICT,DOMEL TEHSIL,56,765,0,765
BANNU DISTRICT,DOMEL TEHSIL,57,697,0,697
BANNU DISTRICT,DOMEL TEHSIL,58,904,0,904
BANNU DISTRICT,DOMEL TEHSIL,59,736,0,736
BANNU DISTRICT,DOMEL TEHSIL,60,1195,0,1195
BANNU DISTRICT,DOMEL TEHSIL,61,794,0,794
BANNU DISTRICT,DOMEL TEHSIL,62,728,0,728
BANNU DISTRICT,DOMEL TEHSIL,63,783,0,783
BANNU DISTRICT,DOMEL TEHSIL,64,649,0,649
BANNU DISTRICT,DOMEL TEHSIL,65,778,0,778
BANNU DISTRICT,DOMEL TEHSIL,66,480,0,480
BANNU DISTRICT,DOMEL TEHSIL,67,451,0,451
BANNU DISTRICT,DOMEL TEHSIL,68,461,0,461
BANNU DISTRICT,DOMEL TEHSIL,69,409,0,409
BANNU DISTRICT,DOMEL TEHSIL,70,561,0,561
BANNU DISTRICT,DOMEL TEHSIL,71,351,0,351
BANNU DISTRICT,DOMEL TEHSIL,72,331,0,331
BANNU DISTRICT,DOMEL TEHSIL,73,325,0,325
BANNU DISTRICT,DOMEL TEHSIL,74,267,0,267
BANNU DISTRICT,DOMEL TEHSIL,>=75,2745,0,2745
BARKHAN DISTRICT,BARKHAN TEHSIL,<1,5091,312,5403
BARKHAN DISTRICT,BARKHAN TEHSIL,1,5374,326,5700
BARKHAN DISTRICT,BARKHAN TEHSIL,2,7159,488,7647
BARKHAN DISTRICT,BARKHAN TEHSIL,3,6170,386,6556
BARKHAN DISTRICT,BARKHAN TEHSIL,4,7401,509,7910
BARKHAN DISTRICT,BARKHAN TEHSIL,5,5932,391,6323
BARKHAN DISTRICT,BARKHAN TEHSIL,6,7209,439,7648
BARKHAN DISTRICT,BARKHAN TEHSIL,7,5056,350,5406
BARKHAN DISTRICT,BARKHAN TEHSIL,8,6732,430,7162
BARKHAN DISTRICT,BARKHAN TEHSIL,9,4720,346,5066
BARKHAN DISTRICT,BARKHAN TEHSIL,10,5651,432,6083
BARKHAN DISTRICT,BARKHAN TEHSIL,11,3304,332,3636
BARKHAN DISTRICT,BARKHAN TEHSIL,12,3955,359,4314
BARKHAN DISTRICT,BARKHAN TEHSIL,13,2567,273,2840
BARKHAN DISTRICT,BARKHAN TEHSIL,14,3134,293,3427
BARKHAN DISTRICT,BARKHAN TEHSIL,15,2529,265,2794
BARKHAN DISTRICT,BARKHAN TEHSIL,16,2660,258,2918
BARKHAN DISTRICT,BARKHAN TEHSIL,17,1836,261,2097
BARKHAN DISTRICT,BARKHAN TEHSIL,18,3213,212,3425
BARKHAN DISTRICT,BARKHAN TEHSIL,19,2147,202,2349
BARKHAN DISTRICT,BARKHAN TEHSIL,20,2956,188,3144
BARKHAN DISTRICT,BARKHAN TEHSIL,21,2001,182,2183
BARKHAN DISTRICT,BARKHAN TEHSIL,22,1942,171,2113
BARKHAN DISTRICT,BARKHAN TEHSIL,23,1864,162,2026
BARKHAN DISTRICT,BARKHAN TEHSIL,24,1763,185,1948
BARKHAN DISTRICT,BARKHAN TEHSIL,25,2826,166,2992
BARKHAN DISTRICT,BARKHAN TEHSIL,26,1874,160,2034
BARKHAN DISTRICT,BARKHAN TEHSIL,27,2101,176,2277
BARKHAN DISTRICT,BARKHAN TEHSIL,28,2248,182,2430
BARKHAN DISTRICT,BARKHAN TEHSIL,29,2482,204,2686
BARKHAN DISTRICT,BARKHAN TEHSIL,30,2371,156,2527
BARKHAN DISTRICT,BARKHAN TEHSIL,31,2198,185,2383
BARKHAN DISTRICT,BARKHAN TEHSIL,32,1985,124,2109
BARKHAN DISTRICT,BARKHAN TEHSIL,33,1654,149,1803
BARKHAN DISTRICT,BARKHAN TEHSIL,34,1398,110,1508
BARKHAN DISTRICT,BARKHAN TEHSIL,35,1693,96,1789
BARKHAN DISTRICT,BARKHAN TEHSIL,36,1469,137,1606
BARKHAN DISTRICT,BARKHAN TEHSIL,37,2133,141,2274
BARKHAN DISTRICT,BARKHAN TEHSIL,38,1547,128,1675
BARKHAN DISTRICT,BARKHAN TEHSIL,39,1596,135,1731
BARKHAN DISTRICT,BARKHAN TEHSIL,40,1602,113,1715
BARKHAN DISTRICT,BARKHAN TEHSIL,41,1288,145,1433
BARKHAN DISTRICT,BARKHAN TEHSIL,42,1268,96,1364
BARKHAN DISTRICT,BARKHAN TEHSIL,43,1008,89,1097
BARKHAN DISTRICT,BARKHAN TEHSIL,44,887,65,952
BARKHAN DISTRICT,BARKHAN TEHSIL,45,1127,72,1199
BARKHAN DISTRICT,BARKHAN TEHSIL,46,1028,90,1118
BARKHAN DISTRICT,BARKHAN TEHSIL,47,1390,95,1485
BARKHAN DISTRICT,BARKHAN TEHSIL,48,881,101,982
BARKHAN DISTRICT,BARKHAN TEHSIL,49,1003,82,1085
BARKHAN DISTRICT,BARKHAN TEHSIL,50,1095,75,1170
BARKHAN DISTRICT,BARKHAN TEHSIL,51,849,87,936
BARKHAN DISTRICT,BARKHAN TEHSIL,52,788,62,850
BARKHAN DISTRICT,BARKHAN TEHSIL,53,652,51,703
BARKHAN DISTRICT,BARKHAN TEHSIL,54,630,52,682
BARKHAN DISTRICT,BARKHAN TEHSIL,55,667,50,717
BARKHAN DISTRICT,BARKHAN TEHSIL,56,570,66,636
BARKHAN DISTRICT,BARKHAN TEHSIL,57,848,68,916
BARKHAN DISTRICT,BARKHAN TEHSIL,58,487,45,532
BARKHAN DISTRICT,BARKHAN TEHSIL,59,654,56,710
BARKHAN DISTRICT,BARKHAN TEHSIL,60,660,49,709
BARKHAN DISTRICT,BARKHAN TEHSIL,61,566,50,616
BARKHAN DISTRICT,BARKHAN TEHSIL,62,515,34,549
BARKHAN DISTRICT,BARKHAN TEHSIL,63,477,62,539
BARKHAN DISTRICT,BARKHAN TEHSIL,64,589,44,633
BARKHAN DISTRICT,BARKHAN TEHSIL,65,441,48,489
BARKHAN DISTRICT,BARKHAN TEHSIL,66,327,39,366
BARKHAN DISTRICT,BARKHAN TEHSIL,67,498,33,531
BARKHAN DISTRICT,BARKHAN TEHSIL,68,341,29,370
BARKHAN DISTRICT,BARKHAN TEHSIL,69,458,26,484
BARKHAN DISTRICT,BARKHAN TEHSIL,70,371,22,393
BARKHAN DISTRICT,BARKHAN TEHSIL,71,281,20,301
BARKHAN DISTRICT,BARKHAN TEHSIL,72,252,18,270
BARKHAN DISTRICT,BARKHAN TEHSIL,73,211,14,225
BARKHAN DISTRICT,BARKHAN TEHSIL,74,287,13,300
BARKHAN DISTRICT,BARKHAN TEHSIL,>=75,1887,139,2026
BATAGRAM DISTRICT,ALLAI TEHSIL,<1,5668,0,5668
BATAGRAM DISTRICT,ALLAI TEHSIL,1,5637,0,5637
BATAGRAM DISTRICT,ALLAI TEHSIL,2,6630,0,6630
BATAGRAM DISTRICT,ALLAI TEHSIL,3,6464,0,6464
BATAGRAM DISTRICT,ALLAI TEHSIL,4,6935,0,6935
BATAGRAM DISTRICT,ALLAI TEHSIL,5,6322,0,6322
BATAGRAM DISTRICT,ALLAI TEHSIL,6,6956,0,6956
BATAGRAM DISTRICT,ALLAI TEHSIL,7,6306,0,6306
BATAGRAM DISTRICT,ALLAI TEHSIL,8,7061,0,7061
BATAGRAM DISTRICT,ALLAI TEHSIL,9,6171,0,6171
BATAGRAM DISTRICT,ALLAI TEHSIL,10,6235,0,6235
BATAGRAM DISTRICT,ALLAI TEHSIL,11,5153,0,5153
BATAGRAM DISTRICT,ALLAI TEHSIL,12,5439,0,5439
BATAGRAM DISTRICT,ALLAI TEHSIL,13,4459,0,4459
BATAGRAM DISTRICT,ALLAI TEHSIL,14,4291,0,4291
BATAGRAM DISTRICT,ALLAI TEHSIL,15,3929,0,3929
BATAGRAM DISTRICT,ALLAI TEHSIL,16,3602,0,3602
BATAGRAM DISTRICT,ALLAI TEHSIL,17,3121,0,3121
BATAGRAM DISTRICT,ALLAI TEHSIL,18,3697,0,3697
BATAGRAM DISTRICT,ALLAI TEHSIL,19,3459,0,3459
BATAGRAM DISTRICT,ALLAI TEHSIL,20,3363,0,3363
BATAGRAM DISTRICT,ALLAI TEHSIL,21,3110,0,3110
BATAGRAM DISTRICT,ALLAI TEHSIL,22,2582,0,2582
BATAGRAM DISTRICT,ALLAI TEHSIL,23,2450,0,2450
BATAGRAM DISTRICT,ALLAI TEHSIL,24,2317,0,2317
BATAGRAM DISTRICT,ALLAI TEHSIL,25,2503,0,2503
BATAGRAM DISTRICT,ALLAI TEHSIL,26,2559,0,2559
BATAGRAM DISTRICT,ALLAI TEHSIL,27,2165,0,2165
BATAGRAM DISTRICT,ALLAI TEHSIL,28,2009,0,2009
BATAGRAM DISTRICT,ALLAI TEHSIL,29,2340,0,2340
BATAGRAM DISTRICT,ALLAI TEHSIL,30,2009,0,2009
BATAGRAM DISTRICT,ALLAI TEHSIL,31,2694,0,2694
BATAGRAM DISTRICT,ALLAI TEHSIL,32,1930,0,1930
BATAGRAM DISTRICT,ALLAI TEHSIL,33,1796,0,1796
BATAGRAM DISTRICT,ALLAI TEHSIL,34,1725,0,1725
BATAGRAM DISTRICT,ALLAI TEHSIL,35,1382,0,1382
BATAGRAM DISTRICT,ALLAI TEHSIL,36,2197,0,2197
BATAGRAM DISTRICT,ALLAI TEHSIL,37,1778,0,1778
BATAGRAM DISTRICT,ALLAI TEHSIL,38,1506,0,1506
BATAGRAM DISTRICT,ALLAI TEHSIL,39,1457,0,1457
BATAGRAM DISTRICT,ALLAI TEHSIL,40,1156,0,1156
BATAGRAM DISTRICT,ALLAI TEHSIL,41,1843,0,1843
BATAGRAM DISTRICT,ALLAI TEHSIL,42,1340,0,1340
BATAGRAM DISTRICT,ALLAI TEHSIL,43,1186,0,1186
BATAGRAM DISTRICT,ALLAI TEHSIL,44,1192,0,1192
BATAGRAM DISTRICT,ALLAI TEHSIL,45,765,0,765
BATAGRAM DISTRICT,ALLAI TEHSIL,46,1345,0,1345
BATAGRAM DISTRICT,ALLAI TEHSIL,47,1095,0,1095
BATAGRAM DISTRICT,ALLAI TEHSIL,48,961,0,961
BATAGRAM DISTRICT,ALLAI TEHSIL,49,981,0,981
BATAGRAM DISTRICT,ALLAI TEHSIL,50,752,0,752
BATAGRAM DISTRICT,ALLAI TEHSIL,51,1102,0,1102
BATAGRAM DISTRICT,ALLAI TEHSIL,52,782,0,782
BATAGRAM DISTRICT,ALLAI TEHSIL,53,818,0,818
BATAGRAM DISTRICT,ALLAI TEHSIL,54,680,0,680
BATAGRAM DISTRICT,ALLAI TEHSIL,55,455,0,455
BATAGRAM DISTRICT,ALLAI TEHSIL,56,757,0,757
BATAGRAM DISTRICT,ALLAI TEHSIL,57,566,0,566
BATAGRAM DISTRICT,ALLAI TEHSIL,58,548,0,548
BATAGRAM DISTRICT,ALLAI TEHSIL,59,544,0,544
BATAGRAM DISTRICT,ALLAI TEHSIL,60,495,0,495
BATAGRAM DISTRICT,ALLAI TEHSIL,61,801,0,801
BATAGRAM DISTRICT,ALLAI TEHSIL,62,527,0,527
BATAGRAM DISTRICT,ALLAI TEHSIL,63,618,0,618
BATAGRAM DISTRICT,ALLAI TEHSIL,64,526,0,526
BATAGRAM DISTRICT,ALLAI TEHSIL,65,368,0,368
BATAGRAM DISTRICT,ALLAI TEHSIL,66,819,0,819
BATAGRAM DISTRICT,ALLAI TEHSIL,67,524,0,524
BATAGRAM DISTRICT,ALLAI TEHSIL,68,455,0,455
BATAGRAM DISTRICT,ALLAI TEHSIL,69,397,0,397
BATAGRAM DISTRICT,ALLAI TEHSIL,70,383,0,383
BATAGRAM DISTRICT,ALLAI TEHSIL,71,677,0,677
BATAGRAM DISTRICT,ALLAI TEHSIL,72,385,0,385
BATAGRAM DISTRICT,ALLAI TEHSIL,73,338,0,338
BATAGRAM DISTRICT,ALLAI TEHSIL,74,260,0,260
BATAGRAM DISTRICT,ALLAI TEHSIL,>=75,2654,0,2654
BATAGRAM DISTRICT,BATAGRAM TEHSIL,<1,8558,0,8558
BATAGRAM DISTRICT,BATAGRAM TEHSIL,1,8573,0,8573
BATAGRAM DISTRICT,BATAGRAM TEHSIL,2,9769,0,9769
BATAGRAM DISTRICT,BATAGRAM TEHSIL,3,9580,0,9580
BATAGRAM DISTRICT,BATAGRAM TEHSIL,4,10425,0,10425
BATAGRAM DISTRICT,BATAGRAM TEHSIL,5,9590,0,9590
BATAGRAM DISTRICT,BATAGRAM TEHSIL,6,9951,0,9951
BATAGRAM DISTRICT,BATAGRAM TEHSIL,7,10140,0,10140
BATAGRAM DISTRICT,BATAGRAM TEHSIL,8,10673,0,10673
BATAGRAM DISTRICT,BATAGRAM TEHSIL,9,9468,0,9468
BATAGRAM DISTRICT,BATAGRAM TEHSIL,10,9190,0,9190
BATAGRAM DISTRICT,BATAGRAM TEHSIL,11,8270,0,8270
BATAGRAM DISTRICT,BATAGRAM TEHSIL,12,8323,0,8323
BATAGRAM DISTRICT,BATAGRAM TEHSIL,13,7637,0,7637
BATAGRAM DISTRICT,BATAGRAM TEHSIL,14,7148,0,7148
BATAGRAM DISTRICT,BATAGRAM TEHSIL,15,7200,0,7200
BATAGRAM DISTRICT,BATAGRAM TEHSIL,16,6453,0,6453
BATAGRAM DISTRICT,BATAGRAM TEHSIL,17,6096,0,6096
BATAGRAM DISTRICT,BATAGRAM TEHSIL,18,6139,0,6139
BATAGRAM DISTRICT,BATAGRAM TEHSIL,19,5882,0,5882
BATAGRAM DISTRICT,BATAGRAM TEHSIL,20,5925,0,5925
BATAGRAM DISTRICT,BATAGRAM TEHSIL,21,5186,0,5186
BATAGRAM DISTRICT,BATAGRAM TEHSIL,22,4830,0,4830
BATAGRAM DISTRICT,BATAGRAM TEHSIL,23,4261,0,4261
BATAGRAM DISTRICT,BATAGRAM TEHSIL,24,4290,0,4290
BATAGRAM DISTRICT,BATAGRAM TEHSIL,25,4389,0,4389
BATAGRAM DISTRICT,BATAGRAM TEHSIL,26,4460,0,4460
BATAGRAM DISTRICT,BATAGRAM TEHSIL,27,3664,0,3664
BATAGRAM DISTRICT,BATAGRAM TEHSIL,28,4061,0,4061
BATAGRAM DISTRICT,BATAGRAM TEHSIL,29,4161,0,4161
BATAGRAM DISTRICT,BATAGRAM TEHSIL,30,3831,0,3831
BATAGRAM DISTRICT,BATAGRAM TEHSIL,31,4336,0,4336
BATAGRAM DISTRICT,BATAGRAM TEHSIL,32,3267,0,3267
BATAGRAM DISTRICT,BATAGRAM TEHSIL,33,3173,0,3173
BATAGRAM DISTRICT,BATAGRAM TEHSIL,34,2973,0,2973
BATAGRAM DISTRICT,BATAGRAM TEHSIL,35,2597,0,2597
BATAGRAM DISTRICT,BATAGRAM TEHSIL,36,3333,0,3333
BATAGRAM DISTRICT,BATAGRAM TEHSIL,37,2641,0,2641
BATAGRAM DISTRICT,BATAGRAM TEHSIL,38,2650,0,2650
BATAGRAM DISTRICT,BATAGRAM TEHSIL,39,2454,0,2454
BATAGRAM DISTRICT,BATAGRAM TEHSIL,40,2355,0,2355
BATAGRAM DISTRICT,BATAGRAM TEHSIL,41,2755,0,2755
BATAGRAM DISTRICT,BATAGRAM TEHSIL,42,2035,0,2035
BATAGRAM DISTRICT,BATAGRAM TEHSIL,43,2194,0,2194
BATAGRAM DISTRICT,BATAGRAM TEHSIL,44,2054,0,2054
BATAGRAM DISTRICT,BATAGRAM TEHSIL,45,1684,0,1684
BATAGRAM DISTRICT,BATAGRAM TEHSIL,46,2315,0,2315
BATAGRAM DISTRICT,BATAGRAM TEHSIL,47,1702,0,1702
BATAGRAM DISTRICT,BATAGRAM TEHSIL,48,1867,0,1867
BATAGRAM DISTRICT,BATAGRAM TEHSIL,49,1813,0,1813
BATAGRAM DISTRICT,BATAGRAM TEHSIL,50,1618,0,1618
BATAGRAM DISTRICT,BATAGRAM TEHSIL,51,1881,0,1881
BATAGRAM DISTRICT,BATAGRAM TEHSIL,52,1380,0,1380
BATAGRAM DISTRICT,BATAGRAM TEHSIL,53,1576,0,1576
BATAGRAM DISTRICT,BATAGRAM TEHSIL,54,1357,0,1357
BATAGRAM DISTRICT,BATAGRAM TEHSIL,55,1109,0,1109
BATAGRAM DISTRICT,BATAGRAM TEHSIL,56,1184,0,1184
BATAGRAM DISTRICT,BATAGRAM TEHSIL,57,947,0,947
BATAGRAM DISTRICT,BATAGRAM TEHSIL,58,933,0,933
BATAGRAM DISTRICT,BATAGRAM TEHSIL,59,1008,0,1008
BATAGRAM DISTRICT,BATAGRAM TEHSIL,60,1009,0,1009
BATAGRAM DISTRICT,BATAGRAM TEHSIL,61,1292,0,1292
BATAGRAM DISTRICT,BATAGRAM TEHSIL,62,1074,0,1074
BATAGRAM DISTRICT,BATAGRAM TEHSIL,63,1006,0,1006
BATAGRAM DISTRICT,BATAGRAM TEHSIL,64,986,0,986
BATAGRAM DISTRICT,BATAGRAM TEHSIL,65,753,0,753
BATAGRAM DISTRICT,BATAGRAM TEHSIL,66,1066,0,1066
BATAGRAM DISTRICT,BATAGRAM TEHSIL,67,919,0,919
BATAGRAM DISTRICT,BATAGRAM TEHSIL,68,801,0,801
BATAGRAM DISTRICT,BATAGRAM TEHSIL,69,679,0,679
BATAGRAM DISTRICT,BATAGRAM TEHSIL,70,610,0,610
BATAGRAM DISTRICT,BATAGRAM TEHSIL,71,910,0,910
BATAGRAM DISTRICT,BATAGRAM TEHSIL,72,757,0,757
BATAGRAM DISTRICT,BATAGRAM TEHSIL,73,538,0,538
BATAGRAM DISTRICT,BATAGRAM TEHSIL,74,445,0,445
BATAGRAM DISTRICT,BATAGRAM TEHSIL,>=75,4088,0,4088
BHAKKAR DISTRICT,BHAKKAR TEHSIL,<1,13819,2447,16266
BHAKKAR DISTRICT,BHAKKAR TEHSIL,1,16035,2637,18672
BHAKKAR DISTRICT,BHAKKAR TEHSIL,2,16149,2663,18812
BHAKKAR DISTRICT,BHAKKAR TEHSIL,3,17680,2769,20449
BHAKKAR DISTRICT,BHAKKAR TEHSIL,4,17960,2775,20735
BHAKKAR DISTRICT,BHAKKAR TEHSIL,5,17391,2731,20122
BHAKKAR DISTRICT,BHAKKAR TEHSIL,6,16525,2593,19118
BHAKKAR DISTRICT,BHAKKAR TEHSIL,7,17695,2792,20487
BHAKKAR DISTRICT,BHAKKAR TEHSIL,8,16492,2571,19063
BHAKKAR DISTRICT,BHAKKAR TEHSIL,9,16655,2826,19481
BHAKKAR DISTRICT,BHAKKAR TEHSIL,10,15114,2322,17436
BHAKKAR DISTRICT,BHAKKAR TEHSIL,11,14917,2903,17820
BHAKKAR DISTRICT,BHAKKAR TEHSIL,12,13636,2345,15981
BHAKKAR DISTRICT,BHAKKAR TEHSIL,13,13095,2486,15581
BHAKKAR DISTRICT,BHAKKAR TEHSIL,14,12690,2405,15095
BHAKKAR DISTRICT,BHAKKAR TEHSIL,15,12442,2436,14878
BHAKKAR DISTRICT,BHAKKAR TEHSIL,16,12484,2497,14981
BHAKKAR DISTRICT,BHAKKAR TEHSIL,17,12145,2639,14784
BHAKKAR DISTRICT,BHAKKAR TEHSIL,18,11092,2226,13318
BHAKKAR DISTRICT,BHAKKAR TEHSIL,19,11026,2613,13639
BHAKKAR DISTRICT,BHAKKAR TEHSIL,20,10568,2176,12744
BHAKKAR DISTRICT,BHAKKAR TEHSIL,21,10266,2583,12849
BHAKKAR DISTRICT,BHAKKAR TEHSIL,22,9607,2208,11815
BHAKKAR DISTRICT,BHAKKAR TEHSIL,23,9628,2339,11967
BHAKKAR DISTRICT,BHAKKAR TEHSIL,24,9568,2189,11757
BHAKKAR DISTRICT,BHAKKAR TEHSIL,25,8864,1942,10806
BHAKKAR DISTRICT,BHAKKAR TEHSIL,26,9161,2005,11166
BHAKKAR DISTRICT,BHAKKAR TEHSIL,27,9172,2072,11244
BHAKKAR DISTRICT,BHAKKAR TEHSIL,28,8042,1895,9937
BHAKKAR DISTRICT,BHAKKAR TEHSIL,29,8510,1768,10278
BHAKKAR DISTRICT,BHAKKAR TEHSIL,30,7146,1524,8670
BHAKKAR DISTRICT,BHAKKAR TEHSIL,31,7828,1679,9507
BHAKKAR DISTRICT,BHAKKAR TEHSIL,32,6854,1660,8514
BHAKKAR DISTRICT,BHAKKAR TEHSIL,33,6600,1500,8100
BHAKKAR DISTRICT,BHAKKAR TEHSIL,34,7502,1597,9099
BHAKKAR DISTRICT,BHAKKAR TEHSIL,35,6081,1226,7307
BHAKKAR DISTRICT,BHAKKAR TEHSIL,36,7726,1435,9161
BHAKKAR DISTRICT,BHAKKAR TEHSIL,37,6700,1236,7936
BHAKKAR DISTRICT,BHAKKAR TEHSIL,38,5892,1353,7245
BHAKKAR DISTRICT,BHAKKAR TEHSIL,39,5948,1277,7225
BHAKKAR DISTRICT,BHAKKAR TEHSIL,40,4745,1076,5821
BHAKKAR DISTRICT,BHAKKAR TEHSIL,41,5683,1166,6849
BHAKKAR DISTRICT,BHAKKAR TEHSIL,42,4894,1043,5937
BHAKKAR DISTRICT,BHAKKAR TEHSIL,43,4668,1069,5737
BHAKKAR DISTRICT,BHAKKAR TEHSIL,44,4835,1146,5981
BHAKKAR DISTRICT,BHAKKAR TEHSIL,45,3836,890,4726
BHAKKAR DISTRICT,BHAKKAR TEHSIL,46,5228,1114,6342
BHAKKAR DISTRICT,BHAKKAR TEHSIL,47,4722,938,5660
BHAKKAR DISTRICT,BHAKKAR TEHSIL,48,4514,1085,5599
BHAKKAR DISTRICT,BHAKKAR TEHSIL,49,4755,1080,5835
BHAKKAR DISTRICT,BHAKKAR TEHSIL,50,3851,946,4797
BHAKKAR DISTRICT,BHAKKAR TEHSIL,51,4731,1044,5775
BHAKKAR DISTRICT,BHAKKAR TEHSIL,52,4058,934,4992
BHAKKAR DISTRICT,BHAKKAR TEHSIL,53,4128,931,5059
BHAKKAR DISTRICT,BHAKKAR TEHSIL,54,3630,870,4500
BHAKKAR DISTRICT,BHAKKAR TEHSIL,55,2637,700,3337
BHAKKAR DISTRICT,BHAKKAR TEHSIL,56,2932,805,3737
BHAKKAR DISTRICT,BHAKKAR TEHSIL,57,2407,645,3052
BHAKKAR DISTRICT,BHAKKAR TEHSIL,58,2263,621,2884
BHAKKAR DISTRICT,BHAKKAR TEHSIL,59,2331,614,2945
BHAKKAR DISTRICT,BHAKKAR TEHSIL,60,2023,516,2539
BHAKKAR DISTRICT,BHAKKAR TEHSIL,61,2607,567,3174
BHAKKAR DISTRICT,BHAKKAR TEHSIL,62,2336,567,2903
BHAKKAR DISTRICT,BHAKKAR TEHSIL,63,2358,549,2907
BHAKKAR DISTRICT,BHAKKAR TEHSIL,64,2182,490,2672
BHAKKAR DISTRICT,BHAKKAR TEHSIL,65,1705,334,2039
BHAKKAR DISTRICT,BHAKKAR TEHSIL,66,1999,371,2370
BHAKKAR DISTRICT,BHAKKAR TEHSIL,67,1703,296,1999
BHAKKAR DISTRICT,BHAKKAR TEHSIL,68,1602,342,1944
BHAKKAR DISTRICT,BHAKKAR TEHSIL,69,1643,268,1911
BHAKKAR DISTRICT,BHAKKAR TEHSIL,70,1248,230,1478
BHAKKAR DISTRICT,BHAKKAR TEHSIL,71,1489,276,1765
BHAKKAR DISTRICT,BHAKKAR TEHSIL,72,1152,222,1374
BHAKKAR DISTRICT,BHAKKAR TEHSIL,73,1140,250,1390
BHAKKAR DISTRICT,BHAKKAR TEHSIL,74,957,156,1113
BHAKKAR DISTRICT,BHAKKAR TEHSIL,>=75,7435,1316,8751
BHAKKAR DISTRICT,DARYA KHAN TEHSIL,<1,6211,1840,8051
BHAKKAR DISTRICT,DARYA KHAN TEHSIL,1,7255,2025,9280
BHAKKAR DISTRICT,DARYA KHAN TEHSIL,2,7931,2069,10000
BHAKKAR DISTRICT,DARYA KHAN TEHSIL,3,8366,2185,10551
BHAKKAR DISTRICT,DARYA KHAN TEHSIL,4,8554,2132,10686
BHAKKAR DISTRICT,DARYA KHAN TEHSIL,5,8508,2104,10612
BHAKKAR DISTRICT,DARYA KHAN TEHSIL,6,7731,2015,9746
BHAKKAR DISTRICT,DARYA KHAN TEHSIL,7,8698,2093,10791
BHAKKAR DISTRICT,DARYA KHAN TEHSIL,8,8112,1955,10067
BHAKKAR DISTRICT,DARYA KHAN TEHSIL,9,7896,2127,10023
BHAKKAR DISTRICT,DARYA KHAN TEHSIL,10,7610,1827,9437
BHAKKAR DISTRICT,DARYA KHAN TEHSIL,11,6834,1999,8833
BHAKKAR DISTRICT,DARYA KHAN TEHSIL,12,6755,1770,8525
BHAKKAR DISTRICT,DARYA KHAN TEHSIL,13,6188,1946,8134
BHAKKAR DISTRICT,DARYA KHAN TEHSIL,14,6114,1817,7931
BHAKKAR DISTRICT,DARYA KHAN TEHSIL,15,6042,1894,7936
BHAKKAR DISTRICT,DARYA KHAN TEHSIL,16,6077,1766,7843
BHAKKAR DISTRICT,DARYA KHAN TEHSIL,17,5943,1924,7867
BHAKKAR DISTRICT,DARYA KHAN TEHSIL,18,5589,1616,7205
BHAKKAR DISTRICT,DARYA KHAN TEHSIL,19,5101,1764,6865
BHAKKAR DISTRICT,DARYA KHAN TEHSIL,20,5626,1565,7191
BHAKKAR DISTRICT,DARYA KHAN TEHSIL,21,4945,1685,6630
BHAKKAR DISTRICT,DARYA KHAN TEHSIL,22,4797,1500,6297
BHAKKAR DISTRICT,DARYA KHAN TEHSIL,23,4732,1498,6230
BHAKKAR DISTRICT,DARYA KHAN TEHSIL,24,4435,1495,5930
BHAKKAR DISTRICT,DARYA KHAN TEHSIL,25,4766,1365,6131
BHAKKAR DISTRICT,DARYA KHAN TEHSIL,26,4479,1379,5858
BHAKKAR DISTRICT,DARYA KHAN TEHSIL,27,4334,1494,5828
BHAKKAR DISTRICT,DARYA KHAN TEHSIL,28,4061,1336,5397
BHAKKAR DISTRICT,DARYA KHAN TEHSIL,29,4090,1401,5491
BHAKKAR DISTRICT,DARYA KHAN TEHSIL,30,4182,1101,5283
BHAKKAR DISTRICT,DARYA KHAN TEHSIL,31,3538,1157,4695
BHAKKAR DISTRICT,DARYA KHAN TEHSIL,32,3334,1097,4431
BHAKKAR DISTRICT,DARYA KHAN TEHSIL,33,3077,972,4049
BHAKKAR DISTRICT,DARYA KHAN TEHSIL,34,3093,945,4038
BHAKKAR DISTRICT,DARYA KHAN TEHSIL,35,3504,1009,4513
BHAKKAR DISTRICT,DARYA KHAN TEHSIL,36,3419,1020,4439
BHAKKAR DISTRICT,DARYA KHAN TEHSIL,37,3503,1069,4572
BHAKKAR DISTRICT,DARYA KHAN TEHSIL,38,3148,921,4069
BHAKKAR DISTRICT,DARYA KHAN TEHSIL,39,3099,947,4046
BHAKKAR DISTRICT,DARYA KHAN TEHSIL,40,2972,773,3745
BHAKKAR DISTRICT,DARYA KHAN TEHSIL,41,2751,860,3611
BHAKKAR DISTRICT,DARYA KHAN TEHSIL,42,2431,780,3211
BHAKKAR DISTRICT,DARYA KHAN TEHSIL,43,2459,706,3165
BHAKKAR DISTRICT,DARYA KHAN TEHSIL,44,2316,652,2968
BHAKKAR DISTRICT,DARYA KHAN TEHSIL,45,2316,572,2888
BHAKKAR DISTRICT,DARYA KHAN TEHSIL,46,2301,650,2951
BHAKKAR DISTRICT,DARYA KHAN TEHSIL,47,2248,683,2931
BHAKKAR DISTRICT,DARYA KHAN TEHSIL,48,2184,684,2868
BHAKKAR DISTRICT,DARYA KHAN TEHSIL,49,2196,702,2898
BHAKKAR DISTRICT,DARYA KHAN TEHSIL,50,2333,607,2940
BHAKKAR DISTRICT,DARYA KHAN TEHSIL,51,2185,648,2833
BHAKKAR DISTRICT,DARYA KHAN TEHSIL,52,1865,534,2399
BHAKKAR DISTRICT,DARYA KHAN TEHSIL,53,2009,569,2578
BHAKKAR DISTRICT,DARYA KHAN TEHSIL,54,1802,521,2323
BHAKKAR DISTRICT,DARYA KHAN TEHSIL,55,1617,480,2097
BHAKKAR DISTRICT,DARYA KHAN TEHSIL,56,1482,480,1962
BHAKKAR DISTRICT,DARYA KHAN TEHSIL,57,1276,425,1701
BHAKKAR DISTRICT,DARYA KHAN TEHSIL,58,1243,373,1616
BHAKKAR DISTRICT,DARYA KHAN TEHSIL,59,1205,383,1588
BHAKKAR DISTRICT,DARYA KHAN TEHSIL,60,1294,323,1617
BHAKKAR DISTRICT,DARYA KHAN TEHSIL,61,1189,409,1598
BHAKKAR DISTRICT,DARYA KHAN TEHSIL,62,1106,362,1468
BHAKKAR DISTRICT,DARYA KHAN TEHSIL,63,1128,377,1505
BHAKKAR DISTRICT,DARYA KHAN TEHSIL,64,1061,300,1361
BHAKKAR DISTRICT,DARYA KHAN TEHSIL,65,1039,215,1254
BHAKKAR DISTRICT,DARYA KHAN TEHSIL,66,953,248,1201
BHAKKAR DISTRICT,DARYA KHAN TEHSIL,67,777,239,1016
BHAKKAR DISTRICT,DARYA KHAN TEHSIL,68,790,215,1005
BHAKKAR DISTRICT,DARYA KHAN TEHSIL,69,849,186,1035
BHAKKAR DISTRICT,DARYA KHAN TEHSIL,70,764,173,937
BHAKKAR DISTRICT,DARYA KHAN TEHSIL,71,762,188,950
BHAKKAR DISTRICT,DARYA KHAN TEHSIL,72,560,164,724
BHAKKAR DISTRICT,DARYA KHAN TEHSIL,73,607,153,760
BHAKKAR DISTRICT,DARYA KHAN TEHSIL,74,494,94,588
BHAKKAR DISTRICT,DARYA KHAN TEHSIL,>=75,3765,869,4634
BHAKKAR DISTRICT,KALUR KOT TEHSIL,<1,6461,1277,7738
BHAKKAR DISTRICT,KALUR KOT TEHSIL,1,7753,1316,9069
BHAKKAR DISTRICT,KALUR KOT TEHSIL,2,8102,1406,9508
BHAKKAR DISTRICT,KALUR KOT TEHSIL,3,8700,1408,10108
BHAKKAR DISTRICT,KALUR KOT TEHSIL,4,8998,1383,10381
BHAKKAR DISTRICT,KALUR KOT TEHSIL,5,8350,1331,9681
BHAKKAR DISTRICT,KALUR KOT TEHSIL,6,7965,1276,9241
BHAKKAR DISTRICT,KALUR KOT TEHSIL,7,8724,1303,10027
BHAKKAR DISTRICT,KALUR KOT TEHSIL,8,8351,1266,9617
BHAKKAR DISTRICT,KALUR KOT TEHSIL,9,8161,1409,9570
BHAKKAR DISTRICT,KALUR KOT TEHSIL,10,7438,1126,8564
BHAKKAR DISTRICT,KALUR KOT TEHSIL,11,7239,1400,8639
BHAKKAR DISTRICT,KALUR KOT TEHSIL,12,6827,1140,7967
BHAKKAR DISTRICT,KALUR KOT TEHSIL,13,6569,1326,7895
BHAKKAR DISTRICT,KALUR KOT TEHSIL,14,6439,1161,7600
BHAKKAR DISTRICT,KALUR KOT TEHSIL,15,6401,1119,7520
BHAKKAR DISTRICT,KALUR KOT TEHSIL,16,6413,1222,7635
BHAKKAR DISTRICT,KALUR KOT TEHSIL,17,6640,1236,7876
BHAKKAR DISTRICT,KALUR KOT TEHSIL,18,5550,1045,6595
BHAKKAR DISTRICT,KALUR KOT TEHSIL,19,5650,1082,6732
BHAKKAR DISTRICT,KALUR KOT TEHSIL,20,5270,982,6252
BHAKKAR DISTRICT,KALUR KOT TEHSIL,21,5431,1134,6565
BHAKKAR DISTRICT,KALUR KOT TEHSIL,22,4861,963,5824
BHAKKAR DISTRICT,KALUR KOT TEHSIL,23,4874,1020,5894
BHAKKAR DISTRICT,KALUR KOT TEHSIL,24,4515,963,5478
BHAKKAR DISTRICT,KALUR KOT TEHSIL,25,4368,854,5222
BHAKKAR DISTRICT,KALUR KOT TEHSIL,26,4844,960,5804
BHAKKAR DISTRICT,KALUR KOT TEHSIL,27,4612,890,5502
BHAKKAR DISTRICT,KALUR KOT TEHSIL,28,4273,806,5079
BHAKKAR DISTRICT,KALUR KOT TEHSIL,29,4572,923,5495
BHAKKAR DISTRICT,KALUR KOT TEHSIL,30,3662,686,4348
BHAKKAR DISTRICT,KALUR KOT TEHSIL,31,4194,833,5027
BHAKKAR DISTRICT,KALUR KOT TEHSIL,32,3974,638,4612
BHAKKAR DISTRICT,KALUR KOT TEHSIL,33,3435,664,4099
BHAKKAR DISTRICT,KALUR KOT TEHSIL,34,3789,677,4466
BHAKKAR DISTRICT,KALUR KOT TEHSIL,35,3417,596,4013
BHAKKAR DISTRICT,KALUR KOT TEHSIL,36,3837,702,4539
BHAKKAR DISTRICT,KALUR KOT TEHSIL,37,3944,621,4565
BHAKKAR DISTRICT,KALUR KOT TEHSIL,38,2966,535,3501
BHAKKAR DISTRICT,KALUR KOT TEHSIL,39,3514,612,4126
BHAKKAR DISTRICT,KALUR KOT TEHSIL,40,2417,438,2855
BHAKKAR DISTRICT,KALUR KOT TEHSIL,41,2879,487,3366
BHAKKAR DISTRICT,KALUR KOT TEHSIL,42,2731,448,3179
BHAKKAR DISTRICT,KALUR KOT TEHSIL,43,2443,459,2902
BHAKKAR DISTRICT,KALUR KOT TEHSIL,44,2429,439,2868
BHAKKAR DISTRICT,KALUR KOT TEHSIL,45,2047,327,2374
BHAKKAR DISTRICT,KALUR KOT TEHSIL,46,2477,439,2916
BHAKKAR DISTRICT,KALUR KOT TEHSIL,47,2597,411,3008
BHAKKAR DISTRICT,KALUR KOT TEHSIL,48,2380,395,2775
BHAKKAR DISTRICT,KALUR KOT TEHSIL,49,2487,472,2959
BHAKKAR DISTRICT,KALUR KOT TEHSIL,50,2056,348,2404
BHAKKAR DISTRICT,KALUR KOT TEHSIL,51,2548,449,2997
BHAKKAR DISTRICT,KALUR KOT TEHSIL,52,2269,402,2671
BHAKKAR DISTRICT,KALUR KOT TEHSIL,53,2053,409,2462
BHAKKAR DISTRICT,KALUR KOT TEHSIL,54,2038,386,2424
BHAKKAR DISTRICT,KALUR KOT TEHSIL,55,1577,301,1878
BHAKKAR DISTRICT,KALUR KOT TEHSIL,56,1674,360,2034
BHAKKAR DISTRICT,KALUR KOT TEHSIL,57,1537,277,1814
BHAKKAR DISTRICT,KALUR KOT TEHSIL,58,1199,263,1462
BHAKKAR DISTRICT,KALUR KOT TEHSIL,59,1420,293,1713
BHAKKAR DISTRICT,KALUR KOT TEHSIL,60,1135,171,1306
BHAKKAR DISTRICT,KALUR KOT TEHSIL,61,1451,262,1713
BHAKKAR DISTRICT,KALUR KOT TEHSIL,62,1453,280,1733
BHAKKAR DISTRICT,KALUR KOT TEHSIL,63,1301,255,1556
BHAKKAR DISTRICT,KALUR KOT TEHSIL,64,1352,223,1575
BHAKKAR DISTRICT,KALUR KOT TEHSIL,65,974,149,1123
BHAKKAR DISTRICT,KALUR KOT TEHSIL,66,1198,191,1389
BHAKKAR DISTRICT,KALUR KOT TEHSIL,67,1202,147,1349
BHAKKAR DISTRICT,KALUR KOT TEHSIL,68,979,166,1145
BHAKKAR DISTRICT,KALUR KOT TEHSIL,69,1010,129,1139
BHAKKAR DISTRICT,KALUR KOT TEHSIL,70,665,93,758
BHAKKAR DISTRICT,KALUR KOT TEHSIL,71,891,116,1007
BHAKKAR DISTRICT,KALUR KOT TEHSIL,72,809,107,916
BHAKKAR DISTRICT,KALUR KOT TEHSIL,73,602,101,703
BHAKKAR DISTRICT,KALUR KOT TEHSIL,74,553,99,652
BHAKKAR DISTRICT,KALUR KOT TEHSIL,>=75,4394,698,5092
BHAKKAR DISTRICT,MANKERA TEHSIL,<1,5618,285,5903
BHAKKAR DISTRICT,MANKERA TEHSIL,1,6107,306,6413
BHAKKAR DISTRICT,MANKERA TEHSIL,2,6392,330,6722
BHAKKAR DISTRICT,MANKERA TEHSIL,3,6732,350,7082
BHAKKAR DISTRICT,MANKERA TEHSIL,4,7139,345,7484
BHAKKAR DISTRICT,MANKERA TEHSIL,5,6647,356,7003
BHAKKAR DISTRICT,MANKERA TEHSIL,6,6360,326,6686
BHAKKAR DISTRICT,MANKERA TEHSIL,7,6849,324,7173
BHAKKAR DISTRICT,MANKERA TEHSIL,8,6565,331,6896
BHAKKAR DISTRICT,MANKERA TEHSIL,9,6434,373,6807
BHAKKAR DISTRICT,MANKERA TEHSIL,10,5943,280,6223
BHAKKAR DISTRICT,MANKERA TEHSIL,11,5815,349,6164
BHAKKAR DISTRICT,MANKERA TEHSIL,12,5440,287,5727
BHAKKAR DISTRICT,MANKERA TEHSIL,13,5191,355,5546
BHAKKAR DISTRICT,MANKERA TEHSIL,14,5365,311,5676
BHAKKAR DISTRICT,MANKERA TEHSIL,15,5108,316,5424
BHAKKAR DISTRICT,MANKERA TEHSIL,16,5356,288,5644
BHAKKAR DISTRICT,MANKERA TEHSIL,17,5746,314,6060
BHAKKAR DISTRICT,MANKERA TEHSIL,18,4333,280,4613
BHAKKAR DISTRICT,MANKERA TEHSIL,19,4318,320,4638
BHAKKAR DISTRICT,MANKERA TEHSIL,20,4365,298,4663
BHAKKAR DISTRICT,MANKERA TEHSIL,21,4311,296,4607
BHAKKAR DISTRICT,MANKERA TEHSIL,22,4291,268,4559
BHAKKAR DISTRICT,MANKERA TEHSIL,23,4326,287,4613
BHAKKAR DISTRICT,MANKERA TEHSIL,24,4202,323,4525
BHAKKAR DISTRICT,MANKERA TEHSIL,25,3720,235,3955
BHAKKAR DISTRICT,MANKERA TEHSIL,26,3998,236,4234
BHAKKAR DISTRICT,MANKERA TEHSIL,27,3857,226,4083
BHAKKAR DISTRICT,MANKERA TEHSIL,28,3804,250,4054
BHAKKAR DISTRICT,MANKERA TEHSIL,29,4027,271,4298
BHAKKAR DISTRICT,MANKERA TEHSIL,30,3283,181,3464
BHAKKAR DISTRICT,MANKERA TEHSIL,31,3457,219,3676
BHAKKAR DISTRICT,MANKERA TEHSIL,32,3060,162,3222
BHAKKAR DISTRICT,MANKERA TEHSIL,33,2774,184,2958
BHAKKAR DISTRICT,MANKERA TEHSIL,34,3376,191,3567
BHAKKAR DISTRICT,MANKERA TEHSIL,35,2910,186,3096
BHAKKAR DISTRICT,MANKERA TEHSIL,36,3832,191,4023
BHAKKAR DISTRICT,MANKERA TEHSIL,37,3251,207,3458
BHAKKAR DISTRICT,MANKERA TEHSIL,38,2990,186,3176
BHAKKAR DISTRICT,MANKERA TEHSIL,39,2911,165,3076
BHAKKAR DISTRICT,MANKERA TEHSIL,40,2081,134,2215
BHAKKAR DISTRICT,MANKERA TEHSIL,41,2708,139,2847
BHAKKAR DISTRICT,MANKERA TEHSIL,42,2267,132,2399
BHAKKAR DISTRICT,MANKERA TEHSIL,43,2148,136,2284
BHAKKAR DISTRICT,MANKERA TEHSIL,44,2160,117,2277
BHAKKAR DISTRICT,MANKERA TEHSIL,45,1712,114,1826
BHAKKAR DISTRICT,MANKERA TEHSIL,46,2308,107,2415
BHAKKAR DISTRICT,MANKERA TEHSIL,47,1983,135,2118
BHAKKAR DISTRICT,MANKERA TEHSIL,48,2036,135,2171
BHAKKAR DISTRICT,MANKERA TEHSIL,49,2174,124,2298
BHAKKAR DISTRICT,MANKERA TEHSIL,50,1684,135,1819
BHAKKAR DISTRICT,MANKERA TEHSIL,51,2208,104,2312
BHAKKAR DISTRICT,MANKERA TEHSIL,52,1752,134,1886
BHAKKAR DISTRICT,MANKERA TEHSIL,53,1880,120,2000
BHAKKAR DISTRICT,MANKERA TEHSIL,54,1678,109,1787
BHAKKAR DISTRICT,MANKERA TEHSIL,55,1231,75,1306
BHAKKAR DISTRICT,MANKERA TEHSIL,56,1409,87,1496
BHAKKAR DISTRICT,MANKERA TEHSIL,57,1091,86,1177
BHAKKAR DISTRICT,MANKERA TEHSIL,58,1114,99,1213
BHAKKAR DISTRICT,MANKERA TEHSIL,59,1147,66,1213
BHAKKAR DISTRICT,MANKERA TEHSIL,60,974,62,1036
BHAKKAR DISTRICT,MANKERA TEHSIL,61,1097,68,1165
BHAKKAR DISTRICT,MANKERA TEHSIL,62,910,67,977
BHAKKAR DISTRICT,MANKERA TEHSIL,63,998,66,1064
BHAKKAR DISTRICT,MANKERA TEHSIL,64,1026,47,1073
BHAKKAR DISTRICT,MANKERA TEHSIL,65,819,52,871
BHAKKAR DISTRICT,MANKERA TEHSIL,66,950,36,986
BHAKKAR DISTRICT,MANKERA TEHSIL,67,776,49,825
BHAKKAR DISTRICT,MANKERA TEHSIL,68,745,36,781
BHAKKAR DISTRICT,MANKERA TEHSIL,69,745,39,784
BHAKKAR DISTRICT,MANKERA TEHSIL,70,601,32,633
BHAKKAR DISTRICT,MANKERA TEHSIL,71,766,28,794
BHAKKAR DISTRICT,MANKERA TEHSIL,72,550,35,585
BHAKKAR DISTRICT,MANKERA TEHSIL,73,506,35,541
BHAKKAR DISTRICT,MANKERA TEHSIL,74,479,24,503
BHAKKAR DISTRICT,MANKERA TEHSIL,>=75,3834,193,4027
BUNER DISTRICT,DAGGAR TEHSIL,<1,9249,0,9249
BUNER DISTRICT,DAGGAR TEHSIL,1,10113,0,10113
BUNER DISTRICT,DAGGAR TEHSIL,2,11175,0,11175
BUNER DISTRICT,DAGGAR TEHSIL,3,11967,0,11967
BUNER DISTRICT,DAGGAR TEHSIL,4,12184,0,12184
BUNER DISTRICT,DAGGAR TEHSIL,5,12042,0,12042
BUNER DISTRICT,DAGGAR TEHSIL,6,11234,0,11234
BUNER DISTRICT,DAGGAR TEHSIL,7,11673,0,11673
BUNER DISTRICT,DAGGAR TEHSIL,8,11614,0,11614
BUNER DISTRICT,DAGGAR TEHSIL,9,11360,0,11360
BUNER DISTRICT,DAGGAR TEHSIL,10,10465,0,10465
BUNER DISTRICT,DAGGAR TEHSIL,11,10535,0,10535
BUNER DISTRICT,DAGGAR TEHSIL,12,9611,0,9611
BUNER DISTRICT,DAGGAR TEHSIL,13,10086,0,10086
BUNER DISTRICT,DAGGAR TEHSIL,14,9119,0,9119
BUNER DISTRICT,DAGGAR TEHSIL,15,9431,0,9431
BUNER DISTRICT,DAGGAR TEHSIL,16,8478,0,8478
BUNER DISTRICT,DAGGAR TEHSIL,17,8971,0,8971
BUNER DISTRICT,DAGGAR TEHSIL,18,7874,0,7874
BUNER DISTRICT,DAGGAR TEHSIL,19,7289,0,7289
BUNER DISTRICT,DAGGAR TEHSIL,20,7467,0,7467
BUNER DISTRICT,DAGGAR TEHSIL,21,6137,0,6137
BUNER DISTRICT,DAGGAR TEHSIL,22,5776,0,5776
BUNER DISTRICT,DAGGAR TEHSIL,23,5468,0,5468
BUNER DISTRICT,DAGGAR TEHSIL,24,4972,0,4972
BUNER DISTRICT,DAGGAR TEHSIL,25,6190,0,6190
BUNER DISTRICT,DAGGAR TEHSIL,26,5501,0,5501
BUNER DISTRICT,DAGGAR TEHSIL,27,5359,0,5359
BUNER DISTRICT,DAGGAR TEHSIL,28,5060,0,5060
BUNER DISTRICT,DAGGAR TEHSIL,29,4690,0,4690
BUNER DISTRICT,DAGGAR TEHSIL,30,5055,0,5055
BUNER DISTRICT,DAGGAR TEHSIL,31,4107,0,4107
BUNER DISTRICT,DAGGAR TEHSIL,32,3541,0,3541
BUNER DISTRICT,DAGGAR TEHSIL,33,3714,0,3714
BUNER DISTRICT,DAGGAR TEHSIL,34,3284,0,3284
BUNER DISTRICT,DAGGAR TEHSIL,35,3865,0,3865
BUNER DISTRICT,DAGGAR TEHSIL,36,3192,0,3192
BUNER DISTRICT,DAGGAR TEHSIL,37,2966,0,2966
BUNER DISTRICT,DAGGAR TEHSIL,38,3232,0,3232
BUNER DISTRICT,DAGGAR TEHSIL,39,2910,0,2910
BUNER DISTRICT,DAGGAR TEHSIL,40,3829,0,3829
BUNER DISTRICT,DAGGAR TEHSIL,41,2788,0,2788
BUNER DISTRICT,DAGGAR TEHSIL,42,2492,0,2492
BUNER DISTRICT,DAGGAR TEHSIL,43,2576,0,2576
BUNER DISTRICT,DAGGAR TEHSIL,44,2270,0,2270
BUNER DISTRICT,DAGGAR TEHSIL,45,2423,0,2423
BUNER DISTRICT,DAGGAR TEHSIL,46,2135,0,2135
BUNER DISTRICT,DAGGAR TEHSIL,47,1833,0,1833
BUNER DISTRICT,DAGGAR TEHSIL,48,1950,0,1950
BUNER DISTRICT,DAGGAR TEHSIL,49,1844,0,1844
BUNER DISTRICT,DAGGAR TEHSIL,50,2427,0,2427
BUNER DISTRICT,DAGGAR TEHSIL,51,1613,0,1613
BUNER DISTRICT,DAGGAR TEHSIL,52,1500,0,1500
BUNER DISTRICT,DAGGAR TEHSIL,53,1606,0,1606
BUNER DISTRICT,DAGGAR TEHSIL,54,1535,0,1535
BUNER DISTRICT,DAGGAR TEHSIL,55,1709,0,1709
BUNER DISTRICT,DAGGAR TEHSIL,56,1258,0,1258
BUNER DISTRICT,DAGGAR TEHSIL,57,977,0,977
BUNER DISTRICT,DAGGAR TEHSIL,58,1291,0,1291
BUNER DISTRICT,DAGGAR TEHSIL,59,1226,0,1226
BUNER DISTRICT,DAGGAR TEHSIL,60,1637,0,1637
BUNER DISTRICT,DAGGAR TEHSIL,61,1302,0,1302
BUNER DISTRICT,DAGGAR TEHSIL,62,1120,0,1120
BUNER DISTRICT,DAGGAR TEHSIL,63,1165,0,1165
BUNER DISTRICT,DAGGAR TEHSIL,64,1103,0,1103
BUNER DISTRICT,DAGGAR TEHSIL,65,1112,0,1112
BUNER DISTRICT,DAGGAR TEHSIL,66,993,0,993
BUNER DISTRICT,DAGGAR TEHSIL,67,792,0,792
BUNER DISTRICT,DAGGAR TEHSIL,68,843,0,843
BUNER DISTRICT,DAGGAR TEHSIL,69,822,0,822
BUNER DISTRICT,DAGGAR TEHSIL,70,959,0,959
BUNER DISTRICT,DAGGAR TEHSIL,71,816,0,816
BUNER DISTRICT,DAGGAR TEHSIL,72,644,0,644
BUNER DISTRICT,DAGGAR TEHSIL,73,599,0,599
BUNER DISTRICT,DAGGAR TEHSIL,74,581,0,581
BUNER DISTRICT,DAGGAR TEHSIL,>=75,4083,0,4083
BUNER DISTRICT,GAGRA TEHSIL,<1,7150,0,7150
BUNER DISTRICT,GAGRA TEHSIL,1,7799,0,7799
BUNER DISTRICT,GAGRA TEHSIL,2,9005,0,9005
BUNER DISTRICT,GAGRA TEHSIL,3,9245,0,9245
BUNER DISTRICT,GAGRA TEHSIL,4,9237,0,9237
BUNER DISTRICT,GAGRA TEHSIL,5,10021,0,10021
BUNER DISTRICT,GAGRA TEHSIL,6,8732,0,8732
BUNER DISTRICT,GAGRA TEHSIL,7,9259,0,9259
BUNER DISTRICT,GAGRA TEHSIL,8,9347,0,9347
BUNER DISTRICT,GAGRA TEHSIL,9,8633,0,8633
BUNER DISTRICT,GAGRA TEHSIL,10,8271,0,8271
BUNER DISTRICT,GAGRA TEHSIL,11,7659,0,7659
BUNER DISTRICT,GAGRA TEHSIL,12,7484,0,7484
BUNER DISTRICT,GAGRA TEHSIL,13,7272,0,7272
BUNER DISTRICT,GAGRA TEHSIL,14,6830,0,6830
BUNER DISTRICT,GAGRA TEHSIL,15,6986,0,6986
BUNER DISTRICT,GAGRA TEHSIL,16,6357,0,6357
BUNER DISTRICT,GAGRA TEHSIL,17,6131,0,6131
BUNER DISTRICT,GAGRA TEHSIL,18,6122,0,6122
BUNER DISTRICT,GAGRA TEHSIL,19,5320,0,5320
BUNER DISTRICT,GAGRA TEHSIL,20,5462,0,5462
BUNER DISTRICT,GAGRA TEHSIL,21,4407,0,4407
BUNER DISTRICT,GAGRA TEHSIL,22,4281,0,4281
BUNER DISTRICT,GAGRA TEHSIL,23,4090,0,4090
BUNER DISTRICT,GAGRA TEHSIL,24,3889,0,3889
BUNER DISTRICT,GAGRA TEHSIL,25,4468,0,4468
BUNER DISTRICT,GAGRA TEHSIL,26,4263,0,4263
BUNER DISTRICT,GAGRA TEHSIL,27,4395,0,4395
BUNER DISTRICT,GAGRA TEHSIL,28,3831,0,3831
BUNER DISTRICT,GAGRA TEHSIL,29,3704,0,3704
BUNER DISTRICT,GAGRA TEHSIL,30,3798,0,3798
BUNER DISTRICT,GAGRA TEHSIL,31,3349,0,3349
BUNER DISTRICT,GAGRA TEHSIL,32,2708,0,2708
BUNER DISTRICT,GAGRA TEHSIL,33,2768,0,2768
BUNER DISTRICT,GAGRA TEHSIL,34,2458,0,2458
BUNER DISTRICT,GAGRA TEHSIL,35,2642,0,2642
BUNER DISTRICT,GAGRA TEHSIL,36,2445,0,2445
BUNER DISTRICT,GAGRA TEHSIL,37,2592,0,2592
BUNER DISTRICT,GAGRA TEHSIL,38,2368,0,2368
BUNER DISTRICT,GAGRA TEHSIL,39,2100,0,2100
BUNER DISTRICT,GAGRA TEHSIL,40,2362,0,2362
BUNER DISTRICT,GAGRA TEHSIL,41,2114,0,2114
BUNER DISTRICT,GAGRA TEHSIL,42,1927,0,1927
BUNER DISTRICT,GAGRA TEHSIL,43,1869,0,1869
BUNER DISTRICT,GAGRA TEHSIL,44,1771,0,1771
BUNER DISTRICT,GAGRA TEHSIL,45,1730,0,1730
BUNER DISTRICT,GAGRA TEHSIL,46,1672,0,1672
BUNER DISTRICT,GAGRA TEHSIL,47,1647,0,1647
BUNER DISTRICT,GAGRA TEHSIL,48,1477,0,1477
BUNER DISTRICT,GAGRA TEHSIL,49,1402,0,1402
BUNER DISTRICT,GAGRA TEHSIL,50,1520,0,1520
BUNER DISTRICT,GAGRA TEHSIL,51,1363,0,1363
BUNER DISTRICT,GAGRA TEHSIL,52,1280,0,1280
BUNER DISTRICT,GAGRA TEHSIL,53,1176,0,1176
BUNER DISTRICT,GAGRA TEHSIL,54,1101,0,1101
BUNER DISTRICT,GAGRA TEHSIL,55,1114,0,1114
BUNER DISTRICT,GAGRA TEHSIL,56,910,0,910
BUNER DISTRICT,GAGRA TEHSIL,57,822,0,822
BUNER DISTRICT,GAGRA TEHSIL,58,854,0,854
BUNER DISTRICT,GAGRA TEHSIL,59,965,0,965
BUNER DISTRICT,GAGRA TEHSIL,60,1019,0,1019
BUNER DISTRICT,GAGRA TEHSIL,61,1045,0,1045
BUNER DISTRICT,GAGRA TEHSIL,62,863,0,863
BUNER DISTRICT,GAGRA TEHSIL,63,944,0,944
BUNER DISTRICT,GAGRA TEHSIL,64,842,0,842
BUNER DISTRICT,GAGRA TEHSIL,65,760,0,760
BUNER DISTRICT,GAGRA TEHSIL,66,711,0,711
BUNER DISTRICT,GAGRA TEHSIL,67,572,0,572
BUNER DISTRICT,GAGRA TEHSIL,68,708,0,708
BUNER DISTRICT,GAGRA TEHSIL,69,722,0,722
BUNER DISTRICT,GAGRA TEHSIL,70,711,0,711
BUNER DISTRICT,GAGRA TEHSIL,71,642,0,642
BUNER DISTRICT,GAGRA TEHSIL,72,436,0,436
BUNER DISTRICT,GAGRA TEHSIL,73,481,0,481
BUNER DISTRICT,GAGRA TEHSIL,74,404,0,404
BUNER DISTRICT,GAGRA TEHSIL,>=75,3157,0,3157
BUNER DISTRICT,KHADO KHEL TEHSIL,<1,3241,0,3241
BUNER DISTRICT,KHADO KHEL TEHSIL,1,3287,0,3287
BUNER DISTRICT,KHADO KHEL TEHSIL,2,3733,0,3733
BUNER DISTRICT,KHADO KHEL TEHSIL,3,3888,0,3888
BUNER DISTRICT,KHADO KHEL TEHSIL,4,4198,0,4198
BUNER DISTRICT,KHADO KHEL TEHSIL,5,4035,0,4035
BUNER DISTRICT,KHADO KHEL TEHSIL,6,3754,0,3754
BUNER DISTRICT,KHADO KHEL TEHSIL,7,3996,0,3996
BUNER DISTRICT,KHADO KHEL TEHSIL,8,3902,0,3902
BUNER DISTRICT,KHADO KHEL TEHSIL,9,3912,0,3912
BUNER DISTRICT,KHADO KHEL TEHSIL,10,3610,0,3610
BUNER DISTRICT,KHADO KHEL TEHSIL,11,3454,0,3454
BUNER DISTRICT,KHADO KHEL TEHSIL,12,3084,0,3084
BUNER DISTRICT,KHADO KHEL TEHSIL,13,3422,0,3422
BUNER DISTRICT,KHADO KHEL TEHSIL,14,2898,0,2898
BUNER DISTRICT,KHADO KHEL TEHSIL,15,3025,0,3025
BUNER DISTRICT,KHADO KHEL TEHSIL,16,2587,0,2587
BUNER DISTRICT,KHADO KHEL TEHSIL,17,2782,0,2782
BUNER DISTRICT,KHADO KHEL TEHSIL,18,2353,0,2353
BUNER DISTRICT,KHADO KHEL TEHSIL,19,2359,0,2359
BUNER DISTRICT,KHADO KHEL TEHSIL,20,2228,0,2228
BUNER DISTRICT,KHADO KHEL TEHSIL,21,1908,0,1908
BUNER DISTRICT,KHADO KHEL TEHSIL,22,1726,0,1726
BUNER DISTRICT,KHADO KHEL TEHSIL,23,1570,0,1570
BUNER DISTRICT,KHADO KHEL TEHSIL,24,1337,0,1337
BUNER DISTRICT,KHADO KHEL TEHSIL,25,1619,0,1619
BUNER DISTRICT,KHADO KHEL TEHSIL,26,1803,0,1803
BUNER DISTRICT,KHADO KHEL TEHSIL,27,1848,0,1848
BUNER DISTRICT,KHADO KHEL TEHSIL,28,1444,0,1444
BUNER DISTRICT,KHADO KHEL TEHSIL,29,1717,0,1717
BUNER DISTRICT,KHADO KHEL TEHSIL,30,1445,0,1445
BUNER DISTRICT,KHADO KHEL TEHSIL,31,1409,0,1409
BUNER DISTRICT,KHADO KHEL TEHSIL,32,1239,0,1239
BUNER DISTRICT,KHADO KHEL TEHSIL,33,1257,0,1257
BUNER DISTRICT,KHADO KHEL TEHSIL,34,1220,0,1220
BUNER DISTRICT,KHADO KHEL TEHSIL,35,1087,0,1087
BUNER DISTRICT,KHADO KHEL TEHSIL,36,1289,0,1289
BUNER DISTRICT,KHADO KHEL TEHSIL,37,1390,0,1390
BUNER DISTRICT,KHADO KHEL TEHSIL,38,985,0,985
BUNER DISTRICT,KHADO KHEL TEHSIL,39,1106,0,1106
BUNER DISTRICT,KHADO KHEL TEHSIL,40,941,0,941
BUNER DISTRICT,KHADO KHEL TEHSIL,41,1120,0,1120
BUNER DISTRICT,KHADO KHEL TEHSIL,42,1006,0,1006
BUNER DISTRICT,KHADO KHEL TEHSIL,43,890,0,890
BUNER DISTRICT,KHADO KHEL TEHSIL,44,878,0,878
BUNER DISTRICT,KHADO KHEL TEHSIL,45,662,0,662
BUNER DISTRICT,KHADO KHEL TEHSIL,46,847,0,847
BUNER DISTRICT,KHADO KHEL TEHSIL,47,842,0,842
BUNER DISTRICT,KHADO KHEL TEHSIL,48,732,0,732
BUNER DISTRICT,KHADO KHEL TEHSIL,49,700,0,700
BUNER DISTRICT,KHADO KHEL TEHSIL,50,653,0,653
BUNER DISTRICT,KHADO KHEL TEHSIL,51,744,0,744
BUNER DISTRICT,KHADO KHEL TEHSIL,52,678,0,678
BUNER DISTRICT,KHADO KHEL TEHSIL,53,562,0,562
BUNER DISTRICT,KHADO KHEL TEHSIL,54,552,0,552
BUNER DISTRICT,KHADO KHEL TEHSIL,55,452,0,452
BUNER DISTRICT,KHADO KHEL TEHSIL,56,458,0,458
BUNER DISTRICT,KHADO KHEL TEHSIL,57,456,0,456
BUNER DISTRICT,KHADO KHEL TEHSIL,58,395,0,395
BUNER DISTRICT,KHADO KHEL TEHSIL,59,489,0,489
BUNER DISTRICT,KHADO KHEL TEHSIL,60,431,0,431
BUNER DISTRICT,KHADO KHEL TEHSIL,61,509,0,509
BUNER DISTRICT,KHADO KHEL TEHSIL,62,470,0,470
BUNER DISTRICT,KHADO KHEL TEHSIL,63,416,0,416
BUNER DISTRICT,KHADO KHEL TEHSIL,64,444,0,444
BUNER DISTRICT,KHADO KHEL TEHSIL,65,357,0,357
BUNER DISTRICT,KHADO KHEL TEHSIL,66,398,0,398
BUNER DISTRICT,KHADO KHEL TEHSIL,67,326,0,326
BUNER DISTRICT,KHADO KHEL TEHSIL,68,289,0,289
BUNER DISTRICT,KHADO KHEL TEHSIL,69,365,0,365
BUNER DISTRICT,KHADO KHEL TEHSIL,70,321,0,321
BUNER DISTRICT,KHADO KHEL TEHSIL,71,316,0,316
BUNER DISTRICT,KHADO KHEL TEHSIL,72,234,0,234
BUNER DISTRICT,KHADO KHEL TEHSIL,73,207,0,207
BUNER DISTRICT,KHADO KHEL TEHSIL,74,192,0,192
BUNER DISTRICT,KHADO KHEL TEHSIL,>=75,1593,0,1593
BUNER DISTRICT,MANDANR TEHSIL,<1,3646,0,3646
BUNER DISTRICT,MANDANR TEHSIL,1,4584,0,4584
BUNER DISTRICT,MANDANR TEHSIL,2,5102,0,5102
BUNER DISTRICT,MANDANR TEHSIL,3,5289,0,5289
BUNER DISTRICT,MANDANR TEHSIL,4,5511,0,5511
BUNER DISTRICT,MANDANR TEHSIL,5,5072,0,5072
BUNER DISTRICT,MANDANR TEHSIL,6,4984,0,4984
BUNER DISTRICT,MANDANR TEHSIL,7,5048,0,5048
BUNER DISTRICT,MANDANR TEHSIL,8,5023,0,5023
BUNER DISTRICT,MANDANR TEHSIL,9,4992,0,4992
BUNER DISTRICT,MANDANR TEHSIL,10,4645,0,4645
BUNER DISTRICT,MANDANR TEHSIL,11,4447,0,4447
BUNER DISTRICT,MANDANR TEHSIL,12,4152,0,4152
BUNER DISTRICT,MANDANR TEHSIL,13,4214,0,4214
BUNER DISTRICT,MANDANR TEHSIL,14,3848,0,3848
BUNER DISTRICT,MANDANR TEHSIL,15,3906,0,3906
BUNER DISTRICT,MANDANR TEHSIL,16,3463,0,3463
BUNER DISTRICT,MANDANR TEHSIL,17,3390,0,3390
BUNER DISTRICT,MANDANR TEHSIL,18,3267,0,3267
BUNER DISTRICT,MANDANR TEHSIL,19,3056,0,3056
BUNER DISTRICT,MANDANR TEHSIL,20,2951,0,2951
BUNER DISTRICT,MANDANR TEHSIL,21,2497,0,2497
BUNER DISTRICT,MANDANR TEHSIL,22,2245,0,2245
BUNER DISTRICT,MANDANR TEHSIL,23,2072,0,2072
BUNER DISTRICT,MANDANR TEHSIL,24,1919,0,1919
BUNER DISTRICT,MANDANR TEHSIL,25,2488,0,2488
BUNER DISTRICT,MANDANR TEHSIL,26,2446,0,2446
BUNER DISTRICT,MANDANR TEHSIL,27,2399,0,2399
BUNER DISTRICT,MANDANR TEHSIL,28,2270,0,2270
BUNER DISTRICT,MANDANR TEHSIL,29,2161,0,2161
BUNER DISTRICT,MANDANR TEHSIL,30,2051,0,2051
BUNER DISTRICT,MANDANR TEHSIL,31,2004,0,2004
BUNER DISTRICT,MANDANR TEHSIL,32,1585,0,1585
BUNER DISTRICT,MANDANR TEHSIL,33,1518,0,1518
BUNER DISTRICT,MANDANR TEHSIL,34,1496,0,1496
BUNER DISTRICT,MANDANR TEHSIL,35,1543,0,1543
BUNER DISTRICT,MANDANR TEHSIL,36,1658,0,1658
BUNER DISTRICT,MANDANR TEHSIL,37,1619,0,1619
BUNER DISTRICT,MANDANR TEHSIL,38,1335,0,1335
BUNER DISTRICT,MANDANR TEHSIL,39,1327,0,1327
BUNER DISTRICT,MANDANR TEHSIL,40,1283,0,1283
BUNER DISTRICT,MANDANR TEHSIL,41,1369,0,1369
BUNER DISTRICT,MANDANR TEHSIL,42,1214,0,1214
BUNER DISTRICT,MANDANR TEHSIL,43,1117,0,1117
BUNER DISTRICT,MANDANR TEHSIL,44,1079,0,1079
BUNER DISTRICT,MANDANR TEHSIL,45,920,0,920
BUNER DISTRICT,MANDANR TEHSIL,46,1037,0,1037
BUNER DISTRICT,MANDANR TEHSIL,47,1010,0,1010
BUNER DISTRICT,MANDANR TEHSIL,48,918,0,918
BUNER DISTRICT,MANDANR TEHSIL,49,858,0,858
BUNER DISTRICT,MANDANR TEHSIL,50,808,0,808
BUNER DISTRICT,MANDANR TEHSIL,51,846,0,846
BUNER DISTRICT,MANDANR TEHSIL,52,780,0,780
BUNER DISTRICT,MANDANR TEHSIL,53,643,0,643
BUNER DISTRICT,MANDANR TEHSIL,54,665,0,665
BUNER DISTRICT,MANDANR TEHSIL,55,590,0,590
BUNER DISTRICT,MANDANR TEHSIL,56,498,0,498
BUNER DISTRICT,MANDANR TEHSIL,57,475,0,475
BUNER DISTRICT,MANDANR TEHSIL,58,489,0,489
BUNER DISTRICT,MANDANR TEHSIL,59,573,0,573
BUNER DISTRICT,MANDANR TEHSIL,60,566,0,566
BUNER DISTRICT,MANDANR TEHSIL,61,561,0,561
BUNER DISTRICT,MANDANR TEHSIL,62,472,0,472
BUNER DISTRICT,MANDANR TEHSIL,63,481,0,481
BUNER DISTRICT,MANDANR TEHSIL,64,489,0,489
BUNER DISTRICT,MANDANR TEHSIL,65,500,0,500
BUNER DISTRICT,MANDANR TEHSIL,66,468,0,468
BUNER DISTRICT,MANDANR TEHSIL,67,374,0,374
BUNER DISTRICT,MANDANR TEHSIL,68,372,0,372
BUNER DISTRICT,MANDANR TEHSIL,69,441,0,441
BUNER DISTRICT,MANDANR TEHSIL,70,412,0,412
BUNER DISTRICT,MANDANR TEHSIL,71,340,0,340
BUNER DISTRICT,MANDANR TEHSIL,72,275,0,275
BUNER DISTRICT,MANDANR TEHSIL,73,304,0,304
BUNER DISTRICT,MANDANR TEHSIL,74,298,0,298
BUNER DISTRICT,MANDANR TEHSIL,>=75,1860,0,1860
CHAGAI DISTRICT,CHAGAI SUB-TEHSIL,<1,1258,0,1258
CHAGAI DISTRICT,CHAGAI SUB-TEHSIL,1,2396,0,2396
CHAGAI DISTRICT,CHAGAI SUB-TEHSIL,2,2481,0,2481
CHAGAI DISTRICT,CHAGAI SUB-TEHSIL,3,2436,0,2436
CHAGAI DISTRICT,CHAGAI SUB-TEHSIL,4,2234,0,2234
CHAGAI DISTRICT,CHAGAI SUB-TEHSIL,5,2340,0,2340
CHAGAI DISTRICT,CHAGAI SUB-TEHSIL,6,2069,0,2069
CHAGAI DISTRICT,CHAGAI SUB-TEHSIL,7,2306,0,2306
CHAGAI DISTRICT,CHAGAI SUB-TEHSIL,8,2129,0,2129
CHAGAI DISTRICT,CHAGAI SUB-TEHSIL,9,2008,0,2008
CHAGAI DISTRICT,CHAGAI SUB-TEHSIL,10,1868,0,1868
CHAGAI DISTRICT,CHAGAI SUB-TEHSIL,11,1696,0,1696
CHAGAI DISTRICT,CHAGAI SUB-TEHSIL,12,1492,0,1492
CHAGAI DISTRICT,CHAGAI SUB-TEHSIL,13,1543,0,1543
CHAGAI DISTRICT,CHAGAI SUB-TEHSIL,14,1295,0,1295
CHAGAI DISTRICT,CHAGAI SUB-TEHSIL,15,1263,0,1263
CHAGAI DISTRICT,CHAGAI SUB-TEHSIL,16,1116,0,1116
CHAGAI DISTRICT,CHAGAI SUB-TEHSIL,17,1099,0,1099
CHAGAI DISTRICT,CHAGAI SUB-TEHSIL,18,1197,0,1197
CHAGAI DISTRICT,CHAGAI SUB-TEHSIL,19,1178,0,1178
CHAGAI DISTRICT,CHAGAI SUB-TEHSIL,20,1081,0,1081
CHAGAI DISTRICT,CHAGAI SUB-TEHSIL,21,983,0,983
CHAGAI DISTRICT,CHAGAI SUB-TEHSIL,22,852,0,852
CHAGAI DISTRICT,CHAGAI SUB-TEHSIL,23,811,0,811
CHAGAI DISTRICT,CHAGAI SUB-TEHSIL,24,767,0,767
CHAGAI DISTRICT,CHAGAI SUB-TEHSIL,25,946,0,946
CHAGAI DISTRICT,CHAGAI SUB-TEHSIL,26,676,0,676
CHAGAI DISTRICT,CHAGAI SUB-TEHSIL,27,948,0,948
CHAGAI DISTRICT,CHAGAI SUB-TEHSIL,28,668,0,668
CHAGAI DISTRICT,CHAGAI SUB-TEHSIL,29,947,0,947
CHAGAI DISTRICT,CHAGAI SUB-TEHSIL,30,734,0,734
CHAGAI DISTRICT,CHAGAI SUB-TEHSIL,31,789,0,789
CHAGAI DISTRICT,CHAGAI SUB-TEHSIL,32,733,0,733
CHAGAI DISTRICT,CHAGAI SUB-TEHSIL,33,637,0,637
CHAGAI DISTRICT,CHAGAI SUB-TEHSIL,34,575,0,575
CHAGAI DISTRICT,CHAGAI SUB-TEHSIL,35,618,0,618
CHAGAI DISTRICT,CHAGAI SUB-TEHSIL,36,447,0,447
CHAGAI DISTRICT,CHAGAI SUB-TEHSIL,37,830,0,830
CHAGAI DISTRICT,CHAGAI SUB-TEHSIL,38,410,0,410
CHAGAI DISTRICT,CHAGAI SUB-TEHSIL,39,576,0,576
CHAGAI DISTRICT,CHAGAI SUB-TEHSIL,40,341,0,341
CHAGAI DISTRICT,CHAGAI SUB-TEHSIL,41,347,0,347
CHAGAI DISTRICT,CHAGAI SUB-TEHSIL,42,477,0,477
CHAGAI DISTRICT,CHAGAI SUB-TEHSIL,43,333,0,333
CHAGAI DISTRICT,CHAGAI SUB-TEHSIL,44,350,0,350
CHAGAI DISTRICT,CHAGAI SUB-TEHSIL,45,311,0,311
CHAGAI DISTRICT,CHAGAI SUB-TEHSIL,46,276,0,276
CHAGAI DISTRICT,CHAGAI SUB-TEHSIL,47,490,0,490
CHAGAI DISTRICT,CHAGAI SUB-TEHSIL,48,294,0,294
CHAGAI DISTRICT,CHAGAI SUB-TEHSIL,49,354,0,354
CHAGAI DISTRICT,CHAGAI SUB-TEHSIL,50,226,0,226
CHAGAI DISTRICT,CHAGAI SUB-TEHSIL,51,251,0,251
CHAGAI DISTRICT,CHAGAI SUB-TEHSIL,52,313,0,313
CHAGAI DISTRICT,CHAGAI SUB-TEHSIL,53,205,0,205
CHAGAI DISTRICT,CHAGAI SUB-TEHSIL,54,216,0,216
CHAGAI DISTRICT,CHAGAI SUB-TEHSIL,55,143,0,143
CHAGAI DISTRICT,CHAGAI SUB-TEHSIL,56,101,0,101
CHAGAI DISTRICT,CHAGAI SUB-TEHSIL,57,268,0,268
CHAGAI DISTRICT,CHAGAI SUB-TEHSIL,58,123,0,123
CHAGAI DISTRICT,CHAGAI SUB-TEHSIL,59,220,0,220
CHAGAI DISTRICT,CHAGAI SUB-TEHSIL,60,133,0,133
CHAGAI DISTRICT,CHAGAI SUB-TEHSIL,61,159,0,159
CHAGAI DISTRICT,CHAGAI SUB-TEHSIL,62,162,0,162
CHAGAI DISTRICT,CHAGAI SUB-TEHSIL,63,109,0,109
CHAGAI DISTRICT,CHAGAI SUB-TEHSIL,64,200,0,200
CHAGAI DISTRICT,CHAGAI SUB-TEHSIL,65,85,0,85
CHAGAI DISTRICT,CHAGAI SUB-TEHSIL,66,77,0,77
CHAGAI DISTRICT,CHAGAI SUB-TEHSIL,67,139,0,139
CHAGAI DISTRICT,CHAGAI SUB-TEHSIL,68,76,0,76
CHAGAI DISTRICT,CHAGAI SUB-TEHSIL,69,145,0,145
CHAGAI DISTRICT,CHAGAI SUB-TEHSIL,70,68,0,68
CHAGAI DISTRICT,CHAGAI SUB-TEHSIL,71,95,0,95
CHAGAI DISTRICT,CHAGAI SUB-TEHSIL,72,81,0,81
CHAGAI DISTRICT,CHAGAI SUB-TEHSIL,73,73,0,73
CHAGAI DISTRICT,CHAGAI SUB-TEHSIL,74,80,0,80
CHAGAI DISTRICT,CHAGAI SUB-TEHSIL,>=75,503,0,503
CHAGAI DISTRICT,DALBANDIN TEHSIL,<1,2856,354,3210
CHAGAI DISTRICT,DALBANDIN TEHSIL,1,4471,530,5001
CHAGAI DISTRICT,DALBANDIN TEHSIL,2,4762,560,5322
CHAGAI DISTRICT,DALBANDIN TEHSIL,3,4328,553,4881
CHAGAI DISTRICT,DALBANDIN TEHSIL,4,4370,520,4890
CHAGAI DISTRICT,DALBANDIN TEHSIL,5,4105,522,4627
CHAGAI DISTRICT,DALBANDIN TEHSIL,6,3892,459,4351
CHAGAI DISTRICT,DALBANDIN TEHSIL,7,4298,551,4849
CHAGAI DISTRICT,DALBANDIN TEHSIL,8,4037,454,4491
CHAGAI DISTRICT,DALBANDIN TEHSIL,9,3622,493,4115
CHAGAI DISTRICT,DALBANDIN TEHSIL,10,3715,400,4115
CHAGAI DISTRICT,DALBANDIN TEHSIL,11,3154,506,3660
CHAGAI DISTRICT,DALBANDIN TEHSIL,12,2899,371,3270
CHAGAI DISTRICT,DALBANDIN TEHSIL,13,2781,421,3202
CHAGAI DISTRICT,DALBANDIN TEHSIL,14,2584,356,2940
CHAGAI DISTRICT,DALBANDIN TEHSIL,15,2454,379,2833
CHAGAI DISTRICT,DALBANDIN TEHSIL,16,2168,348,2516
CHAGAI DISTRICT,DALBANDIN TEHSIL,17,2295,346,2641
CHAGAI DISTRICT,DALBANDIN TEHSIL,18,2247,350,2597
CHAGAI DISTRICT,DALBANDIN TEHSIL,19,2203,380,2583
CHAGAI DISTRICT,DALBANDIN TEHSIL,20,2068,305,2373
CHAGAI DISTRICT,DALBANDIN TEHSIL,21,1957,327,2284
CHAGAI DISTRICT,DALBANDIN TEHSIL,22,1632,273,1905
CHAGAI DISTRICT,DALBANDIN TEHSIL,23,1598,304,1902
CHAGAI DISTRICT,DALBANDIN TEHSIL,24,1282,258,1540
CHAGAI DISTRICT,DALBANDIN TEHSIL,25,1718,259,1977
CHAGAI DISTRICT,DALBANDIN TEHSIL,26,1258,251,1509
CHAGAI DISTRICT,DALBANDIN TEHSIL,27,1784,321,2105
CHAGAI DISTRICT,DALBANDIN TEHSIL,28,1527,264,1791
CHAGAI DISTRICT,DALBANDIN TEHSIL,29,1721,304,2025
CHAGAI DISTRICT,DALBANDIN TEHSIL,30,1369,187,1556
CHAGAI DISTRICT,DALBANDIN TEHSIL,31,1486,248,1734
CHAGAI DISTRICT,DALBANDIN TEHSIL,32,1339,217,1556
CHAGAI DISTRICT,DALBANDIN TEHSIL,33,1119,193,1312
CHAGAI DISTRICT,DALBANDIN TEHSIL,34,1152,191,1343
CHAGAI DISTRICT,DALBANDIN TEHSIL,35,1287,196,1483
CHAGAI DISTRICT,DALBANDIN TEHSIL,36,936,177,1113
CHAGAI DISTRICT,DALBANDIN TEHSIL,37,1481,249,1730
CHAGAI DISTRICT,DALBANDIN TEHSIL,38,953,175,1128
CHAGAI DISTRICT,DALBANDIN TEHSIL,39,1117,174,1291
CHAGAI DISTRICT,DALBANDIN TEHSIL,40,753,110,863
CHAGAI DISTRICT,DALBANDIN TEHSIL,41,801,131,932
CHAGAI DISTRICT,DALBANDIN TEHSIL,42,811,145,956
CHAGAI DISTRICT,DALBANDIN TEHSIL,43,644,109,753
CHAGAI DISTRICT,DALBANDIN TEHSIL,44,596,98,694
CHAGAI DISTRICT,DALBANDIN TEHSIL,45,578,99,677
CHAGAI DISTRICT,DALBANDIN TEHSIL,46,471,81,552
CHAGAI DISTRICT,DALBANDIN TEHSIL,47,843,141,984
CHAGAI DISTRICT,DALBANDIN TEHSIL,48,491,102,593
CHAGAI DISTRICT,DALBANDIN TEHSIL,49,652,129,781
CHAGAI DISTRICT,DALBANDIN TEHSIL,50,541,75,616
CHAGAI DISTRICT,DALBANDIN TEHSIL,51,575,99,674
CHAGAI DISTRICT,DALBANDIN TEHSIL,52,539,84,623
CHAGAI DISTRICT,DALBANDIN TEHSIL,53,464,68,532
CHAGAI DISTRICT,DALBANDIN TEHSIL,54,428,77,505
CHAGAI DISTRICT,DALBANDIN TEHSIL,55,297,43,340
CHAGAI DISTRICT,DALBANDIN TEHSIL,56,240,36,276
CHAGAI DISTRICT,DALBANDIN TEHSIL,57,416,80,496
CHAGAI DISTRICT,DALBANDIN TEHSIL,58,286,51,337
CHAGAI DISTRICT,DALBANDIN TEHSIL,59,396,73,469
CHAGAI DISTRICT,DALBANDIN TEHSIL,60,278,25,303
CHAGAI DISTRICT,DALBANDIN TEHSIL,61,347,89,436
CHAGAI DISTRICT,DALBANDIN TEHSIL,62,294,69,363
CHAGAI DISTRICT,DALBANDIN TEHSIL,63,258,49,307
CHAGAI DISTRICT,DALBANDIN TEHSIL,64,372,51,423
CHAGAI DISTRICT,DALBANDIN TEHSIL,65,213,28,241
CHAGAI DISTRICT,DALBANDIN TEHSIL,66,186,31,217
CHAGAI DISTRICT,DALBANDIN TEHSIL,67,281,60,341
CHAGAI DISTRICT,DALBANDIN TEHSIL,68,178,38,216
CHAGAI DISTRICT,DALBANDIN TEHSIL,69,254,38,292
CHAGAI DISTRICT,DALBANDIN TEHSIL,70,146,13,159
CHAGAI DISTRICT,DALBANDIN TEHSIL,71,146,20,166
CHAGAI DISTRICT,DALBANDIN TEHSIL,72,177,31,208
CHAGAI DISTRICT,DALBANDIN TEHSIL,73,98,18,116
CHAGAI DISTRICT,DALBANDIN TEHSIL,74,142,18,160
CHAGAI DISTRICT,DALBANDIN TEHSIL,>=75,986,130,1116
CHAGAI DISTRICT,NOKUNDI SUB-TEHSIL,<1,627,0,627
CHAGAI DISTRICT,NOKUNDI SUB-TEHSIL,1,589,0,589
CHAGAI DISTRICT,NOKUNDI SUB-TEHSIL,2,795,0,795
CHAGAI DISTRICT,NOKUNDI SUB-TEHSIL,3,758,0,758
CHAGAI DISTRICT,NOKUNDI SUB-TEHSIL,4,779,0,779
CHAGAI DISTRICT,NOKUNDI SUB-TEHSIL,5,699,0,699
CHAGAI DISTRICT,NOKUNDI SUB-TEHSIL,6,702,0,702
CHAGAI DISTRICT,NOKUNDI SUB-TEHSIL,7,749,0,749
CHAGAI DISTRICT,NOKUNDI SUB-TEHSIL,8,754,0,754
CHAGAI DISTRICT,NOKUNDI SUB-TEHSIL,9,686,0,686
CHAGAI DISTRICT,NOKUNDI SUB-TEHSIL,10,703,0,703
CHAGAI DISTRICT,NOKUNDI SUB-TEHSIL,11,650,0,650
CHAGAI DISTRICT,NOKUNDI SUB-TEHSIL,12,548,0,548
CHAGAI DISTRICT,NOKUNDI SUB-TEHSIL,13,564,0,564
CHAGAI DISTRICT,NOKUNDI SUB-TEHSIL,14,489,0,489
CHAGAI DISTRICT,NOKUNDI SUB-TEHSIL,15,467,0,467
CHAGAI DISTRICT,NOKUNDI SUB-TEHSIL,16,430,0,430
CHAGAI DISTRICT,NOKUNDI SUB-TEHSIL,17,418,0,418
CHAGAI DISTRICT,NOKUNDI SUB-TEHSIL,18,513,0,513
CHAGAI DISTRICT,NOKUNDI SUB-TEHSIL,19,450,0,450
CHAGAI DISTRICT,NOKUNDI SUB-TEHSIL,20,464,0,464
CHAGAI DISTRICT,NOKUNDI SUB-TEHSIL,21,473,0,473
CHAGAI DISTRICT,NOKUNDI SUB-TEHSIL,22,332,0,332
CHAGAI DISTRICT,NOKUNDI SUB-TEHSIL,23,361,0,361
CHAGAI DISTRICT,NOKUNDI SUB-TEHSIL,24,349,0,349
CHAGAI DISTRICT,NOKUNDI SUB-TEHSIL,25,353,0,353
CHAGAI DISTRICT,NOKUNDI SUB-TEHSIL,26,360,0,360
CHAGAI DISTRICT,NOKUNDI SUB-TEHSIL,27,347,0,347
CHAGAI DISTRICT,NOKUNDI SUB-TEHSIL,28,316,0,316
CHAGAI DISTRICT,NOKUNDI SUB-TEHSIL,29,418,0,418
CHAGAI DISTRICT,NOKUNDI SUB-TEHSIL,30,260,0,260
CHAGAI DISTRICT,NOKUNDI SUB-TEHSIL,31,359,0,359
CHAGAI DISTRICT,NOKUNDI SUB-TEHSIL,32,329,0,329
CHAGAI DISTRICT,NOKUNDI SUB-TEHSIL,33,320,0,320
CHAGAI DISTRICT,NOKUNDI SUB-TEHSIL,34,431,0,431
CHAGAI DISTRICT,NOKUNDI SUB-TEHSIL,35,226,0,226
CHAGAI DISTRICT,NOKUNDI SUB-TEHSIL,36,331,0,331
CHAGAI DISTRICT,NOKUNDI SUB-TEHSIL,37,258,0,258
CHAGAI DISTRICT,NOKUNDI SUB-TEHSIL,38,201,0,201
CHAGAI DISTRICT,NOKUNDI SUB-TEHSIL,39,217,0,217
CHAGAI DISTRICT,NOKUNDI SUB-TEHSIL,40,139,0,139
CHAGAI DISTRICT,NOKUNDI SUB-TEHSIL,41,188,0,188
CHAGAI DISTRICT,NOKUNDI SUB-TEHSIL,42,160,0,160
CHAGAI DISTRICT,NOKUNDI SUB-TEHSIL,43,131,0,131
CHAGAI DISTRICT,NOKUNDI SUB-TEHSIL,44,168,0,168
CHAGAI DISTRICT,NOKUNDI SUB-TEHSIL,45,104,0,104
CHAGAI DISTRICT,NOKUNDI SUB-TEHSIL,46,163,0,163
CHAGAI DISTRICT,NOKUNDI SUB-TEHSIL,47,156,0,156
CHAGAI DISTRICT,NOKUNDI SUB-TEHSIL,48,108,0,108
CHAGAI DISTRICT,NOKUNDI SUB-TEHSIL,49,110,0,110
CHAGAI DISTRICT,NOKUNDI SUB-TEHSIL,50,81,0,81
CHAGAI DISTRICT,NOKUNDI SUB-TEHSIL,51,126,0,126
CHAGAI DISTRICT,NOKUNDI SUB-TEHSIL,52,111,0,111
CHAGAI DISTRICT,NOKUNDI SUB-TEHSIL,53,81,0,81
CHAGAI DISTRICT,NOKUNDI SUB-TEHSIL,54,83,0,83
CHAGAI DISTRICT,NOKUNDI SUB-TEHSIL,55,63,0,63
CHAGAI DISTRICT,NOKUNDI SUB-TEHSIL,56,68,0,68
CHAGAI DISTRICT,NOKUNDI SUB-TEHSIL,57,84,0,84
CHAGAI DISTRICT,NOKUNDI SUB-TEHSIL,58,67,0,67
CHAGAI DISTRICT,NOKUNDI SUB-TEHSIL,59,80,0,80
CHAGAI DISTRICT,NOKUNDI SUB-TEHSIL,60,50,0,50
CHAGAI DISTRICT,NOKUNDI SUB-TEHSIL,61,80,0,80
CHAGAI DISTRICT,NOKUNDI SUB-TEHSIL,62,60,0,60
CHAGAI DISTRICT,NOKUNDI SUB-TEHSIL,63,61,0,61
CHAGAI DISTRICT,NOKUNDI SUB-TEHSIL,64,89,0,89
CHAGAI DISTRICT,NOKUNDI SUB-TEHSIL,65,45,0,45
CHAGAI DISTRICT,NOKUNDI SUB-TEHSIL,66,54,0,54
CHAGAI DISTRICT,NOKUNDI SUB-TEHSIL,67,65,0,65
CHAGAI DISTRICT,NOKUNDI SUB-TEHSIL,68,35,0,35
CHAGAI DISTRICT,NOKUNDI SUB-TEHSIL,69,47,0,47
CHAGAI DISTRICT,NOKUNDI SUB-TEHSIL,70,29,0,29
CHAGAI DISTRICT,NOKUNDI SUB-TEHSIL,71,38,0,38
CHAGAI DISTRICT,NOKUNDI SUB-TEHSIL,72,34,0,34
CHAGAI DISTRICT,NOKUNDI SUB-TEHSIL,73,22,0,22
CHAGAI DISTRICT,NOKUNDI SUB-TEHSIL,74,34,0,34
CHAGAI DISTRICT,NOKUNDI SUB-TEHSIL,>=75,194,0,194
CHAGAI DISTRICT,TAFTAN SUB-TEHSIL,<1,380,0,380
CHAGAI DISTRICT,TAFTAN SUB-TEHSIL,1,575,0,575
CHAGAI DISTRICT,TAFTAN SUB-TEHSIL,2,661,0,661
CHAGAI DISTRICT,TAFTAN SUB-TEHSIL,3,609,0,609
CHAGAI DISTRICT,TAFTAN SUB-TEHSIL,4,626,0,626
CHAGAI DISTRICT,TAFTAN SUB-TEHSIL,5,552,0,552
CHAGAI DISTRICT,TAFTAN SUB-TEHSIL,6,651,0,651
CHAGAI DISTRICT,TAFTAN SUB-TEHSIL,7,662,0,662
CHAGAI DISTRICT,TAFTAN SUB-TEHSIL,8,630,0,630
CHAGAI DISTRICT,TAFTAN SUB-TEHSIL,9,624,0,624
CHAGAI DISTRICT,TAFTAN SUB-TEHSIL,10,619,0,619
CHAGAI DISTRICT,TAFTAN SUB-TEHSIL,11,536,0,536
CHAGAI DISTRICT,TAFTAN SUB-TEHSIL,12,517,0,517
CHAGAI DISTRICT,TAFTAN SUB-TEHSIL,13,512,0,512
CHAGAI DISTRICT,TAFTAN SUB-TEHSIL,14,493,0,493
CHAGAI DISTRICT,TAFTAN SUB-TEHSIL,15,442,0,442
CHAGAI DISTRICT,TAFTAN SUB-TEHSIL,16,386,0,386
CHAGAI DISTRICT,TAFTAN SUB-TEHSIL,17,402,0,402
CHAGAI DISTRICT,TAFTAN SUB-TEHSIL,18,363,0,363
CHAGAI DISTRICT,TAFTAN SUB-TEHSIL,19,374,0,374
CHAGAI DISTRICT,TAFTAN SUB-TEHSIL,20,312,0,312
CHAGAI DISTRICT,TAFTAN SUB-TEHSIL,21,346,0,346
CHAGAI DISTRICT,TAFTAN SUB-TEHSIL,22,307,0,307
CHAGAI DISTRICT,TAFTAN SUB-TEHSIL,23,321,0,321
CHAGAI DISTRICT,TAFTAN SUB-TEHSIL,24,311,0,311
CHAGAI DISTRICT,TAFTAN SUB-TEHSIL,25,482,0,482
CHAGAI DISTRICT,TAFTAN SUB-TEHSIL,26,249,0,249
CHAGAI DISTRICT,TAFTAN SUB-TEHSIL,27,327,0,327
CHAGAI DISTRICT,TAFTAN SUB-TEHSIL,28,273,0,273
CHAGAI DISTRICT,TAFTAN SUB-TEHSIL,29,368,0,368
CHAGAI DISTRICT,TAFTAN SUB-TEHSIL,30,275,0,275
CHAGAI DISTRICT,TAFTAN SUB-TEHSIL,31,257,0,257
CHAGAI DISTRICT,TAFTAN SUB-TEHSIL,32,277,0,277
CHAGAI DISTRICT,TAFTAN SUB-TEHSIL,33,262,0,262
CHAGAI DISTRICT,TAFTAN SUB-TEHSIL,34,229,0,229
CHAGAI DISTRICT,TAFTAN SUB-TEHSIL,35,241,0,241
CHAGAI DISTRICT,TAFTAN SUB-TEHSIL,36,153,0,153
CHAGAI DISTRICT,TAFTAN SUB-TEHSIL,37,286,0,286
CHAGAI DISTRICT,TAFTAN SUB-TEHSIL,38,177,0,177
CHAGAI DISTRICT,TAFTAN SUB-TEHSIL,39,211,0,211
CHAGAI DISTRICT,TAFTAN SUB-TEHSIL,40,142,0,142
CHAGAI DISTRICT,TAFTAN SUB-TEHSIL,41,128,0,128
CHAGAI DISTRICT,TAFTAN SUB-TEHSIL,42,137,0,137
CHAGAI DISTRICT,TAFTAN SUB-TEHSIL,43,135,0,135
CHAGAI DISTRICT,TAFTAN SUB-TEHSIL,44,121,0,121
CHAGAI DISTRICT,TAFTAN SUB-TEHSIL,45,97,0,97
CHAGAI DISTRICT,TAFTAN SUB-TEHSIL,46,83,0,83
CHAGAI DISTRICT,TAFTAN SUB-TEHSIL,47,130,0,130
CHAGAI DISTRICT,TAFTAN SUB-TEHSIL,48,73,0,73
CHAGAI DISTRICT,TAFTAN SUB-TEHSIL,49,111,0,111
CHAGAI DISTRICT,TAFTAN SUB-TEHSIL,50,70,0,70
CHAGAI DISTRICT,TAFTAN SUB-TEHSIL,51,86,0,86
CHAGAI DISTRICT,TAFTAN SUB-TEHSIL,52,76,0,76
CHAGAI DISTRICT,TAFTAN SUB-TEHSIL,53,70,0,70
CHAGAI DISTRICT,TAFTAN SUB-TEHSIL,54,53,0,53
CHAGAI DISTRICT,TAFTAN SUB-TEHSIL,55,54,0,54
CHAGAI DISTRICT,TAFTAN SUB-TEHSIL,56,41,0,41
CHAGAI DISTRICT,TAFTAN SUB-TEHSIL,57,83,0,83
CHAGAI DISTRICT,TAFTAN SUB-TEHSIL,58,30,0,30
CHAGAI DISTRICT,TAFTAN SUB-TEHSIL,59,65,0,65
CHAGAI DISTRICT,TAFTAN SUB-TEHSIL,60,32,0,32
CHAGAI DISTRICT,TAFTAN SUB-TEHSIL,61,27,0,27
CHAGAI DISTRICT,TAFTAN SUB-TEHSIL,62,40,0,40
CHAGAI DISTRICT,TAFTAN SUB-TEHSIL,63,26,0,26
CHAGAI DISTRICT,TAFTAN SUB-TEHSIL,64,29,0,29
CHAGAI DISTRICT,TAFTAN SUB-TEHSIL,65,21,0,21
CHAGAI DISTRICT,TAFTAN SUB-TEHSIL,66,16,0,16
CHAGAI DISTRICT,TAFTAN SUB-TEHSIL,67,36,0,36
CHAGAI DISTRICT,TAFTAN SUB-TEHSIL,68,21,0,21
CHAGAI DISTRICT,TAFTAN SUB-TEHSIL,69,24,0,24
CHAGAI DISTRICT,TAFTAN SUB-TEHSIL,70,11,0,11
CHAGAI DISTRICT,TAFTAN SUB-TEHSIL,71,11,0,11
CHAGAI DISTRICT,TAFTAN SUB-TEHSIL,72,14,0,14
CHAGAI DISTRICT,TAFTAN SUB-TEHSIL,73,13,0,13
CHAGAI DISTRICT,TAFTAN SUB-TEHSIL,74,11,0,11
CHAGAI DISTRICT,TAFTAN SUB-TEHSIL,>=75,115,0,115
CHAKWAL DISTRICT,CHAKWAL TEHSIL,<1,10777,2828,13605
CHAKWAL DISTRICT,CHAKWAL TEHSIL,1,11396,3141,14537
CHAKWAL DISTRICT,CHAKWAL TEHSIL,2,11274,3180,14454
CHAKWAL DISTRICT,CHAKWAL TEHSIL,3,12027,3476,15503
CHAKWAL DISTRICT,CHAKWAL TEHSIL,4,10970,3152,14122
CHAKWAL DISTRICT,CHAKWAL TEHSIL,5,11159,3187,14346
CHAKWAL DISTRICT,CHAKWAL TEHSIL,6,10900,3220,14120
CHAKWAL DISTRICT,CHAKWAL TEHSIL,7,11585,3299,14884
CHAKWAL DISTRICT,CHAKWAL TEHSIL,8,10097,2928,13025
CHAKWAL DISTRICT,CHAKWAL TEHSIL,9,12059,3451,15510
CHAKWAL DISTRICT,CHAKWAL TEHSIL,10,9436,2661,12097
CHAKWAL DISTRICT,CHAKWAL TEHSIL,11,11887,3230,15117
CHAKWAL DISTRICT,CHAKWAL TEHSIL,12,9658,2639,12297
CHAKWAL DISTRICT,CHAKWAL TEHSIL,13,11157,3050,14207
CHAKWAL DISTRICT,CHAKWAL TEHSIL,14,9761,2756,12517
CHAKWAL DISTRICT,CHAKWAL TEHSIL,15,10213,2758,12971
CHAKWAL DISTRICT,CHAKWAL TEHSIL,16,10425,2876,13301
CHAKWAL DISTRICT,CHAKWAL TEHSIL,17,11098,2997,14095
CHAKWAL DISTRICT,CHAKWAL TEHSIL,18,8116,2353,10469
CHAKWAL DISTRICT,CHAKWAL TEHSIL,19,10424,2835,13259
CHAKWAL DISTRICT,CHAKWAL TEHSIL,20,7943,2251,10194
CHAKWAL DISTRICT,CHAKWAL TEHSIL,21,10370,2830,13200
CHAKWAL DISTRICT,CHAKWAL TEHSIL,22,8357,2418,10775
CHAKWAL DISTRICT,CHAKWAL TEHSIL,23,9432,2620,12052
CHAKWAL DISTRICT,CHAKWAL TEHSIL,24,9011,2604,11615
CHAKWAL DISTRICT,CHAKWAL TEHSIL,25,7245,2042,9287
CHAKWAL DISTRICT,CHAKWAL TEHSIL,26,8529,2494,11023
CHAKWAL DISTRICT,CHAKWAL TEHSIL,27,8469,2412,10881
CHAKWAL DISTRICT,CHAKWAL TEHSIL,28,7623,2228,9851
CHAKWAL DISTRICT,CHAKWAL TEHSIL,29,8274,2394,10668
CHAKWAL DISTRICT,CHAKWAL TEHSIL,30,6905,1999,8904
CHAKWAL DISTRICT,CHAKWAL TEHSIL,31,8373,2222,10595
CHAKWAL DISTRICT,CHAKWAL TEHSIL,32,7401,2261,9662
CHAKWAL DISTRICT,CHAKWAL TEHSIL,33,7627,1967,9594
CHAKWAL DISTRICT,CHAKWAL TEHSIL,34,7332,1932,9264
CHAKWAL DISTRICT,CHAKWAL TEHSIL,35,5738,1772,7510
CHAKWAL DISTRICT,CHAKWAL TEHSIL,36,6862,1948,8810
CHAKWAL DISTRICT,CHAKWAL TEHSIL,37,6178,1692,7870
CHAKWAL DISTRICT,CHAKWAL TEHSIL,38,7003,2053,9056
CHAKWAL DISTRICT,CHAKWAL TEHSIL,39,6376,1797,8173
CHAKWAL DISTRICT,CHAKWAL TEHSIL,40,5389,1633,7022
CHAKWAL DISTRICT,CHAKWAL TEHSIL,41,5939,1516,7455
CHAKWAL DISTRICT,CHAKWAL TEHSIL,42,5191,1535,6726
CHAKWAL DISTRICT,CHAKWAL TEHSIL,43,5477,1513,6990
CHAKWAL DISTRICT,CHAKWAL TEHSIL,44,5142,1370,6512
CHAKWAL DISTRICT,CHAKWAL TEHSIL,45,4348,1373,5721
CHAKWAL DISTRICT,CHAKWAL TEHSIL,46,4929,1282,6211
CHAKWAL DISTRICT,CHAKWAL TEHSIL,47,4457,1125,5582
CHAKWAL DISTRICT,CHAKWAL TEHSIL,48,5289,1406,6695
CHAKWAL DISTRICT,CHAKWAL TEHSIL,49,5274,1199,6473
CHAKWAL DISTRICT,CHAKWAL TEHSIL,50,4587,1326,5913
CHAKWAL DISTRICT,CHAKWAL TEHSIL,51,5052,1117,6169
CHAKWAL DISTRICT,CHAKWAL TEHSIL,52,4740,1200,5940
CHAKWAL DISTRICT,CHAKWAL TEHSIL,53,5109,1058,6167
CHAKWAL DISTRICT,CHAKWAL TEHSIL,54,4564,1042,5606
CHAKWAL DISTRICT,CHAKWAL TEHSIL,55,3844,1007,4851
CHAKWAL DISTRICT,CHAKWAL TEHSIL,56,3698,919,4617
CHAKWAL DISTRICT,CHAKWAL TEHSIL,57,3376,751,4127
CHAKWAL DISTRICT,CHAKWAL TEHSIL,58,3790,870,4660
CHAKWAL DISTRICT,CHAKWAL TEHSIL,59,3758,774,4532
CHAKWAL DISTRICT,CHAKWAL TEHSIL,60,3316,821,4137
CHAKWAL DISTRICT,CHAKWAL TEHSIL,61,3981,834,4815
CHAKWAL DISTRICT,CHAKWAL TEHSIL,62,3783,759,4542
CHAKWAL DISTRICT,CHAKWAL TEHSIL,63,3739,790,4529
CHAKWAL DISTRICT,CHAKWAL TEHSIL,64,3422,645,4067
CHAKWAL DISTRICT,CHAKWAL TEHSIL,65,2772,581,3353
CHAKWAL DISTRICT,CHAKWAL TEHSIL,66,2770,526,3296
CHAKWAL DISTRICT,CHAKWAL TEHSIL,67,2513,460,2973
CHAKWAL DISTRICT,CHAKWAL TEHSIL,68,2685,464,3149
CHAKWAL DISTRICT,CHAKWAL TEHSIL,69,2477,426,2903
CHAKWAL DISTRICT,CHAKWAL TEHSIL,70,2096,457,2553
CHAKWAL DISTRICT,CHAKWAL TEHSIL,71,2156,363,2519
CHAKWAL DISTRICT,CHAKWAL TEHSIL,72,2037,327,2364
CHAKWAL DISTRICT,CHAKWAL TEHSIL,73,1935,327,2262
CHAKWAL DISTRICT,CHAKWAL TEHSIL,74,1543,242,1785
CHAKWAL DISTRICT,CHAKWAL TEHSIL,>=75,13668,2223,15891
CHAKWAL DISTRICT,CHOA SAIDAN SHAH TEHSIL,<1,2643,503,3146
CHAKWAL DISTRICT,CHOA SAIDAN SHAH TEHSIL,1,2745,492,3237
CHAKWAL DISTRICT,CHOA SAIDAN SHAH TEHSIL,2,2724,560,3284
CHAKWAL DISTRICT,CHOA SAIDAN SHAH TEHSIL,3,2933,636,3569
CHAKWAL DISTRICT,CHOA SAIDAN SHAH TEHSIL,4,2700,526,3226
CHAKWAL DISTRICT,CHOA SAIDAN SHAH TEHSIL,5,2742,538,3280
CHAKWAL DISTRICT,CHOA SAIDAN SHAH TEHSIL,6,2792,534,3326
CHAKWAL DISTRICT,CHOA SAIDAN SHAH TEHSIL,7,2803,583,3386
CHAKWAL DISTRICT,CHOA SAIDAN SHAH TEHSIL,8,2449,473,2922
CHAKWAL DISTRICT,CHOA SAIDAN SHAH TEHSIL,9,3033,588,3621
CHAKWAL DISTRICT,CHOA SAIDAN SHAH TEHSIL,10,2165,419,2584
CHAKWAL DISTRICT,CHOA SAIDAN SHAH TEHSIL,11,2800,529,3329
CHAKWAL DISTRICT,CHOA SAIDAN SHAH TEHSIL,12,2226,431,2657
CHAKWAL DISTRICT,CHOA SAIDAN SHAH TEHSIL,13,2470,548,3018
CHAKWAL DISTRICT,CHOA SAIDAN SHAH TEHSIL,14,2098,455,2553
CHAKWAL DISTRICT,CHOA SAIDAN SHAH TEHSIL,15,2175,532,2707
CHAKWAL DISTRICT,CHOA SAIDAN SHAH TEHSIL,16,2312,493,2805
CHAKWAL DISTRICT,CHOA SAIDAN SHAH TEHSIL,17,2474,609,3083
CHAKWAL DISTRICT,CHOA SAIDAN SHAH TEHSIL,18,1828,356,2184
CHAKWAL DISTRICT,CHOA SAIDAN SHAH TEHSIL,19,2513,490,3003
CHAKWAL DISTRICT,CHOA SAIDAN SHAH TEHSIL,20,1779,389,2168
CHAKWAL DISTRICT,CHOA SAIDAN SHAH TEHSIL,21,2430,422,2852
CHAKWAL DISTRICT,CHOA SAIDAN SHAH TEHSIL,22,1865,355,2220
CHAKWAL DISTRICT,CHOA SAIDAN SHAH TEHSIL,23,2294,401,2695
CHAKWAL DISTRICT,CHOA SAIDAN SHAH TEHSIL,24,2083,394,2477
CHAKWAL DISTRICT,CHOA SAIDAN SHAH TEHSIL,25,1674,301,1975
CHAKWAL DISTRICT,CHOA SAIDAN SHAH TEHSIL,26,2070,394,2464
CHAKWAL DISTRICT,CHOA SAIDAN SHAH TEHSIL,27,2048,359,2407
CHAKWAL DISTRICT,CHOA SAIDAN SHAH TEHSIL,28,1826,345,2171
CHAKWAL DISTRICT,CHOA SAIDAN SHAH TEHSIL,29,2014,380,2394
CHAKWAL DISTRICT,CHOA SAIDAN SHAH TEHSIL,30,1579,279,1858
CHAKWAL DISTRICT,CHOA SAIDAN SHAH TEHSIL,31,1992,386,2378
CHAKWAL DISTRICT,CHOA SAIDAN SHAH TEHSIL,32,1799,306,2105
CHAKWAL DISTRICT,CHOA SAIDAN SHAH TEHSIL,33,1869,371,2240
CHAKWAL DISTRICT,CHOA SAIDAN SHAH TEHSIL,34,1862,365,2227
CHAKWAL DISTRICT,CHOA SAIDAN SHAH TEHSIL,35,1296,287,1583
CHAKWAL DISTRICT,CHOA SAIDAN SHAH TEHSIL,36,1782,316,2098
CHAKWAL DISTRICT,CHOA SAIDAN SHAH TEHSIL,37,1604,273,1877
CHAKWAL DISTRICT,CHOA SAIDAN SHAH TEHSIL,38,1651,314,1965
CHAKWAL DISTRICT,CHOA SAIDAN SHAH TEHSIL,39,1618,307,1925
CHAKWAL DISTRICT,CHOA SAIDAN SHAH TEHSIL,40,1151,236,1387
CHAKWAL DISTRICT,CHOA SAIDAN SHAH TEHSIL,41,1405,279,1684
CHAKWAL DISTRICT,CHOA SAIDAN SHAH TEHSIL,42,1245,222,1467
CHAKWAL DISTRICT,CHOA SAIDAN SHAH TEHSIL,43,1193,242,1435
CHAKWAL DISTRICT,CHOA SAIDAN SHAH TEHSIL,44,1194,232,1426
CHAKWAL DISTRICT,CHOA SAIDAN SHAH TEHSIL,45,964,173,1137
CHAKWAL DISTRICT,CHOA SAIDAN SHAH TEHSIL,46,1183,226,1409
CHAKWAL DISTRICT,CHOA SAIDAN SHAH TEHSIL,47,1009,225,1234
CHAKWAL DISTRICT,CHOA SAIDAN SHAH TEHSIL,48,1191,208,1399
CHAKWAL DISTRICT,CHOA SAIDAN SHAH TEHSIL,49,1118,193,1311
CHAKWAL DISTRICT,CHOA SAIDAN SHAH TEHSIL,50,893,178,1071
CHAKWAL DISTRICT,CHOA SAIDAN SHAH TEHSIL,51,1134,220,1354
CHAKWAL DISTRICT,CHOA SAIDAN SHAH TEHSIL,52,1012,162,1174
CHAKWAL DISTRICT,CHOA SAIDAN SHAH TEHSIL,53,1156,206,1362
CHAKWAL DISTRICT,CHOA SAIDAN SHAH TEHSIL,54,956,166,1122
CHAKWAL DISTRICT,CHOA SAIDAN SHAH TEHSIL,55,724,146,870
CHAKWAL DISTRICT,CHOA SAIDAN SHAH TEHSIL,56,867,145,1012
CHAKWAL DISTRICT,CHOA SAIDAN SHAH TEHSIL,57,777,166,943
CHAKWAL DISTRICT,CHOA SAIDAN SHAH TEHSIL,58,784,132,916
CHAKWAL DISTRICT,CHOA SAIDAN SHAH TEHSIL,59,762,131,893
CHAKWAL DISTRICT,CHOA SAIDAN SHAH TEHSIL,60,593,93,686
CHAKWAL DISTRICT,CHOA SAIDAN SHAH TEHSIL,61,866,126,992
CHAKWAL DISTRICT,CHOA SAIDAN SHAH TEHSIL,62,844,99,943
CHAKWAL DISTRICT,CHOA SAIDAN SHAH TEHSIL,63,808,124,932
CHAKWAL DISTRICT,CHOA SAIDAN SHAH TEHSIL,64,706,94,800
CHAKWAL DISTRICT,CHOA SAIDAN SHAH TEHSIL,65,498,73,571
CHAKWAL DISTRICT,CHOA SAIDAN SHAH TEHSIL,66,550,79,629
CHAKWAL DISTRICT,CHOA SAIDAN SHAH TEHSIL,67,569,92,661
CHAKWAL DISTRICT,CHOA SAIDAN SHAH TEHSIL,68,640,82,722
CHAKWAL DISTRICT,CHOA SAIDAN SHAH TEHSIL,69,512,79,591
CHAKWAL DISTRICT,CHOA SAIDAN SHAH TEHSIL,70,348,53,401
CHAKWAL DISTRICT,CHOA SAIDAN SHAH TEHSIL,71,392,72,464
CHAKWAL DISTRICT,CHOA SAIDAN SHAH TEHSIL,72,450,44,494
CHAKWAL DISTRICT,CHOA SAIDAN SHAH TEHSIL,73,428,39,467
CHAKWAL DISTRICT,CHOA SAIDAN SHAH TEHSIL,74,299,26,325
CHAKWAL DISTRICT,CHOA SAIDAN SHAH TEHSIL,>=75,2387,272,2659
CHAKWAL DISTRICT,KALLAR KAHAR TEHSIL,<1,2621,724,3345
CHAKWAL DISTRICT,KALLAR KAHAR TEHSIL,1,2742,895,3637
CHAKWAL DISTRICT,KALLAR KAHAR TEHSIL,2,2731,843,3574
CHAKWAL DISTRICT,KALLAR KAHAR TEHSIL,3,2869,950,3819
CHAKWAL DISTRICT,KALLAR KAHAR TEHSIL,4,2729,867,3596
CHAKWAL DISTRICT,KALLAR KAHAR TEHSIL,5,2685,948,3633
CHAKWAL DISTRICT,KALLAR KAHAR TEHSIL,6,2617,904,3521
CHAKWAL DISTRICT,KALLAR KAHAR TEHSIL,7,2769,1002,3771
CHAKWAL DISTRICT,KALLAR KAHAR TEHSIL,8,2425,834,3259
CHAKWAL DISTRICT,KALLAR KAHAR TEHSIL,9,2775,1019,3794
CHAKWAL DISTRICT,KALLAR KAHAR TEHSIL,10,2163,749,2912
CHAKWAL DISTRICT,KALLAR KAHAR TEHSIL,11,2741,936,3677
CHAKWAL DISTRICT,KALLAR KAHAR TEHSIL,12,2182,823,3005
CHAKWAL DISTRICT,KALLAR KAHAR TEHSIL,13,2456,847,3303
CHAKWAL DISTRICT,KALLAR KAHAR TEHSIL,14,2243,824,3067
CHAKWAL DISTRICT,KALLAR KAHAR TEHSIL,15,2225,1311,3536
CHAKWAL DISTRICT,KALLAR KAHAR TEHSIL,16,2386,1205,3591
CHAKWAL DISTRICT,KALLAR KAHAR TEHSIL,17,2594,1365,3959
CHAKWAL DISTRICT,KALLAR KAHAR TEHSIL,18,1949,715,2664
CHAKWAL DISTRICT,KALLAR KAHAR TEHSIL,19,2566,851,3417
CHAKWAL DISTRICT,KALLAR KAHAR TEHSIL,20,1895,606,2501
CHAKWAL DISTRICT,KALLAR KAHAR TEHSIL,21,2565,831,3396
CHAKWAL DISTRICT,KALLAR KAHAR TEHSIL,22,2094,668,2762
CHAKWAL DISTRICT,KALLAR KAHAR TEHSIL,23,2333,806,3139
CHAKWAL DISTRICT,KALLAR KAHAR TEHSIL,24,2405,758,3163
CHAKWAL DISTRICT,KALLAR KAHAR TEHSIL,25,1685,591,2276
CHAKWAL DISTRICT,KALLAR KAHAR TEHSIL,26,2224,756,2980
CHAKWAL DISTRICT,KALLAR KAHAR TEHSIL,27,2154,677,2831
CHAKWAL DISTRICT,KALLAR KAHAR TEHSIL,28,2006,661,2667
CHAKWAL DISTRICT,KALLAR KAHAR TEHSIL,29,2344,698,3042
CHAKWAL DISTRICT,KALLAR KAHAR TEHSIL,30,1685,597,2282
CHAKWAL DISTRICT,KALLAR KAHAR TEHSIL,31,2201,774,2975
CHAKWAL DISTRICT,KALLAR KAHAR TEHSIL,32,1917,610,2527
CHAKWAL DISTRICT,KALLAR KAHAR TEHSIL,33,1991,650,2641
CHAKWAL DISTRICT,KALLAR KAHAR TEHSIL,34,1963,662,2625
CHAKWAL DISTRICT,KALLAR KAHAR TEHSIL,35,1453,530,1983
CHAKWAL DISTRICT,KALLAR KAHAR TEHSIL,36,1773,657,2430
CHAKWAL DISTRICT,KALLAR KAHAR TEHSIL,37,1659,552,2211
CHAKWAL DISTRICT,KALLAR KAHAR TEHSIL,38,1773,649,2422
CHAKWAL DISTRICT,KALLAR KAHAR TEHSIL,39,1705,564,2269
CHAKWAL DISTRICT,KALLAR KAHAR TEHSIL,40,1229,454,1683
CHAKWAL DISTRICT,KALLAR KAHAR TEHSIL,41,1427,501,1928
CHAKWAL DISTRICT,KALLAR KAHAR TEHSIL,42,1304,453,1757
CHAKWAL DISTRICT,KALLAR KAHAR TEHSIL,43,1334,495,1829
CHAKWAL DISTRICT,KALLAR KAHAR TEHSIL,44,1204,382,1586
CHAKWAL DISTRICT,KALLAR KAHAR TEHSIL,45,925,365,1290
CHAKWAL DISTRICT,KALLAR KAHAR TEHSIL,46,1241,390,1631
CHAKWAL DISTRICT,KALLAR KAHAR TEHSIL,47,1136,377,1513
CHAKWAL DISTRICT,KALLAR KAHAR TEHSIL,48,1188,435,1623
CHAKWAL DISTRICT,KALLAR KAHAR TEHSIL,49,1212,405,1617
CHAKWAL DISTRICT,KALLAR KAHAR TEHSIL,50,956,331,1287
CHAKWAL DISTRICT,KALLAR KAHAR TEHSIL,51,1335,390,1725
CHAKWAL DISTRICT,KALLAR KAHAR TEHSIL,52,1164,389,1553
CHAKWAL DISTRICT,KALLAR KAHAR TEHSIL,53,1212,399,1611
CHAKWAL DISTRICT,KALLAR KAHAR TEHSIL,54,1119,339,1458
CHAKWAL DISTRICT,KALLAR KAHAR TEHSIL,55,812,268,1080
CHAKWAL DISTRICT,KALLAR KAHAR TEHSIL,56,950,284,1234
CHAKWAL DISTRICT,KALLAR KAHAR TEHSIL,57,895,292,1187
CHAKWAL DISTRICT,KALLAR KAHAR TEHSIL,58,951,277,1228
CHAKWAL DISTRICT,KALLAR KAHAR TEHSIL,59,886,235,1121
CHAKWAL DISTRICT,KALLAR KAHAR TEHSIL,60,645,231,876
CHAKWAL DISTRICT,KALLAR KAHAR TEHSIL,61,982,293,1275
CHAKWAL DISTRICT,KALLAR KAHAR TEHSIL,62,920,254,1174
CHAKWAL DISTRICT,KALLAR KAHAR TEHSIL,63,857,259,1116
CHAKWAL DISTRICT,KALLAR KAHAR TEHSIL,64,853,227,1080
CHAKWAL DISTRICT,KALLAR KAHAR TEHSIL,65,549,195,744
CHAKWAL DISTRICT,KALLAR KAHAR TEHSIL,66,740,168,908
CHAKWAL DISTRICT,KALLAR KAHAR TEHSIL,67,679,189,868
CHAKWAL DISTRICT,KALLAR KAHAR TEHSIL,68,687,179,866
CHAKWAL DISTRICT,KALLAR KAHAR TEHSIL,69,601,172,773
CHAKWAL DISTRICT,KALLAR KAHAR TEHSIL,70,387,134,521
CHAKWAL DISTRICT,KALLAR KAHAR TEHSIL,71,569,141,710
CHAKWAL DISTRICT,KALLAR KAHAR TEHSIL,72,551,150,701
CHAKWAL DISTRICT,KALLAR KAHAR TEHSIL,73,503,154,657
CHAKWAL DISTRICT,KALLAR KAHAR TEHSIL,74,420,123,543
CHAKWAL DISTRICT,KALLAR KAHAR TEHSIL,>=75,3380,903,4283
CHAKWAL DISTRICT,LAWA TEHSIL,<1,2248,365,2613
CHAKWAL DISTRICT,LAWA TEHSIL,1,2594,280,2874
CHAKWAL DISTRICT,LAWA TEHSIL,2,2451,341,2792
CHAKWAL DISTRICT,LAWA TEHSIL,3,2625,347,2972
CHAKWAL DISTRICT,LAWA TEHSIL,4,2506,280,2786
CHAKWAL DISTRICT,LAWA TEHSIL,5,2525,302,2827
CHAKWAL DISTRICT,LAWA TEHSIL,6,2385,337,2722
CHAKWAL DISTRICT,LAWA TEHSIL,7,2460,352,2812
CHAKWAL DISTRICT,LAWA TEHSIL,8,2186,303,2489
CHAKWAL DISTRICT,LAWA TEHSIL,9,2501,354,2855
CHAKWAL DISTRICT,LAWA TEHSIL,10,2099,259,2358
CHAKWAL DISTRICT,LAWA TEHSIL,11,2543,365,2908
CHAKWAL DISTRICT,LAWA TEHSIL,12,2121,267,2388
CHAKWAL DISTRICT,LAWA TEHSIL,13,2475,372,2847
CHAKWAL DISTRICT,LAWA TEHSIL,14,2203,262,2465
CHAKWAL DISTRICT,LAWA TEHSIL,15,2257,265,2522
CHAKWAL DISTRICT,LAWA TEHSIL,16,2336,350,2686
CHAKWAL DISTRICT,LAWA TEHSIL,17,2409,317,2726
CHAKWAL DISTRICT,LAWA TEHSIL,18,1790,255,2045
CHAKWAL DISTRICT,LAWA TEHSIL,19,2404,308,2712
CHAKWAL DISTRICT,LAWA TEHSIL,20,1709,222,1931
CHAKWAL DISTRICT,LAWA TEHSIL,21,2192,301,2493
CHAKWAL DISTRICT,LAWA TEHSIL,22,1796,237,2033
CHAKWAL DISTRICT,LAWA TEHSIL,23,2062,307,2369
CHAKWAL DISTRICT,LAWA TEHSIL,24,1884,294,2178
CHAKWAL DISTRICT,LAWA TEHSIL,25,1543,188,1731
CHAKWAL DISTRICT,LAWA TEHSIL,26,1776,290,2066
CHAKWAL DISTRICT,LAWA TEHSIL,27,1689,279,1968
CHAKWAL DISTRICT,LAWA TEHSIL,28,1621,232,1853
CHAKWAL DISTRICT,LAWA TEHSIL,29,1692,288,1980
CHAKWAL DISTRICT,LAWA TEHSIL,30,1352,184,1536
CHAKWAL DISTRICT,LAWA TEHSIL,31,1648,268,1916
CHAKWAL DISTRICT,LAWA TEHSIL,32,1537,236,1773
CHAKWAL DISTRICT,LAWA TEHSIL,33,1452,236,1688
CHAKWAL DISTRICT,LAWA TEHSIL,34,1457,250,1707
CHAKWAL DISTRICT,LAWA TEHSIL,35,1231,161,1392
CHAKWAL DISTRICT,LAWA TEHSIL,36,1384,207,1591
CHAKWAL DISTRICT,LAWA TEHSIL,37,1233,229,1462
CHAKWAL DISTRICT,LAWA TEHSIL,38,1454,185,1639
CHAKWAL DISTRICT,LAWA TEHSIL,39,1374,201,1575
CHAKWAL DISTRICT,LAWA TEHSIL,40,1033,136,1169
CHAKWAL DISTRICT,LAWA TEHSIL,41,1138,189,1327
CHAKWAL DISTRICT,LAWA TEHSIL,42,1126,132,1258
CHAKWAL DISTRICT,LAWA TEHSIL,43,1081,176,1257
CHAKWAL DISTRICT,LAWA TEHSIL,44,968,169,1137
CHAKWAL DISTRICT,LAWA TEHSIL,45,844,102,946
CHAKWAL DISTRICT,LAWA TEHSIL,46,1011,155,1166
CHAKWAL DISTRICT,LAWA TEHSIL,47,892,149,1041
CHAKWAL DISTRICT,LAWA TEHSIL,48,1036,148,1184
CHAKWAL DISTRICT,LAWA TEHSIL,49,992,151,1143
CHAKWAL DISTRICT,LAWA TEHSIL,50,968,117,1085
CHAKWAL DISTRICT,LAWA TEHSIL,51,1016,176,1192
CHAKWAL DISTRICT,LAWA TEHSIL,52,1056,184,1240
CHAKWAL DISTRICT,LAWA TEHSIL,53,1048,157,1205
CHAKWAL DISTRICT,LAWA TEHSIL,54,936,152,1088
CHAKWAL DISTRICT,LAWA TEHSIL,55,804,96,900
CHAKWAL DISTRICT,LAWA TEHSIL,56,900,120,1020
CHAKWAL DISTRICT,LAWA TEHSIL,57,788,148,936
CHAKWAL DISTRICT,LAWA TEHSIL,58,798,135,933
CHAKWAL DISTRICT,LAWA TEHSIL,59,649,112,761
CHAKWAL DISTRICT,LAWA TEHSIL,60,624,59,683
CHAKWAL DISTRICT,LAWA TEHSIL,61,695,123,818
CHAKWAL DISTRICT,LAWA TEHSIL,62,766,86,852
CHAKWAL DISTRICT,LAWA TEHSIL,63,747,111,858
CHAKWAL DISTRICT,LAWA TEHSIL,64,656,107,763
CHAKWAL DISTRICT,LAWA TEHSIL,65,587,68,655
CHAKWAL DISTRICT,LAWA TEHSIL,66,595,80,675
CHAKWAL DISTRICT,LAWA TEHSIL,67,492,74,566
CHAKWAL DISTRICT,LAWA TEHSIL,68,563,63,626
CHAKWAL DISTRICT,LAWA TEHSIL,69,456,86,542
CHAKWAL DISTRICT,LAWA TEHSIL,70,445,53,498
CHAKWAL DISTRICT,LAWA TEHSIL,71,506,100,606
CHAKWAL DISTRICT,LAWA TEHSIL,72,484,70,554
CHAKWAL DISTRICT,LAWA TEHSIL,73,402,71,473
CHAKWAL DISTRICT,LAWA TEHSIL,74,319,49,368
CHAKWAL DISTRICT,LAWA TEHSIL,>=75,3550,415,3965
CHAKWAL DISTRICT,TALA GANG TEHSIL,<1,7063,1282,8345
CHAKWAL DISTRICT,TALA GANG TEHSIL,1,7765,1381,9146
CHAKWAL DISTRICT,TALA GANG TEHSIL,2,7635,1471,9106
CHAKWAL DISTRICT,TALA GANG TEHSIL,3,8190,1483,9673
CHAKWAL DISTRICT,TALA GANG TEHSIL,4,7543,1359,8902
CHAKWAL DISTRICT,TALA GANG TEHSIL,5,7699,1448,9147
CHAKWAL DISTRICT,TALA GANG TEHSIL,6,7274,1444,8718
CHAKWAL DISTRICT,TALA GANG TEHSIL,7,7640,1493,9133
CHAKWAL DISTRICT,TALA GANG TEHSIL,8,6762,1225,7987
CHAKWAL DISTRICT,TALA GANG TEHSIL,9,7697,1435,9132
CHAKWAL DISTRICT,TALA GANG TEHSIL,10,6125,1132,7257
CHAKWAL DISTRICT,TALA GANG TEHSIL,11,7734,1451,9185
CHAKWAL DISTRICT,TALA GANG TEHSIL,12,6657,1255,7912
CHAKWAL DISTRICT,TALA GANG TEHSIL,13,7184,1358,8542
CHAKWAL DISTRICT,TALA GANG TEHSIL,14,6429,1197,7626
CHAKWAL DISTRICT,TALA GANG TEHSIL,15,6643,1207,7850
CHAKWAL DISTRICT,TALA GANG TEHSIL,16,6830,1270,8100
CHAKWAL DISTRICT,TALA GANG TEHSIL,17,7288,1489,8777
CHAKWAL DISTRICT,TALA GANG TEHSIL,18,5709,1111,6820
CHAKWAL DISTRICT,TALA GANG TEHSIL,19,6686,1281,7967
CHAKWAL DISTRICT,TALA GANG TEHSIL,20,5264,1009,6273
CHAKWAL DISTRICT,TALA GANG TEHSIL,21,6544,1264,7808
CHAKWAL DISTRICT,TALA GANG TEHSIL,22,5645,1103,6748
CHAKWAL DISTRICT,TALA GANG TEHSIL,23,6139,1165,7304
CHAKWAL DISTRICT,TALA GANG TEHSIL,24,5842,1180,7022
CHAKWAL DISTRICT,TALA GANG TEHSIL,25,4880,968,5848
CHAKWAL DISTRICT,TALA GANG TEHSIL,26,5734,1109,6843
CHAKWAL DISTRICT,TALA GANG TEHSIL,27,5517,1153,6670
CHAKWAL DISTRICT,TALA GANG TEHSIL,28,5142,1065,6207
CHAKWAL DISTRICT,TALA GANG TEHSIL,29,5282,1064,6346
CHAKWAL DISTRICT,TALA GANG TEHSIL,30,4743,969,5712
CHAKWAL DISTRICT,TALA GANG TEHSIL,31,5370,1115,6485
CHAKWAL DISTRICT,TALA GANG TEHSIL,32,4868,1092,5960
CHAKWAL DISTRICT,TALA GANG TEHSIL,33,4907,1042,5949
CHAKWAL DISTRICT,TALA GANG TEHSIL,34,4521,985,5506
CHAKWAL DISTRICT,TALA GANG TEHSIL,35,3902,798,4700
CHAKWAL DISTRICT,TALA GANG TEHSIL,36,4432,855,5287
CHAKWAL DISTRICT,TALA GANG TEHSIL,37,3883,818,4701
CHAKWAL DISTRICT,TALA GANG TEHSIL,38,4513,934,5447
CHAKWAL DISTRICT,TALA GANG TEHSIL,39,4018,776,4794
CHAKWAL DISTRICT,TALA GANG TEHSIL,40,3548,748,4296
CHAKWAL DISTRICT,TALA GANG TEHSIL,41,3575,734,4309
CHAKWAL DISTRICT,TALA GANG TEHSIL,42,3355,707,4062
CHAKWAL DISTRICT,TALA GANG TEHSIL,43,3428,744,4172
CHAKWAL DISTRICT,TALA GANG TEHSIL,44,3337,628,3965
CHAKWAL DISTRICT,TALA GANG TEHSIL,45,2848,590,3438
CHAKWAL DISTRICT,TALA GANG TEHSIL,46,3118,582,3700
CHAKWAL DISTRICT,TALA GANG TEHSIL,47,2780,471,3251
CHAKWAL DISTRICT,TALA GANG TEHSIL,48,3545,643,4188
CHAKWAL DISTRICT,TALA GANG TEHSIL,49,3134,586,3720
CHAKWAL DISTRICT,TALA GANG TEHSIL,50,3014,606,3620
CHAKWAL DISTRICT,TALA GANG TEHSIL,51,3075,533,3608
CHAKWAL DISTRICT,TALA GANG TEHSIL,52,3131,555,3686
CHAKWAL DISTRICT,TALA GANG TEHSIL,53,3219,582,3801
CHAKWAL DISTRICT,TALA GANG TEHSIL,54,2900,506,3406
CHAKWAL DISTRICT,TALA GANG TEHSIL,55,2500,503,3003
CHAKWAL DISTRICT,TALA GANG TEHSIL,56,2569,415,2984
CHAKWAL DISTRICT,TALA GANG TEHSIL,57,2234,401,2635
CHAKWAL DISTRICT,TALA GANG TEHSIL,58,2391,440,2831
CHAKWAL DISTRICT,TALA GANG TEHSIL,59,2228,419,2647
CHAKWAL DISTRICT,TALA GANG TEHSIL,60,1998,417,2415
CHAKWAL DISTRICT,TALA GANG TEHSIL,61,2089,438,2527
CHAKWAL DISTRICT,TALA GANG TEHSIL,62,2268,409,2677
CHAKWAL DISTRICT,TALA GANG TEHSIL,63,2256,398,2654
CHAKWAL DISTRICT,TALA GANG TEHSIL,64,2054,351,2405
CHAKWAL DISTRICT,TALA GANG TEHSIL,65,1739,303,2042
CHAKWAL DISTRICT,TALA GANG TEHSIL,66,1635,275,1910
CHAKWAL DISTRICT,TALA GANG TEHSIL,67,1559,274,1833
CHAKWAL DISTRICT,TALA GANG TEHSIL,68,1839,276,2115
CHAKWAL DISTRICT,TALA GANG TEHSIL,69,1476,247,1723
CHAKWAL DISTRICT,TALA GANG TEHSIL,70,1384,201,1585
CHAKWAL DISTRICT,TALA GANG TEHSIL,71,1316,207,1523
CHAKWAL DISTRICT,TALA GANG TEHSIL,72,1307,163,1470
CHAKWAL DISTRICT,TALA GANG TEHSIL,73,1280,168,1448
CHAKWAL DISTRICT,TALA GANG TEHSIL,74,1003,129,1132
CHAKWAL DISTRICT,TALA GANG TEHSIL,>=75,9072,1198,10270
CHARSADDA DISTRICT,CHARSADDA TEHSIL,<1,17422,3527,20949
CHARSADDA DISTRICT,CHARSADDA TEHSIL,1,17786,3728,21514
CHARSADDA DISTRICT,CHARSADDA TEHSIL,2,19508,3725,23233
CHARSADDA DISTRICT,CHARSADDA TEHSIL,3,20727,4192,24919
CHARSADDA DISTRICT,CHARSADDA TEHSIL,4,21045,3999,25044
CHARSADDA DISTRICT,CHARSADDA TEHSIL,5,20931,4304,25235
CHARSADDA DISTRICT,CHARSADDA TEHSIL,6,20661,3901,24562
CHARSADDA DISTRICT,CHARSADDA TEHSIL,7,20226,4066,24292
CHARSADDA DISTRICT,CHARSADDA TEHSIL,8,20198,3777,23975
CHARSADDA DISTRICT,CHARSADDA TEHSIL,9,19171,4112,23283
CHARSADDA DISTRICT,CHARSADDA TEHSIL,10,18451,3424,21875
CHARSADDA DISTRICT,CHARSADDA TEHSIL,11,17004,3654,20658
CHARSADDA DISTRICT,CHARSADDA TEHSIL,12,16274,3232,19506
CHARSADDA DISTRICT,CHARSADDA TEHSIL,13,16617,3507,20124
CHARSADDA DISTRICT,CHARSADDA TEHSIL,14,16100,3160,19260
CHARSADDA DISTRICT,CHARSADDA TEHSIL,15,15560,3136,18696
CHARSADDA DISTRICT,CHARSADDA TEHSIL,16,14194,3047,17241
CHARSADDA DISTRICT,CHARSADDA TEHSIL,17,14038,3189,17227
CHARSADDA DISTRICT,CHARSADDA TEHSIL,18,12894,2728,15622
CHARSADDA DISTRICT,CHARSADDA TEHSIL,19,12760,2941,15701
CHARSADDA DISTRICT,CHARSADDA TEHSIL,20,13164,2743,15907
CHARSADDA DISTRICT,CHARSADDA TEHSIL,21,11745,2770,14515
CHARSADDA DISTRICT,CHARSADDA TEHSIL,22,11314,2530,13844
CHARSADDA DISTRICT,CHARSADDA TEHSIL,23,10831,2557,13388
CHARSADDA DISTRICT,CHARSADDA TEHSIL,24,10715,2486,13201
CHARSADDA DISTRICT,CHARSADDA TEHSIL,25,11134,2351,13485
CHARSADDA DISTRICT,CHARSADDA TEHSIL,26,10948,2579,13527
CHARSADDA DISTRICT,CHARSADDA TEHSIL,27,10587,2578,13165
CHARSADDA DISTRICT,CHARSADDA TEHSIL,28,9543,2232,11775
CHARSADDA DISTRICT,CHARSADDA TEHSIL,29,10103,2452,12555
CHARSADDA DISTRICT,CHARSADDA TEHSIL,30,9348,2221,11569
CHARSADDA DISTRICT,CHARSADDA TEHSIL,31,9205,2252,11457
CHARSADDA DISTRICT,CHARSADDA TEHSIL,32,8161,2027,10188
CHARSADDA DISTRICT,CHARSADDA TEHSIL,33,7994,1989,9983
CHARSADDA DISTRICT,CHARSADDA TEHSIL,34,7114,1912,9026
CHARSADDA DISTRICT,CHARSADDA TEHSIL,35,6887,1618,8505
CHARSADDA DISTRICT,CHARSADDA TEHSIL,36,6571,1631,8202
CHARSADDA DISTRICT,CHARSADDA TEHSIL,37,6976,1554,8530
CHARSADDA DISTRICT,CHARSADDA TEHSIL,38,6373,1610,7983
CHARSADDA DISTRICT,CHARSADDA TEHSIL,39,6478,1575,8053
CHARSADDA DISTRICT,CHARSADDA TEHSIL,40,6256,1509,7765
CHARSADDA DISTRICT,CHARSADDA TEHSIL,41,6258,1521,7779
CHARSADDA DISTRICT,CHARSADDA TEHSIL,42,5695,1357,7052
CHARSADDA DISTRICT,CHARSADDA TEHSIL,43,5260,1392,6652
CHARSADDA DISTRICT,CHARSADDA TEHSIL,44,4961,1274,6235
CHARSADDA DISTRICT,CHARSADDA TEHSIL,45,4377,1080,5457
CHARSADDA DISTRICT,CHARSADDA TEHSIL,46,4658,1244,5902
CHARSADDA DISTRICT,CHARSADDA TEHSIL,47,4802,1054,5856
CHARSADDA DISTRICT,CHARSADDA TEHSIL,48,4201,1201,5402
CHARSADDA DISTRICT,CHARSADDA TEHSIL,49,4353,1166,5519
CHARSADDA DISTRICT,CHARSADDA TEHSIL,50,4146,1073,5219
CHARSADDA DISTRICT,CHARSADDA TEHSIL,51,4193,1092,5285
CHARSADDA DISTRICT,CHARSADDA TEHSIL,52,3879,978,4857
CHARSADDA DISTRICT,CHARSADDA TEHSIL,53,3728,988,4716
CHARSADDA DISTRICT,CHARSADDA TEHSIL,54,3212,848,4060
CHARSADDA DISTRICT,CHARSADDA TEHSIL,55,2882,713,3595
CHARSADDA DISTRICT,CHARSADDA TEHSIL,56,3034,793,3827
CHARSADDA DISTRICT,CHARSADDA TEHSIL,57,3205,681,3886
CHARSADDA DISTRICT,CHARSADDA TEHSIL,58,2926,771,3697
CHARSADDA DISTRICT,CHARSADDA TEHSIL,59,3122,765,3887
CHARSADDA DISTRICT,CHARSADDA TEHSIL,60,2909,725,3634
CHARSADDA DISTRICT,CHARSADDA TEHSIL,61,2881,789,3670
CHARSADDA DISTRICT,CHARSADDA TEHSIL,62,2567,672,3239
CHARSADDA DISTRICT,CHARSADDA TEHSIL,63,2682,744,3426
CHARSADDA DISTRICT,CHARSADDA TEHSIL,64,2750,630,3380
CHARSADDA DISTRICT,CHARSADDA TEHSIL,65,1933,512,2445
CHARSADDA DISTRICT,CHARSADDA TEHSIL,66,1851,522,2373
CHARSADDA DISTRICT,CHARSADDA TEHSIL,67,1893,462,2355
CHARSADDA DISTRICT,CHARSADDA TEHSIL,68,1712,437,2149
CHARSADDA DISTRICT,CHARSADDA TEHSIL,69,2035,390,2425
CHARSADDA DISTRICT,CHARSADDA TEHSIL,70,1413,364,1777
CHARSADDA DISTRICT,CHARSADDA TEHSIL,71,1362,384,1746
CHARSADDA DISTRICT,CHARSADDA TEHSIL,72,1221,310,1531
CHARSADDA DISTRICT,CHARSADDA TEHSIL,73,1198,322,1520
CHARSADDA DISTRICT,CHARSADDA TEHSIL,74,1133,227,1360
CHARSADDA DISTRICT,CHARSADDA TEHSIL,>=75,7596,1795,9391
CHARSADDA DISTRICT,SHABQADAR TEHSIL,<1,7842,2553,10395
CHARSADDA DISTRICT,SHABQADAR TEHSIL,1,8229,2424,10653
CHARSADDA DISTRICT,SHABQADAR TEHSIL,2,8968,2763,11731
CHARSADDA DISTRICT,SHABQADAR TEHSIL,3,9512,2885,12397
CHARSADDA DISTRICT,SHABQADAR TEHSIL,4,9998,3063,13061
CHARSADDA DISTRICT,SHABQADAR TEHSIL,5,9010,2767,11777
CHARSADDA DISTRICT,SHABQADAR TEHSIL,6,8915,2851,11766
CHARSADDA DISTRICT,SHABQADAR TEHSIL,7,9257,2855,12112
CHARSADDA DISTRICT,SHABQADAR TEHSIL,8,9012,2848,11860
CHARSADDA DISTRICT,SHABQADAR TEHSIL,9,8682,2750,11432
CHARSADDA DISTRICT,SHABQADAR TEHSIL,10,8116,2471,10587
CHARSADDA DISTRICT,SHABQADAR TEHSIL,11,7604,2304,9908
CHARSADDA DISTRICT,SHABQADAR TEHSIL,12,7296,2300,9596
CHARSADDA DISTRICT,SHABQADAR TEHSIL,13,7453,2287,9740
CHARSADDA DISTRICT,SHABQADAR TEHSIL,14,7220,2247,9467
CHARSADDA DISTRICT,SHABQADAR TEHSIL,15,6962,2017,8979
CHARSADDA DISTRICT,SHABQADAR TEHSIL,16,6305,1953,8258
CHARSADDA DISTRICT,SHABQADAR TEHSIL,17,6446,1915,8361
CHARSADDA DISTRICT,SHABQADAR TEHSIL,18,5624,1824,7448
CHARSADDA DISTRICT,SHABQADAR TEHSIL,19,5505,1857,7362
CHARSADDA DISTRICT,SHABQADAR TEHSIL,20,5669,1934,7603
CHARSADDA DISTRICT,SHABQADAR TEHSIL,21,5230,1886,7116
CHARSADDA DISTRICT,SHABQADAR TEHSIL,22,4908,1685,6593
CHARSADDA DISTRICT,SHABQADAR TEHSIL,23,4613,1722,6335
CHARSADDA DISTRICT,SHABQADAR TEHSIL,24,4484,1589,6073
CHARSADDA DISTRICT,SHABQADAR TEHSIL,25,4885,1523,6408
CHARSADDA DISTRICT,SHABQADAR TEHSIL,26,4350,1448,5798
CHARSADDA DISTRICT,SHABQADAR TEHSIL,27,4604,1443,6047
CHARSADDA DISTRICT,SHABQADAR TEHSIL,28,3905,1379,5284
CHARSADDA DISTRICT,SHABQADAR TEHSIL,29,4182,1399,5581
CHARSADDA DISTRICT,SHABQADAR TEHSIL,30,4026,1222,5248
CHARSADDA DISTRICT,SHABQADAR TEHSIL,31,3867,1267,5134
CHARSADDA DISTRICT,SHABQADAR TEHSIL,32,3519,1121,4640
CHARSADDA DISTRICT,SHABQADAR TEHSIL,33,3250,1153,4403
CHARSADDA DISTRICT,SHABQADAR TEHSIL,34,3045,1007,4052
CHARSADDA DISTRICT,SHABQADAR TEHSIL,35,2628,887,3515
CHARSADDA DISTRICT,SHABQADAR TEHSIL,36,2635,878,3513
CHARSADDA DISTRICT,SHABQADAR TEHSIL,37,2995,958,3953
CHARSADDA DISTRICT,SHABQADAR TEHSIL,38,2389,897,3286
CHARSADDA DISTRICT,SHABQADAR TEHSIL,39,2604,868,3472
CHARSADDA DISTRICT,SHABQADAR TEHSIL,40,2435,821,3256
CHARSADDA DISTRICT,SHABQADAR TEHSIL,41,2514,778,3292
CHARSADDA DISTRICT,SHABQADAR TEHSIL,42,2407,730,3137
CHARSADDA DISTRICT,SHABQADAR TEHSIL,43,2255,733,2988
CHARSADDA DISTRICT,SHABQADAR TEHSIL,44,2105,685,2790
CHARSADDA DISTRICT,SHABQADAR TEHSIL,45,1773,552,2325
CHARSADDA DISTRICT,SHABQADAR TEHSIL,46,2036,672,2708
CHARSADDA DISTRICT,SHABQADAR TEHSIL,47,2326,771,3097
CHARSADDA DISTRICT,SHABQADAR TEHSIL,48,1599,533,2132
CHARSADDA DISTRICT,SHABQADAR TEHSIL,49,1754,579,2333
CHARSADDA DISTRICT,SHABQADAR TEHSIL,50,1785,488,2273
CHARSADDA DISTRICT,SHABQADAR TEHSIL,51,1836,576,2412
CHARSADDA DISTRICT,SHABQADAR TEHSIL,52,1863,518,2381
CHARSADDA DISTRICT,SHABQADAR TEHSIL,53,1476,439,1915
CHARSADDA DISTRICT,SHABQADAR TEHSIL,54,1429,432,1861
CHARSADDA DISTRICT,SHABQADAR TEHSIL,55,1243,396,1639
CHARSADDA DISTRICT,SHABQADAR TEHSIL,56,1329,445,1774
CHARSADDA DISTRICT,SHABQADAR TEHSIL,57,1704,460,2164
CHARSADDA DISTRICT,SHABQADAR TEHSIL,58,1357,438,1795
CHARSADDA DISTRICT,SHABQADAR TEHSIL,59,1586,488,2074
CHARSADDA DISTRICT,SHABQADAR TEHSIL,60,1212,376,1588
CHARSADDA DISTRICT,SHABQADAR TEHSIL,61,1301,444,1745
CHARSADDA DISTRICT,SHABQADAR TEHSIL,62,1164,351,1515
CHARSADDA DISTRICT,SHABQADAR TEHSIL,63,1153,382,1535
CHARSADDA DISTRICT,SHABQADAR TEHSIL,64,1317,370,1687
CHARSADDA DISTRICT,SHABQADAR TEHSIL,65,850,248,1098
CHARSADDA DISTRICT,SHABQADAR TEHSIL,66,782,260,1042
CHARSADDA DISTRICT,SHABQADAR TEHSIL,67,833,237,1070
CHARSADDA DISTRICT,SHABQADAR TEHSIL,68,704,234,938
CHARSADDA DISTRICT,SHABQADAR TEHSIL,69,929,272,1201
CHARSADDA DISTRICT,SHABQADAR TEHSIL,70,645,180,825
CHARSADDA DISTRICT,SHABQADAR TEHSIL,71,526,140,666
CHARSADDA DISTRICT,SHABQADAR TEHSIL,72,422,123,545
CHARSADDA DISTRICT,SHABQADAR TEHSIL,73,458,116,574
CHARSADDA DISTRICT,SHABQADAR TEHSIL,74,472,133,605
CHARSADDA DISTRICT,SHABQADAR TEHSIL,>=75,3138,890,4028
CHARSADDA DISTRICT,TANGI TEHSIL,<1,10531,919,11450
CHARSADDA DISTRICT,TANGI TEHSIL,1,10896,811,11707
CHARSADDA DISTRICT,TANGI TEHSIL,2,12199,912,13111
CHARSADDA DISTRICT,TANGI TEHSIL,3,13019,883,13902
CHARSADDA DISTRICT,TANGI TEHSIL,4,13433,943,14376
CHARSADDA DISTRICT,TANGI TEHSIL,5,12610,924,13534
CHARSADDA DISTRICT,TANGI TEHSIL,6,12472,862,13334
CHARSADDA DISTRICT,TANGI TEHSIL,7,13109,924,14033
CHARSADDA DISTRICT,TANGI TEHSIL,8,12897,803,13700
CHARSADDA DISTRICT,TANGI TEHSIL,9,12282,905,13187
CHARSADDA DISTRICT,TANGI TEHSIL,10,11276,828,12104
CHARSADDA DISTRICT,TANGI TEHSIL,11,10258,821,11079
CHARSADDA DISTRICT,TANGI TEHSIL,12,9827,785,10612
CHARSADDA DISTRICT,TANGI TEHSIL,13,10006,850,10856
CHARSADDA DISTRICT,TANGI TEHSIL,14,9520,795,10315
CHARSADDA DISTRICT,TANGI TEHSIL,15,9520,689,10209
CHARSADDA DISTRICT,TANGI TEHSIL,16,8370,662,9032
CHARSADDA DISTRICT,TANGI TEHSIL,17,8215,734,8949
CHARSADDA DISTRICT,TANGI TEHSIL,18,7668,532,8200
CHARSADDA DISTRICT,TANGI TEHSIL,19,7020,638,7658
CHARSADDA DISTRICT,TANGI TEHSIL,20,8045,619,8664
CHARSADDA DISTRICT,TANGI TEHSIL,21,6899,626,7525
CHARSADDA DISTRICT,TANGI TEHSIL,22,6733,556,7289
CHARSADDA DISTRICT,TANGI TEHSIL,23,6751,528,7279
CHARSADDA DISTRICT,TANGI TEHSIL,24,6472,486,6958
CHARSADDA DISTRICT,TANGI TEHSIL,25,6906,578,7484
CHARSADDA DISTRICT,TANGI TEHSIL,26,6415,523,6938
CHARSADDA DISTRICT,TANGI TEHSIL,27,6291,541,6832
CHARSADDA DISTRICT,TANGI TEHSIL,28,5601,483,6084
CHARSADDA DISTRICT,TANGI TEHSIL,29,5915,539,6454
CHARSADDA DISTRICT,TANGI TEHSIL,30,5859,555,6414
CHARSADDA DISTRICT,TANGI TEHSIL,31,5669,502,6171
CHARSADDA DISTRICT,TANGI TEHSIL,32,4722,438,5160
CHARSADDA DISTRICT,TANGI TEHSIL,33,4574,501,5075
CHARSADDA DISTRICT,TANGI TEHSIL,34,4087,401,4488
CHARSADDA DISTRICT,TANGI TEHSIL,35,3844,433,4277
CHARSADDA DISTRICT,TANGI TEHSIL,36,3831,329,4160
CHARSADDA DISTRICT,TANGI TEHSIL,37,3957,342,4299
CHARSADDA DISTRICT,TANGI TEHSIL,38,3345,340,3685
CHARSADDA DISTRICT,TANGI TEHSIL,39,3595,345,3940
CHARSADDA DISTRICT,TANGI TEHSIL,40,3645,391,4036
CHARSADDA DISTRICT,TANGI TEHSIL,41,3384,324,3708
CHARSADDA DISTRICT,TANGI TEHSIL,42,3042,298,3340
CHARSADDA DISTRICT,TANGI TEHSIL,43,2743,340,3083
CHARSADDA DISTRICT,TANGI TEHSIL,44,2627,280,2907
CHARSADDA DISTRICT,TANGI TEHSIL,45,2438,262,2700
CHARSADDA DISTRICT,TANGI TEHSIL,46,2698,283,2981
CHARSADDA DISTRICT,TANGI TEHSIL,47,2746,268,3014
CHARSADDA DISTRICT,TANGI TEHSIL,48,2179,207,2386
CHARSADDA DISTRICT,TANGI TEHSIL,49,2462,254,2716
CHARSADDA DISTRICT,TANGI TEHSIL,50,2492,268,2760
CHARSADDA DISTRICT,TANGI TEHSIL,51,2373,262,2635
CHARSADDA DISTRICT,TANGI TEHSIL,52,2056,227,2283
CHARSADDA DISTRICT,TANGI TEHSIL,53,1956,197,2153
CHARSADDA DISTRICT,TANGI TEHSIL,54,1655,177,1832
CHARSADDA DISTRICT,TANGI TEHSIL,55,1657,162,1819
CHARSADDA DISTRICT,TANGI TEHSIL,56,1578,184,1762
CHARSADDA DISTRICT,TANGI TEHSIL,57,1807,163,1970
CHARSADDA DISTRICT,TANGI TEHSIL,58,1671,178,1849
CHARSADDA DISTRICT,TANGI TEHSIL,59,1849,167,2016
CHARSADDA DISTRICT,TANGI TEHSIL,60,1720,181,1901
CHARSADDA DISTRICT,TANGI TEHSIL,61,1627,161,1788
CHARSADDA DISTRICT,TANGI TEHSIL,62,1335,150,1485
CHARSADDA DISTRICT,TANGI TEHSIL,63,1536,181,1717
CHARSADDA DISTRICT,TANGI TEHSIL,64,1646,128,1774
CHARSADDA DISTRICT,TANGI TEHSIL,65,1129,132,1261
CHARSADDA DISTRICT,TANGI TEHSIL,66,1042,129,1171
CHARSADDA DISTRICT,TANGI TEHSIL,67,990,75,1065
CHARSADDA DISTRICT,TANGI TEHSIL,68,1025,100,1125
CHARSADDA DISTRICT,TANGI TEHSIL,69,1189,102,1291
CHARSADDA DISTRICT,TANGI TEHSIL,70,823,94,917
CHARSADDA DISTRICT,TANGI TEHSIL,71,740,81,821
CHARSADDA DISTRICT,TANGI TEHSIL,72,616,61,677
CHARSADDA DISTRICT,TANGI TEHSIL,73,712,73,785
CHARSADDA DISTRICT,TANGI TEHSIL,74,669,55,724
CHARSADDA DISTRICT,TANGI TEHSIL,>=75,4756,433,5189
CHINIOT DISTRICT,BHAWANA TEHSIL,<1,9137,877,10014
CHINIOT DISTRICT,BHAWANA TEHSIL,1,8712,898,9610
CHINIOT DISTRICT,BHAWANA TEHSIL,2,9583,822,10405
CHINIOT DISTRICT,BHAWANA TEHSIL,3,10810,956,11766
CHINIOT DISTRICT,BHAWANA TEHSIL,4,10892,978,11870
CHINIOT DISTRICT,BHAWANA TEHSIL,5,10622,987,11609
CHINIOT DISTRICT,BHAWANA TEHSIL,6,10089,1002,11091
CHINIOT DISTRICT,BHAWANA TEHSIL,7,10636,1146,11782
CHINIOT DISTRICT,BHAWANA TEHSIL,8,10202,1015,11217
CHINIOT DISTRICT,BHAWANA TEHSIL,9,9665,1137,10802
CHINIOT DISTRICT,BHAWANA TEHSIL,10,8812,917,9729
CHINIOT DISTRICT,BHAWANA TEHSIL,11,7522,864,8386
CHINIOT DISTRICT,BHAWANA TEHSIL,12,7343,809,8152
CHINIOT DISTRICT,BHAWANA TEHSIL,13,6777,801,7578
CHINIOT DISTRICT,BHAWANA TEHSIL,14,6639,722,7361
CHINIOT DISTRICT,BHAWANA TEHSIL,15,6377,680,7057
CHINIOT DISTRICT,BHAWANA TEHSIL,16,6345,680,7025
CHINIOT DISTRICT,BHAWANA TEHSIL,17,8064,651,8715
CHINIOT DISTRICT,BHAWANA TEHSIL,18,5275,578,5853
CHINIOT DISTRICT,BHAWANA TEHSIL,19,5567,626,6193
CHINIOT DISTRICT,BHAWANA TEHSIL,20,5899,622,6521
CHINIOT DISTRICT,BHAWANA TEHSIL,21,5061,608,5669
CHINIOT DISTRICT,BHAWANA TEHSIL,22,5196,597,5793
CHINIOT DISTRICT,BHAWANA TEHSIL,23,5025,564,5589
CHINIOT DISTRICT,BHAWANA TEHSIL,24,5013,532,5545
CHINIOT DISTRICT,BHAWANA TEHSIL,25,5755,552,6307
CHINIOT DISTRICT,BHAWANA TEHSIL,26,4924,525,5449
CHINIOT DISTRICT,BHAWANA TEHSIL,27,4933,549,5482
CHINIOT DISTRICT,BHAWANA TEHSIL,28,4674,520,5194
CHINIOT DISTRICT,BHAWANA TEHSIL,29,4884,520,5404
CHINIOT DISTRICT,BHAWANA TEHSIL,30,4912,570,5482
CHINIOT DISTRICT,BHAWANA TEHSIL,31,4235,417,4652
CHINIOT DISTRICT,BHAWANA TEHSIL,32,4426,526,4952
CHINIOT DISTRICT,BHAWANA TEHSIL,33,3845,426,4271
CHINIOT DISTRICT,BHAWANA TEHSIL,34,3794,422,4216
CHINIOT DISTRICT,BHAWANA TEHSIL,35,4325,398,4723
CHINIOT DISTRICT,BHAWANA TEHSIL,36,3943,415,4358
CHINIOT DISTRICT,BHAWANA TEHSIL,37,4092,451,4543
CHINIOT DISTRICT,BHAWANA TEHSIL,38,3417,402,3819
CHINIOT DISTRICT,BHAWANA TEHSIL,39,3793,424,4217
CHINIOT DISTRICT,BHAWANA TEHSIL,40,3662,354,4016
CHINIOT DISTRICT,BHAWANA TEHSIL,41,3293,329,3622
CHINIOT DISTRICT,BHAWANA TEHSIL,42,3291,360,3651
CHINIOT DISTRICT,BHAWANA TEHSIL,43,2690,287,2977
CHINIOT DISTRICT,BHAWANA TEHSIL,44,2496,264,2760
CHINIOT DISTRICT,BHAWANA TEHSIL,45,2855,285,3140
CHINIOT DISTRICT,BHAWANA TEHSIL,46,2750,248,2998
CHINIOT DISTRICT,BHAWANA TEHSIL,47,3012,283,3295
CHINIOT DISTRICT,BHAWANA TEHSIL,48,2773,259,3032
CHINIOT DISTRICT,BHAWANA TEHSIL,49,2909,268,3177
CHINIOT DISTRICT,BHAWANA TEHSIL,50,2840,276,3116
CHINIOT DISTRICT,BHAWANA TEHSIL,51,2817,253,3070
CHINIOT DISTRICT,BHAWANA TEHSIL,52,2917,332,3249
CHINIOT DISTRICT,BHAWANA TEHSIL,53,2562,209,2771
CHINIOT DISTRICT,BHAWANA TEHSIL,54,2226,212,2438
CHINIOT DISTRICT,BHAWANA TEHSIL,55,2195,196,2391
CHINIOT DISTRICT,BHAWANA TEHSIL,56,2087,171,2258
CHINIOT DISTRICT,BHAWANA TEHSIL,57,2203,192,2395
CHINIOT DISTRICT,BHAWANA TEHSIL,58,1656,155,1811
CHINIOT DISTRICT,BHAWANA TEHSIL,59,1656,145,1801
CHINIOT DISTRICT,BHAWANA TEHSIL,60,1731,137,1868
CHINIOT DISTRICT,BHAWANA TEHSIL,61,1723,131,1854
CHINIOT DISTRICT,BHAWANA TEHSIL,62,1862,165,2027
CHINIOT DISTRICT,BHAWANA TEHSIL,63,1591,106,1697
CHINIOT DISTRICT,BHAWANA TEHSIL,64,1470,96,1566
CHINIOT DISTRICT,BHAWANA TEHSIL,65,1500,119,1619
CHINIOT DISTRICT,BHAWANA TEHSIL,66,1285,84,1369
CHINIOT DISTRICT,BHAWANA TEHSIL,67,1604,111,1715
CHINIOT DISTRICT,BHAWANA TEHSIL,68,1208,75,1283
CHINIOT DISTRICT,BHAWANA TEHSIL,69,1145,80,1225
CHINIOT DISTRICT,BHAWANA TEHSIL,70,1153,84,1237
CHINIOT DISTRICT,BHAWANA TEHSIL,71,1033,55,1088
CHINIOT DISTRICT,BHAWANA TEHSIL,72,966,71,1037
CHINIOT DISTRICT,BHAWANA TEHSIL,73,862,60,922
CHINIOT DISTRICT,BHAWANA TEHSIL,74,705,54,759
CHINIOT DISTRICT,BHAWANA TEHSIL,>=75,5811,395,6206
CHINIOT DISTRICT,CHINIOT TEHSIL,<1,7359,6830,14189
CHINIOT DISTRICT,CHINIOT TEHSIL,1,7240,7215,14455
CHINIOT DISTRICT,CHINIOT TEHSIL,2,7621,6986,14607
CHINIOT DISTRICT,CHINIOT TEHSIL,3,8480,7642,16122
CHINIOT DISTRICT,CHINIOT TEHSIL,4,8916,7265,16181
CHINIOT DISTRICT,CHINIOT TEHSIL,5,8010,7565,15575
CHINIOT DISTRICT,CHINIOT TEHSIL,6,7968,7131,15099
CHINIOT DISTRICT,CHINIOT TEHSIL,7,7860,7695,15555
CHINIOT DISTRICT,CHINIOT TEHSIL,8,8358,6918,15276
CHINIOT DISTRICT,CHINIOT TEHSIL,9,7364,7322,14686
CHINIOT DISTRICT,CHINIOT TEHSIL,10,7452,6209,13661
CHINIOT DISTRICT,CHINIOT TEHSIL,11,6194,6972,13166
CHINIOT DISTRICT,CHINIOT TEHSIL,12,6122,6043,12165
CHINIOT DISTRICT,CHINIOT TEHSIL,13,5603,6287,11890
CHINIOT DISTRICT,CHINIOT TEHSIL,14,5448,5686,11134
CHINIOT DISTRICT,CHINIOT TEHSIL,15,5394,5870,11264
CHINIOT DISTRICT,CHINIOT TEHSIL,16,5440,5683,11123
CHINIOT DISTRICT,CHINIOT TEHSIL,17,5173,5720,10893
CHINIOT DISTRICT,CHINIOT TEHSIL,18,5266,5380,10646
CHINIOT DISTRICT,CHINIOT TEHSIL,19,4764,5546,10310
CHINIOT DISTRICT,CHINIOT TEHSIL,20,5216,4938,10154
CHINIOT DISTRICT,CHINIOT TEHSIL,21,4368,5290,9658
CHINIOT DISTRICT,CHINIOT TEHSIL,22,4692,4977,9669
CHINIOT DISTRICT,CHINIOT TEHSIL,23,4466,5160,9626
CHINIOT DISTRICT,CHINIOT TEHSIL,24,4350,4987,9337
CHINIOT DISTRICT,CHINIOT TEHSIL,25,4695,4832,9527
CHINIOT DISTRICT,CHINIOT TEHSIL,26,4254,5075,9329
CHINIOT DISTRICT,CHINIOT TEHSIL,27,4182,4978,9160
CHINIOT DISTRICT,CHINIOT TEHSIL,28,4069,4552,8621
CHINIOT DISTRICT,CHINIOT TEHSIL,29,3947,4941,8888
CHINIOT DISTRICT,CHINIOT TEHSIL,30,3929,4199,8128
CHINIOT DISTRICT,CHINIOT TEHSIL,31,3675,4511,8186
CHINIOT DISTRICT,CHINIOT TEHSIL,32,3509,4070,7579
CHINIOT DISTRICT,CHINIOT TEHSIL,33,3126,3991,7117
CHINIOT DISTRICT,CHINIOT TEHSIL,34,3230,3798,7028
CHINIOT DISTRICT,CHINIOT TEHSIL,35,3236,3191,6427
CHINIOT DISTRICT,CHINIOT TEHSIL,36,3355,3495,6850
CHINIOT DISTRICT,CHINIOT TEHSIL,37,3207,3757,6964
CHINIOT DISTRICT,CHINIOT TEHSIL,38,2862,3115,5977
CHINIOT DISTRICT,CHINIOT TEHSIL,39,2992,3425,6417
CHINIOT DISTRICT,CHINIOT TEHSIL,40,2664,2675,5339
CHINIOT DISTRICT,CHINIOT TEHSIL,41,2743,2977,5720
CHINIOT DISTRICT,CHINIOT TEHSIL,42,2587,2692,5279
CHINIOT DISTRICT,CHINIOT TEHSIL,43,2246,2625,4871
CHINIOT DISTRICT,CHINIOT TEHSIL,44,2216,2491,4707
CHINIOT DISTRICT,CHINIOT TEHSIL,45,2111,2027,4138
CHINIOT DISTRICT,CHINIOT TEHSIL,46,2375,2458,4833
CHINIOT DISTRICT,CHINIOT TEHSIL,47,2475,2522,4997
CHINIOT DISTRICT,CHINIOT TEHSIL,48,2246,2306,4552
CHINIOT DISTRICT,CHINIOT TEHSIL,49,2302,2429,4731
CHINIOT DISTRICT,CHINIOT TEHSIL,50,2140,1895,4035
CHINIOT DISTRICT,CHINIOT TEHSIL,51,2396,2493,4889
CHINIOT DISTRICT,CHINIOT TEHSIL,52,2481,2259,4740
CHINIOT DISTRICT,CHINIOT TEHSIL,53,1943,1974,3917
CHINIOT DISTRICT,CHINIOT TEHSIL,54,1757,1795,3552
CHINIOT DISTRICT,CHINIOT TEHSIL,55,1504,1406,2910
CHINIOT DISTRICT,CHINIOT TEHSIL,56,1810,1640,3450
CHINIOT DISTRICT,CHINIOT TEHSIL,57,1853,1587,3440
CHINIOT DISTRICT,CHINIOT TEHSIL,58,1320,1233,2553
CHINIOT DISTRICT,CHINIOT TEHSIL,59,1430,1388,2818
CHINIOT DISTRICT,CHINIOT TEHSIL,60,1313,1102,2415
CHINIOT DISTRICT,CHINIOT TEHSIL,61,1518,1427,2945
CHINIOT DISTRICT,CHINIOT TEHSIL,62,1495,1334,2829
CHINIOT DISTRICT,CHINIOT TEHSIL,63,1307,1213,2520
CHINIOT DISTRICT,CHINIOT TEHSIL,64,1242,1072,2314
CHINIOT DISTRICT,CHINIOT TEHSIL,65,1103,861,1964
CHINIOT DISTRICT,CHINIOT TEHSIL,66,1265,901,2166
CHINIOT DISTRICT,CHINIOT TEHSIL,67,1173,906,2079
CHINIOT DISTRICT,CHINIOT TEHSIL,68,872,747,1619
CHINIOT DISTRICT,CHINIOT TEHSIL,69,984,688,1672
CHINIOT DISTRICT,CHINIOT TEHSIL,70,900,593,1493
CHINIOT DISTRICT,CHINIOT TEHSIL,71,824,669,1493
CHINIOT DISTRICT,CHINIOT TEHSIL,72,826,596,1422
CHINIOT DISTRICT,CHINIOT TEHSIL,73,657,512,1169
CHINIOT DISTRICT,CHINIOT TEHSIL,74,646,397,1043
CHINIOT DISTRICT,CHINIOT TEHSIL,>=75,5152,3391,8543
CHINIOT DISTRICT,LALIAN TEHSIL,<1,8895,2446,11341
CHINIOT DISTRICT,LALIAN TEHSIL,1,8714,2605,11319
CHINIOT DISTRICT,LALIAN TEHSIL,2,8723,2528,11251
CHINIOT DISTRICT,LALIAN TEHSIL,3,9714,2714,12428
CHINIOT DISTRICT,LALIAN TEHSIL,4,10081,2613,12694
CHINIOT DISTRICT,LALIAN TEHSIL,5,9322,2624,11946
CHINIOT DISTRICT,LALIAN TEHSIL,6,9374,2637,12011
CHINIOT DISTRICT,LALIAN TEHSIL,7,9516,2867,12383
CHINIOT DISTRICT,LALIAN TEHSIL,8,9517,2608,12125
CHINIOT DISTRICT,LALIAN TEHSIL,9,8827,2846,11673
CHINIOT DISTRICT,LALIAN TEHSIL,10,8304,2324,10628
CHINIOT DISTRICT,LALIAN TEHSIL,11,7454,2774,10228
CHINIOT DISTRICT,LALIAN TEHSIL,12,7068,2183,9251
CHINIOT DISTRICT,LALIAN TEHSIL,13,6597,2457,9054
CHINIOT DISTRICT,LALIAN TEHSIL,14,6439,2292,8731
CHINIOT DISTRICT,LALIAN TEHSIL,15,6224,2200,8424
CHINIOT DISTRICT,LALIAN TEHSIL,16,6277,2352,8629
CHINIOT DISTRICT,LALIAN TEHSIL,17,6328,2412,8740
CHINIOT DISTRICT,LALIAN TEHSIL,18,6041,2030,8071
CHINIOT DISTRICT,LALIAN TEHSIL,19,5833,2438,8271
CHINIOT DISTRICT,LALIAN TEHSIL,20,5721,1868,7589
CHINIOT DISTRICT,LALIAN TEHSIL,21,5409,2384,7793
CHINIOT DISTRICT,LALIAN TEHSIL,22,5233,1908,7141
CHINIOT DISTRICT,LALIAN TEHSIL,23,4817,1954,6771
CHINIOT DISTRICT,LALIAN TEHSIL,24,5107,1906,7013
CHINIOT DISTRICT,LALIAN TEHSIL,25,5271,1479,6750
CHINIOT DISTRICT,LALIAN TEHSIL,26,4650,1865,6515
CHINIOT DISTRICT,LALIAN TEHSIL,27,4864,1815,6679
CHINIOT DISTRICT,LALIAN TEHSIL,28,4665,1688,6353
CHINIOT DISTRICT,LALIAN TEHSIL,29,5095,1838,6933
CHINIOT DISTRICT,LALIAN TEHSIL,30,4362,1276,5638
CHINIOT DISTRICT,LALIAN TEHSIL,31,4536,1757,6293
CHINIOT DISTRICT,LALIAN TEHSIL,32,4197,1430,5627
CHINIOT DISTRICT,LALIAN TEHSIL,33,3787,1549,5336
CHINIOT DISTRICT,LALIAN TEHSIL,34,3870,1589,5459
CHINIOT DISTRICT,LALIAN TEHSIL,35,3910,1018,4928
CHINIOT DISTRICT,LALIAN TEHSIL,36,4040,1505,5545
CHINIOT DISTRICT,LALIAN TEHSIL,37,4806,1359,6165
CHINIOT DISTRICT,LALIAN TEHSIL,38,3425,1368,4793
CHINIOT DISTRICT,LALIAN TEHSIL,39,4208,1290,5498
CHINIOT DISTRICT,LALIAN TEHSIL,40,2936,947,3883
CHINIOT DISTRICT,LALIAN TEHSIL,41,3378,1249,4627
CHINIOT DISTRICT,LALIAN TEHSIL,42,3713,1083,4796
CHINIOT DISTRICT,LALIAN TEHSIL,43,2720,1072,3792
CHINIOT DISTRICT,LALIAN TEHSIL,44,2716,1088,3804
CHINIOT DISTRICT,LALIAN TEHSIL,45,2225,716,2941
CHINIOT DISTRICT,LALIAN TEHSIL,46,2782,1072,3854
CHINIOT DISTRICT,LALIAN TEHSIL,47,3614,1073,4687
CHINIOT DISTRICT,LALIAN TEHSIL,48,2562,938,3500
CHINIOT DISTRICT,LALIAN TEHSIL,49,2938,955,3893
CHINIOT DISTRICT,LALIAN TEHSIL,50,2275,746,3021
CHINIOT DISTRICT,LALIAN TEHSIL,51,2981,1114,4095
CHINIOT DISTRICT,LALIAN TEHSIL,52,2955,971,3926
CHINIOT DISTRICT,LALIAN TEHSIL,53,2271,891,3162
CHINIOT DISTRICT,LALIAN TEHSIL,54,2125,847,2972
CHINIOT DISTRICT,LALIAN TEHSIL,55,1649,555,2204
CHINIOT DISTRICT,LALIAN TEHSIL,56,1989,783,2772
CHINIOT DISTRICT,LALIAN TEHSIL,57,2414,709,3123
CHINIOT DISTRICT,LALIAN TEHSIL,58,1473,619,2092
CHINIOT DISTRICT,LALIAN TEHSIL,59,1803,651,2454
CHINIOT DISTRICT,LALIAN TEHSIL,60,1492,487,1979
CHINIOT DISTRICT,LALIAN TEHSIL,61,1781,701,2482
CHINIOT DISTRICT,LALIAN TEHSIL,62,1899,687,2586
CHINIOT DISTRICT,LALIAN TEHSIL,63,1464,639,2103
CHINIOT DISTRICT,LALIAN TEHSIL,64,1559,544,2103
CHINIOT DISTRICT,LALIAN TEHSIL,65,1236,339,1575
CHINIOT DISTRICT,LALIAN TEHSIL,66,1580,537,2117
CHINIOT DISTRICT,LALIAN TEHSIL,67,1700,470,2170
CHINIOT DISTRICT,LALIAN TEHSIL,68,1106,376,1482
CHINIOT DISTRICT,LALIAN TEHSIL,69,1284,400,1684
CHINIOT DISTRICT,LALIAN TEHSIL,70,1109,260,1369
CHINIOT DISTRICT,LALIAN TEHSIL,71,1190,378,1568
CHINIOT DISTRICT,LALIAN TEHSIL,72,1167,358,1525
CHINIOT DISTRICT,LALIAN TEHSIL,73,798,279,1077
CHINIOT DISTRICT,LALIAN TEHSIL,74,806,269,1075
CHINIOT DISTRICT,LALIAN TEHSIL,>=75,6496,2016,8512
CHITRAL DISTRICT,CHITRAL SUB-DIVISION,<1,6537,1231,7768
CHITRAL DISTRICT,CHITRAL SUB-DIVISION,1,6723,1147,7870
CHITRAL DISTRICT,CHITRAL SUB-DIVISION,2,6611,1213,7824
CHITRAL DISTRICT,CHITRAL SUB-DIVISION,3,6551,1246,7797
CHITRAL DISTRICT,CHITRAL SUB-DIVISION,4,6699,1185,7884
CHITRAL DISTRICT,CHITRAL SUB-DIVISION,5,6313,1189,7502
CHITRAL DISTRICT,CHITRAL SUB-DIVISION,6,6262,1045,7307
CHITRAL DISTRICT,CHITRAL SUB-DIVISION,7,6094,1120,7214
CHITRAL DISTRICT,CHITRAL SUB-DIVISION,8,5990,960,6950
CHITRAL DISTRICT,CHITRAL SUB-DIVISION,9,6169,1154,7323
CHITRAL DISTRICT,CHITRAL SUB-DIVISION,10,5350,1058,6408
CHITRAL DISTRICT,CHITRAL SUB-DIVISION,11,5735,1080,6815
CHITRAL DISTRICT,CHITRAL SUB-DIVISION,12,5151,1075,6226
CHITRAL DISTRICT,CHITRAL SUB-DIVISION,13,5447,1211,6658
CHITRAL DISTRICT,CHITRAL SUB-DIVISION,14,5186,1094,6280
CHITRAL DISTRICT,CHITRAL SUB-DIVISION,15,5358,1193,6551
CHITRAL DISTRICT,CHITRAL SUB-DIVISION,16,5112,1154,6266
CHITRAL DISTRICT,CHITRAL SUB-DIVISION,17,5102,1442,6544
CHITRAL DISTRICT,CHITRAL SUB-DIVISION,18,5138,1217,6355
CHITRAL DISTRICT,CHITRAL SUB-DIVISION,19,5301,1305,6606
CHITRAL DISTRICT,CHITRAL SUB-DIVISION,20,4534,1021,5555
CHITRAL DISTRICT,CHITRAL SUB-DIVISION,21,4773,1081,5854
CHITRAL DISTRICT,CHITRAL SUB-DIVISION,22,4032,875,4907
CHITRAL DISTRICT,CHITRAL SUB-DIVISION,23,4281,996,5277
CHITRAL DISTRICT,CHITRAL SUB-DIVISION,24,3860,926,4786
CHITRAL DISTRICT,CHITRAL SUB-DIVISION,25,3970,973,4943
CHITRAL DISTRICT,CHITRAL SUB-DIVISION,26,3659,854,4513
CHITRAL DISTRICT,CHITRAL SUB-DIVISION,27,3853,920,4773
CHITRAL DISTRICT,CHITRAL SUB-DIVISION,28,3154,794,3948
CHITRAL DISTRICT,CHITRAL SUB-DIVISION,29,3460,829,4289
CHITRAL DISTRICT,CHITRAL SUB-DIVISION,30,2923,780,3703
CHITRAL DISTRICT,CHITRAL SUB-DIVISION,31,3116,733,3849
CHITRAL DISTRICT,CHITRAL SUB-DIVISION,32,2526,718,3244
CHITRAL DISTRICT,CHITRAL SUB-DIVISION,33,2630,648,3278
CHITRAL DISTRICT,CHITRAL SUB-DIVISION,34,2381,602,2983
CHITRAL DISTRICT,CHITRAL SUB-DIVISION,35,2255,646,2901
CHITRAL DISTRICT,CHITRAL SUB-DIVISION,36,2219,567,2786
CHITRAL DISTRICT,CHITRAL SUB-DIVISION,37,2486,580,3066
CHITRAL DISTRICT,CHITRAL SUB-DIVISION,38,1999,555,2554
CHITRAL DISTRICT,CHITRAL SUB-DIVISION,39,2103,555,2658
CHITRAL DISTRICT,CHITRAL SUB-DIVISION,40,2005,570,2575
CHITRAL DISTRICT,CHITRAL SUB-DIVISION,41,1988,489,2477
CHITRAL DISTRICT,CHITRAL SUB-DIVISION,42,1902,409,2311
CHITRAL DISTRICT,CHITRAL SUB-DIVISION,43,1937,491,2428
CHITRAL DISTRICT,CHITRAL SUB-DIVISION,44,1706,398,2104
CHITRAL DISTRICT,CHITRAL SUB-DIVISION,45,1586,455,2041
CHITRAL DISTRICT,CHITRAL SUB-DIVISION,46,1834,391,2225
CHITRAL DISTRICT,CHITRAL SUB-DIVISION,47,1921,359,2280
CHITRAL DISTRICT,CHITRAL SUB-DIVISION,48,1806,377,2183
CHITRAL DISTRICT,CHITRAL SUB-DIVISION,49,1689,415,2104
CHITRAL DISTRICT,CHITRAL SUB-DIVISION,50,1648,480,2128
CHITRAL DISTRICT,CHITRAL SUB-DIVISION,51,1635,376,2011
CHITRAL DISTRICT,CHITRAL SUB-DIVISION,52,1344,311,1655
CHITRAL DISTRICT,CHITRAL SUB-DIVISION,53,1474,342,1816
CHITRAL DISTRICT,CHITRAL SUB-DIVISION,54,1264,300,1564
CHITRAL DISTRICT,CHITRAL SUB-DIVISION,55,1124,314,1438
CHITRAL DISTRICT,CHITRAL SUB-DIVISION,56,1099,251,1350
CHITRAL DISTRICT,CHITRAL SUB-DIVISION,57,959,250,1209
CHITRAL DISTRICT,CHITRAL SUB-DIVISION,58,976,232,1208
CHITRAL DISTRICT,CHITRAL SUB-DIVISION,59,1068,281,1349
CHITRAL DISTRICT,CHITRAL SUB-DIVISION,60,1147,272,1419
CHITRAL DISTRICT,CHITRAL SUB-DIVISION,61,1372,301,1673
CHITRAL DISTRICT,CHITRAL SUB-DIVISION,62,1055,260,1315
CHITRAL DISTRICT,CHITRAL SUB-DIVISION,63,1059,234,1293
CHITRAL DISTRICT,CHITRAL SUB-DIVISION,64,961,214,1175
CHITRAL DISTRICT,CHITRAL SUB-DIVISION,65,814,172,986
CHITRAL DISTRICT,CHITRAL SUB-DIVISION,66,1088,170,1258
CHITRAL DISTRICT,CHITRAL SUB-DIVISION,67,876,207,1083
CHITRAL DISTRICT,CHITRAL SUB-DIVISION,68,709,123,832
CHITRAL DISTRICT,CHITRAL SUB-DIVISION,69,704,133,837
CHITRAL DISTRICT,CHITRAL SUB-DIVISION,70,670,120,790
CHITRAL DISTRICT,CHITRAL SUB-DIVISION,71,952,144,1096
CHITRAL DISTRICT,CHITRAL SUB-DIVISION,72,623,147,770
CHITRAL DISTRICT,CHITRAL SUB-DIVISION,73,479,84,563
CHITRAL DISTRICT,CHITRAL SUB-DIVISION,74,414,88,502
CHITRAL DISTRICT,CHITRAL SUB-DIVISION,>=75,3617,648,4265
CHITRAL DISTRICT,MASTUJ SUB-DIVISION,<1,4714,0,4714
CHITRAL DISTRICT,MASTUJ SUB-DIVISION,1,4298,0,4298
CHITRAL DISTRICT,MASTUJ SUB-DIVISION,2,4029,0,4029
CHITRAL DISTRICT,MASTUJ SUB-DIVISION,3,4084,0,4084
CHITRAL DISTRICT,MASTUJ SUB-DIVISION,4,4156,0,4156
CHITRAL DISTRICT,MASTUJ SUB-DIVISION,5,4167,0,4167
CHITRAL DISTRICT,MASTUJ SUB-DIVISION,6,3413,0,3413
CHITRAL DISTRICT,MASTUJ SUB-DIVISION,7,4089,0,4089
CHITRAL DISTRICT,MASTUJ SUB-DIVISION,8,3512,0,3512
CHITRAL DISTRICT,MASTUJ SUB-DIVISION,9,4514,0,4514
CHITRAL DISTRICT,MASTUJ SUB-DIVISION,10,3254,0,3254
CHITRAL DISTRICT,MASTUJ SUB-DIVISION,11,4579,0,4579
CHITRAL DISTRICT,MASTUJ SUB-DIVISION,12,3518,0,3518
CHITRAL DISTRICT,MASTUJ SUB-DIVISION,13,4325,0,4325
CHITRAL DISTRICT,MASTUJ SUB-DIVISION,14,4038,0,4038
CHITRAL DISTRICT,MASTUJ SUB-DIVISION,15,4284,0,4284
CHITRAL DISTRICT,MASTUJ SUB-DIVISION,16,3748,0,3748
CHITRAL DISTRICT,MASTUJ SUB-DIVISION,17,4115,0,4115
CHITRAL DISTRICT,MASTUJ SUB-DIVISION,18,3779,0,3779
CHITRAL DISTRICT,MASTUJ SUB-DIVISION,19,4246,0,4246
CHITRAL DISTRICT,MASTUJ SUB-DIVISION,20,3074,0,3074
CHITRAL DISTRICT,MASTUJ SUB-DIVISION,21,3622,0,3622
CHITRAL DISTRICT,MASTUJ SUB-DIVISION,22,2753,0,2753
CHITRAL DISTRICT,MASTUJ SUB-DIVISION,23,3267,0,3267
CHITRAL DISTRICT,MASTUJ SUB-DIVISION,24,2972,0,2972
CHITRAL DISTRICT,MASTUJ SUB-DIVISION,25,2526,0,2526
CHITRAL DISTRICT,MASTUJ SUB-DIVISION,26,2767,0,2767
CHITRAL DISTRICT,MASTUJ SUB-DIVISION,27,2891,0,2891
CHITRAL DISTRICT,MASTUJ SUB-DIVISION,28,2292,0,2292
CHITRAL DISTRICT,MASTUJ SUB-DIVISION,29,2925,0,2925
CHITRAL DISTRICT,MASTUJ SUB-DIVISION,30,1795,0,1795
CHITRAL DISTRICT,MASTUJ SUB-DIVISION,31,2433,0,2433
CHITRAL DISTRICT,MASTUJ SUB-DIVISION,32,1958,0,1958
CHITRAL DISTRICT,MASTUJ SUB-DIVISION,33,2072,0,2072
CHITRAL DISTRICT,MASTUJ SUB-DIVISION,34,1972,0,1972
CHITRAL DISTRICT,MASTUJ SUB-DIVISION,35,1556,0,1556
CHITRAL DISTRICT,MASTUJ SUB-DIVISION,36,1706,0,1706
CHITRAL DISTRICT,MASTUJ SUB-DIVISION,37,1953,0,1953
CHITRAL DISTRICT,MASTUJ SUB-DIVISION,38,1473,0,1473
CHITRAL DISTRICT,MASTUJ SUB-DIVISION,39,1803,0,1803
CHITRAL DISTRICT,MASTUJ SUB-DIVISION,40,1115,0,1115
CHITRAL DISTRICT,MASTUJ SUB-DIVISION,41,1610,0,1610
CHITRAL DISTRICT,MASTUJ SUB-DIVISION,42,1558,0,1558
CHITRAL DISTRICT,MASTUJ SUB-DIVISION,43,1480,0,1480
CHITRAL DISTRICT,MASTUJ SUB-DIVISION,44,1357,0,1357
CHITRAL DISTRICT,MASTUJ SUB-DIVISION,45,1032,0,1032
CHITRAL DISTRICT,MASTUJ SUB-DIVISION,46,1507,0,1507
CHITRAL DISTRICT,MASTUJ SUB-DIVISION,47,1762,0,1762
CHITRAL DISTRICT,MASTUJ SUB-DIVISION,48,1487,0,1487
CHITRAL DISTRICT,MASTUJ SUB-DIVISION,49,1569,0,1569
CHITRAL DISTRICT,MASTUJ SUB-DIVISION,50,997,0,997
CHITRAL DISTRICT,MASTUJ SUB-DIVISION,51,1578,0,1578
CHITRAL DISTRICT,MASTUJ SUB-DIVISION,52,1059,0,1059
CHITRAL DISTRICT,MASTUJ SUB-DIVISION,53,1389,0,1389
CHITRAL DISTRICT,MASTUJ SUB-DIVISION,54,955,0,955
CHITRAL DISTRICT,MASTUJ SUB-DIVISION,55,837,0,837
CHITRAL DISTRICT,MASTUJ SUB-DIVISION,56,934,0,934
CHITRAL DISTRICT,MASTUJ SUB-DIVISION,57,1028,0,1028
CHITRAL DISTRICT,MASTUJ SUB-DIVISION,58,1011,0,1011
CHITRAL DISTRICT,MASTUJ SUB-DIVISION,59,1276,0,1276
CHITRAL DISTRICT,MASTUJ SUB-DIVISION,60,775,0,775
CHITRAL DISTRICT,MASTUJ SUB-DIVISION,61,1482,0,1482
CHITRAL DISTRICT,MASTUJ SUB-DIVISION,62,968,0,968
CHITRAL DISTRICT,MASTUJ SUB-DIVISION,63,1101,0,1101
CHITRAL DISTRICT,MASTUJ SUB-DIVISION,64,835,0,835
CHITRAL DISTRICT,MASTUJ SUB-DIVISION,65,668,0,668
CHITRAL DISTRICT,MASTUJ SUB-DIVISION,66,1108,0,1108
CHITRAL DISTRICT,MASTUJ SUB-DIVISION,67,753,0,753
CHITRAL DISTRICT,MASTUJ SUB-DIVISION,68,670,0,670
CHITRAL DISTRICT,MASTUJ SUB-DIVISION,69,686,0,686
CHITRAL DISTRICT,MASTUJ SUB-DIVISION,70,493,0,493
CHITRAL DISTRICT,MASTUJ SUB-DIVISION,71,1041,0,1041
CHITRAL DISTRICT,MASTUJ SUB-DIVISION,72,465,0,465
CHITRAL DISTRICT,MASTUJ SUB-DIVISION,73,469,0,469
CHITRAL DISTRICT,MASTUJ SUB-DIVISION,74,340,0,340
CHITRAL DISTRICT,MASTUJ SUB-DIVISION,>=75,3230,0,3230
DADU DISTRICT,DADU TALUKA,<1,5395,4019,9414
DADU DISTRICT,DADU TALUKA,1,7102,4268,11370
DADU DISTRICT,DADU TALUKA,2,8529,4920,13449
DADU DISTRICT,DADU TALUKA,3,10162,5714,15876
DADU DISTRICT,DADU TALUKA,4,10343,5691,16034
DADU DISTRICT,DADU TALUKA,5,10394,6122,16516
DADU DISTRICT,DADU TALUKA,6,9844,5425,15269
DADU DISTRICT,DADU TALUKA,7,8687,5520,14207
DADU DISTRICT,DADU TALUKA,8,10000,5307,15307
DADU DISTRICT,DADU TALUKA,9,7674,4951,12625
DADU DISTRICT,DADU TALUKA,10,8845,4790,13635
DADU DISTRICT,DADU TALUKA,11,6310,4415,10725
DADU DISTRICT,DADU TALUKA,12,7516,4336,11852
DADU DISTRICT,DADU TALUKA,13,6019,4190,10209
DADU DISTRICT,DADU TALUKA,14,6386,4072,10458
DADU DISTRICT,DADU TALUKA,15,6461,4501,10962
DADU DISTRICT,DADU TALUKA,16,6305,4279,10584
DADU DISTRICT,DADU TALUKA,17,5694,4438,10132
DADU DISTRICT,DADU TALUKA,18,6655,4283,10938
DADU DISTRICT,DADU TALUKA,19,5198,3931,9129
DADU DISTRICT,DADU TALUKA,20,6030,3751,9781
DADU DISTRICT,DADU TALUKA,21,4046,3442,7488
DADU DISTRICT,DADU TALUKA,22,4688,3360,8048
DADU DISTRICT,DADU TALUKA,23,3824,3146,6970
DADU DISTRICT,DADU TALUKA,24,3744,2909,6653
DADU DISTRICT,DADU TALUKA,25,4955,3112,8067
DADU DISTRICT,DADU TALUKA,26,3762,2893,6655
DADU DISTRICT,DADU TALUKA,27,3779,2964,6743
DADU DISTRICT,DADU TALUKA,28,4517,2901,7418
DADU DISTRICT,DADU TALUKA,29,3893,3017,6910
DADU DISTRICT,DADU TALUKA,30,4637,2719,7356
DADU DISTRICT,DADU TALUKA,31,3473,2523,5996
DADU DISTRICT,DADU TALUKA,32,3473,2536,6009
DADU DISTRICT,DADU TALUKA,33,3402,2471,5873
DADU DISTRICT,DADU TALUKA,34,2767,2015,4782
DADU DISTRICT,DADU TALUKA,35,3712,2119,5831
DADU DISTRICT,DADU TALUKA,36,2527,1733,4260
DADU DISTRICT,DADU TALUKA,37,2972,1903,4875
DADU DISTRICT,DADU TALUKA,38,2925,1985,4910
DADU DISTRICT,DADU TALUKA,39,2826,1894,4720
DADU DISTRICT,DADU TALUKA,40,3238,1920,5158
DADU DISTRICT,DADU TALUKA,41,2335,1780,4115
DADU DISTRICT,DADU TALUKA,42,2366,1717,4083
DADU DISTRICT,DADU TALUKA,43,2200,1623,3823
DADU DISTRICT,DADU TALUKA,44,1988,1534,3522
DADU DISTRICT,DADU TALUKA,45,2447,1478,3925
DADU DISTRICT,DADU TALUKA,46,1670,1342,3012
DADU DISTRICT,DADU TALUKA,47,1991,1442,3433
DADU DISTRICT,DADU TALUKA,48,2022,1476,3498
DADU DISTRICT,DADU TALUKA,49,1857,1617,3474
DADU DISTRICT,DADU TALUKA,50,2248,1310,3558
DADU DISTRICT,DADU TALUKA,51,1550,1201,2751
DADU DISTRICT,DADU TALUKA,52,1590,1187,2777
DADU DISTRICT,DADU TALUKA,53,1420,1017,2437
DADU DISTRICT,DADU TALUKA,54,1242,970,2212
DADU DISTRICT,DADU TALUKA,55,1624,961,2585
DADU DISTRICT,DADU TALUKA,56,988,696,1684
DADU DISTRICT,DADU TALUKA,57,1139,763,1902
DADU DISTRICT,DADU TALUKA,58,960,742,1702
DADU DISTRICT,DADU TALUKA,59,1023,749,1772
DADU DISTRICT,DADU TALUKA,60,1270,664,1934
DADU DISTRICT,DADU TALUKA,61,931,656,1587
DADU DISTRICT,DADU TALUKA,62,1051,709,1760
DADU DISTRICT,DADU TALUKA,63,924,652,1576
DADU DISTRICT,DADU TALUKA,64,814,532,1346
DADU DISTRICT,DADU TALUKA,65,950,558,1508
DADU DISTRICT,DADU TALUKA,66,599,432,1031
DADU DISTRICT,DADU TALUKA,67,701,439,1140
DADU DISTRICT,DADU TALUKA,68,658,452,1110
DADU DISTRICT,DADU TALUKA,69,586,330,916
DADU DISTRICT,DADU TALUKA,70,612,304,916
DADU DISTRICT,DADU TALUKA,71,484,301,785
DADU DISTRICT,DADU TALUKA,72,429,273,702
DADU DISTRICT,DADU TALUKA,73,482,295,777
DADU DISTRICT,DADU TALUKA,74,335,180,515
DADU DISTRICT,DADU TALUKA,>=75,2890,1713,4603
DADU DISTRICT,JOHI TALUKA,<1,5272,726,5998
DADU DISTRICT,JOHI TALUKA,1,7030,653,7683
DADU DISTRICT,JOHI TALUKA,2,8845,902,9747
DADU DISTRICT,JOHI TALUKA,3,9676,1072,10748
DADU DISTRICT,JOHI TALUKA,4,10232,1020,11252
DADU DISTRICT,JOHI TALUKA,5,10290,1111,11401
DADU DISTRICT,JOHI TALUKA,6,10340,975,11315
DADU DISTRICT,JOHI TALUKA,7,7886,968,8854
DADU DISTRICT,JOHI TALUKA,8,10789,902,11691
DADU DISTRICT,JOHI TALUKA,9,7741,868,8609
DADU DISTRICT,JOHI TALUKA,10,9498,820,10318
DADU DISTRICT,JOHI TALUKA,11,5796,697,6493
DADU DISTRICT,JOHI TALUKA,12,7315,765,8080
DADU DISTRICT,JOHI TALUKA,13,5145,642,5787
DADU DISTRICT,JOHI TALUKA,14,5600,659,6259
DADU DISTRICT,JOHI TALUKA,15,5701,658,6359
DADU DISTRICT,JOHI TALUKA,16,5338,585,5923
DADU DISTRICT,JOHI TALUKA,17,4116,588,4704
DADU DISTRICT,JOHI TALUKA,18,5631,575,6206
DADU DISTRICT,JOHI TALUKA,19,3888,566,4454
DADU DISTRICT,JOHI TALUKA,20,5377,530,5907
DADU DISTRICT,JOHI TALUKA,21,3422,472,3894
DADU DISTRICT,JOHI TALUKA,22,4318,478,4796
DADU DISTRICT,JOHI TALUKA,23,3271,436,3707
DADU DISTRICT,JOHI TALUKA,24,3082,353,3435
DADU DISTRICT,JOHI TALUKA,25,4694,475,5169
DADU DISTRICT,JOHI TALUKA,26,3238,417,3655
DADU DISTRICT,JOHI TALUKA,27,3636,477,4113
DADU DISTRICT,JOHI TALUKA,28,3710,406,4116
DADU DISTRICT,JOHI TALUKA,29,3918,496,4414
DADU DISTRICT,JOHI TALUKA,30,4043,361,4404
DADU DISTRICT,JOHI TALUKA,31,3233,378,3611
DADU DISTRICT,JOHI TALUKA,32,3213,420,3633
DADU DISTRICT,JOHI TALUKA,33,3140,408,3548
DADU DISTRICT,JOHI TALUKA,34,2538,285,2823
DADU DISTRICT,JOHI TALUKA,35,3392,285,3677
DADU DISTRICT,JOHI TALUKA,36,2267,219,2486
DADU DISTRICT,JOHI TALUKA,37,3575,488,4063
DADU DISTRICT,JOHI TALUKA,38,2581,294,2875
DADU DISTRICT,JOHI TALUKA,39,2997,349,3346
DADU DISTRICT,JOHI TALUKA,40,2968,256,3224
DADU DISTRICT,JOHI TALUKA,41,2295,269,2564
DADU DISTRICT,JOHI TALUKA,42,2379,276,2655
DADU DISTRICT,JOHI TALUKA,43,2142,235,2377
DADU DISTRICT,JOHI TALUKA,44,1836,242,2078
DADU DISTRICT,JOHI TALUKA,45,2191,191,2382
DADU DISTRICT,JOHI TALUKA,46,1530,172,1702
DADU DISTRICT,JOHI TALUKA,47,2257,273,2530
DADU DISTRICT,JOHI TALUKA,48,1833,179,2012
DADU DISTRICT,JOHI TALUKA,49,1953,265,2218
DADU DISTRICT,JOHI TALUKA,50,1987,143,2130
DADU DISTRICT,JOHI TALUKA,51,1491,228,1719
DADU DISTRICT,JOHI TALUKA,52,1674,202,1876
DADU DISTRICT,JOHI TALUKA,53,1175,142,1317
DADU DISTRICT,JOHI TALUKA,54,1150,110,1260
DADU DISTRICT,JOHI TALUKA,55,1393,117,1510
DADU DISTRICT,JOHI TALUKA,56,961,92,1053
DADU DISTRICT,JOHI TALUKA,57,1477,189,1666
DADU DISTRICT,JOHI TALUKA,58,1094,94,1188
DADU DISTRICT,JOHI TALUKA,59,1074,143,1217
DADU DISTRICT,JOHI TALUKA,60,1197,90,1287
DADU DISTRICT,JOHI TALUKA,61,961,124,1085
DADU DISTRICT,JOHI TALUKA,62,1251,118,1369
DADU DISTRICT,JOHI TALUKA,63,981,115,1096
DADU DISTRICT,JOHI TALUKA,64,824,78,902
DADU DISTRICT,JOHI TALUKA,65,874,79,953
DADU DISTRICT,JOHI TALUKA,66,628,71,699
DADU DISTRICT,JOHI TALUKA,67,923,104,1027
DADU DISTRICT,JOHI TALUKA,68,695,79,774
DADU DISTRICT,JOHI TALUKA,69,649,66,715
DADU DISTRICT,JOHI TALUKA,70,620,40,660
DADU DISTRICT,JOHI TALUKA,71,488,56,544
DADU DISTRICT,JOHI TALUKA,72,611,58,669
DADU DISTRICT,JOHI TALUKA,73,412,46,458
DADU DISTRICT,JOHI TALUKA,74,371,41,412
DADU DISTRICT,JOHI TALUKA,>=75,3239,269,3508
DADU DISTRICT,KHAIRPUR NATHAN SHAH TALUKA,<1,5982,1448,7430
DADU DISTRICT,KHAIRPUR NATHAN SHAH TALUKA,1,6846,1755,8601
DADU DISTRICT,KHAIRPUR NATHAN SHAH TALUKA,2,8180,2166,10346
DADU DISTRICT,KHAIRPUR NATHAN SHAH TALUKA,3,9377,2450,11827
DADU DISTRICT,KHAIRPUR NATHAN SHAH TALUKA,4,9615,2376,11991
DADU DISTRICT,KHAIRPUR NATHAN SHAH TALUKA,5,9759,2421,12180
DADU DISTRICT,KHAIRPUR NATHAN SHAH TALUKA,6,9917,2405,12322
DADU DISTRICT,KHAIRPUR NATHAN SHAH TALUKA,7,8292,2271,10563
DADU DISTRICT,KHAIRPUR NATHAN SHAH TALUKA,8,10089,2385,12474
DADU DISTRICT,KHAIRPUR NATHAN SHAH TALUKA,9,7760,2216,9976
DADU DISTRICT,KHAIRPUR NATHAN SHAH TALUKA,10,8973,2135,11108
DADU DISTRICT,KHAIRPUR NATHAN SHAH TALUKA,11,6495,1735,8230
DADU DISTRICT,KHAIRPUR NATHAN SHAH TALUKA,12,7155,1922,9077
DADU DISTRICT,KHAIRPUR NATHAN SHAH TALUKA,13,5920,1707,7627
DADU DISTRICT,KHAIRPUR NATHAN SHAH TALUKA,14,5866,1713,7579
DADU DISTRICT,KHAIRPUR NATHAN SHAH TALUKA,15,6076,1794,7870
DADU DISTRICT,KHAIRPUR NATHAN SHAH TALUKA,16,5717,1691,7408
DADU DISTRICT,KHAIRPUR NATHAN SHAH TALUKA,17,5310,1595,6905
DADU DISTRICT,KHAIRPUR NATHAN SHAH TALUKA,18,6051,1672,7723
DADU DISTRICT,KHAIRPUR NATHAN SHAH TALUKA,19,4579,1504,6083
DADU DISTRICT,KHAIRPUR NATHAN SHAH TALUKA,20,5346,1529,6875
DADU DISTRICT,KHAIRPUR NATHAN SHAH TALUKA,21,3736,1202,4938
DADU DISTRICT,KHAIRPUR NATHAN SHAH TALUKA,22,3837,1222,5059
DADU DISTRICT,KHAIRPUR NATHAN SHAH TALUKA,23,3486,1097,4583
DADU DISTRICT,KHAIRPUR NATHAN SHAH TALUKA,24,3222,1035,4257
DADU DISTRICT,KHAIRPUR NATHAN SHAH TALUKA,25,4031,1259,5290
DADU DISTRICT,KHAIRPUR NATHAN SHAH TALUKA,26,3379,1089,4468
DADU DISTRICT,KHAIRPUR NATHAN SHAH TALUKA,27,3476,1032,4508
DADU DISTRICT,KHAIRPUR NATHAN SHAH TALUKA,28,3802,1196,4998
DADU DISTRICT,KHAIRPUR NATHAN SHAH TALUKA,29,3672,1000,4672
DADU DISTRICT,KHAIRPUR NATHAN SHAH TALUKA,30,3647,1075,4722
DADU DISTRICT,KHAIRPUR NATHAN SHAH TALUKA,31,3349,913,4262
DADU DISTRICT,KHAIRPUR NATHAN SHAH TALUKA,32,3422,892,4314
DADU DISTRICT,KHAIRPUR NATHAN SHAH TALUKA,33,2877,898,3775
DADU DISTRICT,KHAIRPUR NATHAN SHAH TALUKA,34,2640,737,3377
DADU DISTRICT,KHAIRPUR NATHAN SHAH TALUKA,35,2787,913,3700
DADU DISTRICT,KHAIRPUR NATHAN SHAH TALUKA,36,2905,732,3637
DADU DISTRICT,KHAIRPUR NATHAN SHAH TALUKA,37,3292,785,4077
DADU DISTRICT,KHAIRPUR NATHAN SHAH TALUKA,38,2644,825,3469
DADU DISTRICT,KHAIRPUR NATHAN SHAH TALUKA,39,2594,741,3335
DADU DISTRICT,KHAIRPUR NATHAN SHAH TALUKA,40,2531,874,3405
DADU DISTRICT,KHAIRPUR NATHAN SHAH TALUKA,41,2245,596,2841
DADU DISTRICT,KHAIRPUR NATHAN SHAH TALUKA,42,2277,607,2884
DADU DISTRICT,KHAIRPUR NATHAN SHAH TALUKA,43,2001,650,2651
DADU DISTRICT,KHAIRPUR NATHAN SHAH TALUKA,44,1951,577,2528
DADU DISTRICT,KHAIRPUR NATHAN SHAH TALUKA,45,1799,669,2468
DADU DISTRICT,KHAIRPUR NATHAN SHAH TALUKA,46,1961,489,2450
DADU DISTRICT,KHAIRPUR NATHAN SHAH TALUKA,47,2194,526,2720
DADU DISTRICT,KHAIRPUR NATHAN SHAH TALUKA,48,1725,538,2263
DADU DISTRICT,KHAIRPUR NATHAN SHAH TALUKA,49,1729,473,2202
DADU DISTRICT,KHAIRPUR NATHAN SHAH TALUKA,50,1640,598,2238
DADU DISTRICT,KHAIRPUR NATHAN SHAH TALUKA,51,1594,399,1993
DADU DISTRICT,KHAIRPUR NATHAN SHAH TALUKA,52,1410,382,1792
DADU DISTRICT,KHAIRPUR NATHAN SHAH TALUKA,53,1236,382,1618
DADU DISTRICT,KHAIRPUR NATHAN SHAH TALUKA,54,1124,344,1468
DADU DISTRICT,KHAIRPUR NATHAN SHAH TALUKA,55,1173,422,1595
DADU DISTRICT,KHAIRPUR NATHAN SHAH TALUKA,56,1160,261,1421
DADU DISTRICT,KHAIRPUR NATHAN SHAH TALUKA,57,1288,295,1583
DADU DISTRICT,KHAIRPUR NATHAN SHAH TALUKA,58,1058,289,1347
DADU DISTRICT,KHAIRPUR NATHAN SHAH TALUKA,59,990,245,1235
DADU DISTRICT,KHAIRPUR NATHAN SHAH TALUKA,60,1014,309,1323
DADU DISTRICT,KHAIRPUR NATHAN SHAH TALUKA,61,1060,227,1287
DADU DISTRICT,KHAIRPUR NATHAN SHAH TALUKA,62,1096,245,1341
DADU DISTRICT,KHAIRPUR NATHAN SHAH TALUKA,63,890,267,1157
DADU DISTRICT,KHAIRPUR NATHAN SHAH TALUKA,64,833,208,1041
DADU DISTRICT,KHAIRPUR NATHAN SHAH TALUKA,65,686,221,907
DADU DISTRICT,KHAIRPUR NATHAN SHAH TALUKA,66,733,162,895
DADU DISTRICT,KHAIRPUR NATHAN SHAH TALUKA,67,655,139,794
DADU DISTRICT,KHAIRPUR NATHAN SHAH TALUKA,68,608,164,772
DADU DISTRICT,KHAIRPUR NATHAN SHAH TALUKA,69,518,143,661
DADU DISTRICT,KHAIRPUR NATHAN SHAH TALUKA,70,513,133,646
DADU DISTRICT,KHAIRPUR NATHAN SHAH TALUKA,71,475,103,578
DADU DISTRICT,KHAIRPUR NATHAN SHAH TALUKA,72,438,104,542
DADU DISTRICT,KHAIRPUR NATHAN SHAH TALUKA,73,416,117,533
DADU DISTRICT,KHAIRPUR NATHAN SHAH TALUKA,74,335,96,431
DADU DISTRICT,KHAIRPUR NATHAN SHAH TALUKA,>=75,2605,626,3231
DADU DISTRICT,MEHAR TALUKA,<1,7671,1857,9528
DADU DISTRICT,MEHAR TALUKA,1,9487,2480,11967
DADU DISTRICT,MEHAR TALUKA,2,12100,2861,14961
DADU DISTRICT,MEHAR TALUKA,3,13358,3330,16688
DADU DISTRICT,MEHAR TALUKA,4,14709,3275,17984
DADU DISTRICT,MEHAR TALUKA,5,13917,3619,17536
DADU DISTRICT,MEHAR TALUKA,6,14008,3069,17077
DADU DISTRICT,MEHAR TALUKA,7,11448,3070,14518
DADU DISTRICT,MEHAR TALUKA,8,14333,3154,17487
DADU DISTRICT,MEHAR TALUKA,9,10515,2839,13354
DADU DISTRICT,MEHAR TALUKA,10,12711,2918,15629
DADU DISTRICT,MEHAR TALUKA,11,8341,2319,10660
DADU DISTRICT,MEHAR TALUKA,12,9923,2511,12434
DADU DISTRICT,MEHAR TALUKA,13,7737,2265,10002
DADU DISTRICT,MEHAR TALUKA,14,8368,2230,10598
DADU DISTRICT,MEHAR TALUKA,15,8194,2484,10678
DADU DISTRICT,MEHAR TALUKA,16,7965,2270,10235
DADU DISTRICT,MEHAR TALUKA,17,7066,2300,9366
DADU DISTRICT,MEHAR TALUKA,18,8173,2389,10562
DADU DISTRICT,MEHAR TALUKA,19,6220,1914,8134
DADU DISTRICT,MEHAR TALUKA,20,7344,2267,9611
DADU DISTRICT,MEHAR TALUKA,21,5174,1785,6959
DADU DISTRICT,MEHAR TALUKA,22,5386,1765,7151
DADU DISTRICT,MEHAR TALUKA,23,4286,1551,5837
DADU DISTRICT,MEHAR TALUKA,24,4836,1427,6263
DADU DISTRICT,MEHAR TALUKA,25,5528,1881,7409
DADU DISTRICT,MEHAR TALUKA,26,4367,1241,5608
DADU DISTRICT,MEHAR TALUKA,27,5036,1544,6580
DADU DISTRICT,MEHAR TALUKA,28,5116,1569,6685
DADU DISTRICT,MEHAR TALUKA,29,5162,1476,6638
DADU DISTRICT,MEHAR TALUKA,30,4785,1614,6399
DADU DISTRICT,MEHAR TALUKA,31,4361,1303,5664
DADU DISTRICT,MEHAR TALUKA,32,4609,1363,5972
DADU DISTRICT,MEHAR TALUKA,33,3732,1229,4961
DADU DISTRICT,MEHAR TALUKA,34,3297,980,4277
DADU DISTRICT,MEHAR TALUKA,35,3825,1270,5095
DADU DISTRICT,MEHAR TALUKA,36,3494,857,4351
DADU DISTRICT,MEHAR TALUKA,37,4876,1101,5977
DADU DISTRICT,MEHAR TALUKA,38,3367,1051,4418
DADU DISTRICT,MEHAR TALUKA,39,3430,1045,4475
DADU DISTRICT,MEHAR TALUKA,40,3431,1133,4564
DADU DISTRICT,MEHAR TALUKA,41,3095,845,3940
DADU DISTRICT,MEHAR TALUKA,42,3443,851,4294
DADU DISTRICT,MEHAR TALUKA,43,2654,819,3473
DADU DISTRICT,MEHAR TALUKA,44,2602,775,3377
DADU DISTRICT,MEHAR TALUKA,45,2515,864,3379
DADU DISTRICT,MEHAR TALUKA,46,2379,632,3011
DADU DISTRICT,MEHAR TALUKA,47,3246,780,4026
DADU DISTRICT,MEHAR TALUKA,48,2268,738,3006
DADU DISTRICT,MEHAR TALUKA,49,2273,709,2982
DADU DISTRICT,MEHAR TALUKA,50,2183,805,2988
DADU DISTRICT,MEHAR TALUKA,51,2135,589,2724
DADU DISTRICT,MEHAR TALUKA,52,2146,594,2740
DADU DISTRICT,MEHAR TALUKA,53,1605,491,2096
DADU DISTRICT,MEHAR TALUKA,54,1429,494,1923
DADU DISTRICT,MEHAR TALUKA,55,1659,540,2199
DADU DISTRICT,MEHAR TALUKA,56,1440,352,1792
DADU DISTRICT,MEHAR TALUKA,57,1936,446,2382
DADU DISTRICT,MEHAR TALUKA,58,1288,396,1684
DADU DISTRICT,MEHAR TALUKA,59,1314,378,1692
DADU DISTRICT,MEHAR TALUKA,60,1334,411,1745
DADU DISTRICT,MEHAR TALUKA,61,1236,342,1578
DADU DISTRICT,MEHAR TALUKA,62,1476,414,1890
DADU DISTRICT,MEHAR TALUKA,63,1215,391,1606
DADU DISTRICT,MEHAR TALUKA,64,1068,281,1349
DADU DISTRICT,MEHAR TALUKA,65,1086,337,1423
DADU DISTRICT,MEHAR TALUKA,66,908,235,1143
DADU DISTRICT,MEHAR TALUKA,67,1015,225,1240
DADU DISTRICT,MEHAR TALUKA,68,769,200,969
DADU DISTRICT,MEHAR TALUKA,69,788,204,992
DADU DISTRICT,MEHAR TALUKA,70,704,178,882
DADU DISTRICT,MEHAR TALUKA,71,582,177,759
DADU DISTRICT,MEHAR TALUKA,72,674,120,794
DADU DISTRICT,MEHAR TALUKA,73,535,121,656
DADU DISTRICT,MEHAR TALUKA,74,381,111,492
DADU DISTRICT,MEHAR TALUKA,>=75,3410,931,4341
DERA BUGTI DISTRICT,BAIKER SUB-TEHSIL,<1,1172,0,1172
DERA BUGTI DISTRICT,BAIKER SUB-TEHSIL,1,793,0,793
DERA BUGTI DISTRICT,BAIKER SUB-TEHSIL,2,1264,0,1264
DERA BUGTI DISTRICT,BAIKER SUB-TEHSIL,3,709,0,709
DERA BUGTI DISTRICT,BAIKER SUB-TEHSIL,4,1294,0,1294
DERA BUGTI DISTRICT,BAIKER SUB-TEHSIL,5,688,0,688
DERA BUGTI DISTRICT,BAIKER SUB-TEHSIL,6,1163,0,1163
DERA BUGTI DISTRICT,BAIKER SUB-TEHSIL,7,660,0,660
DERA BUGTI DISTRICT,BAIKER SUB-TEHSIL,8,1031,0,1031
DERA BUGTI DISTRICT,BAIKER SUB-TEHSIL,9,705,0,705
DERA BUGTI DISTRICT,BAIKER SUB-TEHSIL,10,817,0,817
DERA BUGTI DISTRICT,BAIKER SUB-TEHSIL,11,547,0,547
DERA BUGTI DISTRICT,BAIKER SUB-TEHSIL,12,501,0,501
DERA BUGTI DISTRICT,BAIKER SUB-TEHSIL,13,366,0,366
DERA BUGTI DISTRICT,BAIKER SUB-TEHSIL,14,436,0,436
DERA BUGTI DISTRICT,BAIKER SUB-TEHSIL,15,197,0,197
DERA BUGTI DISTRICT,BAIKER SUB-TEHSIL,16,230,0,230
DERA BUGTI DISTRICT,BAIKER SUB-TEHSIL,17,151,0,151
DERA BUGTI DISTRICT,BAIKER SUB-TEHSIL,18,180,0,180
DERA BUGTI DISTRICT,BAIKER SUB-TEHSIL,19,168,0,168
DERA BUGTI DISTRICT,BAIKER SUB-TEHSIL,20,187,0,187
DERA BUGTI DISTRICT,BAIKER SUB-TEHSIL,21,165,0,165
DERA BUGTI DISTRICT,BAIKER SUB-TEHSIL,22,217,0,217
DERA BUGTI DISTRICT,BAIKER SUB-TEHSIL,23,159,0,159
DERA BUGTI DISTRICT,BAIKER SUB-TEHSIL,24,204,0,204
DERA BUGTI DISTRICT,BAIKER SUB-TEHSIL,25,263,0,263
DERA BUGTI DISTRICT,BAIKER SUB-TEHSIL,26,224,0,224
DERA BUGTI DISTRICT,BAIKER SUB-TEHSIL,27,203,0,203
DERA BUGTI DISTRICT,BAIKER SUB-TEHSIL,28,281,0,281
DERA BUGTI DISTRICT,BAIKER SUB-TEHSIL,29,206,0,206
DERA BUGTI DISTRICT,BAIKER SUB-TEHSIL,30,284,0,284
DERA BUGTI DISTRICT,BAIKER SUB-TEHSIL,31,234,0,234
DERA BUGTI DISTRICT,BAIKER SUB-TEHSIL,32,213,0,213
DERA BUGTI DISTRICT,BAIKER SUB-TEHSIL,33,230,0,230
DERA BUGTI DISTRICT,BAIKER SUB-TEHSIL,34,153,0,153
DERA BUGTI DISTRICT,BAIKER SUB-TEHSIL,35,212,0,212
DERA BUGTI DISTRICT,BAIKER SUB-TEHSIL,36,181,0,181
DERA BUGTI DISTRICT,BAIKER SUB-TEHSIL,37,149,0,149
DERA BUGTI DISTRICT,BAIKER SUB-TEHSIL,38,255,0,255
DERA BUGTI DISTRICT,BAIKER SUB-TEHSIL,39,140,0,140
DERA BUGTI DISTRICT,BAIKER SUB-TEHSIL,40,201,0,201
DERA BUGTI DISTRICT,BAIKER SUB-TEHSIL,41,138,0,138
DERA BUGTI DISTRICT,BAIKER SUB-TEHSIL,42,87,0,87
DERA BUGTI DISTRICT,BAIKER SUB-TEHSIL,43,122,0,122
DERA BUGTI DISTRICT,BAIKER SUB-TEHSIL,44,86,0,86
DERA BUGTI DISTRICT,BAIKER SUB-TEHSIL,45,117,0,117
DERA BUGTI DISTRICT,BAIKER SUB-TEHSIL,46,77,0,77
DERA BUGTI DISTRICT,BAIKER SUB-TEHSIL,47,73,0,73
DERA BUGTI DISTRICT,BAIKER SUB-TEHSIL,48,102,0,102
DERA BUGTI DISTRICT,BAIKER SUB-TEHSIL,49,67,0,67
DERA BUGTI DISTRICT,BAIKER SUB-TEHSIL,50,114,0,114
DERA BUGTI DISTRICT,BAIKER SUB-TEHSIL,51,80,0,80
DERA BUGTI DISTRICT,BAIKER SUB-TEHSIL,52,43,0,43
DERA BUGTI DISTRICT,BAIKER SUB-TEHSIL,53,52,0,52
DERA BUGTI DISTRICT,BAIKER SUB-TEHSIL,54,57,0,57
DERA BUGTI DISTRICT,BAIKER SUB-TEHSIL,55,83,0,83
DERA BUGTI DISTRICT,BAIKER SUB-TEHSIL,56,62,0,62
DERA BUGTI DISTRICT,BAIKER SUB-TEHSIL,57,66,0,66
DERA BUGTI DISTRICT,BAIKER SUB-TEHSIL,58,52,0,52
DERA BUGTI DISTRICT,BAIKER SUB-TEHSIL,59,44,0,44
DERA BUGTI DISTRICT,BAIKER SUB-TEHSIL,60,72,0,72
DERA BUGTI DISTRICT,BAIKER SUB-TEHSIL,61,33,0,33
DERA BUGTI DISTRICT,BAIKER SUB-TEHSIL,62,39,0,39
DERA BUGTI DISTRICT,BAIKER SUB-TEHSIL,63,26,0,26
DERA BUGTI DISTRICT,BAIKER SUB-TEHSIL,64,29,0,29
DERA BUGTI DISTRICT,BAIKER SUB-TEHSIL,65,27,0,27
DERA BUGTI DISTRICT,BAIKER SUB-TEHSIL,66,30,0,30
DERA BUGTI DISTRICT,BAIKER SUB-TEHSIL,67,32,0,32
DERA BUGTI DISTRICT,BAIKER SUB-TEHSIL,68,21,0,21
DERA BUGTI DISTRICT,BAIKER SUB-TEHSIL,69,12,0,12
DERA BUGTI DISTRICT,BAIKER SUB-TEHSIL,70,23,0,23
DERA BUGTI DISTRICT,BAIKER SUB-TEHSIL,71,16,0,16
DERA BUGTI DISTRICT,BAIKER SUB-TEHSIL,72,14,0,14
DERA BUGTI DISTRICT,BAIKER SUB-TEHSIL,73,21,0,21
DERA BUGTI DISTRICT,BAIKER SUB-TEHSIL,74,11,0,11
DERA BUGTI DISTRICT,BAIKER SUB-TEHSIL,>=75,136,0,136
DERA BUGTI DISTRICT,DERA BUGTI TEHSIL,<1,1107,1251,2358
DERA BUGTI DISTRICT,DERA BUGTI TEHSIL,1,741,852,1593
DERA BUGTI DISTRICT,DERA BUGTI TEHSIL,2,995,1252,2247
DERA BUGTI DISTRICT,DERA BUGTI TEHSIL,3,813,1304,2117
DERA BUGTI DISTRICT,DERA BUGTI TEHSIL,4,1022,1217,2239
DERA BUGTI DISTRICT,DERA BUGTI TEHSIL,5,796,1099,1895
DERA BUGTI DISTRICT,DERA BUGTI TEHSIL,6,1007,1207,2214
DERA BUGTI DISTRICT,DERA BUGTI TEHSIL,7,768,964,1732
DERA BUGTI DISTRICT,DERA BUGTI TEHSIL,8,895,1025,1920
DERA BUGTI DISTRICT,DERA BUGTI TEHSIL,9,690,912,1602
DERA BUGTI DISTRICT,DERA BUGTI TEHSIL,10,760,908,1668
DERA BUGTI DISTRICT,DERA BUGTI TEHSIL,11,492,646,1138
DERA BUGTI DISTRICT,DERA BUGTI TEHSIL,12,470,709,1179
DERA BUGTI DISTRICT,DERA BUGTI TEHSIL,13,414,519,933
DERA BUGTI DISTRICT,DERA BUGTI TEHSIL,14,344,581,925
DERA BUGTI DISTRICT,DERA BUGTI TEHSIL,15,378,441,819
DERA BUGTI DISTRICT,DERA BUGTI TEHSIL,16,301,457,758
DERA BUGTI DISTRICT,DERA BUGTI TEHSIL,17,419,464,883
DERA BUGTI DISTRICT,DERA BUGTI TEHSIL,18,425,447,872
DERA BUGTI DISTRICT,DERA BUGTI TEHSIL,19,330,504,834
DERA BUGTI DISTRICT,DERA BUGTI TEHSIL,20,324,455,779
DERA BUGTI DISTRICT,DERA BUGTI TEHSIL,21,298,407,705
DERA BUGTI DISTRICT,DERA BUGTI TEHSIL,22,239,351,590
DERA BUGTI DISTRICT,DERA BUGTI TEHSIL,23,214,392,606
DERA BUGTI DISTRICT,DERA BUGTI TEHSIL,24,221,406,627
DERA BUGTI DISTRICT,DERA BUGTI TEHSIL,25,296,401,697
DERA BUGTI DISTRICT,DERA BUGTI TEHSIL,26,267,370,637
DERA BUGTI DISTRICT,DERA BUGTI TEHSIL,27,270,475,745
DERA BUGTI DISTRICT,DERA BUGTI TEHSIL,28,278,348,626
DERA BUGTI DISTRICT,DERA BUGTI TEHSIL,29,283,498,781
DERA BUGTI DISTRICT,DERA BUGTI TEHSIL,30,301,397,698
DERA BUGTI DISTRICT,DERA BUGTI TEHSIL,31,277,322,599
DERA BUGTI DISTRICT,DERA BUGTI TEHSIL,32,210,365,575
DERA BUGTI DISTRICT,DERA BUGTI TEHSIL,33,179,308,487
DERA BUGTI DISTRICT,DERA BUGTI TEHSIL,34,193,265,458
DERA BUGTI DISTRICT,DERA BUGTI TEHSIL,35,201,289,490
DERA BUGTI DISTRICT,DERA BUGTI TEHSIL,36,208,249,457
DERA BUGTI DISTRICT,DERA BUGTI TEHSIL,37,187,314,501
DERA BUGTI DISTRICT,DERA BUGTI TEHSIL,38,151,259,410
DERA BUGTI DISTRICT,DERA BUGTI TEHSIL,39,140,256,396
DERA BUGTI DISTRICT,DERA BUGTI TEHSIL,40,218,262,480
DERA BUGTI DISTRICT,DERA BUGTI TEHSIL,41,155,156,311
DERA BUGTI DISTRICT,DERA BUGTI TEHSIL,42,98,195,293
DERA BUGTI DISTRICT,DERA BUGTI TEHSIL,43,127,156,283
DERA BUGTI DISTRICT,DERA BUGTI TEHSIL,44,122,134,256
DERA BUGTI DISTRICT,DERA BUGTI TEHSIL,45,115,138,253
DERA BUGTI DISTRICT,DERA BUGTI TEHSIL,46,122,121,243
DERA BUGTI DISTRICT,DERA BUGTI TEHSIL,47,103,155,258
DERA BUGTI DISTRICT,DERA BUGTI TEHSIL,48,128,153,281
DERA BUGTI DISTRICT,DERA BUGTI TEHSIL,49,101,186,287
DERA BUGTI DISTRICT,DERA BUGTI TEHSIL,50,145,171,316
DERA BUGTI DISTRICT,DERA BUGTI TEHSIL,51,104,125,229
DERA BUGTI DISTRICT,DERA BUGTI TEHSIL,52,73,157,230
DERA BUGTI DISTRICT,DERA BUGTI TEHSIL,53,95,115,210
DERA BUGTI DISTRICT,DERA BUGTI TEHSIL,54,95,115,210
DERA BUGTI DISTRICT,DERA BUGTI TEHSIL,55,75,113,188
DERA BUGTI DISTRICT,DERA BUGTI TEHSIL,56,102,73,175
DERA BUGTI DISTRICT,DERA BUGTI TEHSIL,57,46,124,170
DERA BUGTI DISTRICT,DERA BUGTI TEHSIL,58,69,91,160
DERA BUGTI DISTRICT,DERA BUGTI TEHSIL,59,55,90,145
DERA BUGTI DISTRICT,DERA BUGTI TEHSIL,60,56,87,143
DERA BUGTI DISTRICT,DERA BUGTI TEHSIL,61,57,67,124
DERA BUGTI DISTRICT,DERA BUGTI TEHSIL,62,49,72,121
DERA BUGTI DISTRICT,DERA BUGTI TEHSIL,63,39,64,103
DERA BUGTI DISTRICT,DERA BUGTI TEHSIL,64,45,62,107
DERA BUGTI DISTRICT,DERA BUGTI TEHSIL,65,36,57,93
DERA BUGTI DISTRICT,DERA BUGTI TEHSIL,66,50,36,86
DERA BUGTI DISTRICT,DERA BUGTI TEHSIL,67,46,51,97
DERA BUGTI DISTRICT,DERA BUGTI TEHSIL,68,39,29,68
DERA BUGTI DISTRICT,DERA BUGTI TEHSIL,69,27,40,67
DERA BUGTI DISTRICT,DERA BUGTI TEHSIL,70,47,36,83
DERA BUGTI DISTRICT,DERA BUGTI TEHSIL,71,24,22,46
DERA BUGTI DISTRICT,DERA BUGTI TEHSIL,72,22,27,49
DERA BUGTI DISTRICT,DERA BUGTI TEHSIL,73,26,28,54
DERA BUGTI DISTRICT,DERA BUGTI TEHSIL,74,18,22,40
DERA BUGTI DISTRICT,DERA BUGTI TEHSIL,>=75,157,209,366
DERA BUGTI DISTRICT,LOTI TEHSIL,<1,1074,0,1074
DERA BUGTI DISTRICT,LOTI TEHSIL,1,784,0,784
DERA BUGTI DISTRICT,LOTI TEHSIL,2,1118,0,1118
DERA BUGTI DISTRICT,LOTI TEHSIL,3,740,0,740
DERA BUGTI DISTRICT,LOTI TEHSIL,4,1072,0,1072
DERA BUGTI DISTRICT,LOTI TEHSIL,5,716,0,716
DERA BUGTI DISTRICT,LOTI TEHSIL,6,931,0,931
DERA BUGTI DISTRICT,LOTI TEHSIL,7,642,0,642
DERA BUGTI DISTRICT,LOTI TEHSIL,8,831,0,831
DERA BUGTI DISTRICT,LOTI TEHSIL,9,710,0,710
DERA BUGTI DISTRICT,LOTI TEHSIL,10,755,0,755
DERA BUGTI DISTRICT,LOTI TEHSIL,11,460,0,460
DERA BUGTI DISTRICT,LOTI TEHSIL,12,460,0,460
DERA BUGTI DISTRICT,LOTI TEHSIL,13,343,0,343
DERA BUGTI DISTRICT,LOTI TEHSIL,14,287,0,287
DERA BUGTI DISTRICT,LOTI TEHSIL,15,265,0,265
DERA BUGTI DISTRICT,LOTI TEHSIL,16,211,0,211
DERA BUGTI DISTRICT,LOTI TEHSIL,17,272,0,272
DERA BUGTI DISTRICT,LOTI TEHSIL,18,196,0,196
DERA BUGTI DISTRICT,LOTI TEHSIL,19,212,0,212
DERA BUGTI DISTRICT,LOTI TEHSIL,20,242,0,242
DERA BUGTI DISTRICT,LOTI TEHSIL,21,165,0,165
DERA BUGTI DISTRICT,LOTI TEHSIL,22,153,0,153
DERA BUGTI DISTRICT,LOTI TEHSIL,23,143,0,143
DERA BUGTI DISTRICT,LOTI TEHSIL,24,144,0,144
DERA BUGTI DISTRICT,LOTI TEHSIL,25,265,0,265
DERA BUGTI DISTRICT,LOTI TEHSIL,26,175,0,175
DERA BUGTI DISTRICT,LOTI TEHSIL,27,185,0,185
DERA BUGTI DISTRICT,LOTI TEHSIL,28,233,0,233
DERA BUGTI DISTRICT,LOTI TEHSIL,29,179,0,179
DERA BUGTI DISTRICT,LOTI TEHSIL,30,342,0,342
DERA BUGTI DISTRICT,LOTI TEHSIL,31,193,0,193
DERA BUGTI DISTRICT,LOTI TEHSIL,32,138,0,138
DERA BUGTI DISTRICT,LOTI TEHSIL,33,153,0,153
DERA BUGTI DISTRICT,LOTI TEHSIL,34,140,0,140
DERA BUGTI DISTRICT,LOTI TEHSIL,35,218,0,218
DERA BUGTI DISTRICT,LOTI TEHSIL,36,134,0,134
DERA BUGTI DISTRICT,LOTI TEHSIL,37,122,0,122
DERA BUGTI DISTRICT,LOTI TEHSIL,38,196,0,196
DERA BUGTI DISTRICT,LOTI TEHSIL,39,150,0,150
DERA BUGTI DISTRICT,LOTI TEHSIL,40,240,0,240
DERA BUGTI DISTRICT,LOTI TEHSIL,41,166,0,166
DERA BUGTI DISTRICT,LOTI TEHSIL,42,95,0,95
DERA BUGTI DISTRICT,LOTI TEHSIL,43,125,0,125
DERA BUGTI DISTRICT,LOTI TEHSIL,44,93,0,93
DERA BUGTI DISTRICT,LOTI TEHSIL,45,143,0,143
DERA BUGTI DISTRICT,LOTI TEHSIL,46,88,0,88
DERA BUGTI DISTRICT,LOTI TEHSIL,47,77,0,77
DERA BUGTI DISTRICT,LOTI TEHSIL,48,112,0,112
DERA BUGTI DISTRICT,LOTI TEHSIL,49,93,0,93
DERA BUGTI DISTRICT,LOTI TEHSIL,50,152,0,152
DERA BUGTI DISTRICT,LOTI TEHSIL,51,55,0,55
DERA BUGTI DISTRICT,LOTI TEHSIL,52,40,0,40
DERA BUGTI DISTRICT,LOTI TEHSIL,53,65,0,65
DERA BUGTI DISTRICT,LOTI TEHSIL,54,74,0,74
DERA BUGTI DISTRICT,LOTI TEHSIL,55,60,0,60
DERA BUGTI DISTRICT,LOTI TEHSIL,56,58,0,58
DERA BUGTI DISTRICT,LOTI TEHSIL,57,40,0,40
DERA BUGTI DISTRICT,LOTI TEHSIL,58,35,0,35
DERA BUGTI DISTRICT,LOTI TEHSIL,59,39,0,39
DERA BUGTI DISTRICT,LOTI TEHSIL,60,62,0,62
DERA BUGTI DISTRICT,LOTI TEHSIL,61,29,0,29
DERA BUGTI DISTRICT,LOTI TEHSIL,62,27,0,27
DERA BUGTI DISTRICT,LOTI TEHSIL,63,29,0,29
DERA BUGTI DISTRICT,LOTI TEHSIL,64,38,0,38
DERA BUGTI DISTRICT,LOTI TEHSIL,65,38,0,38
DERA BUGTI DISTRICT,LOTI TEHSIL,66,29,0,29
DERA BUGTI DISTRICT,LOTI TEHSIL,67,18,0,18
DERA BUGTI DISTRICT,LOTI TEHSIL,68,22,0,22
DERA BUGTI DISTRICT,LOTI TEHSIL,69,17,0,17
DERA BUGTI DISTRICT,LOTI TEHSIL,70,27,0,27
DERA BUGTI DISTRICT,LOTI TEHSIL,71,9,0,9
DERA BUGTI DISTRICT,LOTI TEHSIL,72,13,0,13
DERA BUGTI DISTRICT,LOTI TEHSIL,73,12,0,12
DERA BUGTI DISTRICT,LOTI TEHSIL,74,11,0,11
DERA BUGTI DISTRICT,LOTI TEHSIL,>=75,78,0,78
DERA BUGTI DISTRICT,MALAM SUB-TEHSIL,<1,1675,0,1675
DERA BUGTI DISTRICT,MALAM SUB-TEHSIL,1,1111,0,1111
DERA BUGTI DISTRICT,MALAM SUB-TEHSIL,2,1348,0,1348
DERA BUGTI DISTRICT,MALAM SUB-TEHSIL,3,1177,0,1177
DERA BUGTI DISTRICT,MALAM SUB-TEHSIL,4,1516,0,1516
DERA BUGTI DISTRICT,MALAM SUB-TEHSIL,5,1006,0,1006
DERA BUGTI DISTRICT,MALAM SUB-TEHSIL,6,1481,0,1481
DERA BUGTI DISTRICT,MALAM SUB-TEHSIL,7,934,0,934
DERA BUGTI DISTRICT,MALAM SUB-TEHSIL,8,1290,0,1290
DERA BUGTI DISTRICT,MALAM SUB-TEHSIL,9,901,0,901
DERA BUGTI DISTRICT,MALAM SUB-TEHSIL,10,1130,0,1130
DERA BUGTI DISTRICT,MALAM SUB-TEHSIL,11,742,0,742
DERA BUGTI DISTRICT,MALAM SUB-TEHSIL,12,754,0,754
DERA BUGTI DISTRICT,MALAM SUB-TEHSIL,13,473,0,473
DERA BUGTI DISTRICT,MALAM SUB-TEHSIL,14,603,0,603
DERA BUGTI DISTRICT,MALAM SUB-TEHSIL,15,382,0,382
DERA BUGTI DISTRICT,MALAM SUB-TEHSIL,16,456,0,456
DERA BUGTI DISTRICT,MALAM SUB-TEHSIL,17,290,0,290
DERA BUGTI DISTRICT,MALAM SUB-TEHSIL,18,403,0,403
DERA BUGTI DISTRICT,MALAM SUB-TEHSIL,19,358,0,358
DERA BUGTI DISTRICT,MALAM SUB-TEHSIL,20,397,0,397
DERA BUGTI DISTRICT,MALAM SUB-TEHSIL,21,370,0,370
DERA BUGTI DISTRICT,MALAM SUB-TEHSIL,22,316,0,316
DERA BUGTI DISTRICT,MALAM SUB-TEHSIL,23,319,0,319
DERA BUGTI DISTRICT,MALAM SUB-TEHSIL,24,409,0,409
DERA BUGTI DISTRICT,MALAM SUB-TEHSIL,25,345,0,345
DERA BUGTI DISTRICT,MALAM SUB-TEHSIL,26,323,0,323
DERA BUGTI DISTRICT,MALAM SUB-TEHSIL,27,299,0,299
DERA BUGTI DISTRICT,MALAM SUB-TEHSIL,28,404,0,404
DERA BUGTI DISTRICT,MALAM SUB-TEHSIL,29,279,0,279
DERA BUGTI DISTRICT,MALAM SUB-TEHSIL,30,398,0,398
DERA BUGTI DISTRICT,MALAM SUB-TEHSIL,31,270,0,270
DERA BUGTI DISTRICT,MALAM SUB-TEHSIL,32,317,0,317
DERA BUGTI DISTRICT,MALAM SUB-TEHSIL,33,300,0,300
DERA BUGTI DISTRICT,MALAM SUB-TEHSIL,34,260,0,260
DERA BUGTI DISTRICT,MALAM SUB-TEHSIL,35,237,0,237
DERA BUGTI DISTRICT,MALAM SUB-TEHSIL,36,308,0,308
DERA BUGTI DISTRICT,MALAM SUB-TEHSIL,37,174,0,174
DERA BUGTI DISTRICT,MALAM SUB-TEHSIL,38,332,0,332
DERA BUGTI DISTRICT,MALAM SUB-TEHSIL,39,186,0,186
DERA BUGTI DISTRICT,MALAM SUB-TEHSIL,40,332,0,332
DERA BUGTI DISTRICT,MALAM SUB-TEHSIL,41,146,0,146
DERA BUGTI DISTRICT,MALAM SUB-TEHSIL,42,138,0,138
DERA BUGTI DISTRICT,MALAM SUB-TEHSIL,43,161,0,161
DERA BUGTI DISTRICT,MALAM SUB-TEHSIL,44,152,0,152
DERA BUGTI DISTRICT,MALAM SUB-TEHSIL,45,106,0,106
DERA BUGTI DISTRICT,MALAM SUB-TEHSIL,46,107,0,107
DERA BUGTI DISTRICT,MALAM SUB-TEHSIL,47,101,0,101
DERA BUGTI DISTRICT,MALAM SUB-TEHSIL,48,159,0,159
DERA BUGTI DISTRICT,MALAM SUB-TEHSIL,49,62,0,62
DERA BUGTI DISTRICT,MALAM SUB-TEHSIL,50,141,0,141
DERA BUGTI DISTRICT,MALAM SUB-TEHSIL,51,84,0,84
DERA BUGTI DISTRICT,MALAM SUB-TEHSIL,52,75,0,75
DERA BUGTI DISTRICT,MALAM SUB-TEHSIL,53,92,0,92
DERA BUGTI DISTRICT,MALAM SUB-TEHSIL,54,73,0,73
DERA BUGTI DISTRICT,MALAM SUB-TEHSIL,55,90,0,90
DERA BUGTI DISTRICT,MALAM SUB-TEHSIL,56,110,0,110
DERA BUGTI DISTRICT,MALAM SUB-TEHSIL,57,48,0,48
DERA BUGTI DISTRICT,MALAM SUB-TEHSIL,58,77,0,77
DERA BUGTI DISTRICT,MALAM SUB-TEHSIL,59,38,0,38
DERA BUGTI DISTRICT,MALAM SUB-TEHSIL,60,82,0,82
DERA BUGTI DISTRICT,MALAM SUB-TEHSIL,61,58,0,58
DERA BUGTI DISTRICT,MALAM SUB-TEHSIL,62,32,0,32
DERA BUGTI DISTRICT,MALAM SUB-TEHSIL,63,55,0,55
DERA BUGTI DISTRICT,MALAM SUB-TEHSIL,64,59,0,59
DERA BUGTI DISTRICT,MALAM SUB-TEHSIL,65,36,0,36
DERA BUGTI DISTRICT,MALAM SUB-TEHSIL,66,42,0,42
DERA BUGTI DISTRICT,MALAM SUB-TEHSIL,67,22,0,22
DERA BUGTI DISTRICT,MALAM SUB-TEHSIL,68,41,0,41
DERA BUGTI DISTRICT,MALAM SUB-TEHSIL,69,22,0,22
DERA BUGTI DISTRICT,MALAM SUB-TEHSIL,70,39,0,39
DERA BUGTI DISTRICT,MALAM SUB-TEHSIL,71,18,0,18
DERA BUGTI DISTRICT,MALAM SUB-TEHSIL,72,26,0,26
DERA BUGTI DISTRICT,MALAM SUB-TEHSIL,73,18,0,18
DERA BUGTI DISTRICT,MALAM SUB-TEHSIL,74,20,0,20
DERA BUGTI DISTRICT,MALAM SUB-TEHSIL,>=75,130,0,130
DERA BUGTI DISTRICT,PHELAWAGH TEHSIL,<1,1835,0,1835
DERA BUGTI DISTRICT,PHELAWAGH TEHSIL,1,1175,0,1175
DERA BUGTI DISTRICT,PHELAWAGH TEHSIL,2,1851,0,1851
DERA BUGTI DISTRICT,PHELAWAGH TEHSIL,3,1265,0,1265
DERA BUGTI DISTRICT,PHELAWAGH TEHSIL,4,1833,0,1833
DERA BUGTI DISTRICT,PHELAWAGH TEHSIL,5,1117,0,1117
DERA BUGTI DISTRICT,PHELAWAGH TEHSIL,6,1730,0,1730
DERA BUGTI DISTRICT,PHELAWAGH TEHSIL,7,971,0,971
DERA BUGTI DISTRICT,PHELAWAGH TEHSIL,8,1499,0,1499
DERA BUGTI DISTRICT,PHELAWAGH TEHSIL,9,1097,0,1097
DERA BUGTI DISTRICT,PHELAWAGH TEHSIL,10,1150,0,1150
DERA BUGTI DISTRICT,PHELAWAGH TEHSIL,11,828,0,828
DERA BUGTI DISTRICT,PHELAWAGH TEHSIL,12,741,0,741
DERA BUGTI DISTRICT,PHELAWAGH TEHSIL,13,547,0,547
DERA BUGTI DISTRICT,PHELAWAGH TEHSIL,14,564,0,564
DERA BUGTI DISTRICT,PHELAWAGH TEHSIL,15,356,0,356
DERA BUGTI DISTRICT,PHELAWAGH TEHSIL,16,241,0,241
DERA BUGTI DISTRICT,PHELAWAGH TEHSIL,17,155,0,155
DERA BUGTI DISTRICT,PHELAWAGH TEHSIL,18,124,0,124
DERA BUGTI DISTRICT,PHELAWAGH TEHSIL,19,299,0,299
DERA BUGTI DISTRICT,PHELAWAGH TEHSIL,20,282,0,282
DERA BUGTI DISTRICT,PHELAWAGH TEHSIL,21,340,0,340
DERA BUGTI DISTRICT,PHELAWAGH TEHSIL,22,263,0,263
DERA BUGTI DISTRICT,PHELAWAGH TEHSIL,23,315,0,315
DERA BUGTI DISTRICT,PHELAWAGH TEHSIL,24,345,0,345
DERA BUGTI DISTRICT,PHELAWAGH TEHSIL,25,331,0,331
DERA BUGTI DISTRICT,PHELAWAGH TEHSIL,26,341,0,341
DERA BUGTI DISTRICT,PHELAWAGH TEHSIL,27,289,0,289
DERA BUGTI DISTRICT,PHELAWAGH TEHSIL,28,391,0,391
DERA BUGTI DISTRICT,PHELAWAGH TEHSIL,29,357,0,357
DERA BUGTI DISTRICT,PHELAWAGH TEHSIL,30,408,0,408
DERA BUGTI DISTRICT,PHELAWAGH TEHSIL,31,318,0,318
DERA BUGTI DISTRICT,PHELAWAGH TEHSIL,32,293,0,293
DERA BUGTI DISTRICT,PHELAWAGH TEHSIL,33,297,0,297
DERA BUGTI DISTRICT,PHELAWAGH TEHSIL,34,212,0,212
DERA BUGTI DISTRICT,PHELAWAGH TEHSIL,35,262,0,262
DERA BUGTI DISTRICT,PHELAWAGH TEHSIL,36,198,0,198
DERA BUGTI DISTRICT,PHELAWAGH TEHSIL,37,205,0,205
DERA BUGTI DISTRICT,PHELAWAGH TEHSIL,38,312,0,312
DERA BUGTI DISTRICT,PHELAWAGH TEHSIL,39,249,0,249
DERA BUGTI DISTRICT,PHELAWAGH TEHSIL,40,286,0,286
DERA BUGTI DISTRICT,PHELAWAGH TEHSIL,41,207,0,207
DERA BUGTI DISTRICT,PHELAWAGH TEHSIL,42,179,0,179
DERA BUGTI DISTRICT,PHELAWAGH TEHSIL,43,173,0,173
DERA BUGTI DISTRICT,PHELAWAGH TEHSIL,44,137,0,137
DERA BUGTI DISTRICT,PHELAWAGH TEHSIL,45,174,0,174
DERA BUGTI DISTRICT,PHELAWAGH TEHSIL,46,90,0,90
DERA BUGTI DISTRICT,PHELAWAGH TEHSIL,47,85,0,85
DERA BUGTI DISTRICT,PHELAWAGH TEHSIL,48,154,0,154
DERA BUGTI DISTRICT,PHELAWAGH TEHSIL,49,113,0,113
DERA BUGTI DISTRICT,PHELAWAGH TEHSIL,50,131,0,131
DERA BUGTI DISTRICT,PHELAWAGH TEHSIL,51,75,0,75
DERA BUGTI DISTRICT,PHELAWAGH TEHSIL,52,65,0,65
DERA BUGTI DISTRICT,PHELAWAGH TEHSIL,53,77,0,77
DERA BUGTI DISTRICT,PHELAWAGH TEHSIL,54,60,0,60
DERA BUGTI DISTRICT,PHELAWAGH TEHSIL,55,87,0,87
DERA BUGTI DISTRICT,PHELAWAGH TEHSIL,56,44,0,44
DERA BUGTI DISTRICT,PHELAWAGH TEHSIL,57,45,0,45
DERA BUGTI DISTRICT,PHELAWAGH TEHSIL,58,43,0,43
DERA BUGTI DISTRICT,PHELAWAGH TEHSIL,59,46,0,46
DERA BUGTI DISTRICT,PHELAWAGH TEHSIL,60,29,0,29
DERA BUGTI DISTRICT,PHELAWAGH TEHSIL,61,31,0,31
DERA BUGTI DISTRICT,PHELAWAGH TEHSIL,62,39,0,39
DERA BUGTI DISTRICT,PHELAWAGH TEHSIL,63,37,0,37
DERA BUGTI DISTRICT,PHELAWAGH TEHSIL,64,25,0,25
DERA BUGTI DISTRICT,PHELAWAGH TEHSIL,65,26,0,26
DERA BUGTI DISTRICT,PHELAWAGH TEHSIL,66,16,0,16
DERA BUGTI DISTRICT,PHELAWAGH TEHSIL,67,21,0,21
DERA BUGTI DISTRICT,PHELAWAGH TEHSIL,68,18,0,18
DERA BUGTI DISTRICT,PHELAWAGH TEHSIL,69,11,0,11
DERA BUGTI DISTRICT,PHELAWAGH TEHSIL,70,24,0,24
DERA BUGTI DISTRICT,PHELAWAGH TEHSIL,71,11,0,11
DERA BUGTI DISTRICT,PHELAWAGH TEHSIL,72,8,0,8
DERA BUGTI DISTRICT,PHELAWAGH TEHSIL,73,11,0,11
DERA BUGTI DISTRICT,PHELAWAGH TEHSIL,74,9,0,9
DERA BUGTI DISTRICT,PHELAWAGH TEHSIL,>=75,81,0,81
DERA BUGTI DISTRICT,PIR KOH SUB-TEHSIL,<1,2223,0,2223
DERA BUGTI DISTRICT,PIR KOH SUB-TEHSIL,1,1803,0,1803
DERA BUGTI DISTRICT,PIR KOH SUB-TEHSIL,2,2240,0,2240
DERA BUGTI DISTRICT,PIR KOH SUB-TEHSIL,3,1986,0,1986
DERA BUGTI DISTRICT,PIR KOH SUB-TEHSIL,4,2015,0,2015
DERA BUGTI DISTRICT,PIR KOH SUB-TEHSIL,5,1565,0,1565
DERA BUGTI DISTRICT,PIR KOH SUB-TEHSIL,6,2059,0,2059
DERA BUGTI DISTRICT,PIR KOH SUB-TEHSIL,7,1498,0,1498
DERA BUGTI DISTRICT,PIR KOH SUB-TEHSIL,8,1680,0,1680
DERA BUGTI DISTRICT,PIR KOH SUB-TEHSIL,9,1344,0,1344
DERA BUGTI DISTRICT,PIR KOH SUB-TEHSIL,10,1406,0,1406
DERA BUGTI DISTRICT,PIR KOH SUB-TEHSIL,11,883,0,883
DERA BUGTI DISTRICT,PIR KOH SUB-TEHSIL,12,916,0,916
DERA BUGTI DISTRICT,PIR KOH SUB-TEHSIL,13,595,0,595
DERA BUGTI DISTRICT,PIR KOH SUB-TEHSIL,14,680,0,680
DERA BUGTI DISTRICT,PIR KOH SUB-TEHSIL,15,472,0,472
DERA BUGTI DISTRICT,PIR KOH SUB-TEHSIL,16,626,0,626
DERA BUGTI DISTRICT,PIR KOH SUB-TEHSIL,17,563,0,563
DERA BUGTI DISTRICT,PIR KOH SUB-TEHSIL,18,770,0,770
DERA BUGTI DISTRICT,PIR KOH SUB-TEHSIL,19,740,0,740
DERA BUGTI DISTRICT,PIR KOH SUB-TEHSIL,20,732,0,732
DERA BUGTI DISTRICT,PIR KOH SUB-TEHSIL,21,601,0,601
DERA BUGTI DISTRICT,PIR KOH SUB-TEHSIL,22,535,0,535
DERA BUGTI DISTRICT,PIR KOH SUB-TEHSIL,23,465,0,465
DERA BUGTI DISTRICT,PIR KOH SUB-TEHSIL,24,453,0,453
DERA BUGTI DISTRICT,PIR KOH SUB-TEHSIL,25,598,0,598
DERA BUGTI DISTRICT,PIR KOH SUB-TEHSIL,26,427,0,427
DERA BUGTI DISTRICT,PIR KOH SUB-TEHSIL,27,587,0,587
DERA BUGTI DISTRICT,PIR KOH SUB-TEHSIL,28,459,0,459
DERA BUGTI DISTRICT,PIR KOH SUB-TEHSIL,29,600,0,600
DERA BUGTI DISTRICT,PIR KOH SUB-TEHSIL,30,596,0,596
DERA BUGTI DISTRICT,PIR KOH SUB-TEHSIL,31,442,0,442
DERA BUGTI DISTRICT,PIR KOH SUB-TEHSIL,32,388,0,388
DERA BUGTI DISTRICT,PIR KOH SUB-TEHSIL,33,378,0,378
DERA BUGTI DISTRICT,PIR KOH SUB-TEHSIL,34,305,0,305
DERA BUGTI DISTRICT,PIR KOH SUB-TEHSIL,35,385,0,385
DERA BUGTI DISTRICT,PIR KOH SUB-TEHSIL,36,333,0,333
DERA BUGTI DISTRICT,PIR KOH SUB-TEHSIL,37,427,0,427
DERA BUGTI DISTRICT,PIR KOH SUB-TEHSIL,38,314,0,314
DERA BUGTI DISTRICT,PIR KOH SUB-TEHSIL,39,331,0,331
DERA BUGTI DISTRICT,PIR KOH SUB-TEHSIL,40,401,0,401
DERA BUGTI DISTRICT,PIR KOH SUB-TEHSIL,41,247,0,247
DERA BUGTI DISTRICT,PIR KOH SUB-TEHSIL,42,229,0,229
DERA BUGTI DISTRICT,PIR KOH SUB-TEHSIL,43,186,0,186
DERA BUGTI DISTRICT,PIR KOH SUB-TEHSIL,44,170,0,170
DERA BUGTI DISTRICT,PIR KOH SUB-TEHSIL,45,233,0,233
DERA BUGTI DISTRICT,PIR KOH SUB-TEHSIL,46,144,0,144
DERA BUGTI DISTRICT,PIR KOH SUB-TEHSIL,47,245,0,245
DERA BUGTI DISTRICT,PIR KOH SUB-TEHSIL,48,195,0,195
DERA BUGTI DISTRICT,PIR KOH SUB-TEHSIL,49,202,0,202
DERA BUGTI DISTRICT,PIR KOH SUB-TEHSIL,50,260,0,260
DERA BUGTI DISTRICT,PIR KOH SUB-TEHSIL,51,145,0,145
DERA BUGTI DISTRICT,PIR KOH SUB-TEHSIL,52,141,0,141
DERA BUGTI DISTRICT,PIR KOH SUB-TEHSIL,53,184,0,184
DERA BUGTI DISTRICT,PIR KOH SUB-TEHSIL,54,179,0,179
DERA BUGTI DISTRICT,PIR KOH SUB-TEHSIL,55,162,0,162
DERA BUGTI DISTRICT,PIR KOH SUB-TEHSIL,56,102,0,102
DERA BUGTI DISTRICT,PIR KOH SUB-TEHSIL,57,189,0,189
DERA BUGTI DISTRICT,PIR KOH SUB-TEHSIL,58,114,0,114
DERA BUGTI DISTRICT,PIR KOH SUB-TEHSIL,59,179,0,179
DERA BUGTI DISTRICT,PIR KOH SUB-TEHSIL,60,122,0,122
DERA BUGTI DISTRICT,PIR KOH SUB-TEHSIL,61,73,0,73
DERA BUGTI DISTRICT,PIR KOH SUB-TEHSIL,62,98,0,98
DERA BUGTI DISTRICT,PIR KOH SUB-TEHSIL,63,92,0,92
DERA BUGTI DISTRICT,PIR KOH SUB-TEHSIL,64,89,0,89
DERA BUGTI DISTRICT,PIR KOH SUB-TEHSIL,65,71,0,71
DERA BUGTI DISTRICT,PIR KOH SUB-TEHSIL,66,55,0,55
DERA BUGTI DISTRICT,PIR KOH SUB-TEHSIL,67,95,0,95
DERA BUGTI DISTRICT,PIR KOH SUB-TEHSIL,68,59,0,59
DERA BUGTI DISTRICT,PIR KOH SUB-TEHSIL,69,61,0,61
DERA BUGTI DISTRICT,PIR KOH SUB-TEHSIL,70,51,0,51
DERA BUGTI DISTRICT,PIR KOH SUB-TEHSIL,71,30,0,30
DERA BUGTI DISTRICT,PIR KOH SUB-TEHSIL,72,42,0,42
DERA BUGTI DISTRICT,PIR KOH SUB-TEHSIL,73,41,0,41
DERA BUGTI DISTRICT,PIR KOH SUB-TEHSIL,74,54,0,54
DERA BUGTI DISTRICT,PIR KOH SUB-TEHSIL,>=75,269,0,269
DERA BUGTI DISTRICT,SANGSILLAH SUB-TEHSIL,<1,463,0,463
DERA BUGTI DISTRICT,SANGSILLAH SUB-TEHSIL,1,362,0,362
DERA BUGTI DISTRICT,SANGSILLAH SUB-TEHSIL,2,494,0,494
DERA BUGTI DISTRICT,SANGSILLAH SUB-TEHSIL,3,349,0,349
DERA BUGTI DISTRICT,SANGSILLAH SUB-TEHSIL,4,560,0,560
DERA BUGTI DISTRICT,SANGSILLAH SUB-TEHSIL,5,330,0,330
DERA BUGTI DISTRICT,SANGSILLAH SUB-TEHSIL,6,486,0,486
DERA BUGTI DISTRICT,SANGSILLAH SUB-TEHSIL,7,350,0,350
DERA BUGTI DISTRICT,SANGSILLAH SUB-TEHSIL,8,460,0,460
DERA BUGTI DISTRICT,SANGSILLAH SUB-TEHSIL,9,340,0,340
DERA BUGTI DISTRICT,SANGSILLAH SUB-TEHSIL,10,366,0,366
DERA BUGTI DISTRICT,SANGSILLAH SUB-TEHSIL,11,219,0,219
DERA BUGTI DISTRICT,SANGSILLAH SUB-TEHSIL,12,226,0,226
DERA BUGTI DISTRICT,SANGSILLAH SUB-TEHSIL,13,129,0,129
DERA BUGTI DISTRICT,SANGSILLAH SUB-TEHSIL,14,158,0,158
DERA BUGTI DISTRICT,SANGSILLAH SUB-TEHSIL,15,134,0,134
DERA BUGTI DISTRICT,SANGSILLAH SUB-TEHSIL,16,167,0,167
DERA BUGTI DISTRICT,SANGSILLAH SUB-TEHSIL,17,115,0,115
DERA BUGTI DISTRICT,SANGSILLAH SUB-TEHSIL,18,195,0,195
DERA BUGTI DISTRICT,SANGSILLAH SUB-TEHSIL,19,168,0,168
DERA BUGTI DISTRICT,SANGSILLAH SUB-TEHSIL,20,236,0,236
DERA BUGTI DISTRICT,SANGSILLAH SUB-TEHSIL,21,180,0,180
DERA BUGTI DISTRICT,SANGSILLAH SUB-TEHSIL,22,139,0,139
DERA BUGTI DISTRICT,SANGSILLAH SUB-TEHSIL,23,182,0,182
DERA BUGTI DISTRICT,SANGSILLAH SUB-TEHSIL,24,129,0,129
DERA BUGTI DISTRICT,SANGSILLAH SUB-TEHSIL,25,198,0,198
DERA BUGTI DISTRICT,SANGSILLAH SUB-TEHSIL,26,131,0,131
DERA BUGTI DISTRICT,SANGSILLAH SUB-TEHSIL,27,153,0,153
DERA BUGTI DISTRICT,SANGSILLAH SUB-TEHSIL,28,169,0,169
DERA BUGTI DISTRICT,SANGSILLAH SUB-TEHSIL,29,157,0,157
DERA BUGTI DISTRICT,SANGSILLAH SUB-TEHSIL,30,186,0,186
DERA BUGTI DISTRICT,SANGSILLAH SUB-TEHSIL,31,120,0,120
DERA BUGTI DISTRICT,SANGSILLAH SUB-TEHSIL,32,112,0,112
DERA BUGTI DISTRICT,SANGSILLAH SUB-TEHSIL,33,115,0,115
DERA BUGTI DISTRICT,SANGSILLAH SUB-TEHSIL,34,53,0,53
DERA BUGTI DISTRICT,SANGSILLAH SUB-TEHSIL,35,108,0,108
DERA BUGTI DISTRICT,SANGSILLAH SUB-TEHSIL,36,69,0,69
DERA BUGTI DISTRICT,SANGSILLAH SUB-TEHSIL,37,99,0,99
DERA BUGTI DISTRICT,SANGSILLAH SUB-TEHSIL,38,109,0,109
DERA BUGTI DISTRICT,SANGSILLAH SUB-TEHSIL,39,78,0,78
DERA BUGTI DISTRICT,SANGSILLAH SUB-TEHSIL,40,106,0,106
DERA BUGTI DISTRICT,SANGSILLAH SUB-TEHSIL,41,76,0,76
DERA BUGTI DISTRICT,SANGSILLAH SUB-TEHSIL,42,68,0,68
DERA BUGTI DISTRICT,SANGSILLAH SUB-TEHSIL,43,79,0,79
DERA BUGTI DISTRICT,SANGSILLAH SUB-TEHSIL,44,47,0,47
DERA BUGTI DISTRICT,SANGSILLAH SUB-TEHSIL,45,75,0,75
DERA BUGTI DISTRICT,SANGSILLAH SUB-TEHSIL,46,27,0,27
DERA BUGTI DISTRICT,SANGSILLAH SUB-TEHSIL,47,49,0,49
DERA BUGTI DISTRICT,SANGSILLAH SUB-TEHSIL,48,75,0,75
DERA BUGTI DISTRICT,SANGSILLAH SUB-TEHSIL,49,70,0,70
DERA BUGTI DISTRICT,SANGSILLAH SUB-TEHSIL,50,63,0,63
DERA BUGTI DISTRICT,SANGSILLAH SUB-TEHSIL,51,46,0,46
DERA BUGTI DISTRICT,SANGSILLAH SUB-TEHSIL,52,33,0,33
DERA BUGTI DISTRICT,SANGSILLAH SUB-TEHSIL,53,68,0,68
DERA BUGTI DISTRICT,SANGSILLAH SUB-TEHSIL,54,42,0,42
DERA BUGTI DISTRICT,SANGSILLAH SUB-TEHSIL,55,45,0,45
DERA BUGTI DISTRICT,SANGSILLAH SUB-TEHSIL,56,23,0,23
DERA BUGTI DISTRICT,SANGSILLAH SUB-TEHSIL,57,33,0,33
DERA BUGTI DISTRICT,SANGSILLAH SUB-TEHSIL,58,23,0,23
DERA BUGTI DISTRICT,SANGSILLAH SUB-TEHSIL,59,35,0,35
DERA BUGTI DISTRICT,SANGSILLAH SUB-TEHSIL,60,35,0,35
DERA BUGTI DISTRICT,SANGSILLAH SUB-TEHSIL,61,21,0,21
DERA BUGTI DISTRICT,SANGSILLAH SUB-TEHSIL,62,19,0,19
DERA BUGTI DISTRICT,SANGSILLAH SUB-TEHSIL,63,28,0,28
DERA BUGTI DISTRICT,SANGSILLAH SUB-TEHSIL,64,25,0,25
DERA BUGTI DISTRICT,SANGSILLAH SUB-TEHSIL,65,18,0,18
DERA BUGTI DISTRICT,SANGSILLAH SUB-TEHSIL,66,16,0,16
DERA BUGTI DISTRICT,SANGSILLAH SUB-TEHSIL,67,13,0,13
DERA BUGTI DISTRICT,SANGSILLAH SUB-TEHSIL,68,7,0,7
DERA BUGTI DISTRICT,SANGSILLAH SUB-TEHSIL,69,12,0,12
DERA BUGTI DISTRICT,SANGSILLAH SUB-TEHSIL,70,23,0,23
DERA BUGTI DISTRICT,SANGSILLAH SUB-TEHSIL,71,9,0,9
DERA BUGTI DISTRICT,SANGSILLAH SUB-TEHSIL,72,13,0,13
DERA BUGTI DISTRICT,SANGSILLAH SUB-TEHSIL,73,8,0,8
DERA BUGTI DISTRICT,SANGSILLAH SUB-TEHSIL,74,5,0,5
DERA BUGTI DISTRICT,SANGSILLAH SUB-TEHSIL,>=75,88,0,88
DERA BUGTI DISTRICT,SUI TEHSIL,<1,1590,2885,4475
DERA BUGTI DISTRICT,SUI TEHSIL,1,1923,3363,5286
DERA BUGTI DISTRICT,SUI TEHSIL,2,2136,3794,5930
DERA BUGTI DISTRICT,SUI TEHSIL,3,1859,3663,5522
DERA BUGTI DISTRICT,SUI TEHSIL,4,2235,3565,5800
DERA BUGTI DISTRICT,SUI TEHSIL,5,1548,3314,4862
DERA BUGTI DISTRICT,SUI TEHSIL,6,2408,3017,5425
DERA BUGTI DISTRICT,SUI TEHSIL,7,1636,3169,4805
DERA BUGTI DISTRICT,SUI TEHSIL,8,2257,2768,5025
DERA BUGTI DISTRICT,SUI TEHSIL,9,1779,2582,4361
DERA BUGTI DISTRICT,SUI TEHSIL,10,2193,2235,4428
DERA BUGTI DISTRICT,SUI TEHSIL,11,1388,1730,3118
DERA BUGTI DISTRICT,SUI TEHSIL,12,1437,1672,3109
DERA BUGTI DISTRICT,SUI TEHSIL,13,961,1433,2394
DERA BUGTI DISTRICT,SUI TEHSIL,14,1137,1355,2492
DERA BUGTI DISTRICT,SUI TEHSIL,15,704,1121,1825
DERA BUGTI DISTRICT,SUI TEHSIL,16,795,1117,1912
DERA BUGTI DISTRICT,SUI TEHSIL,17,526,1139,1665
DERA BUGTI DISTRICT,SUI TEHSIL,18,572,1422,1994
DERA BUGTI DISTRICT,SUI TEHSIL,19,737,1426,2163
DERA BUGTI DISTRICT,SUI TEHSIL,20,720,1291,2011
DERA BUGTI DISTRICT,SUI TEHSIL,21,609,1274,1883
DERA BUGTI DISTRICT,SUI TEHSIL,22,568,903,1471
DERA BUGTI DISTRICT,SUI TEHSIL,23,581,1116,1697
DERA BUGTI DISTRICT,SUI TEHSIL,24,579,1045,1624
DERA BUGTI DISTRICT,SUI TEHSIL,25,671,1013,1684
DERA BUGTI DISTRICT,SUI TEHSIL,26,543,901,1444
DERA BUGTI DISTRICT,SUI TEHSIL,27,740,1008,1748
DERA BUGTI DISTRICT,SUI TEHSIL,28,634,1030,1664
DERA BUGTI DISTRICT,SUI TEHSIL,29,768,977,1745
DERA BUGTI DISTRICT,SUI TEHSIL,30,692,983,1675
DERA BUGTI DISTRICT,SUI TEHSIL,31,600,851,1451
DERA BUGTI DISTRICT,SUI TEHSIL,32,522,737,1259
DERA BUGTI DISTRICT,SUI TEHSIL,33,598,689,1287
DERA BUGTI DISTRICT,SUI TEHSIL,34,490,663,1153
DERA BUGTI DISTRICT,SUI TEHSIL,35,525,663,1188
DERA BUGTI DISTRICT,SUI TEHSIL,36,430,545,975
DERA BUGTI DISTRICT,SUI TEHSIL,37,586,528,1114
DERA BUGTI DISTRICT,SUI TEHSIL,38,498,609,1107
DERA BUGTI DISTRICT,SUI TEHSIL,39,577,504,1081
DERA BUGTI DISTRICT,SUI TEHSIL,40,606,609,1215
DERA BUGTI DISTRICT,SUI TEHSIL,41,386,425,811
DERA BUGTI DISTRICT,SUI TEHSIL,42,384,352,736
DERA BUGTI DISTRICT,SUI TEHSIL,43,355,449,804
DERA BUGTI DISTRICT,SUI TEHSIL,44,307,364,671
DERA BUGTI DISTRICT,SUI TEHSIL,45,299,398,697
DERA BUGTI DISTRICT,SUI TEHSIL,46,207,309,516
DERA BUGTI DISTRICT,SUI TEHSIL,47,301,343,644
DERA BUGTI DISTRICT,SUI TEHSIL,48,222,450,672
DERA BUGTI DISTRICT,SUI TEHSIL,49,267,381,648
DERA BUGTI DISTRICT,SUI TEHSIL,50,291,437,728
DERA BUGTI DISTRICT,SUI TEHSIL,51,185,312,497
DERA BUGTI DISTRICT,SUI TEHSIL,52,176,253,429
DERA BUGTI DISTRICT,SUI TEHSIL,53,170,319,489
DERA BUGTI DISTRICT,SUI TEHSIL,54,174,260,434
DERA BUGTI DISTRICT,SUI TEHSIL,55,172,261,433
DERA BUGTI DISTRICT,SUI TEHSIL,56,132,213,345
DERA BUGTI DISTRICT,SUI TEHSIL,57,190,209,399
DERA BUGTI DISTRICT,SUI TEHSIL,58,91,211,302
DERA BUGTI DISTRICT,SUI TEHSIL,59,136,185,321
DERA BUGTI DISTRICT,SUI TEHSIL,60,147,207,354
DERA BUGTI DISTRICT,SUI TEHSIL,61,86,140,226
DERA BUGTI DISTRICT,SUI TEHSIL,62,108,106,214
DERA BUGTI DISTRICT,SUI TEHSIL,63,93,136,229
DERA BUGTI DISTRICT,SUI TEHSIL,64,88,103,191
DERA BUGTI DISTRICT,SUI TEHSIL,65,101,127,228
DERA BUGTI DISTRICT,SUI TEHSIL,66,42,98,140
DERA BUGTI DISTRICT,SUI TEHSIL,67,86,90,176
DERA BUGTI DISTRICT,SUI TEHSIL,68,50,95,145
DERA BUGTI DISTRICT,SUI TEHSIL,69,78,68,146
DERA BUGTI DISTRICT,SUI TEHSIL,70,65,91,156
DERA BUGTI DISTRICT,SUI TEHSIL,71,45,65,110
DERA BUGTI DISTRICT,SUI TEHSIL,72,32,51,83
DERA BUGTI DISTRICT,SUI TEHSIL,73,53,47,100
DERA BUGTI DISTRICT,SUI TEHSIL,74,38,45,83
DERA BUGTI DISTRICT,SUI TEHSIL,>=75,320,431,751
DERA GHAZI KHAN DISTRICT,DE-EXCLUDED AREA D.G KHAN TEHSIL,<1,7780,0,7780
DERA GHAZI KHAN DISTRICT,DE-EXCLUDED AREA D.G KHAN TEHSIL,1,7651,0,7651
DERA GHAZI KHAN DISTRICT,DE-EXCLUDED AREA D.G KHAN TEHSIL,2,9657,0,9657
DERA GHAZI KHAN DISTRICT,DE-EXCLUDED AREA D.G KHAN TEHSIL,3,8660,0,8660
DERA GHAZI KHAN DISTRICT,DE-EXCLUDED AREA D.G KHAN TEHSIL,4,10113,0,10113
DERA GHAZI KHAN DISTRICT,DE-EXCLUDED AREA D.G KHAN TEHSIL,5,7876,0,7876
DERA GHAZI KHAN DISTRICT,DE-EXCLUDED AREA D.G KHAN TEHSIL,6,8680,0,8680
DERA GHAZI KHAN DISTRICT,DE-EXCLUDED AREA D.G KHAN TEHSIL,7,7566,0,7566
DERA GHAZI KHAN DISTRICT,DE-EXCLUDED AREA D.G KHAN TEHSIL,8,8206,0,8206
DERA GHAZI KHAN DISTRICT,DE-EXCLUDED AREA D.G KHAN TEHSIL,9,6967,0,6967
DERA GHAZI KHAN DISTRICT,DE-EXCLUDED AREA D.G KHAN TEHSIL,10,7067,0,7067
DERA GHAZI KHAN DISTRICT,DE-EXCLUDED AREA D.G KHAN TEHSIL,11,5226,0,5226
DERA GHAZI KHAN DISTRICT,DE-EXCLUDED AREA D.G KHAN TEHSIL,12,5213,0,5213
DERA GHAZI KHAN DISTRICT,DE-EXCLUDED AREA D.G KHAN TEHSIL,13,4328,0,4328
DERA GHAZI KHAN DISTRICT,DE-EXCLUDED AREA D.G KHAN TEHSIL,14,4026,0,4026
DERA GHAZI KHAN DISTRICT,DE-EXCLUDED AREA D.G KHAN TEHSIL,15,3458,0,3458
DERA GHAZI KHAN DISTRICT,DE-EXCLUDED AREA D.G KHAN TEHSIL,16,3340,0,3340
DERA GHAZI KHAN DISTRICT,DE-EXCLUDED AREA D.G KHAN TEHSIL,17,3554,0,3554
DERA GHAZI KHAN DISTRICT,DE-EXCLUDED AREA D.G KHAN TEHSIL,18,4198,0,4198
DERA GHAZI KHAN DISTRICT,DE-EXCLUDED AREA D.G KHAN TEHSIL,19,3503,0,3503
DERA GHAZI KHAN DISTRICT,DE-EXCLUDED AREA D.G KHAN TEHSIL,20,3706,0,3706
DERA GHAZI KHAN DISTRICT,DE-EXCLUDED AREA D.G KHAN TEHSIL,21,3207,0,3207
DERA GHAZI KHAN DISTRICT,DE-EXCLUDED AREA D.G KHAN TEHSIL,22,2876,0,2876
DERA GHAZI KHAN DISTRICT,DE-EXCLUDED AREA D.G KHAN TEHSIL,23,2784,0,2784
DERA GHAZI KHAN DISTRICT,DE-EXCLUDED AREA D.G KHAN TEHSIL,24,2776,0,2776
DERA GHAZI KHAN DISTRICT,DE-EXCLUDED AREA D.G KHAN TEHSIL,25,3108,0,3108
DERA GHAZI KHAN DISTRICT,DE-EXCLUDED AREA D.G KHAN TEHSIL,26,2533,0,2533
DERA GHAZI KHAN DISTRICT,DE-EXCLUDED AREA D.G KHAN TEHSIL,27,2851,0,2851
DERA GHAZI KHAN DISTRICT,DE-EXCLUDED AREA D.G KHAN TEHSIL,28,2684,0,2684
DERA GHAZI KHAN DISTRICT,DE-EXCLUDED AREA D.G KHAN TEHSIL,29,2567,0,2567
DERA GHAZI KHAN DISTRICT,DE-EXCLUDED AREA D.G KHAN TEHSIL,30,2619,0,2619
DERA GHAZI KHAN DISTRICT,DE-EXCLUDED AREA D.G KHAN TEHSIL,31,2368,0,2368
DERA GHAZI KHAN DISTRICT,DE-EXCLUDED AREA D.G KHAN TEHSIL,32,2185,0,2185
DERA GHAZI KHAN DISTRICT,DE-EXCLUDED AREA D.G KHAN TEHSIL,33,2033,0,2033
DERA GHAZI KHAN DISTRICT,DE-EXCLUDED AREA D.G KHAN TEHSIL,34,2245,0,2245
DERA GHAZI KHAN DISTRICT,DE-EXCLUDED AREA D.G KHAN TEHSIL,35,2397,0,2397
DERA GHAZI KHAN DISTRICT,DE-EXCLUDED AREA D.G KHAN TEHSIL,36,2109,0,2109
DERA GHAZI KHAN DISTRICT,DE-EXCLUDED AREA D.G KHAN TEHSIL,37,2133,0,2133
DERA GHAZI KHAN DISTRICT,DE-EXCLUDED AREA D.G KHAN TEHSIL,38,1858,0,1858
DERA GHAZI KHAN DISTRICT,DE-EXCLUDED AREA D.G KHAN TEHSIL,39,1768,0,1768
DERA GHAZI KHAN DISTRICT,DE-EXCLUDED AREA D.G KHAN TEHSIL,40,1739,0,1739
DERA GHAZI KHAN DISTRICT,DE-EXCLUDED AREA D.G KHAN TEHSIL,41,1669,0,1669
DERA GHAZI KHAN DISTRICT,DE-EXCLUDED AREA D.G KHAN TEHSIL,42,1384,0,1384
DERA GHAZI KHAN DISTRICT,DE-EXCLUDED AREA D.G KHAN TEHSIL,43,1453,0,1453
DERA GHAZI KHAN DISTRICT,DE-EXCLUDED AREA D.G KHAN TEHSIL,44,1248,0,1248
DERA GHAZI KHAN DISTRICT,DE-EXCLUDED AREA D.G KHAN TEHSIL,45,1311,0,1311
DERA GHAZI KHAN DISTRICT,DE-EXCLUDED AREA D.G KHAN TEHSIL,46,1112,0,1112
DERA GHAZI KHAN DISTRICT,DE-EXCLUDED AREA D.G KHAN TEHSIL,47,1327,0,1327
DERA GHAZI KHAN DISTRICT,DE-EXCLUDED AREA D.G KHAN TEHSIL,48,1308,0,1308
DERA GHAZI KHAN DISTRICT,DE-EXCLUDED AREA D.G KHAN TEHSIL,49,1231,0,1231
DERA GHAZI KHAN DISTRICT,DE-EXCLUDED AREA D.G KHAN TEHSIL,50,1303,0,1303
DERA GHAZI KHAN DISTRICT,DE-EXCLUDED AREA D.G KHAN TEHSIL,51,1152,0,1152
DERA GHAZI KHAN DISTRICT,DE-EXCLUDED AREA D.G KHAN TEHSIL,52,1022,0,1022
DERA GHAZI KHAN DISTRICT,DE-EXCLUDED AREA D.G KHAN TEHSIL,53,1013,0,1013
DERA GHAZI KHAN DISTRICT,DE-EXCLUDED AREA D.G KHAN TEHSIL,54,921,0,921
DERA GHAZI KHAN DISTRICT,DE-EXCLUDED AREA D.G KHAN TEHSIL,55,892,0,892
DERA GHAZI KHAN DISTRICT,DE-EXCLUDED AREA D.G KHAN TEHSIL,56,818,0,818
DERA GHAZI KHAN DISTRICT,DE-EXCLUDED AREA D.G KHAN TEHSIL,57,904,0,904
DERA GHAZI KHAN DISTRICT,DE-EXCLUDED AREA D.G KHAN TEHSIL,58,718,0,718
DERA GHAZI KHAN DISTRICT,DE-EXCLUDED AREA D.G KHAN TEHSIL,59,793,0,793
DERA GHAZI KHAN DISTRICT,DE-EXCLUDED AREA D.G KHAN TEHSIL,60,841,0,841
DERA GHAZI KHAN DISTRICT,DE-EXCLUDED AREA D.G KHAN TEHSIL,61,673,0,673
DERA GHAZI KHAN DISTRICT,DE-EXCLUDED AREA D.G KHAN TEHSIL,62,644,0,644
DERA GHAZI KHAN DISTRICT,DE-EXCLUDED AREA D.G KHAN TEHSIL,63,691,0,691
DERA GHAZI KHAN DISTRICT,DE-EXCLUDED AREA D.G KHAN TEHSIL,64,635,0,635
DERA GHAZI KHAN DISTRICT,DE-EXCLUDED AREA D.G KHAN TEHSIL,65,610,0,610
DERA GHAZI KHAN DISTRICT,DE-EXCLUDED AREA D.G KHAN TEHSIL,66,538,0,538
DERA GHAZI KHAN DISTRICT,DE-EXCLUDED AREA D.G KHAN TEHSIL,67,597,0,597
DERA GHAZI KHAN DISTRICT,DE-EXCLUDED AREA D.G KHAN TEHSIL,68,542,0,542
DERA GHAZI KHAN DISTRICT,DE-EXCLUDED AREA D.G KHAN TEHSIL,69,511,0,511
DERA GHAZI KHAN DISTRICT,DE-EXCLUDED AREA D.G KHAN TEHSIL,70,541,0,541
DERA GHAZI KHAN DISTRICT,DE-EXCLUDED AREA D.G KHAN TEHSIL,71,460,0,460
DERA GHAZI KHAN DISTRICT,DE-EXCLUDED AREA D.G KHAN TEHSIL,72,336,0,336
DERA GHAZI KHAN DISTRICT,DE-EXCLUDED AREA D.G KHAN TEHSIL,73,374,0,374
DERA GHAZI KHAN DISTRICT,DE-EXCLUDED AREA D.G KHAN TEHSIL,74,367,0,367
DERA GHAZI KHAN DISTRICT,DE-EXCLUDED AREA D.G KHAN TEHSIL,>=75,3098,0,3098
DERA GHAZI KHAN DISTRICT,DERA GHAZI KHAN TEHSIL,<1,23875,10032,33907
DERA GHAZI KHAN DISTRICT,DERA GHAZI KHAN TEHSIL,1,24852,10442,35294
DERA GHAZI KHAN DISTRICT,DERA GHAZI KHAN TEHSIL,2,29335,10758,40093
DERA GHAZI KHAN DISTRICT,DERA GHAZI KHAN TEHSIL,3,30938,11640,42578
DERA GHAZI KHAN DISTRICT,DERA GHAZI KHAN TEHSIL,4,33017,11030,44047
DERA GHAZI KHAN DISTRICT,DERA GHAZI KHAN TEHSIL,5,30280,11488,41768
DERA GHAZI KHAN DISTRICT,DERA GHAZI KHAN TEHSIL,6,30283,10545,40828
DERA GHAZI KHAN DISTRICT,DERA GHAZI KHAN TEHSIL,7,31146,11956,43102
DERA GHAZI KHAN DISTRICT,DERA GHAZI KHAN TEHSIL,8,33945,11195,45140
DERA GHAZI KHAN DISTRICT,DERA GHAZI KHAN TEHSIL,9,28143,11356,39499
DERA GHAZI KHAN DISTRICT,DERA GHAZI KHAN TEHSIL,10,29522,10059,39581
DERA GHAZI KHAN DISTRICT,DERA GHAZI KHAN TEHSIL,11,21628,10199,31827
DERA GHAZI KHAN DISTRICT,DERA GHAZI KHAN TEHSIL,12,24336,9217,33553
DERA GHAZI KHAN DISTRICT,DERA GHAZI KHAN TEHSIL,13,19200,9199,28399
DERA GHAZI KHAN DISTRICT,DERA GHAZI KHAN TEHSIL,14,19553,8782,28335
DERA GHAZI KHAN DISTRICT,DERA GHAZI KHAN TEHSIL,15,16955,8739,25694
DERA GHAZI KHAN DISTRICT,DERA GHAZI KHAN TEHSIL,16,16534,8495,25029
DERA GHAZI KHAN DISTRICT,DERA GHAZI KHAN TEHSIL,17,13553,8672,22225
DERA GHAZI KHAN DISTRICT,DERA GHAZI KHAN TEHSIL,18,18345,8536,26881
DERA GHAZI KHAN DISTRICT,DERA GHAZI KHAN TEHSIL,19,14766,9078,23844
DERA GHAZI KHAN DISTRICT,DERA GHAZI KHAN TEHSIL,20,17047,7864,24911
DERA GHAZI KHAN DISTRICT,DERA GHAZI KHAN TEHSIL,21,13198,8331,21529
DERA GHAZI KHAN DISTRICT,DERA GHAZI KHAN TEHSIL,22,14604,7482,22086
DERA GHAZI KHAN DISTRICT,DERA GHAZI KHAN TEHSIL,23,11832,7144,18976
DERA GHAZI KHAN DISTRICT,DERA GHAZI KHAN TEHSIL,24,10822,6743,17565
DERA GHAZI KHAN DISTRICT,DERA GHAZI KHAN TEHSIL,25,13216,6466,19682
DERA GHAZI KHAN DISTRICT,DERA GHAZI KHAN TEHSIL,26,10115,6476,16591
DERA GHAZI KHAN DISTRICT,DERA GHAZI KHAN TEHSIL,27,9956,6497,16453
DERA GHAZI KHAN DISTRICT,DERA GHAZI KHAN TEHSIL,28,10878,6132,17010
DERA GHAZI KHAN DISTRICT,DERA GHAZI KHAN TEHSIL,29,9327,6059,15386
DERA GHAZI KHAN DISTRICT,DERA GHAZI KHAN TEHSIL,30,11875,5967,17842
DERA GHAZI KHAN DISTRICT,DERA GHAZI KHAN TEHSIL,31,9173,5698,14871
DERA GHAZI KHAN DISTRICT,DERA GHAZI KHAN TEHSIL,32,8616,5450,14066
DERA GHAZI KHAN DISTRICT,DERA GHAZI KHAN TEHSIL,33,8329,5227,13556
DERA GHAZI KHAN DISTRICT,DERA GHAZI KHAN TEHSIL,34,7384,4876,12260
DERA GHAZI KHAN DISTRICT,DERA GHAZI KHAN TEHSIL,35,9383,4712,14095
DERA GHAZI KHAN DISTRICT,DERA GHAZI KHAN TEHSIL,36,7350,4697,12047
DERA GHAZI KHAN DISTRICT,DERA GHAZI KHAN TEHSIL,37,7265,4275,11540
DERA GHAZI KHAN DISTRICT,DERA GHAZI KHAN TEHSIL,38,7572,4519,12091
DERA GHAZI KHAN DISTRICT,DERA GHAZI KHAN TEHSIL,39,6854,4252,11106
DERA GHAZI KHAN DISTRICT,DERA GHAZI KHAN TEHSIL,40,8425,4270,12695
DERA GHAZI KHAN DISTRICT,DERA GHAZI KHAN TEHSIL,41,6134,3868,10002
DERA GHAZI KHAN DISTRICT,DERA GHAZI KHAN TEHSIL,42,5686,3577,9263
DERA GHAZI KHAN DISTRICT,DERA GHAZI KHAN TEHSIL,43,5229,3481,8710
DERA GHAZI KHAN DISTRICT,DERA GHAZI KHAN TEHSIL,44,4798,3224,8022
DERA GHAZI KHAN DISTRICT,DERA GHAZI KHAN TEHSIL,45,6055,3153,9208
DERA GHAZI KHAN DISTRICT,DERA GHAZI KHAN TEHSIL,46,4499,2837,7336
DERA GHAZI KHAN DISTRICT,DERA GHAZI KHAN TEHSIL,47,4448,2973,7421
DERA GHAZI KHAN DISTRICT,DERA GHAZI KHAN TEHSIL,48,4958,3033,7991
DERA GHAZI KHAN DISTRICT,DERA GHAZI KHAN TEHSIL,49,4640,2997,7637
DERA GHAZI KHAN DISTRICT,DERA GHAZI KHAN TEHSIL,50,5947,3035,8982
DERA GHAZI KHAN DISTRICT,DERA GHAZI KHAN TEHSIL,51,4064,2784,6848
DERA GHAZI KHAN DISTRICT,DERA GHAZI KHAN TEHSIL,52,3770,2641,6411
DERA GHAZI KHAN DISTRICT,DERA GHAZI KHAN TEHSIL,53,3869,2585,6454
DERA GHAZI KHAN DISTRICT,DERA GHAZI KHAN TEHSIL,54,3546,2400,5946
DERA GHAZI KHAN DISTRICT,DERA GHAZI KHAN TEHSIL,55,4043,2232,6275
DERA GHAZI KHAN DISTRICT,DERA GHAZI KHAN TEHSIL,56,2725,1943,4668
DERA GHAZI KHAN DISTRICT,DERA GHAZI KHAN TEHSIL,57,2490,1618,4108
DERA GHAZI KHAN DISTRICT,DERA GHAZI KHAN TEHSIL,58,2565,1728,4293
DERA GHAZI KHAN DISTRICT,DERA GHAZI KHAN TEHSIL,59,2421,1607,4028
DERA GHAZI KHAN DISTRICT,DERA GHAZI KHAN TEHSIL,60,3685,1743,5428
DERA GHAZI KHAN DISTRICT,DERA GHAZI KHAN TEHSIL,61,2735,1734,4469
DERA GHAZI KHAN DISTRICT,DERA GHAZI KHAN TEHSIL,62,2599,1724,4323
DERA GHAZI KHAN DISTRICT,DERA GHAZI KHAN TEHSIL,63,2606,1613,4219
DERA GHAZI KHAN DISTRICT,DERA GHAZI KHAN TEHSIL,64,2231,1331,3562
DERA GHAZI KHAN DISTRICT,DERA GHAZI KHAN TEHSIL,65,2707,1227,3934
DERA GHAZI KHAN DISTRICT,DERA GHAZI KHAN TEHSIL,66,1865,1053,2918
DERA GHAZI KHAN DISTRICT,DERA GHAZI KHAN TEHSIL,67,2003,988,2991
DERA GHAZI KHAN DISTRICT,DERA GHAZI KHAN TEHSIL,68,1888,998,2886
DERA GHAZI KHAN DISTRICT,DERA GHAZI KHAN TEHSIL,69,1539,844,2383
DERA GHAZI KHAN DISTRICT,DERA GHAZI KHAN TEHSIL,70,2199,816,3015
DERA GHAZI KHAN DISTRICT,DERA GHAZI KHAN TEHSIL,71,1452,794,2246
DERA GHAZI KHAN DISTRICT,DERA GHAZI KHAN TEHSIL,72,1562,741,2303
DERA GHAZI KHAN DISTRICT,DERA GHAZI KHAN TEHSIL,73,1474,669,2143
DERA GHAZI KHAN DISTRICT,DERA GHAZI KHAN TEHSIL,74,1094,552,1646
DERA GHAZI KHAN DISTRICT,DERA GHAZI KHAN TEHSIL,>=75,10649,4264,14913
DERA GHAZI KHAN DISTRICT,KOT CHHUTTA TEHSIL,<1,18878,1289,20167
DERA GHAZI KHAN DISTRICT,KOT CHHUTTA TEHSIL,1,20596,1365,21961
DERA GHAZI KHAN DISTRICT,KOT CHHUTTA TEHSIL,2,24965,1562,26527
DERA GHAZI KHAN DISTRICT,KOT CHHUTTA TEHSIL,3,26036,1870,27906
DERA GHAZI KHAN DISTRICT,KOT CHHUTTA TEHSIL,4,29103,1777,30880
DERA GHAZI KHAN DISTRICT,KOT CHHUTTA TEHSIL,5,25711,1860,27571
DERA GHAZI KHAN DISTRICT,KOT CHHUTTA TEHSIL,6,26383,1717,28100
DERA GHAZI KHAN DISTRICT,KOT CHHUTTA TEHSIL,7,25997,1785,27782
DERA GHAZI KHAN DISTRICT,KOT CHHUTTA TEHSIL,8,28448,1844,30292
DERA GHAZI KHAN DISTRICT,KOT CHHUTTA TEHSIL,9,23167,1557,24724
DERA GHAZI KHAN DISTRICT,KOT CHHUTTA TEHSIL,10,24859,1634,26493
DERA GHAZI KHAN DISTRICT,KOT CHHUTTA TEHSIL,11,17330,1322,18652
DERA GHAZI KHAN DISTRICT,KOT CHHUTTA TEHSIL,12,20010,1415,21425
DERA GHAZI KHAN DISTRICT,KOT CHHUTTA TEHSIL,13,15689,1223,16912
DERA GHAZI KHAN DISTRICT,KOT CHHUTTA TEHSIL,14,16470,1222,17692
DERA GHAZI KHAN DISTRICT,KOT CHHUTTA TEHSIL,15,14292,1154,15446
DERA GHAZI KHAN DISTRICT,KOT CHHUTTA TEHSIL,16,13931,1191,15122
DERA GHAZI KHAN DISTRICT,KOT CHHUTTA TEHSIL,17,11375,984,12359
DERA GHAZI KHAN DISTRICT,KOT CHHUTTA TEHSIL,18,15678,1268,16946
DERA GHAZI KHAN DISTRICT,KOT CHHUTTA TEHSIL,19,12235,1056,13291
DERA GHAZI KHAN DISTRICT,KOT CHHUTTA TEHSIL,20,14434,1163,15597
DERA GHAZI KHAN DISTRICT,KOT CHHUTTA TEHSIL,21,10779,910,11689
DERA GHAZI KHAN DISTRICT,KOT CHHUTTA TEHSIL,22,11753,989,12742
DERA GHAZI KHAN DISTRICT,KOT CHHUTTA TEHSIL,23,9436,812,10248
DERA GHAZI KHAN DISTRICT,KOT CHHUTTA TEHSIL,24,9374,722,10096
DERA GHAZI KHAN DISTRICT,KOT CHHUTTA TEHSIL,25,11004,900,11904
DERA GHAZI KHAN DISTRICT,KOT CHHUTTA TEHSIL,26,8655,695,9350
DERA GHAZI KHAN DISTRICT,KOT CHHUTTA TEHSIL,27,8343,672,9015
DERA GHAZI KHAN DISTRICT,KOT CHHUTTA TEHSIL,28,9402,752,10154
DERA GHAZI KHAN DISTRICT,KOT CHHUTTA TEHSIL,29,8358,626,8984
DERA GHAZI KHAN DISTRICT,KOT CHHUTTA TEHSIL,30,9934,793,10727
DERA GHAZI KHAN DISTRICT,KOT CHHUTTA TEHSIL,31,7967,618,8585
DERA GHAZI KHAN DISTRICT,KOT CHHUTTA TEHSIL,32,7803,647,8450
DERA GHAZI KHAN DISTRICT,KOT CHHUTTA TEHSIL,33,7275,573,7848
DERA GHAZI KHAN DISTRICT,KOT CHHUTTA TEHSIL,34,6960,514,7474
DERA GHAZI KHAN DISTRICT,KOT CHHUTTA TEHSIL,35,7909,618,8527
DERA GHAZI KHAN DISTRICT,KOT CHHUTTA TEHSIL,36,6851,424,7275
DERA GHAZI KHAN DISTRICT,KOT CHHUTTA TEHSIL,37,7128,512,7640
DERA GHAZI KHAN DISTRICT,KOT CHHUTTA TEHSIL,38,6542,528,7070
DERA GHAZI KHAN DISTRICT,KOT CHHUTTA TEHSIL,39,6284,476,6760
DERA GHAZI KHAN DISTRICT,KOT CHHUTTA TEHSIL,40,6962,537,7499
DERA GHAZI KHAN DISTRICT,KOT CHHUTTA TEHSIL,41,5585,386,5971
DERA GHAZI KHAN DISTRICT,KOT CHHUTTA TEHSIL,42,5237,402,5639
DERA GHAZI KHAN DISTRICT,KOT CHHUTTA TEHSIL,43,4434,369,4803
DERA GHAZI KHAN DISTRICT,KOT CHHUTTA TEHSIL,44,4154,312,4466
DERA GHAZI KHAN DISTRICT,KOT CHHUTTA TEHSIL,45,4756,400,5156
DERA GHAZI KHAN DISTRICT,KOT CHHUTTA TEHSIL,46,3945,273,4218
DERA GHAZI KHAN DISTRICT,KOT CHHUTTA TEHSIL,47,4359,369,4728
DERA GHAZI KHAN DISTRICT,KOT CHHUTTA TEHSIL,48,4548,336,4884
DERA GHAZI KHAN DISTRICT,KOT CHHUTTA TEHSIL,49,4124,330,4454
DERA GHAZI KHAN DISTRICT,KOT CHHUTTA TEHSIL,50,4747,359,5106
DERA GHAZI KHAN DISTRICT,KOT CHHUTTA TEHSIL,51,3735,251,3986
DERA GHAZI KHAN DISTRICT,KOT CHHUTTA TEHSIL,52,3637,283,3920
DERA GHAZI KHAN DISTRICT,KOT CHHUTTA TEHSIL,53,3490,249,3739
DERA GHAZI KHAN DISTRICT,KOT CHHUTTA TEHSIL,54,3123,233,3356
DERA GHAZI KHAN DISTRICT,KOT CHHUTTA TEHSIL,55,3328,258,3586
DERA GHAZI KHAN DISTRICT,KOT CHHUTTA TEHSIL,56,2439,182,2621
DERA GHAZI KHAN DISTRICT,KOT CHHUTTA TEHSIL,57,2587,192,2779
DERA GHAZI KHAN DISTRICT,KOT CHHUTTA TEHSIL,58,2218,181,2399
DERA GHAZI KHAN DISTRICT,KOT CHHUTTA TEHSIL,59,2207,167,2374
DERA GHAZI KHAN DISTRICT,KOT CHHUTTA TEHSIL,60,2996,203,3199
DERA GHAZI KHAN DISTRICT,KOT CHHUTTA TEHSIL,61,2331,170,2501
DERA GHAZI KHAN DISTRICT,KOT CHHUTTA TEHSIL,62,2519,150,2669
DERA GHAZI KHAN DISTRICT,KOT CHHUTTA TEHSIL,63,2276,185,2461
DERA GHAZI KHAN DISTRICT,KOT CHHUTTA TEHSIL,64,2141,145,2286
DERA GHAZI KHAN DISTRICT,KOT CHHUTTA TEHSIL,65,2394,182,2576
DERA GHAZI KHAN DISTRICT,KOT CHHUTTA TEHSIL,66,1715,113,1828
DERA GHAZI KHAN DISTRICT,KOT CHHUTTA TEHSIL,67,2206,119,2325
DERA GHAZI KHAN DISTRICT,KOT CHHUTTA TEHSIL,68,1829,123,1952
DERA GHAZI KHAN DISTRICT,KOT CHHUTTA TEHSIL,69,1619,105,1724
DERA GHAZI KHAN DISTRICT,KOT CHHUTTA TEHSIL,70,1971,133,2104
DERA GHAZI KHAN DISTRICT,KOT CHHUTTA TEHSIL,71,1367,84,1451
DERA GHAZI KHAN DISTRICT,KOT CHHUTTA TEHSIL,72,1440,94,1534
DERA GHAZI KHAN DISTRICT,KOT CHHUTTA TEHSIL,73,1279,99,1378
DERA GHAZI KHAN DISTRICT,KOT CHHUTTA TEHSIL,74,1062,58,1120
DERA GHAZI KHAN DISTRICT,KOT CHHUTTA TEHSIL,>=75,9460,595,10055
DERA GHAZI KHAN DISTRICT,TAUNSA TEHSIL,<1,16817,2519,19336
DERA GHAZI KHAN DISTRICT,TAUNSA TEHSIL,1,17371,2799,20170
DERA GHAZI KHAN DISTRICT,TAUNSA TEHSIL,2,20241,2810,23051
DERA GHAZI KHAN DISTRICT,TAUNSA TEHSIL,3,20639,3112,23751
DERA GHAZI KHAN DISTRICT,TAUNSA TEHSIL,4,22480,3050,25530
DERA GHAZI KHAN DISTRICT,TAUNSA TEHSIL,5,19842,2969,22811
DERA GHAZI KHAN DISTRICT,TAUNSA TEHSIL,6,19374,2875,22249
DERA GHAZI KHAN DISTRICT,TAUNSA TEHSIL,7,19989,3082,23071
DERA GHAZI KHAN DISTRICT,TAUNSA TEHSIL,8,20039,2666,22705
DERA GHAZI KHAN DISTRICT,TAUNSA TEHSIL,9,18659,3019,21678
DERA GHAZI KHAN DISTRICT,TAUNSA TEHSIL,10,17492,2380,19872
DERA GHAZI KHAN DISTRICT,TAUNSA TEHSIL,11,15369,2704,18073
DERA GHAZI KHAN DISTRICT,TAUNSA TEHSIL,12,14936,2161,17097
DERA GHAZI KHAN DISTRICT,TAUNSA TEHSIL,13,13832,2405,16237
DERA GHAZI KHAN DISTRICT,TAUNSA TEHSIL,14,13459,2149,15608
DERA GHAZI KHAN DISTRICT,TAUNSA TEHSIL,15,12342,2165,14507
DERA GHAZI KHAN DISTRICT,TAUNSA TEHSIL,16,11945,2003,13948
DERA GHAZI KHAN DISTRICT,TAUNSA TEHSIL,17,11756,2294,14050
DERA GHAZI KHAN DISTRICT,TAUNSA TEHSIL,18,10887,1843,12730
DERA GHAZI KHAN DISTRICT,TAUNSA TEHSIL,19,10749,2128,12877
DERA GHAZI KHAN DISTRICT,TAUNSA TEHSIL,20,10571,1714,12285
DERA GHAZI KHAN DISTRICT,TAUNSA TEHSIL,21,9715,1888,11603
DERA GHAZI KHAN DISTRICT,TAUNSA TEHSIL,22,8997,1603,10600
DERA GHAZI KHAN DISTRICT,TAUNSA TEHSIL,23,8643,1603,10246
DERA GHAZI KHAN DISTRICT,TAUNSA TEHSIL,24,8623,1559,10182
DERA GHAZI KHAN DISTRICT,TAUNSA TEHSIL,25,8443,1427,9870
DERA GHAZI KHAN DISTRICT,TAUNSA TEHSIL,26,7905,1472,9377
DERA GHAZI KHAN DISTRICT,TAUNSA TEHSIL,27,8161,1512,9673
DERA GHAZI KHAN DISTRICT,TAUNSA TEHSIL,28,7461,1342,8803
DERA GHAZI KHAN DISTRICT,TAUNSA TEHSIL,29,7881,1410,9291
DERA GHAZI KHAN DISTRICT,TAUNSA TEHSIL,30,6852,1167,8019
DERA GHAZI KHAN DISTRICT,TAUNSA TEHSIL,31,6984,1289,8273
DERA GHAZI KHAN DISTRICT,TAUNSA TEHSIL,32,6782,1193,7975
DERA GHAZI KHAN DISTRICT,TAUNSA TEHSIL,33,6019,1208,7227
DERA GHAZI KHAN DISTRICT,TAUNSA TEHSIL,34,6851,1307,8158
DERA GHAZI KHAN DISTRICT,TAUNSA TEHSIL,35,6126,1028,7154
DERA GHAZI KHAN DISTRICT,TAUNSA TEHSIL,36,6705,1175,7880
DERA GHAZI KHAN DISTRICT,TAUNSA TEHSIL,37,6511,1249,7760
DERA GHAZI KHAN DISTRICT,TAUNSA TEHSIL,38,5397,1078,6475
DERA GHAZI KHAN DISTRICT,TAUNSA TEHSIL,39,5656,1050,6706
DERA GHAZI KHAN DISTRICT,TAUNSA TEHSIL,40,4527,840,5367
DERA GHAZI KHAN DISTRICT,TAUNSA TEHSIL,41,5270,985,6255
DERA GHAZI KHAN DISTRICT,TAUNSA TEHSIL,42,4635,847,5482
DERA GHAZI KHAN DISTRICT,TAUNSA TEHSIL,43,3951,805,4756
DERA GHAZI KHAN DISTRICT,TAUNSA TEHSIL,44,3916,876,4792
DERA GHAZI KHAN DISTRICT,TAUNSA TEHSIL,45,3364,664,4028
DERA GHAZI KHAN DISTRICT,TAUNSA TEHSIL,46,3959,844,4803
DERA GHAZI KHAN DISTRICT,TAUNSA TEHSIL,47,4028,764,4792
DERA GHAZI KHAN DISTRICT,TAUNSA TEHSIL,48,3725,725,4450
DERA GHAZI KHAN DISTRICT,TAUNSA TEHSIL,49,3928,795,4723
DERA GHAZI KHAN DISTRICT,TAUNSA TEHSIL,50,3184,631,3815
DERA GHAZI KHAN DISTRICT,TAUNSA TEHSIL,51,3818,672,4490
DERA GHAZI KHAN DISTRICT,TAUNSA TEHSIL,52,3466,629,4095
DERA GHAZI KHAN DISTRICT,TAUNSA TEHSIL,53,2996,590,3586
DERA GHAZI KHAN DISTRICT,TAUNSA TEHSIL,54,2779,556,3335
DERA GHAZI KHAN DISTRICT,TAUNSA TEHSIL,55,2228,427,2655
DERA GHAZI KHAN DISTRICT,TAUNSA TEHSIL,56,2527,496,3023
DERA GHAZI KHAN DISTRICT,TAUNSA TEHSIL,57,2463,466,2929
DERA GHAZI KHAN DISTRICT,TAUNSA TEHSIL,58,2072,401,2473
DERA GHAZI KHAN DISTRICT,TAUNSA TEHSIL,59,2138,468,2606
DERA GHAZI KHAN DISTRICT,TAUNSA TEHSIL,60,2108,369,2477
DERA GHAZI KHAN DISTRICT,TAUNSA TEHSIL,61,2401,444,2845
DERA GHAZI KHAN DISTRICT,TAUNSA TEHSIL,62,2286,337,2623
DERA GHAZI KHAN DISTRICT,TAUNSA TEHSIL,63,2051,395,2446
DERA GHAZI KHAN DISTRICT,TAUNSA TEHSIL,64,1859,386,2245
DERA GHAZI KHAN DISTRICT,TAUNSA TEHSIL,65,1794,287,2081
DERA GHAZI KHAN DISTRICT,TAUNSA TEHSIL,66,2071,304,2375
DERA GHAZI KHAN DISTRICT,TAUNSA TEHSIL,67,1743,253,1996
DERA GHAZI KHAN DISTRICT,TAUNSA TEHSIL,68,1476,256,1732
DERA GHAZI KHAN DISTRICT,TAUNSA TEHSIL,69,1432,241,1673
DERA GHAZI KHAN DISTRICT,TAUNSA TEHSIL,70,1356,180,1536
DERA GHAZI KHAN DISTRICT,TAUNSA TEHSIL,71,1573,222,1795
DERA GHAZI KHAN DISTRICT,TAUNSA TEHSIL,72,1315,226,1541
DERA GHAZI KHAN DISTRICT,TAUNSA TEHSIL,73,1042,175,1217
DERA GHAZI KHAN DISTRICT,TAUNSA TEHSIL,74,885,134,1019
DERA GHAZI KHAN DISTRICT,TAUNSA TEHSIL,>=75,7725,1096,8821
DERA ISMAIL KHAN DISTRICT,DARABAN TEHSIL,<1,4278,0,4278
DERA ISMAIL KHAN DISTRICT,DARABAN TEHSIL,1,4203,0,4203
DERA ISMAIL KHAN DISTRICT,DARABAN TEHSIL,2,4529,0,4529
DERA ISMAIL KHAN DISTRICT,DARABAN TEHSIL,3,4819,0,4819
DERA ISMAIL KHAN DISTRICT,DARABAN TEHSIL,4,4801,0,4801
DERA ISMAIL KHAN DISTRICT,DARABAN TEHSIL,5,4658,0,4658
DERA ISMAIL KHAN DISTRICT,DARABAN TEHSIL,6,4158,0,4158
DERA ISMAIL KHAN DISTRICT,DARABAN TEHSIL,7,4875,0,4875
DERA ISMAIL KHAN DISTRICT,DARABAN TEHSIL,8,4317,0,4317
DERA ISMAIL KHAN DISTRICT,DARABAN TEHSIL,9,4170,0,4170
DERA ISMAIL KHAN DISTRICT,DARABAN TEHSIL,10,3591,0,3591
DERA ISMAIL KHAN DISTRICT,DARABAN TEHSIL,11,3169,0,3169
DERA ISMAIL KHAN DISTRICT,DARABAN TEHSIL,12,2877,0,2877
DERA ISMAIL KHAN DISTRICT,DARABAN TEHSIL,13,2677,0,2677
DERA ISMAIL KHAN DISTRICT,DARABAN TEHSIL,14,2324,0,2324
DERA ISMAIL KHAN DISTRICT,DARABAN TEHSIL,15,2218,0,2218
DERA ISMAIL KHAN DISTRICT,DARABAN TEHSIL,16,2069,0,2069
DERA ISMAIL KHAN DISTRICT,DARABAN TEHSIL,17,2177,0,2177
DERA ISMAIL KHAN DISTRICT,DARABAN TEHSIL,18,2267,0,2267
DERA ISMAIL KHAN DISTRICT,DARABAN TEHSIL,19,2114,0,2114
DERA ISMAIL KHAN DISTRICT,DARABAN TEHSIL,20,1991,0,1991
DERA ISMAIL KHAN DISTRICT,DARABAN TEHSIL,21,1977,0,1977
DERA ISMAIL KHAN DISTRICT,DARABAN TEHSIL,22,1731,0,1731
DERA ISMAIL KHAN DISTRICT,DARABAN TEHSIL,23,1823,0,1823
DERA ISMAIL KHAN DISTRICT,DARABAN TEHSIL,24,1772,0,1772
DERA ISMAIL KHAN DISTRICT,DARABAN TEHSIL,25,1892,0,1892
DERA ISMAIL KHAN DISTRICT,DARABAN TEHSIL,26,1939,0,1939
DERA ISMAIL KHAN DISTRICT,DARABAN TEHSIL,27,2035,0,2035
DERA ISMAIL KHAN DISTRICT,DARABAN TEHSIL,28,1741,0,1741
DERA ISMAIL KHAN DISTRICT,DARABAN TEHSIL,29,2007,0,2007
DERA ISMAIL KHAN DISTRICT,DARABAN TEHSIL,30,1399,0,1399
DERA ISMAIL KHAN DISTRICT,DARABAN TEHSIL,31,1709,0,1709
DERA ISMAIL KHAN DISTRICT,DARABAN TEHSIL,32,1437,0,1437
DERA ISMAIL KHAN DISTRICT,DARABAN TEHSIL,33,1308,0,1308
DERA ISMAIL KHAN DISTRICT,DARABAN TEHSIL,34,1239,0,1239
DERA ISMAIL KHAN DISTRICT,DARABAN TEHSIL,35,1015,0,1015
DERA ISMAIL KHAN DISTRICT,DARABAN TEHSIL,36,1303,0,1303
DERA ISMAIL KHAN DISTRICT,DARABAN TEHSIL,37,1275,0,1275
DERA ISMAIL KHAN DISTRICT,DARABAN TEHSIL,38,1046,0,1046
DERA ISMAIL KHAN DISTRICT,DARABAN TEHSIL,39,1091,0,1091
DERA ISMAIL KHAN DISTRICT,DARABAN TEHSIL,40,798,0,798
DERA ISMAIL KHAN DISTRICT,DARABAN TEHSIL,41,1167,0,1167
DERA ISMAIL KHAN DISTRICT,DARABAN TEHSIL,42,1016,0,1016
DERA ISMAIL KHAN DISTRICT,DARABAN TEHSIL,43,861,0,861
DERA ISMAIL KHAN DISTRICT,DARABAN TEHSIL,44,998,0,998
DERA ISMAIL KHAN DISTRICT,DARABAN TEHSIL,45,767,0,767
DERA ISMAIL KHAN DISTRICT,DARABAN TEHSIL,46,953,0,953
DERA ISMAIL KHAN DISTRICT,DARABAN TEHSIL,47,1022,0,1022
DERA ISMAIL KHAN DISTRICT,DARABAN TEHSIL,48,950,0,950
DERA ISMAIL KHAN DISTRICT,DARABAN TEHSIL,49,994,0,994
DERA ISMAIL KHAN DISTRICT,DARABAN TEHSIL,50,682,0,682
DERA ISMAIL KHAN DISTRICT,DARABAN TEHSIL,51,944,0,944
DERA ISMAIL KHAN DISTRICT,DARABAN TEHSIL,52,732,0,732
DERA ISMAIL KHAN DISTRICT,DARABAN TEHSIL,53,674,0,674
DERA ISMAIL KHAN DISTRICT,DARABAN TEHSIL,54,651,0,651
DERA ISMAIL KHAN DISTRICT,DARABAN TEHSIL,55,466,0,466
DERA ISMAIL KHAN DISTRICT,DARABAN TEHSIL,56,579,0,579
DERA ISMAIL KHAN DISTRICT,DARABAN TEHSIL,57,595,0,595
DERA ISMAIL KHAN DISTRICT,DARABAN TEHSIL,58,424,0,424
DERA ISMAIL KHAN DISTRICT,DARABAN TEHSIL,59,479,0,479
DERA ISMAIL KHAN DISTRICT,DARABAN TEHSIL,60,370,0,370
DERA ISMAIL KHAN DISTRICT,DARABAN TEHSIL,61,572,0,572
DERA ISMAIL KHAN DISTRICT,DARABAN TEHSIL,62,518,0,518
DERA ISMAIL KHAN DISTRICT,DARABAN TEHSIL,63,386,0,386
DERA ISMAIL KHAN DISTRICT,DARABAN TEHSIL,64,418,0,418
DERA ISMAIL KHAN DISTRICT,DARABAN TEHSIL,65,314,0,314
DERA ISMAIL KHAN DISTRICT,DARABAN TEHSIL,66,492,0,492
DERA ISMAIL KHAN DISTRICT,DARABAN TEHSIL,67,450,0,450
DERA ISMAIL KHAN DISTRICT,DARABAN TEHSIL,68,298,0,298
DERA ISMAIL KHAN DISTRICT,DARABAN TEHSIL,69,295,0,295
DERA ISMAIL KHAN DISTRICT,DARABAN TEHSIL,70,225,0,225
DERA ISMAIL KHAN DISTRICT,DARABAN TEHSIL,71,322,0,322
DERA ISMAIL KHAN DISTRICT,DARABAN TEHSIL,72,295,0,295
DERA ISMAIL KHAN DISTRICT,DARABAN TEHSIL,73,172,0,172
DERA ISMAIL KHAN DISTRICT,DARABAN TEHSIL,74,163,0,163
DERA ISMAIL KHAN DISTRICT,DARABAN TEHSIL,>=75,1255,0,1255
DERA ISMAIL KHAN DISTRICT,DERA ISMAIL KHAN TEHSIL,<1,14275,5247,19522
DERA ISMAIL KHAN DISTRICT,DERA ISMAIL KHAN TEHSIL,1,15536,5233,20769
DERA ISMAIL KHAN DISTRICT,DERA ISMAIL KHAN TEHSIL,2,16809,5188,21997
DERA ISMAIL KHAN DISTRICT,DERA ISMAIL KHAN TEHSIL,3,18408,5679,24087
DERA ISMAIL KHAN DISTRICT,DERA ISMAIL KHAN TEHSIL,4,18162,5112,23274
DERA ISMAIL KHAN DISTRICT,DERA ISMAIL KHAN TEHSIL,5,17996,5173,23169
DERA ISMAIL KHAN DISTRICT,DERA ISMAIL KHAN TEHSIL,6,16240,4978,21218
DERA ISMAIL KHAN DISTRICT,DERA ISMAIL KHAN TEHSIL,7,18337,5398,23735
DERA ISMAIL KHAN DISTRICT,DERA ISMAIL KHAN TEHSIL,8,16613,4839,21452
DERA ISMAIL KHAN DISTRICT,DERA ISMAIL KHAN TEHSIL,9,16306,5246,21552
DERA ISMAIL KHAN DISTRICT,DERA ISMAIL KHAN TEHSIL,10,14411,4378,18789
DERA ISMAIL KHAN DISTRICT,DERA ISMAIL KHAN TEHSIL,11,13586,5111,18697
DERA ISMAIL KHAN DISTRICT,DERA ISMAIL KHAN TEHSIL,12,12701,4394,17095
DERA ISMAIL KHAN DISTRICT,DERA ISMAIL KHAN TEHSIL,13,12385,4766,17151
DERA ISMAIL KHAN DISTRICT,DERA ISMAIL KHAN TEHSIL,14,11744,4542,16286
DERA ISMAIL KHAN DISTRICT,DERA ISMAIL KHAN TEHSIL,15,11537,4514,16051
DERA ISMAIL KHAN DISTRICT,DERA ISMAIL KHAN TEHSIL,16,10960,4436,15396
DERA ISMAIL KHAN DISTRICT,DERA ISMAIL KHAN TEHSIL,17,10767,4792,15559
DERA ISMAIL KHAN DISTRICT,DERA ISMAIL KHAN TEHSIL,18,10091,4253,14344
DERA ISMAIL KHAN DISTRICT,DERA ISMAIL KHAN TEHSIL,19,9894,4882,14776
DERA ISMAIL KHAN DISTRICT,DERA ISMAIL KHAN TEHSIL,20,9125,4053,13178
DERA ISMAIL KHAN DISTRICT,DERA ISMAIL KHAN TEHSIL,21,8797,4834,13631
DERA ISMAIL KHAN DISTRICT,DERA ISMAIL KHAN TEHSIL,22,7814,4213,12027
DERA ISMAIL KHAN DISTRICT,DERA ISMAIL KHAN TEHSIL,23,8169,4650,12819
DERA ISMAIL KHAN DISTRICT,DERA ISMAIL KHAN TEHSIL,24,7732,4187,11919
DERA ISMAIL KHAN DISTRICT,DERA ISMAIL KHAN TEHSIL,25,8348,3608,11956
DERA ISMAIL KHAN DISTRICT,DERA ISMAIL KHAN TEHSIL,26,8061,4067,12128
DERA ISMAIL KHAN DISTRICT,DERA ISMAIL KHAN TEHSIL,27,8423,4092,12515
DERA ISMAIL KHAN DISTRICT,DERA ISMAIL KHAN TEHSIL,28,7377,3946,11323
DERA ISMAIL KHAN DISTRICT,DERA ISMAIL KHAN TEHSIL,29,7628,3842,11470
DERA ISMAIL KHAN DISTRICT,DERA ISMAIL KHAN TEHSIL,30,7009,3542,10551
DERA ISMAIL KHAN DISTRICT,DERA ISMAIL KHAN TEHSIL,31,6675,3516,10191
DERA ISMAIL KHAN DISTRICT,DERA ISMAIL KHAN TEHSIL,32,6206,3392,9598
DERA ISMAIL KHAN DISTRICT,DERA ISMAIL KHAN TEHSIL,33,5422,3278,8700
DERA ISMAIL KHAN DISTRICT,DERA ISMAIL KHAN TEHSIL,34,5019,2975,7994
DERA ISMAIL KHAN DISTRICT,DERA ISMAIL KHAN TEHSIL,35,5233,2794,8027
DERA ISMAIL KHAN DISTRICT,DERA ISMAIL KHAN TEHSIL,36,4751,2645,7396
DERA ISMAIL KHAN DISTRICT,DERA ISMAIL KHAN TEHSIL,37,4867,2436,7303
DERA ISMAIL KHAN DISTRICT,DERA ISMAIL KHAN TEHSIL,38,4440,2785,7225
DERA ISMAIL KHAN DISTRICT,DERA ISMAIL KHAN TEHSIL,39,4420,2605,7025
DERA ISMAIL KHAN DISTRICT,DERA ISMAIL KHAN TEHSIL,40,4367,2536,6903
DERA ISMAIL KHAN DISTRICT,DERA ISMAIL KHAN TEHSIL,41,3993,2249,6242
DERA ISMAIL KHAN DISTRICT,DERA ISMAIL KHAN TEHSIL,42,3651,2073,5724
DERA ISMAIL KHAN DISTRICT,DERA ISMAIL KHAN TEHSIL,43,3572,2064,5636
DERA ISMAIL KHAN DISTRICT,DERA ISMAIL KHAN TEHSIL,44,3491,1873,5364
DERA ISMAIL KHAN DISTRICT,DERA ISMAIL KHAN TEHSIL,45,3353,1931,5284
DERA ISMAIL KHAN DISTRICT,DERA ISMAIL KHAN TEHSIL,46,3170,1757,4927
DERA ISMAIL KHAN DISTRICT,DERA ISMAIL KHAN TEHSIL,47,3393,1665,5058
DERA ISMAIL KHAN DISTRICT,DERA ISMAIL KHAN TEHSIL,48,3568,2030,5598
DERA ISMAIL KHAN DISTRICT,DERA ISMAIL KHAN TEHSIL,49,3377,1905,5282
DERA ISMAIL KHAN DISTRICT,DERA ISMAIL KHAN TEHSIL,50,3355,1826,5181
DERA ISMAIL KHAN DISTRICT,DERA ISMAIL KHAN TEHSIL,51,3127,1774,4901
DERA ISMAIL KHAN DISTRICT,DERA ISMAIL KHAN TEHSIL,52,2861,1687,4548
DERA ISMAIL KHAN DISTRICT,DERA ISMAIL KHAN TEHSIL,53,2784,1719,4503
DERA ISMAIL KHAN DISTRICT,DERA ISMAIL KHAN TEHSIL,54,2636,1576,4212
DERA ISMAIL KHAN DISTRICT,DERA ISMAIL KHAN TEHSIL,55,2424,1425,3849
DERA ISMAIL KHAN DISTRICT,DERA ISMAIL KHAN TEHSIL,56,2107,1458,3565
DERA ISMAIL KHAN DISTRICT,DERA ISMAIL KHAN TEHSIL,57,2089,1240,3329
DERA ISMAIL KHAN DISTRICT,DERA ISMAIL KHAN TEHSIL,58,2017,1267,3284
DERA ISMAIL KHAN DISTRICT,DERA ISMAIL KHAN TEHSIL,59,1940,1197,3137
DERA ISMAIL KHAN DISTRICT,DERA ISMAIL KHAN TEHSIL,60,1967,1120,3087
DERA ISMAIL KHAN DISTRICT,DERA ISMAIL KHAN TEHSIL,61,1995,1057,3052
DERA ISMAIL KHAN DISTRICT,DERA ISMAIL KHAN TEHSIL,62,2003,1131,3134
DERA ISMAIL KHAN DISTRICT,DERA ISMAIL KHAN TEHSIL,63,1708,1128,2836
DERA ISMAIL KHAN DISTRICT,DERA ISMAIL KHAN TEHSIL,64,1588,913,2501
DERA ISMAIL KHAN DISTRICT,DERA ISMAIL KHAN TEHSIL,65,1415,818,2233
DERA ISMAIL KHAN DISTRICT,DERA ISMAIL KHAN TEHSIL,66,1212,680,1892
DERA ISMAIL KHAN DISTRICT,DERA ISMAIL KHAN TEHSIL,67,1457,651,2108
DERA ISMAIL KHAN DISTRICT,DERA ISMAIL KHAN TEHSIL,68,1116,581,1697
DERA ISMAIL KHAN DISTRICT,DERA ISMAIL KHAN TEHSIL,69,1021,520,1541
DERA ISMAIL KHAN DISTRICT,DERA ISMAIL KHAN TEHSIL,70,922,493,1415
DERA ISMAIL KHAN DISTRICT,DERA ISMAIL KHAN TEHSIL,71,950,475,1425
DERA ISMAIL KHAN DISTRICT,DERA ISMAIL KHAN TEHSIL,72,880,490,1370
DERA ISMAIL KHAN DISTRICT,DERA ISMAIL KHAN TEHSIL,73,711,410,1121
DERA ISMAIL KHAN DISTRICT,DERA ISMAIL KHAN TEHSIL,74,528,323,851
DERA ISMAIL KHAN DISTRICT,DERA ISMAIL KHAN TEHSIL,>=75,4409,2355,6764
DERA ISMAIL KHAN DISTRICT,KULACHI TEHSIL,<1,2256,661,2917
DERA ISMAIL KHAN DISTRICT,KULACHI TEHSIL,1,1926,604,2530
DERA ISMAIL KHAN DISTRICT,KULACHI TEHSIL,2,2680,653,3333
DERA ISMAIL KHAN DISTRICT,KULACHI TEHSIL,3,2681,692,3373
DERA ISMAIL KHAN DISTRICT,KULACHI TEHSIL,4,2873,691,3564
DERA ISMAIL KHAN DISTRICT,KULACHI TEHSIL,5,2755,710,3465
DERA ISMAIL KHAN DISTRICT,KULACHI TEHSIL,6,2720,602,3322
DERA ISMAIL KHAN DISTRICT,KULACHI TEHSIL,7,2747,705,3452
DERA ISMAIL KHAN DISTRICT,KULACHI TEHSIL,8,2748,608,3356
DERA ISMAIL KHAN DISTRICT,KULACHI TEHSIL,9,2401,633,3034
DERA ISMAIL KHAN DISTRICT,KULACHI TEHSIL,10,2452,568,3020
DERA ISMAIL KHAN DISTRICT,KULACHI TEHSIL,11,1928,626,2554
DERA ISMAIL KHAN DISTRICT,KULACHI TEHSIL,12,1938,526,2464
DERA ISMAIL KHAN DISTRICT,KULACHI TEHSIL,13,1720,570,2290
DERA ISMAIL KHAN DISTRICT,KULACHI TEHSIL,14,1687,521,2208
DERA ISMAIL KHAN DISTRICT,KULACHI TEHSIL,15,1537,498,2035
DERA ISMAIL KHAN DISTRICT,KULACHI TEHSIL,16,1538,502,2040
DERA ISMAIL KHAN DISTRICT,KULACHI TEHSIL,17,1434,524,1958
DERA ISMAIL KHAN DISTRICT,KULACHI TEHSIL,18,1353,403,1756
DERA ISMAIL KHAN DISTRICT,KULACHI TEHSIL,19,1213,468,1681
DERA ISMAIL KHAN DISTRICT,KULACHI TEHSIL,20,1441,404,1845
DERA ISMAIL KHAN DISTRICT,KULACHI TEHSIL,21,1232,484,1716
DERA ISMAIL KHAN DISTRICT,KULACHI TEHSIL,22,1149,396,1545
DERA ISMAIL KHAN DISTRICT,KULACHI TEHSIL,23,1118,437,1555
DERA ISMAIL KHAN DISTRICT,KULACHI TEHSIL,24,1076,387,1463
DERA ISMAIL KHAN DISTRICT,KULACHI TEHSIL,25,1405,402,1807
DERA ISMAIL KHAN DISTRICT,KULACHI TEHSIL,26,1295,434,1729
DERA ISMAIL KHAN DISTRICT,KULACHI TEHSIL,27,1268,441,1709
DERA ISMAIL KHAN DISTRICT,KULACHI TEHSIL,28,1056,405,1461
DERA ISMAIL KHAN DISTRICT,KULACHI TEHSIL,29,1120,423,1543
DERA ISMAIL KHAN DISTRICT,KULACHI TEHSIL,30,1087,341,1428
DERA ISMAIL KHAN DISTRICT,KULACHI TEHSIL,31,1025,339,1364
DERA ISMAIL KHAN DISTRICT,KULACHI TEHSIL,32,952,387,1339
DERA ISMAIL KHAN DISTRICT,KULACHI TEHSIL,33,741,307,1048
DERA ISMAIL KHAN DISTRICT,KULACHI TEHSIL,34,699,313,1012
DERA ISMAIL KHAN DISTRICT,KULACHI TEHSIL,35,780,257,1037
DERA ISMAIL KHAN DISTRICT,KULACHI TEHSIL,36,674,248,922
DERA ISMAIL KHAN DISTRICT,KULACHI TEHSIL,37,734,250,984
DERA ISMAIL KHAN DISTRICT,KULACHI TEHSIL,38,696,278,974
DERA ISMAIL KHAN DISTRICT,KULACHI TEHSIL,39,697,254,951
DERA ISMAIL KHAN DISTRICT,KULACHI TEHSIL,40,669,215,884
DERA ISMAIL KHAN DISTRICT,KULACHI TEHSIL,41,666,250,916
DERA ISMAIL KHAN DISTRICT,KULACHI TEHSIL,42,692,251,943
DERA ISMAIL KHAN DISTRICT,KULACHI TEHSIL,43,533,235,768
DERA ISMAIL KHAN DISTRICT,KULACHI TEHSIL,44,544,217,761
DERA ISMAIL KHAN DISTRICT,KULACHI TEHSIL,45,501,191,692
DERA ISMAIL KHAN DISTRICT,KULACHI TEHSIL,46,567,221,788
DERA ISMAIL KHAN DISTRICT,KULACHI TEHSIL,47,677,220,897
DERA ISMAIL KHAN DISTRICT,KULACHI TEHSIL,48,493,228,721
DERA ISMAIL KHAN DISTRICT,KULACHI TEHSIL,49,587,249,836
DERA ISMAIL KHAN DISTRICT,KULACHI TEHSIL,50,508,177,685
DERA ISMAIL KHAN DISTRICT,KULACHI TEHSIL,51,566,251,817
DERA ISMAIL KHAN DISTRICT,KULACHI TEHSIL,52,527,232,759
DERA ISMAIL KHAN DISTRICT,KULACHI TEHSIL,53,399,171,570
DERA ISMAIL KHAN DISTRICT,KULACHI TEHSIL,54,434,202,636
DERA ISMAIL KHAN DISTRICT,KULACHI TEHSIL,55,370,140,510
DERA ISMAIL KHAN DISTRICT,KULACHI TEHSIL,56,425,158,583
DERA ISMAIL KHAN DISTRICT,KULACHI TEHSIL,57,453,178,631
DERA ISMAIL KHAN DISTRICT,KULACHI TEHSIL,58,342,125,467
DERA ISMAIL KHAN DISTRICT,KULACHI TEHSIL,59,373,147,520
DERA ISMAIL KHAN DISTRICT,KULACHI TEHSIL,60,306,113,419
DERA ISMAIL KHAN DISTRICT,KULACHI TEHSIL,61,321,155,476
DERA ISMAIL KHAN DISTRICT,KULACHI TEHSIL,62,330,153,483
DERA ISMAIL KHAN DISTRICT,KULACHI TEHSIL,63,268,121,389
DERA ISMAIL KHAN DISTRICT,KULACHI TEHSIL,64,276,138,414
DERA ISMAIL KHAN DISTRICT,KULACHI TEHSIL,65,221,70,291
DERA ISMAIL KHAN DISTRICT,KULACHI TEHSIL,66,238,118,356
DERA ISMAIL KHAN DISTRICT,KULACHI TEHSIL,67,269,135,404
DERA ISMAIL KHAN DISTRICT,KULACHI TEHSIL,68,198,77,275
DERA ISMAIL KHAN DISTRICT,KULACHI TEHSIL,69,184,65,249
DERA ISMAIL KHAN DISTRICT,KULACHI TEHSIL,70,152,58,210
DERA ISMAIL KHAN DISTRICT,KULACHI TEHSIL,71,178,56,234
DERA ISMAIL KHAN DISTRICT,KULACHI TEHSIL,72,144,82,226
DERA ISMAIL KHAN DISTRICT,KULACHI TEHSIL,73,104,64,168
DERA ISMAIL KHAN DISTRICT,KULACHI TEHSIL,74,99,40,139
DERA ISMAIL KHAN DISTRICT,KULACHI TEHSIL,>=75,693,298,991
DERA ISMAIL KHAN DISTRICT,PAHARPUR TEHSIL,<1,8051,2219,10270
DERA ISMAIL KHAN DISTRICT,PAHARPUR TEHSIL,1,8954,2131,11085
DERA ISMAIL KHAN DISTRICT,PAHARPUR TEHSIL,2,9789,2369,12158
DERA ISMAIL KHAN DISTRICT,PAHARPUR TEHSIL,3,10419,2501,12920
DERA ISMAIL KHAN DISTRICT,PAHARPUR TEHSIL,4,10529,2607,13136
DERA ISMAIL KHAN DISTRICT,PAHARPUR TEHSIL,5,10360,2531,12891
DERA ISMAIL KHAN DISTRICT,PAHARPUR TEHSIL,6,9687,2257,11944
DERA ISMAIL KHAN DISTRICT,PAHARPUR TEHSIL,7,10551,2569,13120
DERA ISMAIL KHAN DISTRICT,PAHARPUR TEHSIL,8,9778,2367,12145
DERA ISMAIL KHAN DISTRICT,PAHARPUR TEHSIL,9,9696,2324,12020
DERA ISMAIL KHAN DISTRICT,PAHARPUR TEHSIL,10,8492,2131,10623
DERA ISMAIL KHAN DISTRICT,PAHARPUR TEHSIL,11,8005,2066,10071
DERA ISMAIL KHAN DISTRICT,PAHARPUR TEHSIL,12,7353,1814,9167
DERA ISMAIL KHAN DISTRICT,PAHARPUR TEHSIL,13,7308,1904,9212
DERA ISMAIL KHAN DISTRICT,PAHARPUR TEHSIL,14,7189,1868,9057
DERA ISMAIL KHAN DISTRICT,PAHARPUR TEHSIL,15,7044,1762,8806
DERA ISMAIL KHAN DISTRICT,PAHARPUR TEHSIL,16,6306,1709,8015
DERA ISMAIL KHAN DISTRICT,PAHARPUR TEHSIL,17,6567,1749,8316
DERA ISMAIL KHAN DISTRICT,PAHARPUR TEHSIL,18,5335,1385,6720
DERA ISMAIL KHAN DISTRICT,PAHARPUR TEHSIL,19,5600,1553,7153
DERA ISMAIL KHAN DISTRICT,PAHARPUR TEHSIL,20,5044,1303,6347
DERA ISMAIL KHAN DISTRICT,PAHARPUR TEHSIL,21,5134,1382,6516
DERA ISMAIL KHAN DISTRICT,PAHARPUR TEHSIL,22,4599,1200,5799
DERA ISMAIL KHAN DISTRICT,PAHARPUR TEHSIL,23,4947,1338,6285
DERA ISMAIL KHAN DISTRICT,PAHARPUR TEHSIL,24,4778,1318,6096
DERA ISMAIL KHAN DISTRICT,PAHARPUR TEHSIL,25,4673,1239,5912
DERA ISMAIL KHAN DISTRICT,PAHARPUR TEHSIL,26,4850,1279,6129
DERA ISMAIL KHAN DISTRICT,PAHARPUR TEHSIL,27,5175,1333,6508
DERA ISMAIL KHAN DISTRICT,PAHARPUR TEHSIL,28,4208,1110,5318
DERA ISMAIL KHAN DISTRICT,PAHARPUR TEHSIL,29,4887,1252,6139
DERA ISMAIL KHAN DISTRICT,PAHARPUR TEHSIL,30,3562,853,4415
DERA ISMAIL KHAN DISTRICT,PAHARPUR TEHSIL,31,4226,1131,5357
DERA ISMAIL KHAN DISTRICT,PAHARPUR TEHSIL,32,3618,971,4589
DERA ISMAIL KHAN DISTRICT,PAHARPUR TEHSIL,33,3409,877,4286
DERA ISMAIL KHAN DISTRICT,PAHARPUR TEHSIL,34,3210,904,4114
DERA ISMAIL KHAN DISTRICT,PAHARPUR TEHSIL,35,2668,642,3310
DERA ISMAIL KHAN DISTRICT,PAHARPUR TEHSIL,36,3028,849,3877
DERA ISMAIL KHAN DISTRICT,PAHARPUR TEHSIL,37,3333,849,4182
DERA ISMAIL KHAN DISTRICT,PAHARPUR TEHSIL,38,2388,673,3061
DERA ISMAIL KHAN DISTRICT,PAHARPUR TEHSIL,39,2876,757,3633
DERA ISMAIL KHAN DISTRICT,PAHARPUR TEHSIL,40,2046,488,2534
DERA ISMAIL KHAN DISTRICT,PAHARPUR TEHSIL,41,2503,671,3174
DERA ISMAIL KHAN DISTRICT,PAHARPUR TEHSIL,42,2524,631,3155
DERA ISMAIL KHAN DISTRICT,PAHARPUR TEHSIL,43,2158,585,2743
DERA ISMAIL KHAN DISTRICT,PAHARPUR TEHSIL,44,2260,615,2875
DERA ISMAIL KHAN DISTRICT,PAHARPUR TEHSIL,45,1696,372,2068
DERA ISMAIL KHAN DISTRICT,PAHARPUR TEHSIL,46,2212,603,2815
DERA ISMAIL KHAN DISTRICT,PAHARPUR TEHSIL,47,2334,599,2933
DERA ISMAIL KHAN DISTRICT,PAHARPUR TEHSIL,48,2193,566,2759
DERA ISMAIL KHAN DISTRICT,PAHARPUR TEHSIL,49,2266,595,2861
DERA ISMAIL KHAN DISTRICT,PAHARPUR TEHSIL,50,1811,432,2243
DERA ISMAIL KHAN DISTRICT,PAHARPUR TEHSIL,51,2142,626,2768
DERA ISMAIL KHAN DISTRICT,PAHARPUR TEHSIL,52,2297,538,2835
DERA ISMAIL KHAN DISTRICT,PAHARPUR TEHSIL,53,1855,465,2320
DERA ISMAIL KHAN DISTRICT,PAHARPUR TEHSIL,54,1740,466,2206
DERA ISMAIL KHAN DISTRICT,PAHARPUR TEHSIL,55,1365,338,1703
DERA ISMAIL KHAN DISTRICT,PAHARPUR TEHSIL,56,1463,427,1890
DERA ISMAIL KHAN DISTRICT,PAHARPUR TEHSIL,57,1377,393,1770
DERA ISMAIL KHAN DISTRICT,PAHARPUR TEHSIL,58,1204,349,1553
DERA ISMAIL KHAN DISTRICT,PAHARPUR TEHSIL,59,1218,340,1558
DERA ISMAIL KHAN DISTRICT,PAHARPUR TEHSIL,60,1129,235,1364
DERA ISMAIL KHAN DISTRICT,PAHARPUR TEHSIL,61,1383,398,1781
DERA ISMAIL KHAN DISTRICT,PAHARPUR TEHSIL,62,1472,363,1835
DERA ISMAIL KHAN DISTRICT,PAHARPUR TEHSIL,63,1161,346,1507
DERA ISMAIL KHAN DISTRICT,PAHARPUR TEHSIL,64,1200,308,1508
DERA ISMAIL KHAN DISTRICT,PAHARPUR TEHSIL,65,818,213,1031
DERA ISMAIL KHAN DISTRICT,PAHARPUR TEHSIL,66,1074,312,1386
DERA ISMAIL KHAN DISTRICT,PAHARPUR TEHSIL,67,1170,254,1424
DERA ISMAIL KHAN DISTRICT,PAHARPUR TEHSIL,68,837,230,1067
DERA ISMAIL KHAN DISTRICT,PAHARPUR TEHSIL,69,721,188,909
DERA ISMAIL KHAN DISTRICT,PAHARPUR TEHSIL,70,557,109,666
DERA ISMAIL KHAN DISTRICT,PAHARPUR TEHSIL,71,711,223,934
DERA ISMAIL KHAN DISTRICT,PAHARPUR TEHSIL,72,751,151,902
DERA ISMAIL KHAN DISTRICT,PAHARPUR TEHSIL,73,487,161,648
DERA ISMAIL KHAN DISTRICT,PAHARPUR TEHSIL,74,424,100,524
DERA ISMAIL KHAN DISTRICT,PAHARPUR TEHSIL,>=75,3335,800,4135
DERA ISMAIL KHAN DISTRICT,PAROA TEHSIL,<1,7456,1213,8669
DERA ISMAIL KHAN DISTRICT,PAROA TEHSIL,1,8093,1066,9159
DERA ISMAIL KHAN DISTRICT,PAROA TEHSIL,2,9261,1289,10550
DERA ISMAIL KHAN DISTRICT,PAROA TEHSIL,3,9564,1382,10946
DERA ISMAIL KHAN DISTRICT,PAROA TEHSIL,4,9834,1381,11215
DERA ISMAIL KHAN DISTRICT,PAROA TEHSIL,5,9344,1437,10781
DERA ISMAIL KHAN DISTRICT,PAROA TEHSIL,6,8737,1251,9988
DERA ISMAIL KHAN DISTRICT,PAROA TEHSIL,7,9577,1402,10979
DERA ISMAIL KHAN DISTRICT,PAROA TEHSIL,8,8960,1293,10253
DERA ISMAIL KHAN DISTRICT,PAROA TEHSIL,9,8334,1353,9687
DERA ISMAIL KHAN DISTRICT,PAROA TEHSIL,10,7784,1153,8937
DERA ISMAIL KHAN DISTRICT,PAROA TEHSIL,11,6652,1082,7734
DERA ISMAIL KHAN DISTRICT,PAROA TEHSIL,12,6522,965,7487
DERA ISMAIL KHAN DISTRICT,PAROA TEHSIL,13,5707,979,6686
DERA ISMAIL KHAN DISTRICT,PAROA TEHSIL,14,5557,953,6510
DERA ISMAIL KHAN DISTRICT,PAROA TEHSIL,15,5048,896,5944
DERA ISMAIL KHAN DISTRICT,PAROA TEHSIL,16,4925,953,5878
DERA ISMAIL KHAN DISTRICT,PAROA TEHSIL,17,4549,945,5494
DERA ISMAIL KHAN DISTRICT,PAROA TEHSIL,18,4671,775,5446
DERA ISMAIL KHAN DISTRICT,PAROA TEHSIL,19,4428,698,5126
DERA ISMAIL KHAN DISTRICT,PAROA TEHSIL,20,4824,671,5495
DERA ISMAIL KHAN DISTRICT,PAROA TEHSIL,21,4233,649,4882
DERA ISMAIL KHAN DISTRICT,PAROA TEHSIL,22,3853,560,4413
DERA ISMAIL KHAN DISTRICT,PAROA TEHSIL,23,3870,619,4489
DERA ISMAIL KHAN DISTRICT,PAROA TEHSIL,24,3714,621,4335
DERA ISMAIL KHAN DISTRICT,PAROA TEHSIL,25,3947,569,4516
DERA ISMAIL KHAN DISTRICT,PAROA TEHSIL,26,3772,676,4448
DERA ISMAIL KHAN DISTRICT,PAROA TEHSIL,27,3903,649,4552
DERA ISMAIL KHAN DISTRICT,PAROA TEHSIL,28,3584,542,4126
DERA ISMAIL KHAN DISTRICT,PAROA TEHSIL,29,3664,583,4247
DERA ISMAIL KHAN DISTRICT,PAROA TEHSIL,30,3307,466,3773
DERA ISMAIL KHAN DISTRICT,PAROA TEHSIL,31,3294,615,3909
DERA ISMAIL KHAN DISTRICT,PAROA TEHSIL,32,2900,469,3369
DERA ISMAIL KHAN DISTRICT,PAROA TEHSIL,33,2588,414,3002
DERA ISMAIL KHAN DISTRICT,PAROA TEHSIL,34,2404,476,2880
DERA ISMAIL KHAN DISTRICT,PAROA TEHSIL,35,2514,318,2832
DERA ISMAIL KHAN DISTRICT,PAROA TEHSIL,36,2485,497,2982
DERA ISMAIL KHAN DISTRICT,PAROA TEHSIL,37,2528,356,2884
DERA ISMAIL KHAN DISTRICT,PAROA TEHSIL,38,2105,392,2497
DERA ISMAIL KHAN DISTRICT,PAROA TEHSIL,39,2113,388,2501
DERA ISMAIL KHAN DISTRICT,PAROA TEHSIL,40,2198,277,2475
DERA ISMAIL KHAN DISTRICT,PAROA TEHSIL,41,2039,385,2424
DERA ISMAIL KHAN DISTRICT,PAROA TEHSIL,42,1908,291,2199
DERA ISMAIL KHAN DISTRICT,PAROA TEHSIL,43,1762,297,2059
DERA ISMAIL KHAN DISTRICT,PAROA TEHSIL,44,1696,314,2010
DERA ISMAIL KHAN DISTRICT,PAROA TEHSIL,45,1560,237,1797
DERA ISMAIL KHAN DISTRICT,PAROA TEHSIL,46,1691,368,2059
DERA ISMAIL KHAN DISTRICT,PAROA TEHSIL,47,1771,276,2047
DERA ISMAIL KHAN DISTRICT,PAROA TEHSIL,48,1692,314,2006
DERA ISMAIL KHAN DISTRICT,PAROA TEHSIL,49,1683,285,1968
DERA ISMAIL KHAN DISTRICT,PAROA TEHSIL,50,1494,230,1724
DERA ISMAIL KHAN DISTRICT,PAROA TEHSIL,51,1500,287,1787
DERA ISMAIL KHAN DISTRICT,PAROA TEHSIL,52,1401,202,1603
DERA ISMAIL KHAN DISTRICT,PAROA TEHSIL,53,1212,232,1444
DERA ISMAIL KHAN DISTRICT,PAROA TEHSIL,54,1192,224,1416
DERA ISMAIL KHAN DISTRICT,PAROA TEHSIL,55,1060,168,1228
DERA ISMAIL KHAN DISTRICT,PAROA TEHSIL,56,1092,156,1248
DERA ISMAIL KHAN DISTRICT,PAROA TEHSIL,57,964,125,1089
DERA ISMAIL KHAN DISTRICT,PAROA TEHSIL,58,831,137,968
DERA ISMAIL KHAN DISTRICT,PAROA TEHSIL,59,908,125,1033
DERA ISMAIL KHAN DISTRICT,PAROA TEHSIL,60,912,132,1044
DERA ISMAIL KHAN DISTRICT,PAROA TEHSIL,61,971,164,1135
DERA ISMAIL KHAN DISTRICT,PAROA TEHSIL,62,880,126,1006
DERA ISMAIL KHAN DISTRICT,PAROA TEHSIL,63,829,161,990
DERA ISMAIL KHAN DISTRICT,PAROA TEHSIL,64,789,113,902
DERA ISMAIL KHAN DISTRICT,PAROA TEHSIL,65,641,106,747
DERA ISMAIL KHAN DISTRICT,PAROA TEHSIL,66,809,139,948
DERA ISMAIL KHAN DISTRICT,PAROA TEHSIL,67,765,113,878
DERA ISMAIL KHAN DISTRICT,PAROA TEHSIL,68,531,99,630
DERA ISMAIL KHAN DISTRICT,PAROA TEHSIL,69,520,84,604
DERA ISMAIL KHAN DISTRICT,PAROA TEHSIL,70,496,65,561
DERA ISMAIL KHAN DISTRICT,PAROA TEHSIL,71,581,88,669
DERA ISMAIL KHAN DISTRICT,PAROA TEHSIL,72,484,77,561
DERA ISMAIL KHAN DISTRICT,PAROA TEHSIL,73,318,64,382
DERA ISMAIL KHAN DISTRICT,PAROA TEHSIL,74,286,37,323
DERA ISMAIL KHAN DISTRICT,PAROA TEHSIL,>=75,2391,387,2778
FAISALABAD DISTRICT,CHAK JHUMRA TEHSIL,<1,6704,1165,7869
FAISALABAD DISTRICT,CHAK JHUMRA TEHSIL,1,6711,1073,7784
FAISALABAD DISTRICT,CHAK JHUMRA TEHSIL,2,7011,1173,8184
FAISALABAD DISTRICT,CHAK JHUMRA TEHSIL,3,7574,1180,8754
FAISALABAD DISTRICT,CHAK JHUMRA TEHSIL,4,7480,1167,8647
FAISALABAD DISTRICT,CHAK JHUMRA TEHSIL,5,7296,1174,8470
FAISALABAD DISTRICT,CHAK JHUMRA TEHSIL,6,7304,1128,8432
FAISALABAD DISTRICT,CHAK JHUMRA TEHSIL,7,7464,1201,8665
FAISALABAD DISTRICT,CHAK JHUMRA TEHSIL,8,7182,1090,8272
FAISALABAD DISTRICT,CHAK JHUMRA TEHSIL,9,7318,1165,8483
FAISALABAD DISTRICT,CHAK JHUMRA TEHSIL,10,6678,1068,7746
FAISALABAD DISTRICT,CHAK JHUMRA TEHSIL,11,6886,1115,8001
FAISALABAD DISTRICT,CHAK JHUMRA TEHSIL,12,6252,990,7242
FAISALABAD DISTRICT,CHAK JHUMRA TEHSIL,13,6456,1034,7490
FAISALABAD DISTRICT,CHAK JHUMRA TEHSIL,14,6239,1014,7253
FAISALABAD DISTRICT,CHAK JHUMRA TEHSIL,15,6105,1042,7147
FAISALABAD DISTRICT,CHAK JHUMRA TEHSIL,16,6169,1058,7227
FAISALABAD DISTRICT,CHAK JHUMRA TEHSIL,17,6421,1068,7489
FAISALABAD DISTRICT,CHAK JHUMRA TEHSIL,18,5629,881,6510
FAISALABAD DISTRICT,CHAK JHUMRA TEHSIL,19,6022,1072,7094
FAISALABAD DISTRICT,CHAK JHUMRA TEHSIL,20,5179,910,6089
FAISALABAD DISTRICT,CHAK JHUMRA TEHSIL,21,5656,1084,6740
FAISALABAD DISTRICT,CHAK JHUMRA TEHSIL,22,5185,917,6102
FAISALABAD DISTRICT,CHAK JHUMRA TEHSIL,23,5035,986,6021
FAISALABAD DISTRICT,CHAK JHUMRA TEHSIL,24,4848,970,5818
FAISALABAD DISTRICT,CHAK JHUMRA TEHSIL,25,4531,768,5299
FAISALABAD DISTRICT,CHAK JHUMRA TEHSIL,26,4470,954,5424
FAISALABAD DISTRICT,CHAK JHUMRA TEHSIL,27,4427,940,5367
FAISALABAD DISTRICT,CHAK JHUMRA TEHSIL,28,3991,760,4751
FAISALABAD DISTRICT,CHAK JHUMRA TEHSIL,29,4393,838,5231
FAISALABAD DISTRICT,CHAK JHUMRA TEHSIL,30,4180,726,4906
FAISALABAD DISTRICT,CHAK JHUMRA TEHSIL,31,3847,786,4633
FAISALABAD DISTRICT,CHAK JHUMRA TEHSIL,32,3686,726,4412
FAISALABAD DISTRICT,CHAK JHUMRA TEHSIL,33,3536,730,4266
FAISALABAD DISTRICT,CHAK JHUMRA TEHSIL,34,3506,711,4217
FAISALABAD DISTRICT,CHAK JHUMRA TEHSIL,35,3384,555,3939
FAISALABAD DISTRICT,CHAK JHUMRA TEHSIL,36,3339,655,3994
FAISALABAD DISTRICT,CHAK JHUMRA TEHSIL,37,3513,610,4123
FAISALABAD DISTRICT,CHAK JHUMRA TEHSIL,38,3058,577,3635
FAISALABAD DISTRICT,CHAK JHUMRA TEHSIL,39,3215,563,3778
FAISALABAD DISTRICT,CHAK JHUMRA TEHSIL,40,2693,474,3167
FAISALABAD DISTRICT,CHAK JHUMRA TEHSIL,41,2976,546,3522
FAISALABAD DISTRICT,CHAK JHUMRA TEHSIL,42,2820,515,3335
FAISALABAD DISTRICT,CHAK JHUMRA TEHSIL,43,2373,490,2863
FAISALABAD DISTRICT,CHAK JHUMRA TEHSIL,44,2394,473,2867
FAISALABAD DISTRICT,CHAK JHUMRA TEHSIL,45,2138,340,2478
FAISALABAD DISTRICT,CHAK JHUMRA TEHSIL,46,2261,443,2704
FAISALABAD DISTRICT,CHAK JHUMRA TEHSIL,47,2570,440,3010
FAISALABAD DISTRICT,CHAK JHUMRA TEHSIL,48,2278,471,2749
FAISALABAD DISTRICT,CHAK JHUMRA TEHSIL,49,2479,469,2948
FAISALABAD DISTRICT,CHAK JHUMRA TEHSIL,50,2268,347,2615
FAISALABAD DISTRICT,CHAK JHUMRA TEHSIL,51,2505,453,2958
FAISALABAD DISTRICT,CHAK JHUMRA TEHSIL,52,2449,442,2891
FAISALABAD DISTRICT,CHAK JHUMRA TEHSIL,53,2246,351,2597
FAISALABAD DISTRICT,CHAK JHUMRA TEHSIL,54,2162,401,2563
FAISALABAD DISTRICT,CHAK JHUMRA TEHSIL,55,1706,311,2017
FAISALABAD DISTRICT,CHAK JHUMRA TEHSIL,56,1661,286,1947
FAISALABAD DISTRICT,CHAK JHUMRA TEHSIL,57,1660,315,1975
FAISALABAD DISTRICT,CHAK JHUMRA TEHSIL,58,1382,267,1649
FAISALABAD DISTRICT,CHAK JHUMRA TEHSIL,59,1582,253,1835
FAISALABAD DISTRICT,CHAK JHUMRA TEHSIL,60,1478,200,1678
FAISALABAD DISTRICT,CHAK JHUMRA TEHSIL,61,1650,296,1946
FAISALABAD DISTRICT,CHAK JHUMRA TEHSIL,62,1496,243,1739
FAISALABAD DISTRICT,CHAK JHUMRA TEHSIL,63,1370,225,1595
FAISALABAD DISTRICT,CHAK JHUMRA TEHSIL,64,1175,221,1396
FAISALABAD DISTRICT,CHAK JHUMRA TEHSIL,65,1137,159,1296
FAISALABAD DISTRICT,CHAK JHUMRA TEHSIL,66,1145,137,1282
FAISALABAD DISTRICT,CHAK JHUMRA TEHSIL,67,1062,153,1215
FAISALABAD DISTRICT,CHAK JHUMRA TEHSIL,68,867,118,985
FAISALABAD DISTRICT,CHAK JHUMRA TEHSIL,69,893,105,998
FAISALABAD DISTRICT,CHAK JHUMRA TEHSIL,70,953,122,1075
FAISALABAD DISTRICT,CHAK JHUMRA TEHSIL,71,968,138,1106
FAISALABAD DISTRICT,CHAK JHUMRA TEHSIL,72,850,113,963
FAISALABAD DISTRICT,CHAK JHUMRA TEHSIL,73,695,90,785
FAISALABAD DISTRICT,CHAK JHUMRA TEHSIL,74,587,86,673
FAISALABAD DISTRICT,CHAK JHUMRA TEHSIL,>=75,5361,679,6040
FAISALABAD DISTRICT,FAISALABAD CITY TEHSIL,<1,924,72578,73502
FAISALABAD DISTRICT,FAISALABAD CITY TEHSIL,1,959,76763,77722
FAISALABAD DISTRICT,FAISALABAD CITY TEHSIL,2,877,72925,73802
FAISALABAD DISTRICT,FAISALABAD CITY TEHSIL,3,1006,77992,78998
FAISALABAD DISTRICT,FAISALABAD CITY TEHSIL,4,989,73251,74240
FAISALABAD DISTRICT,FAISALABAD CITY TEHSIL,5,966,73735,74701
FAISALABAD DISTRICT,FAISALABAD CITY TEHSIL,6,1030,72095,73125
FAISALABAD DISTRICT,FAISALABAD CITY TEHSIL,7,998,77808,78806
FAISALABAD DISTRICT,FAISALABAD CITY TEHSIL,8,957,68258,69215
FAISALABAD DISTRICT,FAISALABAD CITY TEHSIL,9,934,77805,78739
FAISALABAD DISTRICT,FAISALABAD CITY TEHSIL,10,850,64704,65554
FAISALABAD DISTRICT,FAISALABAD CITY TEHSIL,11,851,77508,78359
FAISALABAD DISTRICT,FAISALABAD CITY TEHSIL,12,798,63449,64247
FAISALABAD DISTRICT,FAISALABAD CITY TEHSIL,13,746,69739,70485
FAISALABAD DISTRICT,FAISALABAD CITY TEHSIL,14,709,63686,64395
FAISALABAD DISTRICT,FAISALABAD CITY TEHSIL,15,642,64553,65195
FAISALABAD DISTRICT,FAISALABAD CITY TEHSIL,16,653,66410,67063
FAISALABAD DISTRICT,FAISALABAD CITY TEHSIL,17,716,68431,69147
FAISALABAD DISTRICT,FAISALABAD CITY TEHSIL,18,645,60689,61334
FAISALABAD DISTRICT,FAISALABAD CITY TEHSIL,19,682,71049,71731
FAISALABAD DISTRICT,FAISALABAD CITY TEHSIL,20,592,61192,61784
FAISALABAD DISTRICT,FAISALABAD CITY TEHSIL,21,645,74386,75031
FAISALABAD DISTRICT,FAISALABAD CITY TEHSIL,22,616,66362,66978
FAISALABAD DISTRICT,FAISALABAD CITY TEHSIL,23,625,68286,68911
FAISALABAD DISTRICT,FAISALABAD CITY TEHSIL,24,597,66916,67513
FAISALABAD DISTRICT,FAISALABAD CITY TEHSIL,25,543,51327,51870
FAISALABAD DISTRICT,FAISALABAD CITY TEHSIL,26,544,62307,62851
FAISALABAD DISTRICT,FAISALABAD CITY TEHSIL,27,534,58614,59148
FAISALABAD DISTRICT,FAISALABAD CITY TEHSIL,28,563,56405,56968
FAISALABAD DISTRICT,FAISALABAD CITY TEHSIL,29,606,56576,57182
FAISALABAD DISTRICT,FAISALABAD CITY TEHSIL,30,492,49261,49753
FAISALABAD DISTRICT,FAISALABAD CITY TEHSIL,31,525,54625,55150
FAISALABAD DISTRICT,FAISALABAD CITY TEHSIL,32,524,51597,52121
FAISALABAD DISTRICT,FAISALABAD CITY TEHSIL,33,510,51168,51678
FAISALABAD DISTRICT,FAISALABAD CITY TEHSIL,34,452,48320,48772
FAISALABAD DISTRICT,FAISALABAD CITY TEHSIL,35,384,39808,40192
FAISALABAD DISTRICT,FAISALABAD CITY TEHSIL,36,428,44107,44535
FAISALABAD DISTRICT,FAISALABAD CITY TEHSIL,37,513,40415,40928
FAISALABAD DISTRICT,FAISALABAD CITY TEHSIL,38,395,43986,44381
FAISALABAD DISTRICT,FAISALABAD CITY TEHSIL,39,442,40835,41277
FAISALABAD DISTRICT,FAISALABAD CITY TEHSIL,40,274,36431,36705
FAISALABAD DISTRICT,FAISALABAD CITY TEHSIL,41,364,37791,38155
FAISALABAD DISTRICT,FAISALABAD CITY TEHSIL,42,361,33899,34260
FAISALABAD DISTRICT,FAISALABAD CITY TEHSIL,43,273,33440,33713
FAISALABAD DISTRICT,FAISALABAD CITY TEHSIL,44,255,31618,31873
FAISALABAD DISTRICT,FAISALABAD CITY TEHSIL,45,223,26563,26786
FAISALABAD DISTRICT,FAISALABAD CITY TEHSIL,46,263,28412,28675
FAISALABAD DISTRICT,FAISALABAD CITY TEHSIL,47,314,26260,26574
FAISALABAD DISTRICT,FAISALABAD CITY TEHSIL,48,237,29282,29519
FAISALABAD DISTRICT,FAISALABAD CITY TEHSIL,49,263,28863,29126
FAISALABAD DISTRICT,FAISALABAD CITY TEHSIL,50,173,25248,25421
FAISALABAD DISTRICT,FAISALABAD CITY TEHSIL,51,269,27741,28010
FAISALABAD DISTRICT,FAISALABAD CITY TEHSIL,52,253,26133,26386
FAISALABAD DISTRICT,FAISALABAD CITY TEHSIL,53,205,25697,25902
FAISALABAD DISTRICT,FAISALABAD CITY TEHSIL,54,194,24015,24209
FAISALABAD DISTRICT,FAISALABAD CITY TEHSIL,55,146,19309,19455
FAISALABAD DISTRICT,FAISALABAD CITY TEHSIL,56,170,20097,20267
FAISALABAD DISTRICT,FAISALABAD CITY TEHSIL,57,186,16386,16572
FAISALABAD DISTRICT,FAISALABAD CITY TEHSIL,58,158,17376,17534
FAISALABAD DISTRICT,FAISALABAD CITY TEHSIL,59,164,16641,16805
FAISALABAD DISTRICT,FAISALABAD CITY TEHSIL,60,124,14125,14249
FAISALABAD DISTRICT,FAISALABAD CITY TEHSIL,61,162,15677,15839
FAISALABAD DISTRICT,FAISALABAD CITY TEHSIL,62,133,14598,14731
FAISALABAD DISTRICT,FAISALABAD CITY TEHSIL,63,119,14015,14134
FAISALABAD DISTRICT,FAISALABAD CITY TEHSIL,64,104,11984,12088
FAISALABAD DISTRICT,FAISALABAD CITY TEHSIL,65,103,9351,9454
FAISALABAD DISTRICT,FAISALABAD CITY TEHSIL,66,119,8717,8836
FAISALABAD DISTRICT,FAISALABAD CITY TEHSIL,67,110,7509,7619
FAISALABAD DISTRICT,FAISALABAD CITY TEHSIL,68,89,7749,7838
FAISALABAD DISTRICT,FAISALABAD CITY TEHSIL,69,93,7311,7404
FAISALABAD DISTRICT,FAISALABAD CITY TEHSIL,70,62,6612,6674
FAISALABAD DISTRICT,FAISALABAD CITY TEHSIL,71,94,7208,7302
FAISALABAD DISTRICT,FAISALABAD CITY TEHSIL,72,76,6640,6716
FAISALABAD DISTRICT,FAISALABAD CITY TEHSIL,73,61,6176,6237
FAISALABAD DISTRICT,FAISALABAD CITY TEHSIL,74,39,4914,4953
FAISALABAD DISTRICT,FAISALABAD CITY TEHSIL,>=75,406,36449,36855
FAISALABAD DISTRICT,FAISALABAD SADAR TEHSIL,<1,35128,966,36094
FAISALABAD DISTRICT,FAISALABAD SADAR TEHSIL,1,36011,964,36975
FAISALABAD DISTRICT,FAISALABAD SADAR TEHSIL,2,34631,984,35615
FAISALABAD DISTRICT,FAISALABAD SADAR TEHSIL,3,37327,1052,38379
FAISALABAD DISTRICT,FAISALABAD SADAR TEHSIL,4,36653,1065,37718
FAISALABAD DISTRICT,FAISALABAD SADAR TEHSIL,5,36247,1015,37262
FAISALABAD DISTRICT,FAISALABAD SADAR TEHSIL,6,35184,1010,36194
FAISALABAD DISTRICT,FAISALABAD SADAR TEHSIL,7,37907,1042,38949
FAISALABAD DISTRICT,FAISALABAD SADAR TEHSIL,8,34446,966,35412
FAISALABAD DISTRICT,FAISALABAD SADAR TEHSIL,9,36885,1001,37886
FAISALABAD DISTRICT,FAISALABAD SADAR TEHSIL,10,32088,896,32984
FAISALABAD DISTRICT,FAISALABAD SADAR TEHSIL,11,35079,957,36036
FAISALABAD DISTRICT,FAISALABAD SADAR TEHSIL,12,30272,859,31131
FAISALABAD DISTRICT,FAISALABAD SADAR TEHSIL,13,31638,914,32552
FAISALABAD DISTRICT,FAISALABAD SADAR TEHSIL,14,29682,836,30518
FAISALABAD DISTRICT,FAISALABAD SADAR TEHSIL,15,30026,830,30856
FAISALABAD DISTRICT,FAISALABAD SADAR TEHSIL,16,30115,840,30955
FAISALABAD DISTRICT,FAISALABAD SADAR TEHSIL,17,30089,951,31040
FAISALABAD DISTRICT,FAISALABAD SADAR TEHSIL,18,27253,779,28032
FAISALABAD DISTRICT,FAISALABAD SADAR TEHSIL,19,30139,902,31041
FAISALABAD DISTRICT,FAISALABAD SADAR TEHSIL,20,26515,710,27225
FAISALABAD DISTRICT,FAISALABAD SADAR TEHSIL,21,30018,840,30858
FAISALABAD DISTRICT,FAISALABAD SADAR TEHSIL,22,26909,740,27649
FAISALABAD DISTRICT,FAISALABAD SADAR TEHSIL,23,26586,781,27367
FAISALABAD DISTRICT,FAISALABAD SADAR TEHSIL,24,26191,754,26945
FAISALABAD DISTRICT,FAISALABAD SADAR TEHSIL,25,21933,583,22516
FAISALABAD DISTRICT,FAISALABAD SADAR TEHSIL,26,24728,702,25430
FAISALABAD DISTRICT,FAISALABAD SADAR TEHSIL,27,24420,711,25131
FAISALABAD DISTRICT,FAISALABAD SADAR TEHSIL,28,22735,624,23359
FAISALABAD DISTRICT,FAISALABAD SADAR TEHSIL,29,23893,731,24624
FAISALABAD DISTRICT,FAISALABAD SADAR TEHSIL,30,20014,491,20505
FAISALABAD DISTRICT,FAISALABAD SADAR TEHSIL,31,22915,668,23583
FAISALABAD DISTRICT,FAISALABAD SADAR TEHSIL,32,19896,572,20468
FAISALABAD DISTRICT,FAISALABAD SADAR TEHSIL,33,20063,569,20632
FAISALABAD DISTRICT,FAISALABAD SADAR TEHSIL,34,20226,606,20832
FAISALABAD DISTRICT,FAISALABAD SADAR TEHSIL,35,16507,414,16921
FAISALABAD DISTRICT,FAISALABAD SADAR TEHSIL,36,18804,546,19350
FAISALABAD DISTRICT,FAISALABAD SADAR TEHSIL,37,17990,486,18476
FAISALABAD DISTRICT,FAISALABAD SADAR TEHSIL,38,16948,444,17392
FAISALABAD DISTRICT,FAISALABAD SADAR TEHSIL,39,17039,555,17594
FAISALABAD DISTRICT,FAISALABAD SADAR TEHSIL,40,13168,350,13518
FAISALABAD DISTRICT,FAISALABAD SADAR TEHSIL,41,15554,500,16054
FAISALABAD DISTRICT,FAISALABAD SADAR TEHSIL,42,13594,375,13969
FAISALABAD DISTRICT,FAISALABAD SADAR TEHSIL,43,13017,421,13438
FAISALABAD DISTRICT,FAISALABAD SADAR TEHSIL,44,12759,371,13130
FAISALABAD DISTRICT,FAISALABAD SADAR TEHSIL,45,10086,286,10372
FAISALABAD DISTRICT,FAISALABAD SADAR TEHSIL,46,12241,340,12581
FAISALABAD DISTRICT,FAISALABAD SADAR TEHSIL,47,12266,328,12594
FAISALABAD DISTRICT,FAISALABAD SADAR TEHSIL,48,11831,341,12172
FAISALABAD DISTRICT,FAISALABAD SADAR TEHSIL,49,12489,352,12841
FAISALABAD DISTRICT,FAISALABAD SADAR TEHSIL,50,9635,246,9881
FAISALABAD DISTRICT,FAISALABAD SADAR TEHSIL,51,12776,373,13149
FAISALABAD DISTRICT,FAISALABAD SADAR TEHSIL,52,11712,343,12055
FAISALABAD DISTRICT,FAISALABAD SADAR TEHSIL,53,11062,292,11354
FAISALABAD DISTRICT,FAISALABAD SADAR TEHSIL,54,10332,313,10645
FAISALABAD DISTRICT,FAISALABAD SADAR TEHSIL,55,7469,202,7671
FAISALABAD DISTRICT,FAISALABAD SADAR TEHSIL,56,8835,249,9084
FAISALABAD DISTRICT,FAISALABAD SADAR TEHSIL,57,7968,214,8182
FAISALABAD DISTRICT,FAISALABAD SADAR TEHSIL,58,7377,200,7577
FAISALABAD DISTRICT,FAISALABAD SADAR TEHSIL,59,7841,233,8074
FAISALABAD DISTRICT,FAISALABAD SADAR TEHSIL,60,5845,150,5995
FAISALABAD DISTRICT,FAISALABAD SADAR TEHSIL,61,7683,221,7904
FAISALABAD DISTRICT,FAISALABAD SADAR TEHSIL,62,6722,160,6882
FAISALABAD DISTRICT,FAISALABAD SADAR TEHSIL,63,6437,185,6622
FAISALABAD DISTRICT,FAISALABAD SADAR TEHSIL,64,5639,143,5782
FAISALABAD DISTRICT,FAISALABAD SADAR TEHSIL,65,4182,115,4297
FAISALABAD DISTRICT,FAISALABAD SADAR TEHSIL,66,4706,108,4814
FAISALABAD DISTRICT,FAISALABAD SADAR TEHSIL,67,4118,83,4201
FAISALABAD DISTRICT,FAISALABAD SADAR TEHSIL,68,3918,86,4004
FAISALABAD DISTRICT,FAISALABAD SADAR TEHSIL,69,3791,97,3888
FAISALABAD DISTRICT,FAISALABAD SADAR TEHSIL,70,3413,64,3477
FAISALABAD DISTRICT,FAISALABAD SADAR TEHSIL,71,4474,100,4574
FAISALABAD DISTRICT,FAISALABAD SADAR TEHSIL,72,3631,92,3723
FAISALABAD DISTRICT,FAISALABAD SADAR TEHSIL,73,3221,69,3290
FAISALABAD DISTRICT,FAISALABAD SADAR TEHSIL,74,2691,71,2762
FAISALABAD DISTRICT,FAISALABAD SADAR TEHSIL,>=75,21541,444,21985
FAISALABAD DISTRICT,JARANWALA TEHSIL,<1,30909,5117,36026
FAISALABAD DISTRICT,JARANWALA TEHSIL,1,31284,5270,36554
FAISALABAD DISTRICT,JARANWALA TEHSIL,2,30994,5303,36297
FAISALABAD DISTRICT,JARANWALA TEHSIL,3,34541,5697,40238
FAISALABAD DISTRICT,JARANWALA TEHSIL,4,34600,5404,40004
FAISALABAD DISTRICT,JARANWALA TEHSIL,5,33143,5495,38638
FAISALABAD DISTRICT,JARANWALA TEHSIL,6,32888,5291,38179
FAISALABAD DISTRICT,JARANWALA TEHSIL,7,35313,5869,41182
FAISALABAD DISTRICT,JARANWALA TEHSIL,8,33436,5217,38653
FAISALABAD DISTRICT,JARANWALA TEHSIL,9,32766,5774,38540
FAISALABAD DISTRICT,JARANWALA TEHSIL,10,30805,4827,35632
FAISALABAD DISTRICT,JARANWALA TEHSIL,11,30189,5592,35781
FAISALABAD DISTRICT,JARANWALA TEHSIL,12,27828,4634,32462
FAISALABAD DISTRICT,JARANWALA TEHSIL,13,27719,5062,32781
FAISALABAD DISTRICT,JARANWALA TEHSIL,14,26641,4663,31304
FAISALABAD DISTRICT,JARANWALA TEHSIL,15,26868,4752,31620
FAISALABAD DISTRICT,JARANWALA TEHSIL,16,26334,4627,30961
FAISALABAD DISTRICT,JARANWALA TEHSIL,17,28312,5090,33402
FAISALABAD DISTRICT,JARANWALA TEHSIL,18,23322,3958,27280
FAISALABAD DISTRICT,JARANWALA TEHSIL,19,25529,4834,30363
FAISALABAD DISTRICT,JARANWALA TEHSIL,20,23913,4317,28230
FAISALABAD DISTRICT,JARANWALA TEHSIL,21,24754,4834,29588
FAISALABAD DISTRICT,JARANWALA TEHSIL,22,24016,4616,28632
FAISALABAD DISTRICT,JARANWALA TEHSIL,23,22576,4423,26999
FAISALABAD DISTRICT,JARANWALA TEHSIL,24,21426,4405,25831
FAISALABAD DISTRICT,JARANWALA TEHSIL,25,20440,3603,24043
FAISALABAD DISTRICT,JARANWALA TEHSIL,26,20401,4351,24752
FAISALABAD DISTRICT,JARANWALA TEHSIL,27,19847,4081,23928
FAISALABAD DISTRICT,JARANWALA TEHSIL,28,19309,3992,23301
FAISALABAD DISTRICT,JARANWALA TEHSIL,29,19361,3960,23321
FAISALABAD DISTRICT,JARANWALA TEHSIL,30,18810,3692,22502
FAISALABAD DISTRICT,JARANWALA TEHSIL,31,18101,3734,21835
FAISALABAD DISTRICT,JARANWALA TEHSIL,32,16991,3568,20559
FAISALABAD DISTRICT,JARANWALA TEHSIL,33,16185,3464,19649
FAISALABAD DISTRICT,JARANWALA TEHSIL,34,16563,3318,19881
FAISALABAD DISTRICT,JARANWALA TEHSIL,35,16293,3040,19333
FAISALABAD DISTRICT,JARANWALA TEHSIL,36,16468,3061,19529
FAISALABAD DISTRICT,JARANWALA TEHSIL,37,16153,2796,18949
FAISALABAD DISTRICT,JARANWALA TEHSIL,38,14474,3099,17573
FAISALABAD DISTRICT,JARANWALA TEHSIL,39,15298,2952,18250
FAISALABAD DISTRICT,JARANWALA TEHSIL,40,12795,2594,15389
FAISALABAD DISTRICT,JARANWALA TEHSIL,41,13646,2521,16167
FAISALABAD DISTRICT,JARANWALA TEHSIL,42,12410,2345,14755
FAISALABAD DISTRICT,JARANWALA TEHSIL,43,11032,2280,13312
FAISALABAD DISTRICT,JARANWALA TEHSIL,44,10614,2167,12781
FAISALABAD DISTRICT,JARANWALA TEHSIL,45,9534,1940,11474
FAISALABAD DISTRICT,JARANWALA TEHSIL,46,10618,1916,12534
FAISALABAD DISTRICT,JARANWALA TEHSIL,47,11321,1853,13174
FAISALABAD DISTRICT,JARANWALA TEHSIL,48,10069,2026,12095
FAISALABAD DISTRICT,JARANWALA TEHSIL,49,10959,2009,12968
FAISALABAD DISTRICT,JARANWALA TEHSIL,50,9807,1894,11701
FAISALABAD DISTRICT,JARANWALA TEHSIL,51,10612,1999,12611
FAISALABAD DISTRICT,JARANWALA TEHSIL,52,10437,1776,12213
FAISALABAD DISTRICT,JARANWALA TEHSIL,53,9255,1747,11002
FAISALABAD DISTRICT,JARANWALA TEHSIL,54,8469,1713,10182
FAISALABAD DISTRICT,JARANWALA TEHSIL,55,7142,1271,8413
FAISALABAD DISTRICT,JARANWALA TEHSIL,56,7679,1251,8930
FAISALABAD DISTRICT,JARANWALA TEHSIL,57,7413,1161,8574
FAISALABAD DISTRICT,JARANWALA TEHSIL,58,6156,1138,7294
FAISALABAD DISTRICT,JARANWALA TEHSIL,59,6221,1139,7360
FAISALABAD DISTRICT,JARANWALA TEHSIL,60,5878,1028,6906
FAISALABAD DISTRICT,JARANWALA TEHSIL,61,6313,987,7300
FAISALABAD DISTRICT,JARANWALA TEHSIL,62,6266,984,7250
FAISALABAD DISTRICT,JARANWALA TEHSIL,63,5208,885,6093
FAISALABAD DISTRICT,JARANWALA TEHSIL,64,4960,802,5762
FAISALABAD DISTRICT,JARANWALA TEHSIL,65,4322,610,4932
FAISALABAD DISTRICT,JARANWALA TEHSIL,66,4366,574,4940
FAISALABAD DISTRICT,JARANWALA TEHSIL,67,4532,508,5040
FAISALABAD DISTRICT,JARANWALA TEHSIL,68,3323,476,3799
FAISALABAD DISTRICT,JARANWALA TEHSIL,69,3412,422,3834
FAISALABAD DISTRICT,JARANWALA TEHSIL,70,3810,474,4284
FAISALABAD DISTRICT,JARANWALA TEHSIL,71,3844,526,4370
FAISALABAD DISTRICT,JARANWALA TEHSIL,72,3867,478,4345
FAISALABAD DISTRICT,JARANWALA TEHSIL,73,2821,386,3207
FAISALABAD DISTRICT,JARANWALA TEHSIL,74,2463,346,2809
FAISALABAD DISTRICT,JARANWALA TEHSIL,>=75,20943,2598,23541
FAISALABAD DISTRICT,SAMMUNDRI TEHSIL,<1,11515,3655,15170
FAISALABAD DISTRICT,SAMMUNDRI TEHSIL,1,11965,3746,15711
FAISALABAD DISTRICT,SAMMUNDRI TEHSIL,2,11444,3566,15010
FAISALABAD DISTRICT,SAMMUNDRI TEHSIL,3,12422,3883,16305
FAISALABAD DISTRICT,SAMMUNDRI TEHSIL,4,12290,3866,16156
FAISALABAD DISTRICT,SAMMUNDRI TEHSIL,5,12106,3665,15771
FAISALABAD DISTRICT,SAMMUNDRI TEHSIL,6,11775,3666,15441
FAISALABAD DISTRICT,SAMMUNDRI TEHSIL,7,12680,4028,16708
FAISALABAD DISTRICT,SAMMUNDRI TEHSIL,8,11690,3772,15462
FAISALABAD DISTRICT,SAMMUNDRI TEHSIL,9,12596,4150,16746
FAISALABAD DISTRICT,SAMMUNDRI TEHSIL,10,11013,3496,14509
FAISALABAD DISTRICT,SAMMUNDRI TEHSIL,11,11671,3931,15602
FAISALABAD DISTRICT,SAMMUNDRI TEHSIL,12,10465,3416,13881
FAISALABAD DISTRICT,SAMMUNDRI TEHSIL,13,10611,3763,14374
FAISALABAD DISTRICT,SAMMUNDRI TEHSIL,14,10195,3528,13723
FAISALABAD DISTRICT,SAMMUNDRI TEHSIL,15,10197,3487,13684
FAISALABAD DISTRICT,SAMMUNDRI TEHSIL,16,10392,3564,13956
FAISALABAD DISTRICT,SAMMUNDRI TEHSIL,17,10523,3597,14120
FAISALABAD DISTRICT,SAMMUNDRI TEHSIL,18,9275,2979,12254
FAISALABAD DISTRICT,SAMMUNDRI TEHSIL,19,9850,3417,13267
FAISALABAD DISTRICT,SAMMUNDRI TEHSIL,20,8955,2965,11920
FAISALABAD DISTRICT,SAMMUNDRI TEHSIL,21,10046,3519,13565
FAISALABAD DISTRICT,SAMMUNDRI TEHSIL,22,9122,3035,12157
FAISALABAD DISTRICT,SAMMUNDRI TEHSIL,23,8612,3092,11704
FAISALABAD DISTRICT,SAMMUNDRI TEHSIL,24,8478,2926,11404
FAISALABAD DISTRICT,SAMMUNDRI TEHSIL,25,7515,2332,9847
FAISALABAD DISTRICT,SAMMUNDRI TEHSIL,26,8056,2809,10865
FAISALABAD DISTRICT,SAMMUNDRI TEHSIL,27,7468,2670,10138
FAISALABAD DISTRICT,SAMMUNDRI TEHSIL,28,7463,2467,9930
FAISALABAD DISTRICT,SAMMUNDRI TEHSIL,29,7394,2593,9987
FAISALABAD DISTRICT,SAMMUNDRI TEHSIL,30,6968,2259,9227
FAISALABAD DISTRICT,SAMMUNDRI TEHSIL,31,7476,2414,9890
FAISALABAD DISTRICT,SAMMUNDRI TEHSIL,32,6403,2132,8535
FAISALABAD DISTRICT,SAMMUNDRI TEHSIL,33,6744,2205,8949
FAISALABAD DISTRICT,SAMMUNDRI TEHSIL,34,6554,2156,8710
FAISALABAD DISTRICT,SAMMUNDRI TEHSIL,35,5820,1709,7529
FAISALABAD DISTRICT,SAMMUNDRI TEHSIL,36,6279,2146,8425
FAISALABAD DISTRICT,SAMMUNDRI TEHSIL,37,5272,1876,7148
FAISALABAD DISTRICT,SAMMUNDRI TEHSIL,38,5561,1910,7471
FAISALABAD DISTRICT,SAMMUNDRI TEHSIL,39,5601,1856,7457
FAISALABAD DISTRICT,SAMMUNDRI TEHSIL,40,4925,1586,6511
FAISALABAD DISTRICT,SAMMUNDRI TEHSIL,41,5312,1865,7177
FAISALABAD DISTRICT,SAMMUNDRI TEHSIL,42,4486,1541,6027
FAISALABAD DISTRICT,SAMMUNDRI TEHSIL,43,4593,1622,6215
FAISALABAD DISTRICT,SAMMUNDRI TEHSIL,44,4335,1466,5801
FAISALABAD DISTRICT,SAMMUNDRI TEHSIL,45,3632,1216,4848
FAISALABAD DISTRICT,SAMMUNDRI TEHSIL,46,4358,1417,5775
FAISALABAD DISTRICT,SAMMUNDRI TEHSIL,47,3925,1310,5235
FAISALABAD DISTRICT,SAMMUNDRI TEHSIL,48,4159,1401,5560
FAISALABAD DISTRICT,SAMMUNDRI TEHSIL,49,4379,1431,5810
FAISALABAD DISTRICT,SAMMUNDRI TEHSIL,50,3918,1170,5088
FAISALABAD DISTRICT,SAMMUNDRI TEHSIL,51,4457,1438,5895
FAISALABAD DISTRICT,SAMMUNDRI TEHSIL,52,3877,1256,5133
FAISALABAD DISTRICT,SAMMUNDRI TEHSIL,53,3961,1240,5201
FAISALABAD DISTRICT,SAMMUNDRI TEHSIL,54,3638,1254,4892
FAISALABAD DISTRICT,SAMMUNDRI TEHSIL,55,2857,865,3722
FAISALABAD DISTRICT,SAMMUNDRI TEHSIL,56,3289,1036,4325
FAISALABAD DISTRICT,SAMMUNDRI TEHSIL,57,2729,828,3557
FAISALABAD DISTRICT,SAMMUNDRI TEHSIL,58,2868,815,3683
FAISALABAD DISTRICT,SAMMUNDRI TEHSIL,59,2862,808,3670
FAISALABAD DISTRICT,SAMMUNDRI TEHSIL,60,2437,690,3127
FAISALABAD DISTRICT,SAMMUNDRI TEHSIL,61,2809,841,3650
FAISALABAD DISTRICT,SAMMUNDRI TEHSIL,62,2566,663,3229
FAISALABAD DISTRICT,SAMMUNDRI TEHSIL,63,2398,647,3045
FAISALABAD DISTRICT,SAMMUNDRI TEHSIL,64,2274,571,2845
FAISALABAD DISTRICT,SAMMUNDRI TEHSIL,65,1820,435,2255
FAISALABAD DISTRICT,SAMMUNDRI TEHSIL,66,1874,440,2314
FAISALABAD DISTRICT,SAMMUNDRI TEHSIL,67,1725,395,2120
FAISALABAD DISTRICT,SAMMUNDRI TEHSIL,68,1610,376,1986
FAISALABAD DISTRICT,SAMMUNDRI TEHSIL,69,1659,359,2018
FAISALABAD DISTRICT,SAMMUNDRI TEHSIL,70,1578,340,1918
FAISALABAD DISTRICT,SAMMUNDRI TEHSIL,71,1712,419,2131
FAISALABAD DISTRICT,SAMMUNDRI TEHSIL,72,1476,352,1828
FAISALABAD DISTRICT,SAMMUNDRI TEHSIL,73,1225,303,1528
FAISALABAD DISTRICT,SAMMUNDRI TEHSIL,74,1209,267,1476
FAISALABAD DISTRICT,SAMMUNDRI TEHSIL,>=75,8782,2029,10811
FAISALABAD DISTRICT,TANDLIAN WALA TEHSIL,<1,15652,1945,17597
FAISALABAD DISTRICT,TANDLIAN WALA TEHSIL,1,16428,2112,18540
FAISALABAD DISTRICT,TANDLIAN WALA TEHSIL,2,16923,1985,18908
FAISALABAD DISTRICT,TANDLIAN WALA TEHSIL,3,18898,2235,21133
FAISALABAD DISTRICT,TANDLIAN WALA TEHSIL,4,20016,2105,22121
FAISALABAD DISTRICT,TANDLIAN WALA TEHSIL,5,17973,2179,20152
FAISALABAD DISTRICT,TANDLIAN WALA TEHSIL,6,17751,2114,19865
FAISALABAD DISTRICT,TANDLIAN WALA TEHSIL,7,18915,2344,21259
FAISALABAD DISTRICT,TANDLIAN WALA TEHSIL,8,18741,2087,20828
FAISALABAD DISTRICT,TANDLIAN WALA TEHSIL,9,16573,2166,18739
FAISALABAD DISTRICT,TANDLIAN WALA TEHSIL,10,16509,1989,18498
FAISALABAD DISTRICT,TANDLIAN WALA TEHSIL,11,13315,2074,15389
FAISALABAD DISTRICT,TANDLIAN WALA TEHSIL,12,13830,1794,15624
FAISALABAD DISTRICT,TANDLIAN WALA TEHSIL,13,11892,1936,13828
FAISALABAD DISTRICT,TANDLIAN WALA TEHSIL,14,12488,1710,14198
FAISALABAD DISTRICT,TANDLIAN WALA TEHSIL,15,12263,1777,14040
FAISALABAD DISTRICT,TANDLIAN WALA TEHSIL,16,11789,1723,13512
FAISALABAD DISTRICT,TANDLIAN WALA TEHSIL,17,12468,2025,14493
FAISALABAD DISTRICT,TANDLIAN WALA TEHSIL,18,11107,1395,12502
FAISALABAD DISTRICT,TANDLIAN WALA TEHSIL,19,10297,1695,11992
FAISALABAD DISTRICT,TANDLIAN WALA TEHSIL,20,12170,1524,13694
FAISALABAD DISTRICT,TANDLIAN WALA TEHSIL,21,10215,1720,11935
FAISALABAD DISTRICT,TANDLIAN WALA TEHSIL,22,10817,1683,12500
FAISALABAD DISTRICT,TANDLIAN WALA TEHSIL,23,9389,1582,10971
FAISALABAD DISTRICT,TANDLIAN WALA TEHSIL,24,8694,1481,10175
FAISALABAD DISTRICT,TANDLIAN WALA TEHSIL,25,10749,1414,12163
FAISALABAD DISTRICT,TANDLIAN WALA TEHSIL,26,8791,1599,10390
FAISALABAD DISTRICT,TANDLIAN WALA TEHSIL,27,8658,1468,10126
FAISALABAD DISTRICT,TANDLIAN WALA TEHSIL,28,9099,1414,10513
FAISALABAD DISTRICT,TANDLIAN WALA TEHSIL,29,8733,1378,10111
FAISALABAD DISTRICT,TANDLIAN WALA TEHSIL,30,9620,1217,10837
FAISALABAD DISTRICT,TANDLIAN WALA TEHSIL,31,8472,1308,9780
FAISALABAD DISTRICT,TANDLIAN WALA TEHSIL,32,7961,1234,9195
FAISALABAD DISTRICT,TANDLIAN WALA TEHSIL,33,6884,1205,8089
FAISALABAD DISTRICT,TANDLIAN WALA TEHSIL,34,7128,1294,8422
FAISALABAD DISTRICT,TANDLIAN WALA TEHSIL,35,8400,1040,9440
FAISALABAD DISTRICT,TANDLIAN WALA TEHSIL,36,7785,1104,8889
FAISALABAD DISTRICT,TANDLIAN WALA TEHSIL,37,7340,1093,8433
FAISALABAD DISTRICT,TANDLIAN WALA TEHSIL,38,6709,1001,7710
FAISALABAD DISTRICT,TANDLIAN WALA TEHSIL,39,7033,1069,8102
FAISALABAD DISTRICT,TANDLIAN WALA TEHSIL,40,6839,863,7702
FAISALABAD DISTRICT,TANDLIAN WALA TEHSIL,41,6492,934,7426
FAISALABAD DISTRICT,TANDLIAN WALA TEHSIL,42,5900,860,6760
FAISALABAD DISTRICT,TANDLIAN WALA TEHSIL,43,4729,843,5572
FAISALABAD DISTRICT,TANDLIAN WALA TEHSIL,44,4832,699,5531
FAISALABAD DISTRICT,TANDLIAN WALA TEHSIL,45,5254,629,5883
FAISALABAD DISTRICT,TANDLIAN WALA TEHSIL,46,5180,792,5972
FAISALABAD DISTRICT,TANDLIAN WALA TEHSIL,47,5089,730,5819
FAISALABAD DISTRICT,TANDLIAN WALA TEHSIL,48,4663,711,5374
FAISALABAD DISTRICT,TANDLIAN WALA TEHSIL,49,4855,719,5574
FAISALABAD DISTRICT,TANDLIAN WALA TEHSIL,50,5099,584,5683
FAISALABAD DISTRICT,TANDLIAN WALA TEHSIL,51,5362,782,6144
FAISALABAD DISTRICT,TANDLIAN WALA TEHSIL,52,4869,707,5576
FAISALABAD DISTRICT,TANDLIAN WALA TEHSIL,53,3936,629,4565
FAISALABAD DISTRICT,TANDLIAN WALA TEHSIL,54,3649,578,4227
FAISALABAD DISTRICT,TANDLIAN WALA TEHSIL,55,3880,466,4346
FAISALABAD DISTRICT,TANDLIAN WALA TEHSIL,56,3665,484,4149
FAISALABAD DISTRICT,TANDLIAN WALA TEHSIL,57,3357,479,3836
FAISALABAD DISTRICT,TANDLIAN WALA TEHSIL,58,2963,406,3369
FAISALABAD DISTRICT,TANDLIAN WALA TEHSIL,59,3234,417,3651
FAISALABAD DISTRICT,TANDLIAN WALA TEHSIL,60,3489,357,3846
FAISALABAD DISTRICT,TANDLIAN WALA TEHSIL,61,3600,474,4074
FAISALABAD DISTRICT,TANDLIAN WALA TEHSIL,62,3432,411,3843
FAISALABAD DISTRICT,TANDLIAN WALA TEHSIL,63,2751,336,3087
FAISALABAD DISTRICT,TANDLIAN WALA TEHSIL,64,2689,362,3051
FAISALABAD DISTRICT,TANDLIAN WALA TEHSIL,65,2818,250,3068
FAISALABAD DISTRICT,TANDLIAN WALA TEHSIL,66,2554,236,2790
FAISALABAD DISTRICT,TANDLIAN WALA TEHSIL,67,2088,260,2348
FAISALABAD DISTRICT,TANDLIAN WALA TEHSIL,68,1976,232,2208
FAISALABAD DISTRICT,TANDLIAN WALA TEHSIL,69,2030,199,2229
FAISALABAD DISTRICT,TANDLIAN WALA TEHSIL,70,2180,184,2364
FAISALABAD DISTRICT,TANDLIAN WALA TEHSIL,71,2064,202,2266
FAISALABAD DISTRICT,TANDLIAN WALA TEHSIL,72,1711,189,1900
FAISALABAD DISTRICT,TANDLIAN WALA TEHSIL,73,1394,152,1546
FAISALABAD DISTRICT,TANDLIAN WALA TEHSIL,74,1285,125,1410
FAISALABAD DISTRICT,TANDLIAN WALA TEHSIL,>=75,10277,996,11273
FR BANNU,TRIBAL AREA ADJ. BANNU DISTRICT,<1,1172,0,1172
FR BANNU,TRIBAL AREA ADJ. BANNU DISTRICT,1,1282,0,1282
FR BANNU,TRIBAL AREA ADJ. BANNU DISTRICT,2,1691,0,1691
FR BANNU,TRIBAL AREA ADJ. BANNU DISTRICT,3,1694,0,1694
FR BANNU,TRIBAL AREA ADJ. BANNU DISTRICT,4,1812,0,1812
FR BANNU,TRIBAL AREA ADJ. BANNU DISTRICT,5,1698,0,1698
FR BANNU,TRIBAL AREA ADJ. BANNU DISTRICT,6,1778,0,1778
FR BANNU,TRIBAL AREA ADJ. BANNU DISTRICT,7,1660,0,1660
FR BANNU,TRIBAL AREA ADJ. BANNU DISTRICT,8,1803,0,1803
FR BANNU,TRIBAL AREA ADJ. BANNU DISTRICT,9,1423,0,1423
FR BANNU,TRIBAL AREA ADJ. BANNU DISTRICT,10,1460,0,1460
FR BANNU,TRIBAL AREA ADJ. BANNU DISTRICT,11,1042,0,1042
FR BANNU,TRIBAL AREA ADJ. BANNU DISTRICT,12,1074,0,1074
FR BANNU,TRIBAL AREA ADJ. BANNU DISTRICT,13,857,0,857
FR BANNU,TRIBAL AREA ADJ. BANNU DISTRICT,14,833,0,833
FR BANNU,TRIBAL AREA ADJ. BANNU DISTRICT,15,790,0,790
FR BANNU,TRIBAL AREA ADJ. BANNU DISTRICT,16,777,0,777
FR BANNU,TRIBAL AREA ADJ. BANNU DISTRICT,17,520,0,520
FR BANNU,TRIBAL AREA ADJ. BANNU DISTRICT,18,855,0,855
FR BANNU,TRIBAL AREA ADJ. BANNU DISTRICT,19,720,0,720
FR BANNU,TRIBAL AREA ADJ. BANNU DISTRICT,20,880,0,880
FR BANNU,TRIBAL AREA ADJ. BANNU DISTRICT,21,767,0,767
FR BANNU,TRIBAL AREA ADJ. BANNU DISTRICT,22,758,0,758
FR BANNU,TRIBAL AREA ADJ. BANNU DISTRICT,23,774,0,774
FR BANNU,TRIBAL AREA ADJ. BANNU DISTRICT,24,676,0,676
FR BANNU,TRIBAL AREA ADJ. BANNU DISTRICT,25,922,0,922
FR BANNU,TRIBAL AREA ADJ. BANNU DISTRICT,26,650,0,650
FR BANNU,TRIBAL AREA ADJ. BANNU DISTRICT,27,729,0,729
FR BANNU,TRIBAL AREA ADJ. BANNU DISTRICT,28,628,0,628
FR BANNU,TRIBAL AREA ADJ. BANNU DISTRICT,29,640,0,640
FR BANNU,TRIBAL AREA ADJ. BANNU DISTRICT,30,717,0,717
FR BANNU,TRIBAL AREA ADJ. BANNU DISTRICT,31,511,0,511
FR BANNU,TRIBAL AREA ADJ. BANNU DISTRICT,32,465,0,465
FR BANNU,TRIBAL AREA ADJ. BANNU DISTRICT,33,483,0,483
FR BANNU,TRIBAL AREA ADJ. BANNU DISTRICT,34,340,0,340
FR BANNU,TRIBAL AREA ADJ. BANNU DISTRICT,35,465,0,465
FR BANNU,TRIBAL AREA ADJ. BANNU DISTRICT,36,278,0,278
FR BANNU,TRIBAL AREA ADJ. BANNU DISTRICT,37,330,0,330
FR BANNU,TRIBAL AREA ADJ. BANNU DISTRICT,38,335,0,335
FR BANNU,TRIBAL AREA ADJ. BANNU DISTRICT,39,343,0,343
FR BANNU,TRIBAL AREA ADJ. BANNU DISTRICT,40,474,0,474
FR BANNU,TRIBAL AREA ADJ. BANNU DISTRICT,41,314,0,314
FR BANNU,TRIBAL AREA ADJ. BANNU DISTRICT,42,276,0,276
FR BANNU,TRIBAL AREA ADJ. BANNU DISTRICT,43,286,0,286
FR BANNU,TRIBAL AREA ADJ. BANNU DISTRICT,44,254,0,254
FR BANNU,TRIBAL AREA ADJ. BANNU DISTRICT,45,307,0,307
FR BANNU,TRIBAL AREA ADJ. BANNU DISTRICT,46,194,0,194
FR BANNU,TRIBAL AREA ADJ. BANNU DISTRICT,47,213,0,213
FR BANNU,TRIBAL AREA ADJ. BANNU DISTRICT,48,191,0,191
FR BANNU,TRIBAL AREA ADJ. BANNU DISTRICT,49,209,0,209
FR BANNU,TRIBAL AREA ADJ. BANNU DISTRICT,50,333,0,333
FR BANNU,TRIBAL AREA ADJ. BANNU DISTRICT,51,188,0,188
FR BANNU,TRIBAL AREA ADJ. BANNU DISTRICT,52,169,0,169
FR BANNU,TRIBAL AREA ADJ. BANNU DISTRICT,53,172,0,172
FR BANNU,TRIBAL AREA ADJ. BANNU DISTRICT,54,166,0,166
FR BANNU,TRIBAL AREA ADJ. BANNU DISTRICT,55,216,0,216
FR BANNU,TRIBAL AREA ADJ. BANNU DISTRICT,56,117,0,117
FR BANNU,TRIBAL AREA ADJ. BANNU DISTRICT,57,151,0,151
FR BANNU,TRIBAL AREA ADJ. BANNU DISTRICT,58,144,0,144
FR BANNU,TRIBAL AREA ADJ. BANNU DISTRICT,59,137,0,137
FR BANNU,TRIBAL AREA ADJ. BANNU DISTRICT,60,205,0,205
FR BANNU,TRIBAL AREA ADJ. BANNU DISTRICT,61,139,0,139
FR BANNU,TRIBAL AREA ADJ. BANNU DISTRICT,62,115,0,115
FR BANNU,TRIBAL AREA ADJ. BANNU DISTRICT,63,148,0,148
FR BANNU,TRIBAL AREA ADJ. BANNU DISTRICT,64,124,0,124
FR BANNU,TRIBAL AREA ADJ. BANNU DISTRICT,65,132,0,132
FR BANNU,TRIBAL AREA ADJ. BANNU DISTRICT,66,91,0,91
FR BANNU,TRIBAL AREA ADJ. BANNU DISTRICT,67,103,0,103
FR BANNU,TRIBAL AREA ADJ. BANNU DISTRICT,68,64,0,64
FR BANNU,TRIBAL AREA ADJ. BANNU DISTRICT,69,77,0,77
FR BANNU,TRIBAL AREA ADJ. BANNU DISTRICT,70,99,0,99
FR BANNU,TRIBAL AREA ADJ. BANNU DISTRICT,71,74,0,74
FR BANNU,TRIBAL AREA ADJ. BANNU DISTRICT,72,53,0,53
FR BANNU,TRIBAL AREA ADJ. BANNU DISTRICT,73,61,0,61
FR BANNU,TRIBAL AREA ADJ. BANNU DISTRICT,74,63,0,63
FR BANNU,TRIBAL AREA ADJ. BANNU DISTRICT,>=75,421,0,421
FR D.I.KHAN,TRIBAL AREA ADJ. DERA ISMAIL KHAN DISTRICT,<1,2302,0,2302
FR D.I.KHAN,TRIBAL AREA ADJ. DERA ISMAIL KHAN DISTRICT,1,2717,0,2717
FR D.I.KHAN,TRIBAL AREA ADJ. DERA ISMAIL KHAN DISTRICT,2,2970,0,2970
FR D.I.KHAN,TRIBAL AREA ADJ. DERA ISMAIL KHAN DISTRICT,3,2875,0,2875
FR D.I.KHAN,TRIBAL AREA ADJ. DERA ISMAIL KHAN DISTRICT,4,2975,0,2975
FR D.I.KHAN,TRIBAL AREA ADJ. DERA ISMAIL KHAN DISTRICT,5,2692,0,2692
FR D.I.KHAN,TRIBAL AREA ADJ. DERA ISMAIL KHAN DISTRICT,6,2750,0,2750
FR D.I.KHAN,TRIBAL AREA ADJ. DERA ISMAIL KHAN DISTRICT,7,2701,0,2701
FR D.I.KHAN,TRIBAL AREA ADJ. DERA ISMAIL KHAN DISTRICT,8,2763,0,2763
FR D.I.KHAN,TRIBAL AREA ADJ. DERA ISMAIL KHAN DISTRICT,9,2365,0,2365
FR D.I.KHAN,TRIBAL AREA ADJ. DERA ISMAIL KHAN DISTRICT,10,2270,0,2270
FR D.I.KHAN,TRIBAL AREA ADJ. DERA ISMAIL KHAN DISTRICT,11,1779,0,1779
FR D.I.KHAN,TRIBAL AREA ADJ. DERA ISMAIL KHAN DISTRICT,12,1779,0,1779
FR D.I.KHAN,TRIBAL AREA ADJ. DERA ISMAIL KHAN DISTRICT,13,1426,0,1426
FR D.I.KHAN,TRIBAL AREA ADJ. DERA ISMAIL KHAN DISTRICT,14,1394,0,1394
FR D.I.KHAN,TRIBAL AREA ADJ. DERA ISMAIL KHAN DISTRICT,15,1162,0,1162
FR D.I.KHAN,TRIBAL AREA ADJ. DERA ISMAIL KHAN DISTRICT,16,1191,0,1191
FR D.I.KHAN,TRIBAL AREA ADJ. DERA ISMAIL KHAN DISTRICT,17,991,0,991
FR D.I.KHAN,TRIBAL AREA ADJ. DERA ISMAIL KHAN DISTRICT,18,1391,0,1391
FR D.I.KHAN,TRIBAL AREA ADJ. DERA ISMAIL KHAN DISTRICT,19,1190,0,1190
FR D.I.KHAN,TRIBAL AREA ADJ. DERA ISMAIL KHAN DISTRICT,20,1320,0,1320
FR D.I.KHAN,TRIBAL AREA ADJ. DERA ISMAIL KHAN DISTRICT,21,1038,0,1038
FR D.I.KHAN,TRIBAL AREA ADJ. DERA ISMAIL KHAN DISTRICT,22,872,0,872
FR D.I.KHAN,TRIBAL AREA ADJ. DERA ISMAIL KHAN DISTRICT,23,1005,0,1005
FR D.I.KHAN,TRIBAL AREA ADJ. DERA ISMAIL KHAN DISTRICT,24,882,0,882
FR D.I.KHAN,TRIBAL AREA ADJ. DERA ISMAIL KHAN DISTRICT,25,1187,0,1187
FR D.I.KHAN,TRIBAL AREA ADJ. DERA ISMAIL KHAN DISTRICT,26,896,0,896
FR D.I.KHAN,TRIBAL AREA ADJ. DERA ISMAIL KHAN DISTRICT,27,942,0,942
FR D.I.KHAN,TRIBAL AREA ADJ. DERA ISMAIL KHAN DISTRICT,28,914,0,914
FR D.I.KHAN,TRIBAL AREA ADJ. DERA ISMAIL KHAN DISTRICT,29,873,0,873
FR D.I.KHAN,TRIBAL AREA ADJ. DERA ISMAIL KHAN DISTRICT,30,1076,0,1076
FR D.I.KHAN,TRIBAL AREA ADJ. DERA ISMAIL KHAN DISTRICT,31,844,0,844
FR D.I.KHAN,TRIBAL AREA ADJ. DERA ISMAIL KHAN DISTRICT,32,625,0,625
FR D.I.KHAN,TRIBAL AREA ADJ. DERA ISMAIL KHAN DISTRICT,33,638,0,638
FR D.I.KHAN,TRIBAL AREA ADJ. DERA ISMAIL KHAN DISTRICT,34,484,0,484
FR D.I.KHAN,TRIBAL AREA ADJ. DERA ISMAIL KHAN DISTRICT,35,611,0,611
FR D.I.KHAN,TRIBAL AREA ADJ. DERA ISMAIL KHAN DISTRICT,36,506,0,506
FR D.I.KHAN,TRIBAL AREA ADJ. DERA ISMAIL KHAN DISTRICT,37,480,0,480
FR D.I.KHAN,TRIBAL AREA ADJ. DERA ISMAIL KHAN DISTRICT,38,532,0,532
FR D.I.KHAN,TRIBAL AREA ADJ. DERA ISMAIL KHAN DISTRICT,39,479,0,479
FR D.I.KHAN,TRIBAL AREA ADJ. DERA ISMAIL KHAN DISTRICT,40,658,0,658
FR D.I.KHAN,TRIBAL AREA ADJ. DERA ISMAIL KHAN DISTRICT,41,500,0,500
FR D.I.KHAN,TRIBAL AREA ADJ. DERA ISMAIL KHAN DISTRICT,42,353,0,353
FR D.I.KHAN,TRIBAL AREA ADJ. DERA ISMAIL KHAN DISTRICT,43,420,0,420
FR D.I.KHAN,TRIBAL AREA ADJ. DERA ISMAIL KHAN DISTRICT,44,369,0,369
FR D.I.KHAN,TRIBAL AREA ADJ. DERA ISMAIL KHAN DISTRICT,45,456,0,456
FR D.I.KHAN,TRIBAL AREA ADJ. DERA ISMAIL KHAN DISTRICT,46,368,0,368
FR D.I.KHAN,TRIBAL AREA ADJ. DERA ISMAIL KHAN DISTRICT,47,316,0,316
FR D.I.KHAN,TRIBAL AREA ADJ. DERA ISMAIL KHAN DISTRICT,48,360,0,360
FR D.I.KHAN,TRIBAL AREA ADJ. DERA ISMAIL KHAN DISTRICT,49,361,0,361
FR D.I.KHAN,TRIBAL AREA ADJ. DERA ISMAIL KHAN DISTRICT,50,499,0,499
FR D.I.KHAN,TRIBAL AREA ADJ. DERA ISMAIL KHAN DISTRICT,51,347,0,347
FR D.I.KHAN,TRIBAL AREA ADJ. DERA ISMAIL KHAN DISTRICT,52,263,0,263
FR D.I.KHAN,TRIBAL AREA ADJ. DERA ISMAIL KHAN DISTRICT,53,318,0,318
FR D.I.KHAN,TRIBAL AREA ADJ. DERA ISMAIL KHAN DISTRICT,54,328,0,328
FR D.I.KHAN,TRIBAL AREA ADJ. DERA ISMAIL KHAN DISTRICT,55,299,0,299
FR D.I.KHAN,TRIBAL AREA ADJ. DERA ISMAIL KHAN DISTRICT,56,258,0,258
FR D.I.KHAN,TRIBAL AREA ADJ. DERA ISMAIL KHAN DISTRICT,57,236,0,236
FR D.I.KHAN,TRIBAL AREA ADJ. DERA ISMAIL KHAN DISTRICT,58,254,0,254
FR D.I.KHAN,TRIBAL AREA ADJ. DERA ISMAIL KHAN DISTRICT,59,265,0,265
FR D.I.KHAN,TRIBAL AREA ADJ. DERA ISMAIL KHAN DISTRICT,60,332,0,332
FR D.I.KHAN,TRIBAL AREA ADJ. DERA ISMAIL KHAN DISTRICT,61,254,0,254
FR D.I.KHAN,TRIBAL AREA ADJ. DERA ISMAIL KHAN DISTRICT,62,210,0,210
FR D.I.KHAN,TRIBAL AREA ADJ. DERA ISMAIL KHAN DISTRICT,63,239,0,239
FR D.I.KHAN,TRIBAL AREA ADJ. DERA ISMAIL KHAN DISTRICT,64,201,0,201
FR D.I.KHAN,TRIBAL AREA ADJ. DERA ISMAIL KHAN DISTRICT,65,180,0,180
FR D.I.KHAN,TRIBAL AREA ADJ. DERA ISMAIL KHAN DISTRICT,66,193,0,193
FR D.I.KHAN,TRIBAL AREA ADJ. DERA ISMAIL KHAN DISTRICT,67,153,0,153
FR D.I.KHAN,TRIBAL AREA ADJ. DERA ISMAIL KHAN DISTRICT,68,138,0,138
FR D.I.KHAN,TRIBAL AREA ADJ. DERA ISMAIL KHAN DISTRICT,69,149,0,149
FR D.I.KHAN,TRIBAL AREA ADJ. DERA ISMAIL KHAN DISTRICT,70,159,0,159
FR D.I.KHAN,TRIBAL AREA ADJ. DERA ISMAIL KHAN DISTRICT,71,118,0,118
FR D.I.KHAN,TRIBAL AREA ADJ. DERA ISMAIL KHAN DISTRICT,72,108,0,108
FR D.I.KHAN,TRIBAL AREA ADJ. DERA ISMAIL KHAN DISTRICT,73,108,0,108
FR D.I.KHAN,TRIBAL AREA ADJ. DERA ISMAIL KHAN DISTRICT,74,102,0,102
FR D.I.KHAN,TRIBAL AREA ADJ. DERA ISMAIL KHAN DISTRICT,>=75,747,0,747
FR LAKKI MARWAT,TRIBAL AREA ADJ. LAKKI MARWAT DISTRICT,<1,831,0,831
FR LAKKI MARWAT,TRIBAL AREA ADJ. LAKKI MARWAT DISTRICT,1,776,0,776
FR LAKKI MARWAT,TRIBAL AREA ADJ. LAKKI MARWAT DISTRICT,2,1103,0,1103
FR LAKKI MARWAT,TRIBAL AREA ADJ. LAKKI MARWAT DISTRICT,3,971,0,971
FR LAKKI MARWAT,TRIBAL AREA ADJ. LAKKI MARWAT DISTRICT,4,1122,0,1122
FR LAKKI MARWAT,TRIBAL AREA ADJ. LAKKI MARWAT DISTRICT,5,921,0,921
FR LAKKI MARWAT,TRIBAL AREA ADJ. LAKKI MARWAT DISTRICT,6,1087,0,1087
FR LAKKI MARWAT,TRIBAL AREA ADJ. LAKKI MARWAT DISTRICT,7,839,0,839
FR LAKKI MARWAT,TRIBAL AREA ADJ. LAKKI MARWAT DISTRICT,8,1070,0,1070
FR LAKKI MARWAT,TRIBAL AREA ADJ. LAKKI MARWAT DISTRICT,9,817,0,817
FR LAKKI MARWAT,TRIBAL AREA ADJ. LAKKI MARWAT DISTRICT,10,981,0,981
FR LAKKI MARWAT,TRIBAL AREA ADJ. LAKKI MARWAT DISTRICT,11,702,0,702
FR LAKKI MARWAT,TRIBAL AREA ADJ. LAKKI MARWAT DISTRICT,12,694,0,694
FR LAKKI MARWAT,TRIBAL AREA ADJ. LAKKI MARWAT DISTRICT,13,640,0,640
FR LAKKI MARWAT,TRIBAL AREA ADJ. LAKKI MARWAT DISTRICT,14,634,0,634
FR LAKKI MARWAT,TRIBAL AREA ADJ. LAKKI MARWAT DISTRICT,15,572,0,572
FR LAKKI MARWAT,TRIBAL AREA ADJ. LAKKI MARWAT DISTRICT,16,551,0,551
FR LAKKI MARWAT,TRIBAL AREA ADJ. LAKKI MARWAT DISTRICT,17,584,0,584
FR LAKKI MARWAT,TRIBAL AREA ADJ. LAKKI MARWAT DISTRICT,18,529,0,529
FR LAKKI MARWAT,TRIBAL AREA ADJ. LAKKI MARWAT DISTRICT,19,469,0,469
FR LAKKI MARWAT,TRIBAL AREA ADJ. LAKKI MARWAT DISTRICT,20,560,0,560
FR LAKKI MARWAT,TRIBAL AREA ADJ. LAKKI MARWAT DISTRICT,21,401,0,401
FR LAKKI MARWAT,TRIBAL AREA ADJ. LAKKI MARWAT DISTRICT,22,392,0,392
FR LAKKI MARWAT,TRIBAL AREA ADJ. LAKKI MARWAT DISTRICT,23,387,0,387
FR LAKKI MARWAT,TRIBAL AREA ADJ. LAKKI MARWAT DISTRICT,24,319,0,319
FR LAKKI MARWAT,TRIBAL AREA ADJ. LAKKI MARWAT DISTRICT,25,475,0,475
FR LAKKI MARWAT,TRIBAL AREA ADJ. LAKKI MARWAT DISTRICT,26,371,0,371
FR LAKKI MARWAT,TRIBAL AREA ADJ. LAKKI MARWAT DISTRICT,27,367,0,367
FR LAKKI MARWAT,TRIBAL AREA ADJ. LAKKI MARWAT DISTRICT,28,382,0,382
FR LAKKI MARWAT,TRIBAL AREA ADJ. LAKKI MARWAT DISTRICT,29,330,0,330
FR LAKKI MARWAT,TRIBAL AREA ADJ. LAKKI MARWAT DISTRICT,30,391,0,391
FR LAKKI MARWAT,TRIBAL AREA ADJ. LAKKI MARWAT DISTRICT,31,279,0,279
FR LAKKI MARWAT,TRIBAL AREA ADJ. LAKKI MARWAT DISTRICT,32,237,0,237
FR LAKKI MARWAT,TRIBAL AREA ADJ. LAKKI MARWAT DISTRICT,33,233,0,233
FR LAKKI MARWAT,TRIBAL AREA ADJ. LAKKI MARWAT DISTRICT,34,206,0,206
FR LAKKI MARWAT,TRIBAL AREA ADJ. LAKKI MARWAT DISTRICT,35,293,0,293
FR LAKKI MARWAT,TRIBAL AREA ADJ. LAKKI MARWAT DISTRICT,36,202,0,202
FR LAKKI MARWAT,TRIBAL AREA ADJ. LAKKI MARWAT DISTRICT,37,181,0,181
FR LAKKI MARWAT,TRIBAL AREA ADJ. LAKKI MARWAT DISTRICT,38,245,0,245
FR LAKKI MARWAT,TRIBAL AREA ADJ. LAKKI MARWAT DISTRICT,39,207,0,207
FR LAKKI MARWAT,TRIBAL AREA ADJ. LAKKI MARWAT DISTRICT,40,310,0,310
FR LAKKI MARWAT,TRIBAL AREA ADJ. LAKKI MARWAT DISTRICT,41,196,0,196
FR LAKKI MARWAT,TRIBAL AREA ADJ. LAKKI MARWAT DISTRICT,42,144,0,144
FR LAKKI MARWAT,TRIBAL AREA ADJ. LAKKI MARWAT DISTRICT,43,168,0,168
FR LAKKI MARWAT,TRIBAL AREA ADJ. LAKKI MARWAT DISTRICT,44,148,0,148
FR LAKKI MARWAT,TRIBAL AREA ADJ. LAKKI MARWAT DISTRICT,45,200,0,200
FR LAKKI MARWAT,TRIBAL AREA ADJ. LAKKI MARWAT DISTRICT,46,138,0,138
FR LAKKI MARWAT,TRIBAL AREA ADJ. LAKKI MARWAT DISTRICT,47,115,0,115
FR LAKKI MARWAT,TRIBAL AREA ADJ. LAKKI MARWAT DISTRICT,48,142,0,142
FR LAKKI MARWAT,TRIBAL AREA ADJ. LAKKI MARWAT DISTRICT,49,131,0,131
FR LAKKI MARWAT,TRIBAL AREA ADJ. LAKKI MARWAT DISTRICT,50,201,0,201
FR LAKKI MARWAT,TRIBAL AREA ADJ. LAKKI MARWAT DISTRICT,51,129,0,129
FR LAKKI MARWAT,TRIBAL AREA ADJ. LAKKI MARWAT DISTRICT,52,108,0,108
FR LAKKI MARWAT,TRIBAL AREA ADJ. LAKKI MARWAT DISTRICT,53,132,0,132
FR LAKKI MARWAT,TRIBAL AREA ADJ. LAKKI MARWAT DISTRICT,54,122,0,122
FR LAKKI MARWAT,TRIBAL AREA ADJ. LAKKI MARWAT DISTRICT,55,144,0,144
FR LAKKI MARWAT,TRIBAL AREA ADJ. LAKKI MARWAT DISTRICT,56,110,0,110
FR LAKKI MARWAT,TRIBAL AREA ADJ. LAKKI MARWAT DISTRICT,57,90,0,90
FR LAKKI MARWAT,TRIBAL AREA ADJ. LAKKI MARWAT DISTRICT,58,114,0,114
FR LAKKI MARWAT,TRIBAL AREA ADJ. LAKKI MARWAT DISTRICT,59,82,0,82
FR LAKKI MARWAT,TRIBAL AREA ADJ. LAKKI MARWAT DISTRICT,60,130,0,130
FR LAKKI MARWAT,TRIBAL AREA ADJ. LAKKI MARWAT DISTRICT,61,80,0,80
FR LAKKI MARWAT,TRIBAL AREA ADJ. LAKKI MARWAT DISTRICT,62,81,0,81
FR LAKKI MARWAT,TRIBAL AREA ADJ. LAKKI MARWAT DISTRICT,63,79,0,79
FR LAKKI MARWAT,TRIBAL AREA ADJ. LAKKI MARWAT DISTRICT,64,89,0,89
FR LAKKI MARWAT,TRIBAL AREA ADJ. LAKKI MARWAT DISTRICT,65,69,0,69
FR LAKKI MARWAT,TRIBAL AREA ADJ. LAKKI MARWAT DISTRICT,66,40,0,40
FR LAKKI MARWAT,TRIBAL AREA ADJ. LAKKI MARWAT DISTRICT,67,52,0,52
FR LAKKI MARWAT,TRIBAL AREA ADJ. LAKKI MARWAT DISTRICT,68,52,0,52
FR LAKKI MARWAT,TRIBAL AREA ADJ. LAKKI MARWAT DISTRICT,69,31,0,31
FR LAKKI MARWAT,TRIBAL AREA ADJ. LAKKI MARWAT DISTRICT,70,53,0,53
FR LAKKI MARWAT,TRIBAL AREA ADJ. LAKKI MARWAT DISTRICT,71,37,0,37
FR LAKKI MARWAT,TRIBAL AREA ADJ. LAKKI MARWAT DISTRICT,72,22,0,22
FR LAKKI MARWAT,TRIBAL AREA ADJ. LAKKI MARWAT DISTRICT,73,29,0,29
FR LAKKI MARWAT,TRIBAL AREA ADJ. LAKKI MARWAT DISTRICT,74,40,0,40
FR LAKKI MARWAT,TRIBAL AREA ADJ. LAKKI MARWAT DISTRICT,>=75,235,0,235
FR PESHAWAR,TRIBAL AREA ADJ. PESHAWAR DISTRICT,<1,1751,0,1751
FR PESHAWAR,TRIBAL AREA ADJ. PESHAWAR DISTRICT,1,1955,0,1955
FR PESHAWAR,TRIBAL AREA ADJ. PESHAWAR DISTRICT,2,1877,0,1877
FR PESHAWAR,TRIBAL AREA ADJ. PESHAWAR DISTRICT,3,1964,0,1964
FR PESHAWAR,TRIBAL AREA ADJ. PESHAWAR DISTRICT,4,1810,0,1810
FR PESHAWAR,TRIBAL AREA ADJ. PESHAWAR DISTRICT,5,1991,0,1991
FR PESHAWAR,TRIBAL AREA ADJ. PESHAWAR DISTRICT,6,1893,0,1893
FR PESHAWAR,TRIBAL AREA ADJ. PESHAWAR DISTRICT,7,1998,0,1998
FR PESHAWAR,TRIBAL AREA ADJ. PESHAWAR DISTRICT,8,1768,0,1768
FR PESHAWAR,TRIBAL AREA ADJ. PESHAWAR DISTRICT,9,2051,0,2051
FR PESHAWAR,TRIBAL AREA ADJ. PESHAWAR DISTRICT,10,1623,0,1623
FR PESHAWAR,TRIBAL AREA ADJ. PESHAWAR DISTRICT,11,1869,0,1869
FR PESHAWAR,TRIBAL AREA ADJ. PESHAWAR DISTRICT,12,1515,0,1515
FR PESHAWAR,TRIBAL AREA ADJ. PESHAWAR DISTRICT,13,1754,0,1754
FR PESHAWAR,TRIBAL AREA ADJ. PESHAWAR DISTRICT,14,1575,0,1575
FR PESHAWAR,TRIBAL AREA ADJ. PESHAWAR DISTRICT,15,1557,0,1557
FR PESHAWAR,TRIBAL AREA ADJ. PESHAWAR DISTRICT,16,1491,0,1491
FR PESHAWAR,TRIBAL AREA ADJ. PESHAWAR DISTRICT,17,1546,0,1546
FR PESHAWAR,TRIBAL AREA ADJ. PESHAWAR DISTRICT,18,1344,0,1344
FR PESHAWAR,TRIBAL AREA ADJ. PESHAWAR DISTRICT,19,1542,0,1542
FR PESHAWAR,TRIBAL AREA ADJ. PESHAWAR DISTRICT,20,1151,0,1151
FR PESHAWAR,TRIBAL AREA ADJ. PESHAWAR DISTRICT,21,1539,0,1539
FR PESHAWAR,TRIBAL AREA ADJ. PESHAWAR DISTRICT,22,1073,0,1073
FR PESHAWAR,TRIBAL AREA ADJ. PESHAWAR DISTRICT,23,1263,0,1263
FR PESHAWAR,TRIBAL AREA ADJ. PESHAWAR DISTRICT,24,1154,0,1154
FR PESHAWAR,TRIBAL AREA ADJ. PESHAWAR DISTRICT,25,796,0,796
FR PESHAWAR,TRIBAL AREA ADJ. PESHAWAR DISTRICT,26,1083,0,1083
FR PESHAWAR,TRIBAL AREA ADJ. PESHAWAR DISTRICT,27,1157,0,1157
FR PESHAWAR,TRIBAL AREA ADJ. PESHAWAR DISTRICT,28,881,0,881
FR PESHAWAR,TRIBAL AREA ADJ. PESHAWAR DISTRICT,29,1024,0,1024
FR PESHAWAR,TRIBAL AREA ADJ. PESHAWAR DISTRICT,30,678,0,678
FR PESHAWAR,TRIBAL AREA ADJ. PESHAWAR DISTRICT,31,1039,0,1039
FR PESHAWAR,TRIBAL AREA ADJ. PESHAWAR DISTRICT,32,784,0,784
FR PESHAWAR,TRIBAL AREA ADJ. PESHAWAR DISTRICT,33,861,0,861
FR PESHAWAR,TRIBAL AREA ADJ. PESHAWAR DISTRICT,34,800,0,800
FR PESHAWAR,TRIBAL AREA ADJ. PESHAWAR DISTRICT,35,464,0,464
FR PESHAWAR,TRIBAL AREA ADJ. PESHAWAR DISTRICT,36,652,0,652
FR PESHAWAR,TRIBAL AREA ADJ. PESHAWAR DISTRICT,37,655,0,655
FR PESHAWAR,TRIBAL AREA ADJ. PESHAWAR DISTRICT,38,604,0,604
FR PESHAWAR,TRIBAL AREA ADJ. PESHAWAR DISTRICT,39,661,0,661
FR PESHAWAR,TRIBAL AREA ADJ. PESHAWAR DISTRICT,40,461,0,461
FR PESHAWAR,TRIBAL AREA ADJ. PESHAWAR DISTRICT,41,687,0,687
FR PESHAWAR,TRIBAL AREA ADJ. PESHAWAR DISTRICT,42,456,0,456
FR PESHAWAR,TRIBAL AREA ADJ. PESHAWAR DISTRICT,43,522,0,522
FR PESHAWAR,TRIBAL AREA ADJ. PESHAWAR DISTRICT,44,481,0,481
FR PESHAWAR,TRIBAL AREA ADJ. PESHAWAR DISTRICT,45,313,0,313
FR PESHAWAR,TRIBAL AREA ADJ. PESHAWAR DISTRICT,46,503,0,503
FR PESHAWAR,TRIBAL AREA ADJ. PESHAWAR DISTRICT,47,457,0,457
FR PESHAWAR,TRIBAL AREA ADJ. PESHAWAR DISTRICT,48,391,0,391
FR PESHAWAR,TRIBAL AREA ADJ. PESHAWAR DISTRICT,49,392,0,392
FR PESHAWAR,TRIBAL AREA ADJ. PESHAWAR DISTRICT,50,273,0,273
FR PESHAWAR,TRIBAL AREA ADJ. PESHAWAR DISTRICT,51,396,0,396
FR PESHAWAR,TRIBAL AREA ADJ. PESHAWAR DISTRICT,52,316,0,316
FR PESHAWAR,TRIBAL AREA ADJ. PESHAWAR DISTRICT,53,340,0,340
FR PESHAWAR,TRIBAL AREA ADJ. PESHAWAR DISTRICT,54,304,0,304
FR PESHAWAR,TRIBAL AREA ADJ. PESHAWAR DISTRICT,55,234,0,234
FR PESHAWAR,TRIBAL AREA ADJ. PESHAWAR DISTRICT,56,310,0,310
FR PESHAWAR,TRIBAL AREA ADJ. PESHAWAR DISTRICT,57,384,0,384
FR PESHAWAR,TRIBAL AREA ADJ. PESHAWAR DISTRICT,58,334,0,334
FR PESHAWAR,TRIBAL AREA ADJ. PESHAWAR DISTRICT,59,297,0,297
FR PESHAWAR,TRIBAL AREA ADJ. PESHAWAR DISTRICT,60,197,0,197
FR PESHAWAR,TRIBAL AREA ADJ. PESHAWAR DISTRICT,61,301,0,301
FR PESHAWAR,TRIBAL AREA ADJ. PESHAWAR DISTRICT,62,264,0,264
FR PESHAWAR,TRIBAL AREA ADJ. PESHAWAR DISTRICT,63,252,0,252
FR PESHAWAR,TRIBAL AREA ADJ. PESHAWAR DISTRICT,64,266,0,266
FR PESHAWAR,TRIBAL AREA ADJ. PESHAWAR DISTRICT,65,174,0,174
FR PESHAWAR,TRIBAL AREA ADJ. PESHAWAR DISTRICT,66,206,0,206
FR PESHAWAR,TRIBAL AREA ADJ. PESHAWAR DISTRICT,67,226,0,226
FR PESHAWAR,TRIBAL AREA ADJ. PESHAWAR DISTRICT,68,206,0,206
FR PESHAWAR,TRIBAL AREA ADJ. PESHAWAR DISTRICT,69,188,0,188
FR PESHAWAR,TRIBAL AREA ADJ. PESHAWAR DISTRICT,70,101,0,101
FR PESHAWAR,TRIBAL AREA ADJ. PESHAWAR DISTRICT,71,132,0,132
FR PESHAWAR,TRIBAL AREA ADJ. PESHAWAR DISTRICT,72,131,0,131
FR PESHAWAR,TRIBAL AREA ADJ. PESHAWAR DISTRICT,73,116,0,116
FR PESHAWAR,TRIBAL AREA ADJ. PESHAWAR DISTRICT,74,105,0,105
FR PESHAWAR,TRIBAL AREA ADJ. PESHAWAR DISTRICT,>=75,852,0,852
FR TANK,TRIBAL AREA ADJ. TANK DISTRICT,<1,883,0,883
FR TANK,TRIBAL AREA ADJ. TANK DISTRICT,1,1248,0,1248
FR TANK,TRIBAL AREA ADJ. TANK DISTRICT,2,1399,0,1399
FR TANK,TRIBAL AREA ADJ. TANK DISTRICT,3,1417,0,1417
FR TANK,TRIBAL AREA ADJ. TANK DISTRICT,4,1416,0,1416
FR TANK,TRIBAL AREA ADJ. TANK DISTRICT,5,1286,0,1286
FR TANK,TRIBAL AREA ADJ. TANK DISTRICT,6,1392,0,1392
FR TANK,TRIBAL AREA ADJ. TANK DISTRICT,7,1177,0,1177
FR TANK,TRIBAL AREA ADJ. TANK DISTRICT,8,1393,0,1393
FR TANK,TRIBAL AREA ADJ. TANK DISTRICT,9,1110,0,1110
FR TANK,TRIBAL AREA ADJ. TANK DISTRICT,10,1143,0,1143
FR TANK,TRIBAL AREA ADJ. TANK DISTRICT,11,892,0,892
FR TANK,TRIBAL AREA ADJ. TANK DISTRICT,12,903,0,903
FR TANK,TRIBAL AREA ADJ. TANK DISTRICT,13,877,0,877
FR TANK,TRIBAL AREA ADJ. TANK DISTRICT,14,793,0,793
FR TANK,TRIBAL AREA ADJ. TANK DISTRICT,15,745,0,745
FR TANK,TRIBAL AREA ADJ. TANK DISTRICT,16,682,0,682
FR TANK,TRIBAL AREA ADJ. TANK DISTRICT,17,650,0,650
FR TANK,TRIBAL AREA ADJ. TANK DISTRICT,18,637,0,637
FR TANK,TRIBAL AREA ADJ. TANK DISTRICT,19,604,0,604
FR TANK,TRIBAL AREA ADJ. TANK DISTRICT,20,642,0,642
FR TANK,TRIBAL AREA ADJ. TANK DISTRICT,21,590,0,590
FR TANK,TRIBAL AREA ADJ. TANK DISTRICT,22,535,0,535
FR TANK,TRIBAL AREA ADJ. TANK DISTRICT,23,585,0,585
FR TANK,TRIBAL AREA ADJ. TANK DISTRICT,24,585,0,585
FR TANK,TRIBAL AREA ADJ. TANK DISTRICT,25,629,0,629
FR TANK,TRIBAL AREA ADJ. TANK DISTRICT,26,696,0,696
FR TANK,TRIBAL AREA ADJ. TANK DISTRICT,27,618,0,618
FR TANK,TRIBAL AREA ADJ. TANK DISTRICT,28,553,0,553
FR TANK,TRIBAL AREA ADJ. TANK DISTRICT,29,551,0,551
FR TANK,TRIBAL AREA ADJ. TANK DISTRICT,30,465,0,465
FR TANK,TRIBAL AREA ADJ. TANK DISTRICT,31,567,0,567
FR TANK,TRIBAL AREA ADJ. TANK DISTRICT,32,406,0,406
FR TANK,TRIBAL AREA ADJ. TANK DISTRICT,33,392,0,392
FR TANK,TRIBAL AREA ADJ. TANK DISTRICT,34,344,0,344
FR TANK,TRIBAL AREA ADJ. TANK DISTRICT,35,347,0,347
FR TANK,TRIBAL AREA ADJ. TANK DISTRICT,36,371,0,371
FR TANK,TRIBAL AREA ADJ. TANK DISTRICT,37,304,0,304
FR TANK,TRIBAL AREA ADJ. TANK DISTRICT,38,298,0,298
FR TANK,TRIBAL AREA ADJ. TANK DISTRICT,39,294,0,294
FR TANK,TRIBAL AREA ADJ. TANK DISTRICT,40,298,0,298
FR TANK,TRIBAL AREA ADJ. TANK DISTRICT,41,309,0,309
FR TANK,TRIBAL AREA ADJ. TANK DISTRICT,42,223,0,223
FR TANK,TRIBAL AREA ADJ. TANK DISTRICT,43,270,0,270
FR TANK,TRIBAL AREA ADJ. TANK DISTRICT,44,229,0,229
FR TANK,TRIBAL AREA ADJ. TANK DISTRICT,45,181,0,181
FR TANK,TRIBAL AREA ADJ. TANK DISTRICT,46,217,0,217
FR TANK,TRIBAL AREA ADJ. TANK DISTRICT,47,201,0,201
FR TANK,TRIBAL AREA ADJ. TANK DISTRICT,48,206,0,206
FR TANK,TRIBAL AREA ADJ. TANK DISTRICT,49,219,0,219
FR TANK,TRIBAL AREA ADJ. TANK DISTRICT,50,215,0,215
FR TANK,TRIBAL AREA ADJ. TANK DISTRICT,51,242,0,242
FR TANK,TRIBAL AREA ADJ. TANK DISTRICT,52,189,0,189
FR TANK,TRIBAL AREA ADJ. TANK DISTRICT,53,219,0,219
FR TANK,TRIBAL AREA ADJ. TANK DISTRICT,54,203,0,203
FR TANK,TRIBAL AREA ADJ. TANK DISTRICT,55,164,0,164
FR TANK,TRIBAL AREA ADJ. TANK DISTRICT,56,171,0,171
FR TANK,TRIBAL AREA ADJ. TANK DISTRICT,57,194,0,194
FR TANK,TRIBAL AREA ADJ. TANK DISTRICT,58,175,0,175
FR TANK,TRIBAL AREA ADJ. TANK DISTRICT,59,136,0,136
FR TANK,TRIBAL AREA ADJ. TANK DISTRICT,60,155,0,155
FR TANK,TRIBAL AREA ADJ. TANK DISTRICT,61,124,0,124
FR TANK,TRIBAL AREA ADJ. TANK DISTRICT,62,108,0,108
FR TANK,TRIBAL AREA ADJ. TANK DISTRICT,63,119,0,119
FR TANK,TRIBAL AREA ADJ. TANK DISTRICT,64,118,0,118
FR TANK,TRIBAL AREA ADJ. TANK DISTRICT,65,103,0,103
FR TANK,TRIBAL AREA ADJ. TANK DISTRICT,66,114,0,114
FR TANK,TRIBAL AREA ADJ. TANK DISTRICT,67,91,0,91
FR TANK,TRIBAL AREA ADJ. TANK DISTRICT,68,63,0,63
FR TANK,TRIBAL AREA ADJ. TANK DISTRICT,69,61,0,61
FR TANK,TRIBAL AREA ADJ. TANK DISTRICT,70,89,0,89
FR TANK,TRIBAL AREA ADJ. TANK DISTRICT,71,66,0,66
FR TANK,TRIBAL AREA ADJ. TANK DISTRICT,72,59,0,59
FR TANK,TRIBAL AREA ADJ. TANK DISTRICT,73,64,0,64
FR TANK,TRIBAL AREA ADJ. TANK DISTRICT,74,45,0,45
FR TANK,TRIBAL AREA ADJ. TANK DISTRICT,>=75,359,0,359
GHOTKI DISTRICT,DAHARKI TALUKA,<1,6513,2100,8613
GHOTKI DISTRICT,DAHARKI TALUKA,1,6598,2392,8990
GHOTKI DISTRICT,DAHARKI TALUKA,2,7842,2411,10253
GHOTKI DISTRICT,DAHARKI TALUKA,3,7850,2723,10573
GHOTKI DISTRICT,DAHARKI TALUKA,4,8654,2721,11375
GHOTKI DISTRICT,DAHARKI TALUKA,5,7944,2724,10668
GHOTKI DISTRICT,DAHARKI TALUKA,6,8579,2490,11069
GHOTKI DISTRICT,DAHARKI TALUKA,7,7247,2758,10005
GHOTKI DISTRICT,DAHARKI TALUKA,8,9263,2590,11853
GHOTKI DISTRICT,DAHARKI TALUKA,9,6677,2515,9192
GHOTKI DISTRICT,DAHARKI TALUKA,10,8174,2392,10566
GHOTKI DISTRICT,DAHARKI TALUKA,11,5320,2225,7545
GHOTKI DISTRICT,DAHARKI TALUKA,12,6308,2140,8448
GHOTKI DISTRICT,DAHARKI TALUKA,13,4834,2090,6924
GHOTKI DISTRICT,DAHARKI TALUKA,14,4957,1952,6909
GHOTKI DISTRICT,DAHARKI TALUKA,15,4746,2047,6793
GHOTKI DISTRICT,DAHARKI TALUKA,16,4523,1994,6517
GHOTKI DISTRICT,DAHARKI TALUKA,17,4409,2001,6410
GHOTKI DISTRICT,DAHARKI TALUKA,18,4736,1912,6648
GHOTKI DISTRICT,DAHARKI TALUKA,19,4134,1903,6037
GHOTKI DISTRICT,DAHARKI TALUKA,20,4656,1741,6397
GHOTKI DISTRICT,DAHARKI TALUKA,21,3354,1557,4911
GHOTKI DISTRICT,DAHARKI TALUKA,22,3343,1449,4792
GHOTKI DISTRICT,DAHARKI TALUKA,23,2887,1396,4283
GHOTKI DISTRICT,DAHARKI TALUKA,24,2834,1346,4180
GHOTKI DISTRICT,DAHARKI TALUKA,25,3464,1309,4773
GHOTKI DISTRICT,DAHARKI TALUKA,26,2801,1409,4210
GHOTKI DISTRICT,DAHARKI TALUKA,27,2649,1380,4029
GHOTKI DISTRICT,DAHARKI TALUKA,28,3449,1463,4912
GHOTKI DISTRICT,DAHARKI TALUKA,29,2823,1340,4163
GHOTKI DISTRICT,DAHARKI TALUKA,30,3497,1226,4723
GHOTKI DISTRICT,DAHARKI TALUKA,31,3048,1303,4351
GHOTKI DISTRICT,DAHARKI TALUKA,32,2596,1155,3751
GHOTKI DISTRICT,DAHARKI TALUKA,33,2575,1202,3777
GHOTKI DISTRICT,DAHARKI TALUKA,34,2647,1092,3739
GHOTKI DISTRICT,DAHARKI TALUKA,35,2702,1001,3703
GHOTKI DISTRICT,DAHARKI TALUKA,36,2763,1040,3803
GHOTKI DISTRICT,DAHARKI TALUKA,37,2324,909,3233
GHOTKI DISTRICT,DAHARKI TALUKA,38,2544,1118,3662
GHOTKI DISTRICT,DAHARKI TALUKA,39,2156,963,3119
GHOTKI DISTRICT,DAHARKI TALUKA,40,2266,922,3188
GHOTKI DISTRICT,DAHARKI TALUKA,41,1930,935,2865
GHOTKI DISTRICT,DAHARKI TALUKA,42,1748,780,2528
GHOTKI DISTRICT,DAHARKI TALUKA,43,1656,797,2453
GHOTKI DISTRICT,DAHARKI TALUKA,44,1588,777,2365
GHOTKI DISTRICT,DAHARKI TALUKA,45,1652,629,2281
GHOTKI DISTRICT,DAHARKI TALUKA,46,1483,700,2183
GHOTKI DISTRICT,DAHARKI TALUKA,47,1416,593,2009
GHOTKI DISTRICT,DAHARKI TALUKA,48,1523,657,2180
GHOTKI DISTRICT,DAHARKI TALUKA,49,1258,563,1821
GHOTKI DISTRICT,DAHARKI TALUKA,50,1501,543,2044
GHOTKI DISTRICT,DAHARKI TALUKA,51,1166,530,1696
GHOTKI DISTRICT,DAHARKI TALUKA,52,947,418,1365
GHOTKI DISTRICT,DAHARKI TALUKA,53,1009,403,1412
GHOTKI DISTRICT,DAHARKI TALUKA,54,929,385,1314
GHOTKI DISTRICT,DAHARKI TALUKA,55,979,324,1303
GHOTKI DISTRICT,DAHARKI TALUKA,56,788,332,1120
GHOTKI DISTRICT,DAHARKI TALUKA,57,706,290,996
GHOTKI DISTRICT,DAHARKI TALUKA,58,793,316,1109
GHOTKI DISTRICT,DAHARKI TALUKA,59,694,278,972
GHOTKI DISTRICT,DAHARKI TALUKA,60,936,280,1216
GHOTKI DISTRICT,DAHARKI TALUKA,61,718,303,1021
GHOTKI DISTRICT,DAHARKI TALUKA,62,645,288,933
GHOTKI DISTRICT,DAHARKI TALUKA,63,742,273,1015
GHOTKI DISTRICT,DAHARKI TALUKA,64,683,242,925
GHOTKI DISTRICT,DAHARKI TALUKA,65,668,239,907
GHOTKI DISTRICT,DAHARKI TALUKA,66,528,234,762
GHOTKI DISTRICT,DAHARKI TALUKA,67,434,197,631
GHOTKI DISTRICT,DAHARKI TALUKA,68,491,160,651
GHOTKI DISTRICT,DAHARKI TALUKA,69,348,141,489
GHOTKI DISTRICT,DAHARKI TALUKA,70,474,155,629
GHOTKI DISTRICT,DAHARKI TALUKA,71,398,153,551
GHOTKI DISTRICT,DAHARKI TALUKA,72,315,120,435
GHOTKI DISTRICT,DAHARKI TALUKA,73,317,116,433
GHOTKI DISTRICT,DAHARKI TALUKA,74,277,92,369
GHOTKI DISTRICT,DAHARKI TALUKA,>=75,1997,642,2639
GHOTKI DISTRICT,GHOTKI TALUKA,<1,10676,3312,13988
GHOTKI DISTRICT,GHOTKI TALUKA,1,10579,3149,13728
GHOTKI DISTRICT,GHOTKI TALUKA,2,12973,3353,16326
GHOTKI DISTRICT,GHOTKI TALUKA,3,13950,3661,17611
GHOTKI DISTRICT,GHOTKI TALUKA,4,14511,3746,18257
GHOTKI DISTRICT,GHOTKI TALUKA,5,14206,3875,18081
GHOTKI DISTRICT,GHOTKI TALUKA,6,13886,3621,17507
GHOTKI DISTRICT,GHOTKI TALUKA,7,13426,3819,17245
GHOTKI DISTRICT,GHOTKI TALUKA,8,14564,3880,18444
GHOTKI DISTRICT,GHOTKI TALUKA,9,11967,3574,15541
GHOTKI DISTRICT,GHOTKI TALUKA,10,12903,3547,16450
GHOTKI DISTRICT,GHOTKI TALUKA,11,9342,3160,12502
GHOTKI DISTRICT,GHOTKI TALUKA,12,10638,3104,13742
GHOTKI DISTRICT,GHOTKI TALUKA,13,8665,2983,11648
GHOTKI DISTRICT,GHOTKI TALUKA,14,9235,2896,12131
GHOTKI DISTRICT,GHOTKI TALUKA,15,8599,3103,11702
GHOTKI DISTRICT,GHOTKI TALUKA,16,8587,2824,11411
GHOTKI DISTRICT,GHOTKI TALUKA,17,7459,2868,10327
GHOTKI DISTRICT,GHOTKI TALUKA,18,9149,3111,12260
GHOTKI DISTRICT,GHOTKI TALUKA,19,7477,2719,10196
GHOTKI DISTRICT,GHOTKI TALUKA,20,7626,2615,10241
GHOTKI DISTRICT,GHOTKI TALUKA,21,5772,2329,8101
GHOTKI DISTRICT,GHOTKI TALUKA,22,5978,2255,8233
GHOTKI DISTRICT,GHOTKI TALUKA,23,5191,2191,7382
GHOTKI DISTRICT,GHOTKI TALUKA,24,5137,1916,7053
GHOTKI DISTRICT,GHOTKI TALUKA,25,5657,2045,7702
GHOTKI DISTRICT,GHOTKI TALUKA,26,5373,1953,7326
GHOTKI DISTRICT,GHOTKI TALUKA,27,5007,1944,6951
GHOTKI DISTRICT,GHOTKI TALUKA,28,5396,2045,7441
GHOTKI DISTRICT,GHOTKI TALUKA,29,4823,1807,6630
GHOTKI DISTRICT,GHOTKI TALUKA,30,4971,1919,6890
GHOTKI DISTRICT,GHOTKI TALUKA,31,4556,1626,6182
GHOTKI DISTRICT,GHOTKI TALUKA,32,4429,1641,6070
GHOTKI DISTRICT,GHOTKI TALUKA,33,4261,1586,5847
GHOTKI DISTRICT,GHOTKI TALUKA,34,4327,1525,5852
GHOTKI DISTRICT,GHOTKI TALUKA,35,4267,1585,5852
GHOTKI DISTRICT,GHOTKI TALUKA,36,4554,1371,5925
GHOTKI DISTRICT,GHOTKI TALUKA,37,4039,1376,5415
GHOTKI DISTRICT,GHOTKI TALUKA,38,3832,1480,5312
GHOTKI DISTRICT,GHOTKI TALUKA,39,3660,1333,4993
GHOTKI DISTRICT,GHOTKI TALUKA,40,3411,1343,4754
GHOTKI DISTRICT,GHOTKI TALUKA,41,3265,1149,4414
GHOTKI DISTRICT,GHOTKI TALUKA,42,3074,1079,4153
GHOTKI DISTRICT,GHOTKI TALUKA,43,2644,1063,3707
GHOTKI DISTRICT,GHOTKI TALUKA,44,2567,979,3546
GHOTKI DISTRICT,GHOTKI TALUKA,45,2681,969,3650
GHOTKI DISTRICT,GHOTKI TALUKA,46,2653,967,3620
GHOTKI DISTRICT,GHOTKI TALUKA,47,2583,865,3448
GHOTKI DISTRICT,GHOTKI TALUKA,48,2591,934,3525
GHOTKI DISTRICT,GHOTKI TALUKA,49,2259,837,3096
GHOTKI DISTRICT,GHOTKI TALUKA,50,2362,893,3255
GHOTKI DISTRICT,GHOTKI TALUKA,51,2110,691,2801
GHOTKI DISTRICT,GHOTKI TALUKA,52,1871,662,2533
GHOTKI DISTRICT,GHOTKI TALUKA,53,1738,637,2375
GHOTKI DISTRICT,GHOTKI TALUKA,54,1579,573,2152
GHOTKI DISTRICT,GHOTKI TALUKA,55,1571,620,2191
GHOTKI DISTRICT,GHOTKI TALUKA,56,1389,507,1896
GHOTKI DISTRICT,GHOTKI TALUKA,57,1337,436,1773
GHOTKI DISTRICT,GHOTKI TALUKA,58,1321,480,1801
GHOTKI DISTRICT,GHOTKI TALUKA,59,1164,472,1636
GHOTKI DISTRICT,GHOTKI TALUKA,60,1388,501,1889
GHOTKI DISTRICT,GHOTKI TALUKA,61,1294,451,1745
GHOTKI DISTRICT,GHOTKI TALUKA,62,1280,432,1712
GHOTKI DISTRICT,GHOTKI TALUKA,63,1159,402,1561
GHOTKI DISTRICT,GHOTKI TALUKA,64,1069,336,1405
GHOTKI DISTRICT,GHOTKI TALUKA,65,1021,314,1335
GHOTKI DISTRICT,GHOTKI TALUKA,66,995,317,1312
GHOTKI DISTRICT,GHOTKI TALUKA,67,827,242,1069
GHOTKI DISTRICT,GHOTKI TALUKA,68,747,269,1016
GHOTKI DISTRICT,GHOTKI TALUKA,69,688,216,904
GHOTKI DISTRICT,GHOTKI TALUKA,70,729,212,941
GHOTKI DISTRICT,GHOTKI TALUKA,71,650,193,843
GHOTKI DISTRICT,GHOTKI TALUKA,72,568,178,746
GHOTKI DISTRICT,GHOTKI TALUKA,73,497,154,651
GHOTKI DISTRICT,GHOTKI TALUKA,74,425,145,570
GHOTKI DISTRICT,GHOTKI TALUKA,>=75,3586,981,4567
GHOTKI DISTRICT,KHANGARH TALUKA,<1,4144,872,5016
GHOTKI DISTRICT,KHANGARH TALUKA,1,3468,967,4435
GHOTKI DISTRICT,KHANGARH TALUKA,2,4360,960,5320
GHOTKI DISTRICT,KHANGARH TALUKA,3,4334,1151,5485
GHOTKI DISTRICT,KHANGARH TALUKA,4,4888,1065,5953
GHOTKI DISTRICT,KHANGARH TALUKA,5,4175,1067,5242
GHOTKI DISTRICT,KHANGARH TALUKA,6,4710,986,5696
GHOTKI DISTRICT,KHANGARH TALUKA,7,3850,1093,4943
GHOTKI DISTRICT,KHANGARH TALUKA,8,4878,1022,5900
GHOTKI DISTRICT,KHANGARH TALUKA,9,3362,974,4336
GHOTKI DISTRICT,KHANGARH TALUKA,10,4261,899,5160
GHOTKI DISTRICT,KHANGARH TALUKA,11,2889,853,3742
GHOTKI DISTRICT,KHANGARH TALUKA,12,3228,770,3998
GHOTKI DISTRICT,KHANGARH TALUKA,13,2606,712,3318
GHOTKI DISTRICT,KHANGARH TALUKA,14,2807,718,3525
GHOTKI DISTRICT,KHANGARH TALUKA,15,2579,663,3242
GHOTKI DISTRICT,KHANGARH TALUKA,16,2450,659,3109
GHOTKI DISTRICT,KHANGARH TALUKA,17,2643,579,3222
GHOTKI DISTRICT,KHANGARH TALUKA,18,2533,744,3277
GHOTKI DISTRICT,KHANGARH TALUKA,19,2257,587,2844
GHOTKI DISTRICT,KHANGARH TALUKA,20,2339,606,2945
GHOTKI DISTRICT,KHANGARH TALUKA,21,1673,493,2166
GHOTKI DISTRICT,KHANGARH TALUKA,22,1742,507,2249
GHOTKI DISTRICT,KHANGARH TALUKA,23,1467,480,1947
GHOTKI DISTRICT,KHANGARH TALUKA,24,1342,409,1751
GHOTKI DISTRICT,KHANGARH TALUKA,25,1631,414,2045
GHOTKI DISTRICT,KHANGARH TALUKA,26,1393,437,1830
GHOTKI DISTRICT,KHANGARH TALUKA,27,1372,462,1834
GHOTKI DISTRICT,KHANGARH TALUKA,28,1511,420,1931
GHOTKI DISTRICT,KHANGARH TALUKA,29,1562,415,1977
GHOTKI DISTRICT,KHANGARH TALUKA,30,1597,397,1994
GHOTKI DISTRICT,KHANGARH TALUKA,31,1533,439,1972
GHOTKI DISTRICT,KHANGARH TALUKA,32,1382,396,1778
GHOTKI DISTRICT,KHANGARH TALUKA,33,1311,349,1660
GHOTKI DISTRICT,KHANGARH TALUKA,34,1320,349,1669
GHOTKI DISTRICT,KHANGARH TALUKA,35,1428,373,1801
GHOTKI DISTRICT,KHANGARH TALUKA,36,1382,367,1749
GHOTKI DISTRICT,KHANGARH TALUKA,37,1568,388,1956
GHOTKI DISTRICT,KHANGARH TALUKA,38,1106,347,1453
GHOTKI DISTRICT,KHANGARH TALUKA,39,1205,350,1555
GHOTKI DISTRICT,KHANGARH TALUKA,40,997,246,1243
GHOTKI DISTRICT,KHANGARH TALUKA,41,1039,240,1279
GHOTKI DISTRICT,KHANGARH TALUKA,42,998,275,1273
GHOTKI DISTRICT,KHANGARH TALUKA,43,763,197,960
GHOTKI DISTRICT,KHANGARH TALUKA,44,809,247,1056
GHOTKI DISTRICT,KHANGARH TALUKA,45,804,183,987
GHOTKI DISTRICT,KHANGARH TALUKA,46,825,204,1029
GHOTKI DISTRICT,KHANGARH TALUKA,47,871,237,1108
GHOTKI DISTRICT,KHANGARH TALUKA,48,730,177,907
GHOTKI DISTRICT,KHANGARH TALUKA,49,751,193,944
GHOTKI DISTRICT,KHANGARH TALUKA,50,632,147,779
GHOTKI DISTRICT,KHANGARH TALUKA,51,622,163,785
GHOTKI DISTRICT,KHANGARH TALUKA,52,628,194,822
GHOTKI DISTRICT,KHANGARH TALUKA,53,499,116,615
GHOTKI DISTRICT,KHANGARH TALUKA,54,503,132,635
GHOTKI DISTRICT,KHANGARH TALUKA,55,433,99,532
GHOTKI DISTRICT,KHANGARH TALUKA,56,422,81,503
GHOTKI DISTRICT,KHANGARH TALUKA,57,426,115,541
GHOTKI DISTRICT,KHANGARH TALUKA,58,362,108,470
GHOTKI DISTRICT,KHANGARH TALUKA,59,405,97,502
GHOTKI DISTRICT,KHANGARH TALUKA,60,434,90,524
GHOTKI DISTRICT,KHANGARH TALUKA,61,353,113,466
GHOTKI DISTRICT,KHANGARH TALUKA,62,386,107,493
GHOTKI DISTRICT,KHANGARH TALUKA,63,303,93,396
GHOTKI DISTRICT,KHANGARH TALUKA,64,345,88,433
GHOTKI DISTRICT,KHANGARH TALUKA,65,297,70,367
GHOTKI DISTRICT,KHANGARH TALUKA,66,309,58,367
GHOTKI DISTRICT,KHANGARH TALUKA,67,276,54,330
GHOTKI DISTRICT,KHANGARH TALUKA,68,242,55,297
GHOTKI DISTRICT,KHANGARH TALUKA,69,264,68,332
GHOTKI DISTRICT,KHANGARH TALUKA,70,230,35,265
GHOTKI DISTRICT,KHANGARH TALUKA,71,209,45,254
GHOTKI DISTRICT,KHANGARH TALUKA,72,205,48,253
GHOTKI DISTRICT,KHANGARH TALUKA,73,169,36,205
GHOTKI DISTRICT,KHANGARH TALUKA,74,169,30,199
GHOTKI DISTRICT,KHANGARH TALUKA,>=75,1248,243,1491
GHOTKI DISTRICT,MIRPUR MATHELO TALUKA,<1,7091,1678,8769
GHOTKI DISTRICT,MIRPUR MATHELO TALUKA,1,7606,2033,9639
GHOTKI DISTRICT,MIRPUR MATHELO TALUKA,2,8910,2101,11011
GHOTKI DISTRICT,MIRPUR MATHELO TALUKA,3,9308,2347,11655
GHOTKI DISTRICT,MIRPUR MATHELO TALUKA,4,9938,2377,12315
GHOTKI DISTRICT,MIRPUR MATHELO TALUKA,5,9131,2349,11480
GHOTKI DISTRICT,MIRPUR MATHELO TALUKA,6,9607,2277,11884
GHOTKI DISTRICT,MIRPUR MATHELO TALUKA,7,8603,2259,10862
GHOTKI DISTRICT,MIRPUR MATHELO TALUKA,8,10167,2418,12585
GHOTKI DISTRICT,MIRPUR MATHELO TALUKA,9,7638,2108,9746
GHOTKI DISTRICT,MIRPUR MATHELO TALUKA,10,8833,2181,11014
GHOTKI DISTRICT,MIRPUR MATHELO TALUKA,11,5773,1843,7616
GHOTKI DISTRICT,MIRPUR MATHELO TALUKA,12,6973,1907,8880
GHOTKI DISTRICT,MIRPUR MATHELO TALUKA,13,5290,1693,6983
GHOTKI DISTRICT,MIRPUR MATHELO TALUKA,14,5550,1690,7240
GHOTKI DISTRICT,MIRPUR MATHELO TALUKA,15,4989,1758,6747
GHOTKI DISTRICT,MIRPUR MATHELO TALUKA,16,5102,1764,6866
GHOTKI DISTRICT,MIRPUR MATHELO TALUKA,17,4146,1660,5806
GHOTKI DISTRICT,MIRPUR MATHELO TALUKA,18,6169,1817,7986
GHOTKI DISTRICT,MIRPUR MATHELO TALUKA,19,4731,1644,6375
GHOTKI DISTRICT,MIRPUR MATHELO TALUKA,20,5125,1494,6619
GHOTKI DISTRICT,MIRPUR MATHELO TALUKA,21,3809,1374,5183
GHOTKI DISTRICT,MIRPUR MATHELO TALUKA,22,3971,1360,5331
GHOTKI DISTRICT,MIRPUR MATHELO TALUKA,23,3282,1250,4532
GHOTKI DISTRICT,MIRPUR MATHELO TALUKA,24,3110,1287,4397
GHOTKI DISTRICT,MIRPUR MATHELO TALUKA,25,3783,1120,4903
GHOTKI DISTRICT,MIRPUR MATHELO TALUKA,26,3168,1254,4422
GHOTKI DISTRICT,MIRPUR MATHELO TALUKA,27,3102,1138,4240
GHOTKI DISTRICT,MIRPUR MATHELO TALUKA,28,3656,1279,4935
GHOTKI DISTRICT,MIRPUR MATHELO TALUKA,29,3149,1109,4258
GHOTKI DISTRICT,MIRPUR MATHELO TALUKA,30,3680,1085,4765
GHOTKI DISTRICT,MIRPUR MATHELO TALUKA,31,3303,1068,4371
GHOTKI DISTRICT,MIRPUR MATHELO TALUKA,32,3104,1059,4163
GHOTKI DISTRICT,MIRPUR MATHELO TALUKA,33,3054,1010,4064
GHOTKI DISTRICT,MIRPUR MATHELO TALUKA,34,2937,928,3865
GHOTKI DISTRICT,MIRPUR MATHELO TALUKA,35,3085,832,3917
GHOTKI DISTRICT,MIRPUR MATHELO TALUKA,36,3084,955,4039
GHOTKI DISTRICT,MIRPUR MATHELO TALUKA,37,2920,798,3718
GHOTKI DISTRICT,MIRPUR MATHELO TALUKA,38,2761,919,3680
GHOTKI DISTRICT,MIRPUR MATHELO TALUKA,39,2531,867,3398
GHOTKI DISTRICT,MIRPUR MATHELO TALUKA,40,2507,763,3270
GHOTKI DISTRICT,MIRPUR MATHELO TALUKA,41,2197,749,2946
GHOTKI DISTRICT,MIRPUR MATHELO TALUKA,42,2071,715,2786
GHOTKI DISTRICT,MIRPUR MATHELO TALUKA,43,1886,739,2625
GHOTKI DISTRICT,MIRPUR MATHELO TALUKA,44,1849,674,2523
GHOTKI DISTRICT,MIRPUR MATHELO TALUKA,45,1742,531,2273
GHOTKI DISTRICT,MIRPUR MATHELO TALUKA,46,1753,639,2392
GHOTKI DISTRICT,MIRPUR MATHELO TALUKA,47,1634,518,2152
GHOTKI DISTRICT,MIRPUR MATHELO TALUKA,48,1714,534,2248
GHOTKI DISTRICT,MIRPUR MATHELO TALUKA,49,1502,523,2025
GHOTKI DISTRICT,MIRPUR MATHELO TALUKA,50,1577,471,2048
GHOTKI DISTRICT,MIRPUR MATHELO TALUKA,51,1374,456,1830
GHOTKI DISTRICT,MIRPUR MATHELO TALUKA,52,1045,450,1495
GHOTKI DISTRICT,MIRPUR MATHELO TALUKA,53,1076,372,1448
GHOTKI DISTRICT,MIRPUR MATHELO TALUKA,54,1014,387,1401
GHOTKI DISTRICT,MIRPUR MATHELO TALUKA,55,1006,343,1349
GHOTKI DISTRICT,MIRPUR MATHELO TALUKA,56,869,354,1223
GHOTKI DISTRICT,MIRPUR MATHELO TALUKA,57,758,260,1018
GHOTKI DISTRICT,MIRPUR MATHELO TALUKA,58,809,274,1083
GHOTKI DISTRICT,MIRPUR MATHELO TALUKA,59,823,257,1080
GHOTKI DISTRICT,MIRPUR MATHELO TALUKA,60,1017,308,1325
GHOTKI DISTRICT,MIRPUR MATHELO TALUKA,61,896,282,1178
GHOTKI DISTRICT,MIRPUR MATHELO TALUKA,62,761,260,1021
GHOTKI DISTRICT,MIRPUR MATHELO TALUKA,63,762,229,991
GHOTKI DISTRICT,MIRPUR MATHELO TALUKA,64,654,226,880
GHOTKI DISTRICT,MIRPUR MATHELO TALUKA,65,737,169,906
GHOTKI DISTRICT,MIRPUR MATHELO TALUKA,66,683,174,857
GHOTKI DISTRICT,MIRPUR MATHELO TALUKA,67,504,143,647
GHOTKI DISTRICT,MIRPUR MATHELO TALUKA,68,480,127,607
GHOTKI DISTRICT,MIRPUR MATHELO TALUKA,69,468,124,592
GHOTKI DISTRICT,MIRPUR MATHELO TALUKA,70,519,105,624
GHOTKI DISTRICT,MIRPUR MATHELO TALUKA,71,485,113,598
GHOTKI DISTRICT,MIRPUR MATHELO TALUKA,72,324,95,419
GHOTKI DISTRICT,MIRPUR MATHELO TALUKA,73,280,92,372
GHOTKI DISTRICT,MIRPUR MATHELO TALUKA,74,296,74,370
GHOTKI DISTRICT,MIRPUR MATHELO TALUKA,>=75,2310,650,2960
GHOTKI DISTRICT,UBAURO TALUKA,<1,9070,974,10044
GHOTKI DISTRICT,UBAURO TALUKA,1,9479,1369,10848
GHOTKI DISTRICT,UBAURO TALUKA,2,11740,1320,13060
GHOTKI DISTRICT,UBAURO TALUKA,3,11625,1472,13097
GHOTKI DISTRICT,UBAURO TALUKA,4,12407,1428,13835
GHOTKI DISTRICT,UBAURO TALUKA,5,11415,1465,12880
GHOTKI DISTRICT,UBAURO TALUKA,6,11795,1340,13135
GHOTKI DISTRICT,UBAURO TALUKA,7,11081,1518,12599
GHOTKI DISTRICT,UBAURO TALUKA,8,12683,1504,14187
GHOTKI DISTRICT,UBAURO TALUKA,9,9538,1313,10851
GHOTKI DISTRICT,UBAURO TALUKA,10,10918,1300,12218
GHOTKI DISTRICT,UBAURO TALUKA,11,7386,1074,8460
GHOTKI DISTRICT,UBAURO TALUKA,12,8479,1129,9608
GHOTKI DISTRICT,UBAURO TALUKA,13,6471,1056,7527
GHOTKI DISTRICT,UBAURO TALUKA,14,6761,1069,7830
GHOTKI DISTRICT,UBAURO TALUKA,15,6130,1101,7231
GHOTKI DISTRICT,UBAURO TALUKA,16,6265,1041,7306
GHOTKI DISTRICT,UBAURO TALUKA,17,4917,995,5912
GHOTKI DISTRICT,UBAURO TALUKA,18,7326,1159,8485
GHOTKI DISTRICT,UBAURO TALUKA,19,6085,1004,7089
GHOTKI DISTRICT,UBAURO TALUKA,20,6250,1016,7266
GHOTKI DISTRICT,UBAURO TALUKA,21,4651,811,5462
GHOTKI DISTRICT,UBAURO TALUKA,22,4428,781,5209
GHOTKI DISTRICT,UBAURO TALUKA,23,3932,711,4643
GHOTKI DISTRICT,UBAURO TALUKA,24,3540,616,4156
GHOTKI DISTRICT,UBAURO TALUKA,25,4738,775,5513
GHOTKI DISTRICT,UBAURO TALUKA,26,3737,619,4356
GHOTKI DISTRICT,UBAURO TALUKA,27,3785,629,4414
GHOTKI DISTRICT,UBAURO TALUKA,28,4133,712,4845
GHOTKI DISTRICT,UBAURO TALUKA,29,4284,624,4908
GHOTKI DISTRICT,UBAURO TALUKA,30,4220,633,4853
GHOTKI DISTRICT,UBAURO TALUKA,31,4148,572,4720
GHOTKI DISTRICT,UBAURO TALUKA,32,3625,505,4130
GHOTKI DISTRICT,UBAURO TALUKA,33,3813,512,4325
GHOTKI DISTRICT,UBAURO TALUKA,34,3382,530,3912
GHOTKI DISTRICT,UBAURO TALUKA,35,3478,574,4052
GHOTKI DISTRICT,UBAURO TALUKA,36,3109,472,3581
GHOTKI DISTRICT,UBAURO TALUKA,37,3767,483,4250
GHOTKI DISTRICT,UBAURO TALUKA,38,2784,529,3313
GHOTKI DISTRICT,UBAURO TALUKA,39,3156,471,3627
GHOTKI DISTRICT,UBAURO TALUKA,40,2484,499,2983
GHOTKI DISTRICT,UBAURO TALUKA,41,2605,414,3019
GHOTKI DISTRICT,UBAURO TALUKA,42,2640,365,3005
GHOTKI DISTRICT,UBAURO TALUKA,43,2187,381,2568
GHOTKI DISTRICT,UBAURO TALUKA,44,2058,331,2389
GHOTKI DISTRICT,UBAURO TALUKA,45,1972,372,2344
GHOTKI DISTRICT,UBAURO TALUKA,46,1916,302,2218
GHOTKI DISTRICT,UBAURO TALUKA,47,2210,304,2514
GHOTKI DISTRICT,UBAURO TALUKA,48,1801,325,2126
GHOTKI DISTRICT,UBAURO TALUKA,49,1888,251,2139
GHOTKI DISTRICT,UBAURO TALUKA,50,1657,324,1981
GHOTKI DISTRICT,UBAURO TALUKA,51,1634,242,1876
GHOTKI DISTRICT,UBAURO TALUKA,52,1499,200,1699
GHOTKI DISTRICT,UBAURO TALUKA,53,1266,222,1488
GHOTKI DISTRICT,UBAURO TALUKA,54,1213,171,1384
GHOTKI DISTRICT,UBAURO TALUKA,55,1163,210,1373
GHOTKI DISTRICT,UBAURO TALUKA,56,1024,124,1148
GHOTKI DISTRICT,UBAURO TALUKA,57,1225,147,1372
GHOTKI DISTRICT,UBAURO TALUKA,58,956,136,1092
GHOTKI DISTRICT,UBAURO TALUKA,59,1091,146,1237
GHOTKI DISTRICT,UBAURO TALUKA,60,1021,182,1203
GHOTKI DISTRICT,UBAURO TALUKA,61,987,148,1135
GHOTKI DISTRICT,UBAURO TALUKA,62,1077,121,1198
GHOTKI DISTRICT,UBAURO TALUKA,63,981,136,1117
GHOTKI DISTRICT,UBAURO TALUKA,64,882,124,1006
GHOTKI DISTRICT,UBAURO TALUKA,65,753,105,858
GHOTKI DISTRICT,UBAURO TALUKA,66,744,74,818
GHOTKI DISTRICT,UBAURO TALUKA,67,766,77,843
GHOTKI DISTRICT,UBAURO TALUKA,68,597,90,687
GHOTKI DISTRICT,UBAURO TALUKA,69,593,76,669
GHOTKI DISTRICT,UBAURO TALUKA,70,549,85,634
GHOTKI DISTRICT,UBAURO TALUKA,71,553,69,622
GHOTKI DISTRICT,UBAURO TALUKA,72,496,60,556
GHOTKI DISTRICT,UBAURO TALUKA,73,427,57,484
GHOTKI DISTRICT,UBAURO TALUKA,74,399,59,458
GHOTKI DISTRICT,UBAURO TALUKA,>=75,3083,361,3444
GUJRANWALA DISTRICT,GUJRANWALA CITY TEHSIL,<1,1899,4341,6240
GUJRANWALA DISTRICT,GUJRANWALA CITY TEHSIL,1,1756,4854,6610
GUJRANWALA DISTRICT,GUJRANWALA CITY TEHSIL,2,1972,4908,6880
GUJRANWALA DISTRICT,GUJRANWALA CITY TEHSIL,3,2177,5258,7435
GUJRANWALA DISTRICT,GUJRANWALA CITY TEHSIL,4,2020,4899,6919
GUJRANWALA DISTRICT,GUJRANWALA CITY TEHSIL,5,2189,5060,7249
GUJRANWALA DISTRICT,GUJRANWALA CITY TEHSIL,6,2089,4796,6885
GUJRANWALA DISTRICT,GUJRANWALA CITY TEHSIL,7,2160,5131,7291
GUJRANWALA DISTRICT,GUJRANWALA CITY TEHSIL,8,2001,4575,6576
GUJRANWALA DISTRICT,GUJRANWALA CITY TEHSIL,9,1998,4896,6894
GUJRANWALA DISTRICT,GUJRANWALA CITY TEHSIL,10,1918,4103,6021
GUJRANWALA DISTRICT,GUJRANWALA CITY TEHSIL,11,1904,4979,6883
GUJRANWALA DISTRICT,GUJRANWALA CITY TEHSIL,12,1747,4021,5768
GUJRANWALA DISTRICT,GUJRANWALA CITY TEHSIL,13,1837,4502,6339
GUJRANWALA DISTRICT,GUJRANWALA CITY TEHSIL,14,1737,4147,5884
GUJRANWALA DISTRICT,GUJRANWALA CITY TEHSIL,15,1709,4140,5849
GUJRANWALA DISTRICT,GUJRANWALA CITY TEHSIL,16,1656,4220,5876
GUJRANWALA DISTRICT,GUJRANWALA CITY TEHSIL,17,1658,4145,5803
GUJRANWALA DISTRICT,GUJRANWALA CITY TEHSIL,18,1643,3732,5375
GUJRANWALA DISTRICT,GUJRANWALA CITY TEHSIL,19,1545,3977,5522
GUJRANWALA DISTRICT,GUJRANWALA CITY TEHSIL,20,1467,3591,5058
GUJRANWALA DISTRICT,GUJRANWALA CITY TEHSIL,21,1495,3945,5440
GUJRANWALA DISTRICT,GUJRANWALA CITY TEHSIL,22,1577,3688,5265
GUJRANWALA DISTRICT,GUJRANWALA CITY TEHSIL,23,1385,3493,4878
GUJRANWALA DISTRICT,GUJRANWALA CITY TEHSIL,24,1365,3361,4726
GUJRANWALA DISTRICT,GUJRANWALA CITY TEHSIL,25,1359,3071,4430
GUJRANWALA DISTRICT,GUJRANWALA CITY TEHSIL,26,1296,3181,4477
GUJRANWALA DISTRICT,GUJRANWALA CITY TEHSIL,27,1188,3119,4307
GUJRANWALA DISTRICT,GUJRANWALA CITY TEHSIL,28,1280,3067,4347
GUJRANWALA DISTRICT,GUJRANWALA CITY TEHSIL,29,977,2795,3772
GUJRANWALA DISTRICT,GUJRANWALA CITY TEHSIL,30,1189,2850,4039
GUJRANWALA DISTRICT,GUJRANWALA CITY TEHSIL,31,1004,2483,3487
GUJRANWALA DISTRICT,GUJRANWALA CITY TEHSIL,32,1122,2672,3794
GUJRANWALA DISTRICT,GUJRANWALA CITY TEHSIL,33,912,2520,3432
GUJRANWALA DISTRICT,GUJRANWALA CITY TEHSIL,34,818,2316,3134
GUJRANWALA DISTRICT,GUJRANWALA CITY TEHSIL,35,1025,2315,3340
GUJRANWALA DISTRICT,GUJRANWALA CITY TEHSIL,36,765,2137,2902
GUJRANWALA DISTRICT,GUJRANWALA CITY TEHSIL,37,760,2257,3017
GUJRANWALA DISTRICT,GUJRANWALA CITY TEHSIL,38,875,2244,3119
GUJRANWALA DISTRICT,GUJRANWALA CITY TEHSIL,39,755,2167,2922
GUJRANWALA DISTRICT,GUJRANWALA CITY TEHSIL,40,940,2081,3021
GUJRANWALA DISTRICT,GUJRANWALA CITY TEHSIL,41,622,1881,2503
GUJRANWALA DISTRICT,GUJRANWALA CITY TEHSIL,42,746,1854,2600
GUJRANWALA DISTRICT,GUJRANWALA CITY TEHSIL,43,637,1682,2319
GUJRANWALA DISTRICT,GUJRANWALA CITY TEHSIL,44,566,1664,2230
GUJRANWALA DISTRICT,GUJRANWALA CITY TEHSIL,45,768,1561,2329
GUJRANWALA DISTRICT,GUJRANWALA CITY TEHSIL,46,433,1268,1701
GUJRANWALA DISTRICT,GUJRANWALA CITY TEHSIL,47,449,1452,1901
GUJRANWALA DISTRICT,GUJRANWALA CITY TEHSIL,48,521,1532,2053
GUJRANWALA DISTRICT,GUJRANWALA CITY TEHSIL,49,463,1493,1956
GUJRANWALA DISTRICT,GUJRANWALA CITY TEHSIL,50,635,1543,2178
GUJRANWALA DISTRICT,GUJRANWALA CITY TEHSIL,51,414,1377,1791
GUJRANWALA DISTRICT,GUJRANWALA CITY TEHSIL,52,455,1319,1774
GUJRANWALA DISTRICT,GUJRANWALA CITY TEHSIL,53,424,1307,1731
GUJRANWALA DISTRICT,GUJRANWALA CITY TEHSIL,54,359,1154,1513
GUJRANWALA DISTRICT,GUJRANWALA CITY TEHSIL,55,513,1150,1663
GUJRANWALA DISTRICT,GUJRANWALA CITY TEHSIL,56,292,939,1231
GUJRANWALA DISTRICT,GUJRANWALA CITY TEHSIL,57,303,807,1110
GUJRANWALA DISTRICT,GUJRANWALA CITY TEHSIL,58,325,853,1178
GUJRANWALA DISTRICT,GUJRANWALA CITY TEHSIL,59,268,862,1130
GUJRANWALA DISTRICT,GUJRANWALA CITY TEHSIL,60,385,846,1231
GUJRANWALA DISTRICT,GUJRANWALA CITY TEHSIL,61,214,777,991
GUJRANWALA DISTRICT,GUJRANWALA CITY TEHSIL,62,243,747,990
GUJRANWALA DISTRICT,GUJRANWALA CITY TEHSIL,63,210,722,932
GUJRANWALA DISTRICT,GUJRANWALA CITY TEHSIL,64,205,604,809
GUJRANWALA DISTRICT,GUJRANWALA CITY TEHSIL,65,243,585,828
GUJRANWALA DISTRICT,GUJRANWALA CITY TEHSIL,66,133,423,556
GUJRANWALA DISTRICT,GUJRANWALA CITY TEHSIL,67,124,381,505
GUJRANWALA DISTRICT,GUJRANWALA CITY TEHSIL,68,131,414,545
GUJRANWALA DISTRICT,GUJRANWALA CITY TEHSIL,69,122,426,548
GUJRANWALA DISTRICT,GUJRANWALA CITY TEHSIL,70,201,473,674
GUJRANWALA DISTRICT,GUJRANWALA CITY TEHSIL,71,106,356,462
GUJRANWALA DISTRICT,GUJRANWALA CITY TEHSIL,72,115,344,459
GUJRANWALA DISTRICT,GUJRANWALA CITY TEHSIL,73,118,326,444
GUJRANWALA DISTRICT,GUJRANWALA CITY TEHSIL,74,93,260,353
GUJRANWALA DISTRICT,GUJRANWALA CITY TEHSIL,>=75,885,2455,3340
GUJRANWALA DISTRICT,GUJRANWALA SADDAR TEHSIL,<1,15294,49183,64477
GUJRANWALA DISTRICT,GUJRANWALA SADDAR TEHSIL,1,16192,52395,68587
GUJRANWALA DISTRICT,GUJRANWALA SADDAR TEHSIL,2,16448,52287,68735
GUJRANWALA DISTRICT,GUJRANWALA SADDAR TEHSIL,3,17629,56275,73904
GUJRANWALA DISTRICT,GUJRANWALA SADDAR TEHSIL,4,16928,52934,69862
GUJRANWALA DISTRICT,GUJRANWALA SADDAR TEHSIL,5,17245,53663,70908
GUJRANWALA DISTRICT,GUJRANWALA SADDAR TEHSIL,6,16805,52733,69538
GUJRANWALA DISTRICT,GUJRANWALA SADDAR TEHSIL,7,17435,55698,73133
GUJRANWALA DISTRICT,GUJRANWALA SADDAR TEHSIL,8,16113,50103,66216
GUJRANWALA DISTRICT,GUJRANWALA SADDAR TEHSIL,9,16790,53412,70202
GUJRANWALA DISTRICT,GUJRANWALA SADDAR TEHSIL,10,15382,48038,63420
GUJRANWALA DISTRICT,GUJRANWALA SADDAR TEHSIL,11,16521,53240,69761
GUJRANWALA DISTRICT,GUJRANWALA SADDAR TEHSIL,12,14907,46918,61825
GUJRANWALA DISTRICT,GUJRANWALA SADDAR TEHSIL,13,15572,49634,65206
GUJRANWALA DISTRICT,GUJRANWALA SADDAR TEHSIL,14,14667,45732,60399
GUJRANWALA DISTRICT,GUJRANWALA SADDAR TEHSIL,15,14554,46690,61244
GUJRANWALA DISTRICT,GUJRANWALA SADDAR TEHSIL,16,15138,46685,61823
GUJRANWALA DISTRICT,GUJRANWALA SADDAR TEHSIL,17,14133,47884,62017
GUJRANWALA DISTRICT,GUJRANWALA SADDAR TEHSIL,18,13629,42687,56316
GUJRANWALA DISTRICT,GUJRANWALA SADDAR TEHSIL,19,13718,46090,59808
GUJRANWALA DISTRICT,GUJRANWALA SADDAR TEHSIL,20,12696,40865,53561
GUJRANWALA DISTRICT,GUJRANWALA SADDAR TEHSIL,21,13474,46971,60445
GUJRANWALA DISTRICT,GUJRANWALA SADDAR TEHSIL,22,12883,44281,57164
GUJRANWALA DISTRICT,GUJRANWALA SADDAR TEHSIL,23,12149,43529,55678
GUJRANWALA DISTRICT,GUJRANWALA SADDAR TEHSIL,24,11910,43367,55277
GUJRANWALA DISTRICT,GUJRANWALA SADDAR TEHSIL,25,10685,36794,47479
GUJRANWALA DISTRICT,GUJRANWALA SADDAR TEHSIL,26,11157,41389,52546
GUJRANWALA DISTRICT,GUJRANWALA SADDAR TEHSIL,27,9915,38440,48355
GUJRANWALA DISTRICT,GUJRANWALA SADDAR TEHSIL,28,10114,39114,49228
GUJRANWALA DISTRICT,GUJRANWALA SADDAR TEHSIL,29,9259,34037,43296
GUJRANWALA DISTRICT,GUJRANWALA SADDAR TEHSIL,30,9739,35954,45693
GUJRANWALA DISTRICT,GUJRANWALA SADDAR TEHSIL,31,8607,32377,40984
GUJRANWALA DISTRICT,GUJRANWALA SADDAR TEHSIL,32,8747,35034,43781
GUJRANWALA DISTRICT,GUJRANWALA SADDAR TEHSIL,33,7882,31497,39379
GUJRANWALA DISTRICT,GUJRANWALA SADDAR TEHSIL,34,7651,28491,36142
GUJRANWALA DISTRICT,GUJRANWALA SADDAR TEHSIL,35,8181,29081,37262
GUJRANWALA DISTRICT,GUJRANWALA SADDAR TEHSIL,36,7818,27464,35282
GUJRANWALA DISTRICT,GUJRANWALA SADDAR TEHSIL,37,6875,23524,30399
GUJRANWALA DISTRICT,GUJRANWALA SADDAR TEHSIL,38,7412,29946,37358
GUJRANWALA DISTRICT,GUJRANWALA SADDAR TEHSIL,39,6801,24435,31236
GUJRANWALA DISTRICT,GUJRANWALA SADDAR TEHSIL,40,7239,28728,35967
GUJRANWALA DISTRICT,GUJRANWALA SADDAR TEHSIL,41,6231,22086,28317
GUJRANWALA DISTRICT,GUJRANWALA SADDAR TEHSIL,42,5867,22654,28521
GUJRANWALA DISTRICT,GUJRANWALA SADDAR TEHSIL,43,5603,21668,27271
GUJRANWALA DISTRICT,GUJRANWALA SADDAR TEHSIL,44,5321,19124,24445
GUJRANWALA DISTRICT,GUJRANWALA SADDAR TEHSIL,45,5486,21273,26759
GUJRANWALA DISTRICT,GUJRANWALA SADDAR TEHSIL,46,4855,16421,21276
GUJRANWALA DISTRICT,GUJRANWALA SADDAR TEHSIL,47,4608,14754,19362
GUJRANWALA DISTRICT,GUJRANWALA SADDAR TEHSIL,48,5060,18495,23555
GUJRANWALA DISTRICT,GUJRANWALA SADDAR TEHSIL,49,4825,16910,21735
GUJRANWALA DISTRICT,GUJRANWALA SADDAR TEHSIL,50,5235,20840,26075
GUJRANWALA DISTRICT,GUJRANWALA SADDAR TEHSIL,51,4561,15266,19827
GUJRANWALA DISTRICT,GUJRANWALA SADDAR TEHSIL,52,4539,15656,20195
GUJRANWALA DISTRICT,GUJRANWALA SADDAR TEHSIL,53,4270,15770,20040
GUJRANWALA DISTRICT,GUJRANWALA SADDAR TEHSIL,54,4030,14246,18276
GUJRANWALA DISTRICT,GUJRANWALA SADDAR TEHSIL,55,3986,15230,19216
GUJRANWALA DISTRICT,GUJRANWALA SADDAR TEHSIL,56,3282,11084,14366
GUJRANWALA DISTRICT,GUJRANWALA SADDAR TEHSIL,57,2869,8701,11570
GUJRANWALA DISTRICT,GUJRANWALA SADDAR TEHSIL,58,3059,10355,13414
GUJRANWALA DISTRICT,GUJRANWALA SADDAR TEHSIL,59,2858,9569,12427
GUJRANWALA DISTRICT,GUJRANWALA SADDAR TEHSIL,60,3176,11406,14582
GUJRANWALA DISTRICT,GUJRANWALA SADDAR TEHSIL,61,2533,8407,10940
GUJRANWALA DISTRICT,GUJRANWALA SADDAR TEHSIL,62,2386,8416,10802
GUJRANWALA DISTRICT,GUJRANWALA SADDAR TEHSIL,63,2285,8767,11052
GUJRANWALA DISTRICT,GUJRANWALA SADDAR TEHSIL,64,2200,7303,9503
GUJRANWALA DISTRICT,GUJRANWALA SADDAR TEHSIL,65,2318,8062,10380
GUJRANWALA DISTRICT,GUJRANWALA SADDAR TEHSIL,66,1599,4806,6405
GUJRANWALA DISTRICT,GUJRANWALA SADDAR TEHSIL,67,1274,4015,5289
GUJRANWALA DISTRICT,GUJRANWALA SADDAR TEHSIL,68,1566,4917,6483
GUJRANWALA DISTRICT,GUJRANWALA SADDAR TEHSIL,69,1549,4624,6173
GUJRANWALA DISTRICT,GUJRANWALA SADDAR TEHSIL,70,1975,5845,7820
GUJRANWALA DISTRICT,GUJRANWALA SADDAR TEHSIL,71,1389,3934,5323
GUJRANWALA DISTRICT,GUJRANWALA SADDAR TEHSIL,72,1355,3908,5263
GUJRANWALA DISTRICT,GUJRANWALA SADDAR TEHSIL,73,1301,3868,5169
GUJRANWALA DISTRICT,GUJRANWALA SADDAR TEHSIL,74,1163,3239,4402
GUJRANWALA DISTRICT,GUJRANWALA SADDAR TEHSIL,>=75,10281,26122,36403
GUJRANWALA DISTRICT,KAMOKE TEHSIL,<1,7176,5851,13027
GUJRANWALA DISTRICT,KAMOKE TEHSIL,1,8318,5977,14295
GUJRANWALA DISTRICT,KAMOKE TEHSIL,2,8505,6148,14653
GUJRANWALA DISTRICT,KAMOKE TEHSIL,3,9017,6605,15622
GUJRANWALA DISTRICT,KAMOKE TEHSIL,4,8776,6291,15067
GUJRANWALA DISTRICT,KAMOKE TEHSIL,5,8838,6325,15163
GUJRANWALA DISTRICT,KAMOKE TEHSIL,6,8830,6108,14938
GUJRANWALA DISTRICT,KAMOKE TEHSIL,7,8909,6670,15579
GUJRANWALA DISTRICT,KAMOKE TEHSIL,8,8507,5879,14386
GUJRANWALA DISTRICT,KAMOKE TEHSIL,9,8778,6362,15140
GUJRANWALA DISTRICT,KAMOKE TEHSIL,10,8222,5580,13802
GUJRANWALA DISTRICT,KAMOKE TEHSIL,11,8675,6351,15026
GUJRANWALA DISTRICT,KAMOKE TEHSIL,12,7867,5623,13490
GUJRANWALA DISTRICT,KAMOKE TEHSIL,13,7941,5908,13849
GUJRANWALA DISTRICT,KAMOKE TEHSIL,14,7589,5499,13088
GUJRANWALA DISTRICT,KAMOKE TEHSIL,15,7780,5675,13455
GUJRANWALA DISTRICT,KAMOKE TEHSIL,16,7775,5571,13346
GUJRANWALA DISTRICT,KAMOKE TEHSIL,17,7509,5632,13141
GUJRANWALA DISTRICT,KAMOKE TEHSIL,18,6950,5298,12248
GUJRANWALA DISTRICT,KAMOKE TEHSIL,19,7164,5389,12553
GUJRANWALA DISTRICT,KAMOKE TEHSIL,20,6635,5056,11691
GUJRANWALA DISTRICT,KAMOKE TEHSIL,21,6919,5596,12515
GUJRANWALA DISTRICT,KAMOKE TEHSIL,22,6612,5233,11845
GUJRANWALA DISTRICT,KAMOKE TEHSIL,23,6156,4899,11055
GUJRANWALA DISTRICT,KAMOKE TEHSIL,24,5892,4959,10851
GUJRANWALA DISTRICT,KAMOKE TEHSIL,25,5403,4220,9623
GUJRANWALA DISTRICT,KAMOKE TEHSIL,26,5468,4758,10226
GUJRANWALA DISTRICT,KAMOKE TEHSIL,27,5105,4163,9268
GUJRANWALA DISTRICT,KAMOKE TEHSIL,28,5158,4127,9285
GUJRANWALA DISTRICT,KAMOKE TEHSIL,29,4677,3821,8498
GUJRANWALA DISTRICT,KAMOKE TEHSIL,30,4832,3829,8661
GUJRANWALA DISTRICT,KAMOKE TEHSIL,31,4228,3566,7794
GUJRANWALA DISTRICT,KAMOKE TEHSIL,32,4342,3666,8008
GUJRANWALA DISTRICT,KAMOKE TEHSIL,33,4051,3417,7468
GUJRANWALA DISTRICT,KAMOKE TEHSIL,34,3885,3172,7057
GUJRANWALA DISTRICT,KAMOKE TEHSIL,35,4098,3051,7149
GUJRANWALA DISTRICT,KAMOKE TEHSIL,36,3894,2907,6801
GUJRANWALA DISTRICT,KAMOKE TEHSIL,37,3698,2666,6364
GUJRANWALA DISTRICT,KAMOKE TEHSIL,38,3842,3169,7011
GUJRANWALA DISTRICT,KAMOKE TEHSIL,39,3752,2842,6594
GUJRANWALA DISTRICT,KAMOKE TEHSIL,40,3454,2827,6281
GUJRANWALA DISTRICT,KAMOKE TEHSIL,41,3179,2610,5789
GUJRANWALA DISTRICT,KAMOKE TEHSIL,42,3219,2427,5646
GUJRANWALA DISTRICT,KAMOKE TEHSIL,43,2875,2310,5185
GUJRANWALA DISTRICT,KAMOKE TEHSIL,44,2720,2284,5004
GUJRANWALA DISTRICT,KAMOKE TEHSIL,45,2644,2293,4937
GUJRANWALA DISTRICT,KAMOKE TEHSIL,46,2382,1879,4261
GUJRANWALA DISTRICT,KAMOKE TEHSIL,47,2526,1950,4476
GUJRANWALA DISTRICT,KAMOKE TEHSIL,48,2665,1979,4644
GUJRANWALA DISTRICT,KAMOKE TEHSIL,49,2575,2016,4591
GUJRANWALA DISTRICT,KAMOKE TEHSIL,50,2576,2084,4660
GUJRANWALA DISTRICT,KAMOKE TEHSIL,51,2373,1797,4170
GUJRANWALA DISTRICT,KAMOKE TEHSIL,52,2428,1791,4219
GUJRANWALA DISTRICT,KAMOKE TEHSIL,53,2201,1724,3925
GUJRANWALA DISTRICT,KAMOKE TEHSIL,54,2029,1552,3581
GUJRANWALA DISTRICT,KAMOKE TEHSIL,55,1886,1512,3398
GUJRANWALA DISTRICT,KAMOKE TEHSIL,56,1562,1162,2724
GUJRANWALA DISTRICT,KAMOKE TEHSIL,57,1462,1095,2557
GUJRANWALA DISTRICT,KAMOKE TEHSIL,58,1636,1036,2672
GUJRANWALA DISTRICT,KAMOKE TEHSIL,59,1507,1045,2552
GUJRANWALA DISTRICT,KAMOKE TEHSIL,60,1504,1062,2566
GUJRANWALA DISTRICT,KAMOKE TEHSIL,61,1357,1033,2390
GUJRANWALA DISTRICT,KAMOKE TEHSIL,62,1356,1026,2382
GUJRANWALA DISTRICT,KAMOKE TEHSIL,63,1252,879,2131
GUJRANWALA DISTRICT,KAMOKE TEHSIL,64,1186,813,1999
GUJRANWALA DISTRICT,KAMOKE TEHSIL,65,1211,810,2021
GUJRANWALA DISTRICT,KAMOKE TEHSIL,66,824,581,1405
GUJRANWALA DISTRICT,KAMOKE TEHSIL,67,798,469,1267
GUJRANWALA DISTRICT,KAMOKE TEHSIL,68,855,523,1378
GUJRANWALA DISTRICT,KAMOKE TEHSIL,69,887,535,1422
GUJRANWALA DISTRICT,KAMOKE TEHSIL,70,1115,601,1716
GUJRANWALA DISTRICT,KAMOKE TEHSIL,71,765,503,1268
GUJRANWALA DISTRICT,KAMOKE TEHSIL,72,787,478,1265
GUJRANWALA DISTRICT,KAMOKE TEHSIL,73,724,436,1160
GUJRANWALA DISTRICT,KAMOKE TEHSIL,74,674,388,1062
GUJRANWALA DISTRICT,KAMOKE TEHSIL,>=75,5909,3445,9354
GUJRANWALA DISTRICT,NOWSHERA VIRKAN TEHSIL,<1,10674,1032,11706
GUJRANWALA DISTRICT,NOWSHERA VIRKAN TEHSIL,1,11984,1242,13226
GUJRANWALA DISTRICT,NOWSHERA VIRKAN TEHSIL,2,12302,1208,13510
GUJRANWALA DISTRICT,NOWSHERA VIRKAN TEHSIL,3,12761,1378,14139
GUJRANWALA DISTRICT,NOWSHERA VIRKAN TEHSIL,4,12993,1272,14265
GUJRANWALA DISTRICT,NOWSHERA VIRKAN TEHSIL,5,12613,1263,13876
GUJRANWALA DISTRICT,NOWSHERA VIRKAN TEHSIL,6,12779,1242,14021
GUJRANWALA DISTRICT,NOWSHERA VIRKAN TEHSIL,7,13215,1348,14563
GUJRANWALA DISTRICT,NOWSHERA VIRKAN TEHSIL,8,12282,1157,13439
GUJRANWALA DISTRICT,NOWSHERA VIRKAN TEHSIL,9,12822,1404,14226
GUJRANWALA DISTRICT,NOWSHERA VIRKAN TEHSIL,10,11882,1178,13060
GUJRANWALA DISTRICT,NOWSHERA VIRKAN TEHSIL,11,12789,1240,14029
GUJRANWALA DISTRICT,NOWSHERA VIRKAN TEHSIL,12,11522,1199,12721
GUJRANWALA DISTRICT,NOWSHERA VIRKAN TEHSIL,13,11839,1189,13028
GUJRANWALA DISTRICT,NOWSHERA VIRKAN TEHSIL,14,11561,1128,12689
GUJRANWALA DISTRICT,NOWSHERA VIRKAN TEHSIL,15,11277,1154,12431
GUJRANWALA DISTRICT,NOWSHERA VIRKAN TEHSIL,16,11563,1186,12749
GUJRANWALA DISTRICT,NOWSHERA VIRKAN TEHSIL,17,11234,1168,12402
GUJRANWALA DISTRICT,NOWSHERA VIRKAN TEHSIL,18,10244,999,11243
GUJRANWALA DISTRICT,NOWSHERA VIRKAN TEHSIL,19,10439,1055,11494
GUJRANWALA DISTRICT,NOWSHERA VIRKAN TEHSIL,20,9603,953,10556
GUJRANWALA DISTRICT,NOWSHERA VIRKAN TEHSIL,21,10132,1055,11187
GUJRANWALA DISTRICT,NOWSHERA VIRKAN TEHSIL,22,9507,990,10497
GUJRANWALA DISTRICT,NOWSHERA VIRKAN TEHSIL,23,9084,934,10018
GUJRANWALA DISTRICT,NOWSHERA VIRKAN TEHSIL,24,8742,893,9635
GUJRANWALA DISTRICT,NOWSHERA VIRKAN TEHSIL,25,7601,836,8437
GUJRANWALA DISTRICT,NOWSHERA VIRKAN TEHSIL,26,7780,825,8605
GUJRANWALA DISTRICT,NOWSHERA VIRKAN TEHSIL,27,7089,814,7903
GUJRANWALA DISTRICT,NOWSHERA VIRKAN TEHSIL,28,7285,787,8072
GUJRANWALA DISTRICT,NOWSHERA VIRKAN TEHSIL,29,6489,693,7182
GUJRANWALA DISTRICT,NOWSHERA VIRKAN TEHSIL,30,7102,819,7921
GUJRANWALA DISTRICT,NOWSHERA VIRKAN TEHSIL,31,6193,705,6898
GUJRANWALA DISTRICT,NOWSHERA VIRKAN TEHSIL,32,6472,740,7212
GUJRANWALA DISTRICT,NOWSHERA VIRKAN TEHSIL,33,5754,647,6401
GUJRANWALA DISTRICT,NOWSHERA VIRKAN TEHSIL,34,5707,595,6302
GUJRANWALA DISTRICT,NOWSHERA VIRKAN TEHSIL,35,5989,612,6601
GUJRANWALA DISTRICT,NOWSHERA VIRKAN TEHSIL,36,5454,601,6055
GUJRANWALA DISTRICT,NOWSHERA VIRKAN TEHSIL,37,5465,555,6020
GUJRANWALA DISTRICT,NOWSHERA VIRKAN TEHSIL,38,5428,577,6005
GUJRANWALA DISTRICT,NOWSHERA VIRKAN TEHSIL,39,5391,572,5963
GUJRANWALA DISTRICT,NOWSHERA VIRKAN TEHSIL,40,5442,555,5997
GUJRANWALA DISTRICT,NOWSHERA VIRKAN TEHSIL,41,4774,469,5243
GUJRANWALA DISTRICT,NOWSHERA VIRKAN TEHSIL,42,4806,480,5286
GUJRANWALA DISTRICT,NOWSHERA VIRKAN TEHSIL,43,4298,452,4750
GUJRANWALA DISTRICT,NOWSHERA VIRKAN TEHSIL,44,4106,425,4531
GUJRANWALA DISTRICT,NOWSHERA VIRKAN TEHSIL,45,4056,441,4497
GUJRANWALA DISTRICT,NOWSHERA VIRKAN TEHSIL,46,3625,345,3970
GUJRANWALA DISTRICT,NOWSHERA VIRKAN TEHSIL,47,3900,362,4262
GUJRANWALA DISTRICT,NOWSHERA VIRKAN TEHSIL,48,3963,426,4389
GUJRANWALA DISTRICT,NOWSHERA VIRKAN TEHSIL,49,4007,390,4397
GUJRANWALA DISTRICT,NOWSHERA VIRKAN TEHSIL,50,3934,405,4339
GUJRANWALA DISTRICT,NOWSHERA VIRKAN TEHSIL,51,3624,331,3955
GUJRANWALA DISTRICT,NOWSHERA VIRKAN TEHSIL,52,3845,349,4194
GUJRANWALA DISTRICT,NOWSHERA VIRKAN TEHSIL,53,3286,348,3634
GUJRANWALA DISTRICT,NOWSHERA VIRKAN TEHSIL,54,3095,286,3381
GUJRANWALA DISTRICT,NOWSHERA VIRKAN TEHSIL,55,2816,303,3119
GUJRANWALA DISTRICT,NOWSHERA VIRKAN TEHSIL,56,2397,218,2615
GUJRANWALA DISTRICT,NOWSHERA VIRKAN TEHSIL,57,2363,216,2579
GUJRANWALA DISTRICT,NOWSHERA VIRKAN TEHSIL,58,2267,232,2499
GUJRANWALA DISTRICT,NOWSHERA VIRKAN TEHSIL,59,2222,235,2457
GUJRANWALA DISTRICT,NOWSHERA VIRKAN TEHSIL,60,2327,235,2562
GUJRANWALA DISTRICT,NOWSHERA VIRKAN TEHSIL,61,2006,199,2205
GUJRANWALA DISTRICT,NOWSHERA VIRKAN TEHSIL,62,1964,196,2160
GUJRANWALA DISTRICT,NOWSHERA VIRKAN TEHSIL,63,1832,170,2002
GUJRANWALA DISTRICT,NOWSHERA VIRKAN TEHSIL,64,1769,168,1937
GUJRANWALA DISTRICT,NOWSHERA VIRKAN TEHSIL,65,1760,174,1934
GUJRANWALA DISTRICT,NOWSHERA VIRKAN TEHSIL,66,1172,126,1298
GUJRANWALA DISTRICT,NOWSHERA VIRKAN TEHSIL,67,1169,109,1278
GUJRANWALA DISTRICT,NOWSHERA VIRKAN TEHSIL,68,1225,109,1334
GUJRANWALA DISTRICT,NOWSHERA VIRKAN TEHSIL,69,1245,115,1360
GUJRANWALA DISTRICT,NOWSHERA VIRKAN TEHSIL,70,1648,147,1795
GUJRANWALA DISTRICT,NOWSHERA VIRKAN TEHSIL,71,1199,118,1317
GUJRANWALA DISTRICT,NOWSHERA VIRKAN TEHSIL,72,1265,78,1343
GUJRANWALA DISTRICT,NOWSHERA VIRKAN TEHSIL,73,1115,106,1221
GUJRANWALA DISTRICT,NOWSHERA VIRKAN TEHSIL,74,1040,93,1133
GUJRANWALA DISTRICT,NOWSHERA VIRKAN TEHSIL,>=75,8830,721,9551
GUJRANWALA DISTRICT,WAZIRABAD TEHSIL,<1,12048,6714,18762
GUJRANWALA DISTRICT,WAZIRABAD TEHSIL,1,12997,7446,20443
GUJRANWALA DISTRICT,WAZIRABAD TEHSIL,2,12881,7000,19881
GUJRANWALA DISTRICT,WAZIRABAD TEHSIL,3,13733,7445,21178
GUJRANWALA DISTRICT,WAZIRABAD TEHSIL,4,12995,7078,20073
GUJRANWALA DISTRICT,WAZIRABAD TEHSIL,5,13246,7091,20337
GUJRANWALA DISTRICT,WAZIRABAD TEHSIL,6,13177,7204,20381
GUJRANWALA DISTRICT,WAZIRABAD TEHSIL,7,13837,7510,21347
GUJRANWALA DISTRICT,WAZIRABAD TEHSIL,8,12333,6694,19027
GUJRANWALA DISTRICT,WAZIRABAD TEHSIL,9,13362,7451,20813
GUJRANWALA DISTRICT,WAZIRABAD TEHSIL,10,11768,6168,17936
GUJRANWALA DISTRICT,WAZIRABAD TEHSIL,11,13684,7532,21216
GUJRANWALA DISTRICT,WAZIRABAD TEHSIL,12,11784,6339,18123
GUJRANWALA DISTRICT,WAZIRABAD TEHSIL,13,12724,6763,19487
GUJRANWALA DISTRICT,WAZIRABAD TEHSIL,14,11873,6243,18116
GUJRANWALA DISTRICT,WAZIRABAD TEHSIL,15,12018,6209,18227
GUJRANWALA DISTRICT,WAZIRABAD TEHSIL,16,11984,6450,18434
GUJRANWALA DISTRICT,WAZIRABAD TEHSIL,17,11792,6567,18359
GUJRANWALA DISTRICT,WAZIRABAD TEHSIL,18,10507,5595,16102
GUJRANWALA DISTRICT,WAZIRABAD TEHSIL,19,11427,6437,17864
GUJRANWALA DISTRICT,WAZIRABAD TEHSIL,20,9582,5229,14811
GUJRANWALA DISTRICT,WAZIRABAD TEHSIL,21,11077,6419,17496
GUJRANWALA DISTRICT,WAZIRABAD TEHSIL,22,10058,5705,15763
GUJRANWALA DISTRICT,WAZIRABAD TEHSIL,23,9888,5736,15624
GUJRANWALA DISTRICT,WAZIRABAD TEHSIL,24,9144,5698,14842
GUJRANWALA DISTRICT,WAZIRABAD TEHSIL,25,7855,4549,12404
GUJRANWALA DISTRICT,WAZIRABAD TEHSIL,26,8607,5330,13937
GUJRANWALA DISTRICT,WAZIRABAD TEHSIL,27,8062,5026,13088
GUJRANWALA DISTRICT,WAZIRABAD TEHSIL,28,7802,4851,12653
GUJRANWALA DISTRICT,WAZIRABAD TEHSIL,29,7853,4652,12505
GUJRANWALA DISTRICT,WAZIRABAD TEHSIL,30,7383,4371,11754
GUJRANWALA DISTRICT,WAZIRABAD TEHSIL,31,7103,4496,11599
GUJRANWALA DISTRICT,WAZIRABAD TEHSIL,32,7065,4382,11447
GUJRANWALA DISTRICT,WAZIRABAD TEHSIL,33,6748,4311,11059
GUJRANWALA DISTRICT,WAZIRABAD TEHSIL,34,6225,4069,10294
GUJRANWALA DISTRICT,WAZIRABAD TEHSIL,35,6229,3518,9747
GUJRANWALA DISTRICT,WAZIRABAD TEHSIL,36,6569,3905,10474
GUJRANWALA DISTRICT,WAZIRABAD TEHSIL,37,6064,3605,9669
GUJRANWALA DISTRICT,WAZIRABAD TEHSIL,38,6256,3957,10213
GUJRANWALA DISTRICT,WAZIRABAD TEHSIL,39,6170,3604,9774
GUJRANWALA DISTRICT,WAZIRABAD TEHSIL,40,5374,3244,8618
GUJRANWALA DISTRICT,WAZIRABAD TEHSIL,41,5577,3141,8718
GUJRANWALA DISTRICT,WAZIRABAD TEHSIL,42,5244,3076,8320
GUJRANWALA DISTRICT,WAZIRABAD TEHSIL,43,5003,3124,8127
GUJRANWALA DISTRICT,WAZIRABAD TEHSIL,44,4829,2886,7715
GUJRANWALA DISTRICT,WAZIRABAD TEHSIL,45,4272,2514,6786
GUJRANWALA DISTRICT,WAZIRABAD TEHSIL,46,4226,2598,6824
GUJRANWALA DISTRICT,WAZIRABAD TEHSIL,47,4328,2438,6766
GUJRANWALA DISTRICT,WAZIRABAD TEHSIL,48,4440,2790,7230
GUJRANWALA DISTRICT,WAZIRABAD TEHSIL,49,4630,2672,7302
GUJRANWALA DISTRICT,WAZIRABAD TEHSIL,50,4353,2639,6992
GUJRANWALA DISTRICT,WAZIRABAD TEHSIL,51,4415,2506,6921
GUJRANWALA DISTRICT,WAZIRABAD TEHSIL,52,4430,2493,6923
GUJRANWALA DISTRICT,WAZIRABAD TEHSIL,53,4136,2516,6652
GUJRANWALA DISTRICT,WAZIRABAD TEHSIL,54,3837,2322,6159
GUJRANWALA DISTRICT,WAZIRABAD TEHSIL,55,3229,2002,5231
GUJRANWALA DISTRICT,WAZIRABAD TEHSIL,56,3013,1825,4838
GUJRANWALA DISTRICT,WAZIRABAD TEHSIL,57,2795,1550,4345
GUJRANWALA DISTRICT,WAZIRABAD TEHSIL,58,3049,1675,4724
GUJRANWALA DISTRICT,WAZIRABAD TEHSIL,59,3042,1734,4776
GUJRANWALA DISTRICT,WAZIRABAD TEHSIL,60,2728,1607,4335
GUJRANWALA DISTRICT,WAZIRABAD TEHSIL,61,2764,1567,4331
GUJRANWALA DISTRICT,WAZIRABAD TEHSIL,62,2671,1523,4194
GUJRANWALA DISTRICT,WAZIRABAD TEHSIL,63,2481,1508,3989
GUJRANWALA DISTRICT,WAZIRABAD TEHSIL,64,2254,1275,3529
GUJRANWALA DISTRICT,WAZIRABAD TEHSIL,65,2079,1161,3240
GUJRANWALA DISTRICT,WAZIRABAD TEHSIL,66,1683,947,2630
GUJRANWALA DISTRICT,WAZIRABAD TEHSIL,67,1755,846,2601
GUJRANWALA DISTRICT,WAZIRABAD TEHSIL,68,1568,862,2430
GUJRANWALA DISTRICT,WAZIRABAD TEHSIL,69,1694,793,2487
GUJRANWALA DISTRICT,WAZIRABAD TEHSIL,70,1914,902,2816
GUJRANWALA DISTRICT,WAZIRABAD TEHSIL,71,1579,801,2380
GUJRANWALA DISTRICT,WAZIRABAD TEHSIL,72,1581,772,2353
GUJRANWALA DISTRICT,WAZIRABAD TEHSIL,73,1317,680,1997
GUJRANWALA DISTRICT,WAZIRABAD TEHSIL,74,1268,570,1838
GUJRANWALA DISTRICT,WAZIRABAD TEHSIL,>=75,11091,4805,15896
GUJRAT DISTRICT,GUJRAT TEHSIL,<1,20995,11648,32643
GUJRAT DISTRICT,GUJRAT TEHSIL,1,22741,12475,35216
GUJRAT DISTRICT,GUJRAT TEHSIL,2,22822,12669,35491
GUJRAT DISTRICT,GUJRAT TEHSIL,3,23977,13505,37482
GUJRAT DISTRICT,GUJRAT TEHSIL,4,22817,12402,35219
GUJRAT DISTRICT,GUJRAT TEHSIL,5,23511,12934,36445
GUJRAT DISTRICT,GUJRAT TEHSIL,6,22852,12543,35395
GUJRAT DISTRICT,GUJRAT TEHSIL,7,24708,13552,38260
GUJRAT DISTRICT,GUJRAT TEHSIL,8,21698,11814,33512
GUJRAT DISTRICT,GUJRAT TEHSIL,9,24016,13499,37515
GUJRAT DISTRICT,GUJRAT TEHSIL,10,20561,11296,31857
GUJRAT DISTRICT,GUJRAT TEHSIL,11,23892,13035,36927
GUJRAT DISTRICT,GUJRAT TEHSIL,12,20392,11212,31604
GUJRAT DISTRICT,GUJRAT TEHSIL,13,22617,12287,34904
GUJRAT DISTRICT,GUJRAT TEHSIL,14,20421,11132,31553
GUJRAT DISTRICT,GUJRAT TEHSIL,15,20976,11350,32326
GUJRAT DISTRICT,GUJRAT TEHSIL,16,21241,11208,32449
GUJRAT DISTRICT,GUJRAT TEHSIL,17,21765,12105,33870
GUJRAT DISTRICT,GUJRAT TEHSIL,18,18390,9805,28195
GUJRAT DISTRICT,GUJRAT TEHSIL,19,20496,11247,31743
GUJRAT DISTRICT,GUJRAT TEHSIL,20,17035,9406,26441
GUJRAT DISTRICT,GUJRAT TEHSIL,21,19806,11505,31311
GUJRAT DISTRICT,GUJRAT TEHSIL,22,17771,10022,27793
GUJRAT DISTRICT,GUJRAT TEHSIL,23,17805,10491,28296
GUJRAT DISTRICT,GUJRAT TEHSIL,24,16507,10133,26640
GUJRAT DISTRICT,GUJRAT TEHSIL,25,14269,8627,22896
GUJRAT DISTRICT,GUJRAT TEHSIL,26,15367,9714,25081
GUJRAT DISTRICT,GUJRAT TEHSIL,27,14972,9571,24543
GUJRAT DISTRICT,GUJRAT TEHSIL,28,14375,9087,23462
GUJRAT DISTRICT,GUJRAT TEHSIL,29,14005,8886,22891
GUJRAT DISTRICT,GUJRAT TEHSIL,30,13674,8714,22388
GUJRAT DISTRICT,GUJRAT TEHSIL,31,13235,8552,21787
GUJRAT DISTRICT,GUJRAT TEHSIL,32,12794,8478,21272
GUJRAT DISTRICT,GUJRAT TEHSIL,33,12576,7968,20544
GUJRAT DISTRICT,GUJRAT TEHSIL,34,11448,7242,18690
GUJRAT DISTRICT,GUJRAT TEHSIL,35,11462,7104,18566
GUJRAT DISTRICT,GUJRAT TEHSIL,36,10460,6555,17015
GUJRAT DISTRICT,GUJRAT TEHSIL,37,9693,6194,15887
GUJRAT DISTRICT,GUJRAT TEHSIL,38,10819,7157,17976
GUJRAT DISTRICT,GUJRAT TEHSIL,39,10223,6372,16595
GUJRAT DISTRICT,GUJRAT TEHSIL,40,10642,7150,17792
GUJRAT DISTRICT,GUJRAT TEHSIL,41,8965,5500,14465
GUJRAT DISTRICT,GUJRAT TEHSIL,42,8453,5622,14075
GUJRAT DISTRICT,GUJRAT TEHSIL,43,8539,5510,14049
GUJRAT DISTRICT,GUJRAT TEHSIL,44,8074,5039,13113
GUJRAT DISTRICT,GUJRAT TEHSIL,45,8515,5355,13870
GUJRAT DISTRICT,GUJRAT TEHSIL,46,7333,4287,11620
GUJRAT DISTRICT,GUJRAT TEHSIL,47,6999,4109,11108
GUJRAT DISTRICT,GUJRAT TEHSIL,48,8254,4924,13178
GUJRAT DISTRICT,GUJRAT TEHSIL,49,8071,4645,12716
GUJRAT DISTRICT,GUJRAT TEHSIL,50,8804,5352,14156
GUJRAT DISTRICT,GUJRAT TEHSIL,51,7390,4170,11560
GUJRAT DISTRICT,GUJRAT TEHSIL,52,7284,4366,11650
GUJRAT DISTRICT,GUJRAT TEHSIL,53,7479,4503,11982
GUJRAT DISTRICT,GUJRAT TEHSIL,54,6986,4100,11086
GUJRAT DISTRICT,GUJRAT TEHSIL,55,7140,4184,11324
GUJRAT DISTRICT,GUJRAT TEHSIL,56,5718,3168,8886
GUJRAT DISTRICT,GUJRAT TEHSIL,57,4936,2672,7608
GUJRAT DISTRICT,GUJRAT TEHSIL,58,5832,3049,8881
GUJRAT DISTRICT,GUJRAT TEHSIL,59,5717,3000,8717
GUJRAT DISTRICT,GUJRAT TEHSIL,60,6430,3524,9954
GUJRAT DISTRICT,GUJRAT TEHSIL,61,5564,2909,8473
GUJRAT DISTRICT,GUJRAT TEHSIL,62,5357,2756,8113
GUJRAT DISTRICT,GUJRAT TEHSIL,63,5395,2874,8269
GUJRAT DISTRICT,GUJRAT TEHSIL,64,4839,2278,7117
GUJRAT DISTRICT,GUJRAT TEHSIL,65,5094,2554,7648
GUJRAT DISTRICT,GUJRAT TEHSIL,66,3536,1622,5158
GUJRAT DISTRICT,GUJRAT TEHSIL,67,3192,1423,4615
GUJRAT DISTRICT,GUJRAT TEHSIL,68,3695,1654,5349
GUJRAT DISTRICT,GUJRAT TEHSIL,69,3459,1527,4986
GUJRAT DISTRICT,GUJRAT TEHSIL,70,4236,1815,6051
GUJRAT DISTRICT,GUJRAT TEHSIL,71,3031,1340,4371
GUJRAT DISTRICT,GUJRAT TEHSIL,72,3118,1284,4402
GUJRAT DISTRICT,GUJRAT TEHSIL,73,2825,1290,4115
GUJRAT DISTRICT,GUJRAT TEHSIL,74,2620,1050,3670
GUJRAT DISTRICT,GUJRAT TEHSIL,>=75,22292,8607,30899
GUJRAT DISTRICT,KHARIAN TEHSIL,<1,17187,4661,21848
GUJRAT DISTRICT,KHARIAN TEHSIL,1,18751,4995,23746
GUJRAT DISTRICT,KHARIAN TEHSIL,2,18957,5096,24053
GUJRAT DISTRICT,KHARIAN TEHSIL,3,20024,5553,25577
GUJRAT DISTRICT,KHARIAN TEHSIL,4,18913,5131,24044
GUJRAT DISTRICT,KHARIAN TEHSIL,5,19090,5255,24345
GUJRAT DISTRICT,KHARIAN TEHSIL,6,18918,5135,24053
GUJRAT DISTRICT,KHARIAN TEHSIL,7,20246,5443,25689
GUJRAT DISTRICT,KHARIAN TEHSIL,8,17813,4730,22543
GUJRAT DISTRICT,KHARIAN TEHSIL,9,19907,5552,25459
GUJRAT DISTRICT,KHARIAN TEHSIL,10,16572,4268,20840
GUJRAT DISTRICT,KHARIAN TEHSIL,11,19383,5015,24398
GUJRAT DISTRICT,KHARIAN TEHSIL,12,16462,4179,20641
GUJRAT DISTRICT,KHARIAN TEHSIL,13,18340,4754,23094
GUJRAT DISTRICT,KHARIAN TEHSIL,14,16586,4282,20868
GUJRAT DISTRICT,KHARIAN TEHSIL,15,16624,4337,20961
GUJRAT DISTRICT,KHARIAN TEHSIL,16,17142,4287,21429
GUJRAT DISTRICT,KHARIAN TEHSIL,17,17110,4581,21691
GUJRAT DISTRICT,KHARIAN TEHSIL,18,14206,3671,17877
GUJRAT DISTRICT,KHARIAN TEHSIL,19,16329,4477,20806
GUJRAT DISTRICT,KHARIAN TEHSIL,20,12919,3674,16593
GUJRAT DISTRICT,KHARIAN TEHSIL,21,15845,4749,20594
GUJRAT DISTRICT,KHARIAN TEHSIL,22,13812,4175,17987
GUJRAT DISTRICT,KHARIAN TEHSIL,23,13991,4877,18868
GUJRAT DISTRICT,KHARIAN TEHSIL,24,13704,4847,18551
GUJRAT DISTRICT,KHARIAN TEHSIL,25,10871,3988,14859
GUJRAT DISTRICT,KHARIAN TEHSIL,26,12784,5184,17968
GUJRAT DISTRICT,KHARIAN TEHSIL,27,12470,5163,17633
GUJRAT DISTRICT,KHARIAN TEHSIL,28,11734,4632,16366
GUJRAT DISTRICT,KHARIAN TEHSIL,29,11936,5063,16999
GUJRAT DISTRICT,KHARIAN TEHSIL,30,10865,4173,15038
GUJRAT DISTRICT,KHARIAN TEHSIL,31,11249,4736,15985
GUJRAT DISTRICT,KHARIAN TEHSIL,32,10448,4282,14730
GUJRAT DISTRICT,KHARIAN TEHSIL,33,10426,4371,14797
GUJRAT DISTRICT,KHARIAN TEHSIL,34,9720,4061,13781
GUJRAT DISTRICT,KHARIAN TEHSIL,35,8670,3337,12007
GUJRAT DISTRICT,KHARIAN TEHSIL,36,8956,3646,12602
GUJRAT DISTRICT,KHARIAN TEHSIL,37,8017,3272,11289
GUJRAT DISTRICT,KHARIAN TEHSIL,38,8974,3436,12410
GUJRAT DISTRICT,KHARIAN TEHSIL,39,8178,3162,11340
GUJRAT DISTRICT,KHARIAN TEHSIL,40,8119,2803,10922
GUJRAT DISTRICT,KHARIAN TEHSIL,41,7458,2644,10102
GUJRAT DISTRICT,KHARIAN TEHSIL,42,6885,2326,9211
GUJRAT DISTRICT,KHARIAN TEHSIL,43,7059,2329,9388
GUJRAT DISTRICT,KHARIAN TEHSIL,44,6577,2026,8603
GUJRAT DISTRICT,KHARIAN TEHSIL,45,6186,2028,8214
GUJRAT DISTRICT,KHARIAN TEHSIL,46,6316,1722,8038
GUJRAT DISTRICT,KHARIAN TEHSIL,47,5542,1628,7170
GUJRAT DISTRICT,KHARIAN TEHSIL,48,6752,1828,8580
GUJRAT DISTRICT,KHARIAN TEHSIL,49,6509,1776,8285
GUJRAT DISTRICT,KHARIAN TEHSIL,50,6778,1912,8690
GUJRAT DISTRICT,KHARIAN TEHSIL,51,6018,1554,7572
GUJRAT DISTRICT,KHARIAN TEHSIL,52,6154,1581,7735
GUJRAT DISTRICT,KHARIAN TEHSIL,53,6115,1669,7784
GUJRAT DISTRICT,KHARIAN TEHSIL,54,6037,1391,7428
GUJRAT DISTRICT,KHARIAN TEHSIL,55,5462,1464,6926
GUJRAT DISTRICT,KHARIAN TEHSIL,56,4642,1207,5849
GUJRAT DISTRICT,KHARIAN TEHSIL,57,3906,989,4895
GUJRAT DISTRICT,KHARIAN TEHSIL,58,5005,1113,6118
GUJRAT DISTRICT,KHARIAN TEHSIL,59,4794,1077,5871
GUJRAT DISTRICT,KHARIAN TEHSIL,60,5306,1169,6475
GUJRAT DISTRICT,KHARIAN TEHSIL,61,4848,1168,6016
GUJRAT DISTRICT,KHARIAN TEHSIL,62,4857,1069,5926
GUJRAT DISTRICT,KHARIAN TEHSIL,63,4804,1090,5894
GUJRAT DISTRICT,KHARIAN TEHSIL,64,4217,869,5086
GUJRAT DISTRICT,KHARIAN TEHSIL,65,4203,845,5048
GUJRAT DISTRICT,KHARIAN TEHSIL,66,3414,617,4031
GUJRAT DISTRICT,KHARIAN TEHSIL,67,3055,660,3715
GUJRAT DISTRICT,KHARIAN TEHSIL,68,3321,652,3973
GUJRAT DISTRICT,KHARIAN TEHSIL,69,3109,574,3683
GUJRAT DISTRICT,KHARIAN TEHSIL,70,3448,665,4113
GUJRAT DISTRICT,KHARIAN TEHSIL,71,2774,500,3274
GUJRAT DISTRICT,KHARIAN TEHSIL,72,2859,538,3397
GUJRAT DISTRICT,KHARIAN TEHSIL,73,2668,506,3174
GUJRAT DISTRICT,KHARIAN TEHSIL,74,2214,369,2583
GUJRAT DISTRICT,KHARIAN TEHSIL,>=75,19794,3340,23134
GUJRAT DISTRICT,SARAI ALAMGIR TEHSIL,<1,4343,1109,5452
GUJRAT DISTRICT,SARAI ALAMGIR TEHSIL,1,4438,1229,5667
GUJRAT DISTRICT,SARAI ALAMGIR TEHSIL,2,4460,1185,5645
GUJRAT DISTRICT,SARAI ALAMGIR TEHSIL,3,4836,1323,6159
GUJRAT DISTRICT,SARAI ALAMGIR TEHSIL,4,4413,1240,5653
GUJRAT DISTRICT,SARAI ALAMGIR TEHSIL,5,4513,1319,5832
GUJRAT DISTRICT,SARAI ALAMGIR TEHSIL,6,4592,1261,5853
GUJRAT DISTRICT,SARAI ALAMGIR TEHSIL,7,4826,1395,6221
GUJRAT DISTRICT,SARAI ALAMGIR TEHSIL,8,4216,1187,5403
GUJRAT DISTRICT,SARAI ALAMGIR TEHSIL,9,5144,1423,6567
GUJRAT DISTRICT,SARAI ALAMGIR TEHSIL,10,3875,1112,4987
GUJRAT DISTRICT,SARAI ALAMGIR TEHSIL,11,5045,1426,6471
GUJRAT DISTRICT,SARAI ALAMGIR TEHSIL,12,3965,1110,5075
GUJRAT DISTRICT,SARAI ALAMGIR TEHSIL,13,4668,1325,5993
GUJRAT DISTRICT,SARAI ALAMGIR TEHSIL,14,4122,1157,5279
GUJRAT DISTRICT,SARAI ALAMGIR TEHSIL,15,4256,1136,5392
GUJRAT DISTRICT,SARAI ALAMGIR TEHSIL,16,4315,1125,5440
GUJRAT DISTRICT,SARAI ALAMGIR TEHSIL,17,4417,1165,5582
GUJRAT DISTRICT,SARAI ALAMGIR TEHSIL,18,3426,926,4352
GUJRAT DISTRICT,SARAI ALAMGIR TEHSIL,19,4258,1189,5447
GUJRAT DISTRICT,SARAI ALAMGIR TEHSIL,20,3202,905,4107
GUJRAT DISTRICT,SARAI ALAMGIR TEHSIL,21,4174,1279,5453
GUJRAT DISTRICT,SARAI ALAMGIR TEHSIL,22,3293,1024,4317
GUJRAT DISTRICT,SARAI ALAMGIR TEHSIL,23,3558,1063,4621
GUJRAT DISTRICT,SARAI ALAMGIR TEHSIL,24,3407,1075,4482
GUJRAT DISTRICT,SARAI ALAMGIR TEHSIL,25,2573,785,3358
GUJRAT DISTRICT,SARAI ALAMGIR TEHSIL,26,3101,984,4085
GUJRAT DISTRICT,SARAI ALAMGIR TEHSIL,27,3187,970,4157
GUJRAT DISTRICT,SARAI ALAMGIR TEHSIL,28,2877,885,3762
GUJRAT DISTRICT,SARAI ALAMGIR TEHSIL,29,3062,999,4061
GUJRAT DISTRICT,SARAI ALAMGIR TEHSIL,30,2472,780,3252
GUJRAT DISTRICT,SARAI ALAMGIR TEHSIL,31,2995,908,3903
GUJRAT DISTRICT,SARAI ALAMGIR TEHSIL,32,2727,864,3591
GUJRAT DISTRICT,SARAI ALAMGIR TEHSIL,33,2659,898,3557
GUJRAT DISTRICT,SARAI ALAMGIR TEHSIL,34,2464,817,3281
GUJRAT DISTRICT,SARAI ALAMGIR TEHSIL,35,2011,616,2627
GUJRAT DISTRICT,SARAI ALAMGIR TEHSIL,36,2331,708,3039
GUJRAT DISTRICT,SARAI ALAMGIR TEHSIL,37,2144,623,2767
GUJRAT DISTRICT,SARAI ALAMGIR TEHSIL,38,2220,755,2975
GUJRAT DISTRICT,SARAI ALAMGIR TEHSIL,39,2206,717,2923
GUJRAT DISTRICT,SARAI ALAMGIR TEHSIL,40,1850,547,2397
GUJRAT DISTRICT,SARAI ALAMGIR TEHSIL,41,2009,583,2592
GUJRAT DISTRICT,SARAI ALAMGIR TEHSIL,42,1759,563,2322
GUJRAT DISTRICT,SARAI ALAMGIR TEHSIL,43,1914,587,2501
GUJRAT DISTRICT,SARAI ALAMGIR TEHSIL,44,1729,514,2243
GUJRAT DISTRICT,SARAI ALAMGIR TEHSIL,45,1446,473,1919
GUJRAT DISTRICT,SARAI ALAMGIR TEHSIL,46,1594,488,2082
GUJRAT DISTRICT,SARAI ALAMGIR TEHSIL,47,1461,455,1916
GUJRAT DISTRICT,SARAI ALAMGIR TEHSIL,48,1762,536,2298
GUJRAT DISTRICT,SARAI ALAMGIR TEHSIL,49,1758,503,2261
GUJRAT DISTRICT,SARAI ALAMGIR TEHSIL,50,1465,466,1931
GUJRAT DISTRICT,SARAI ALAMGIR TEHSIL,51,1596,486,2082
GUJRAT DISTRICT,SARAI ALAMGIR TEHSIL,52,1538,451,1989
GUJRAT DISTRICT,SARAI ALAMGIR TEHSIL,53,1607,465,2072
GUJRAT DISTRICT,SARAI ALAMGIR TEHSIL,54,1543,443,1986
GUJRAT DISTRICT,SARAI ALAMGIR TEHSIL,55,1218,352,1570
GUJRAT DISTRICT,SARAI ALAMGIR TEHSIL,56,1155,334,1489
GUJRAT DISTRICT,SARAI ALAMGIR TEHSIL,57,1073,295,1368
GUJRAT DISTRICT,SARAI ALAMGIR TEHSIL,58,1203,319,1522
GUJRAT DISTRICT,SARAI ALAMGIR TEHSIL,59,1258,333,1591
GUJRAT DISTRICT,SARAI ALAMGIR TEHSIL,60,1020,266,1286
GUJRAT DISTRICT,SARAI ALAMGIR TEHSIL,61,1158,337,1495
GUJRAT DISTRICT,SARAI ALAMGIR TEHSIL,62,1157,308,1465
GUJRAT DISTRICT,SARAI ALAMGIR TEHSIL,63,1092,291,1383
GUJRAT DISTRICT,SARAI ALAMGIR TEHSIL,64,1023,240,1263
GUJRAT DISTRICT,SARAI ALAMGIR TEHSIL,65,906,182,1088
GUJRAT DISTRICT,SARAI ALAMGIR TEHSIL,66,740,194,934
GUJRAT DISTRICT,SARAI ALAMGIR TEHSIL,67,775,148,923
GUJRAT DISTRICT,SARAI ALAMGIR TEHSIL,68,818,186,1004
GUJRAT DISTRICT,SARAI ALAMGIR TEHSIL,69,769,152,921
GUJRAT DISTRICT,SARAI ALAMGIR TEHSIL,70,656,125,781
GUJRAT DISTRICT,SARAI ALAMGIR TEHSIL,71,625,121,746
GUJRAT DISTRICT,SARAI ALAMGIR TEHSIL,72,646,122,768
GUJRAT DISTRICT,SARAI ALAMGIR TEHSIL,73,613,115,728
GUJRAT DISTRICT,SARAI ALAMGIR TEHSIL,74,545,105,650
GUJRAT DISTRICT,SARAI ALAMGIR TEHSIL,>=75,4185,782,4967
GWADAR DISTRICT,GWADAR TEHSIL,<1,1050,2208,3258
GWADAR DISTRICT,GWADAR TEHSIL,1,1240,2197,3437
GWADAR DISTRICT,GWADAR TEHSIL,2,1299,2412,3711
GWADAR DISTRICT,GWADAR TEHSIL,3,1414,2586,4000
GWADAR DISTRICT,GWADAR TEHSIL,4,1404,2538,3942
GWADAR DISTRICT,GWADAR TEHSIL,5,1530,2591,4121
GWADAR DISTRICT,GWADAR TEHSIL,6,1350,2406,3756
GWADAR DISTRICT,GWADAR TEHSIL,7,1600,2585,4185
GWADAR DISTRICT,GWADAR TEHSIL,8,1493,2701,4194
GWADAR DISTRICT,GWADAR TEHSIL,9,1418,2489,3907
GWADAR DISTRICT,GWADAR TEHSIL,10,1331,2558,3889
GWADAR DISTRICT,GWADAR TEHSIL,11,1353,2150,3503
GWADAR DISTRICT,GWADAR TEHSIL,12,1094,2113,3207
GWADAR DISTRICT,GWADAR TEHSIL,13,1151,1865,3016
GWADAR DISTRICT,GWADAR TEHSIL,14,1001,1835,2836
GWADAR DISTRICT,GWADAR TEHSIL,15,1087,1994,3081
GWADAR DISTRICT,GWADAR TEHSIL,16,1000,1903,2903
GWADAR DISTRICT,GWADAR TEHSIL,17,1090,2113,3203
GWADAR DISTRICT,GWADAR TEHSIL,18,976,2360,3336
GWADAR DISTRICT,GWADAR TEHSIL,19,1049,2215,3264
GWADAR DISTRICT,GWADAR TEHSIL,20,1016,2103,3119
GWADAR DISTRICT,GWADAR TEHSIL,21,880,1881,2761
GWADAR DISTRICT,GWADAR TEHSIL,22,691,1745,2436
GWADAR DISTRICT,GWADAR TEHSIL,23,779,1678,2457
GWADAR DISTRICT,GWADAR TEHSIL,24,742,1469,2211
GWADAR DISTRICT,GWADAR TEHSIL,25,729,1931,2660
GWADAR DISTRICT,GWADAR TEHSIL,26,615,1394,2009
GWADAR DISTRICT,GWADAR TEHSIL,27,891,1681,2572
GWADAR DISTRICT,GWADAR TEHSIL,28,691,1596,2287
GWADAR DISTRICT,GWADAR TEHSIL,29,850,1586,2436
GWADAR DISTRICT,GWADAR TEHSIL,30,692,1721,2413
GWADAR DISTRICT,GWADAR TEHSIL,31,783,1564,2347
GWADAR DISTRICT,GWADAR TEHSIL,32,634,1318,1952
GWADAR DISTRICT,GWADAR TEHSIL,33,625,1362,1987
GWADAR DISTRICT,GWADAR TEHSIL,34,465,1119,1584
GWADAR DISTRICT,GWADAR TEHSIL,35,672,1432,2104
GWADAR DISTRICT,GWADAR TEHSIL,36,524,881,1405
GWADAR DISTRICT,GWADAR TEHSIL,37,893,1085,1978
GWADAR DISTRICT,GWADAR TEHSIL,38,503,1053,1556
GWADAR DISTRICT,GWADAR TEHSIL,39,623,970,1593
GWADAR DISTRICT,GWADAR TEHSIL,40,383,1121,1504
GWADAR DISTRICT,GWADAR TEHSIL,41,414,866,1280
GWADAR DISTRICT,GWADAR TEHSIL,42,461,747,1208
GWADAR DISTRICT,GWADAR TEHSIL,43,382,776,1158
GWADAR DISTRICT,GWADAR TEHSIL,44,353,559,912
GWADAR DISTRICT,GWADAR TEHSIL,45,277,758,1035
GWADAR DISTRICT,GWADAR TEHSIL,46,277,422,699
GWADAR DISTRICT,GWADAR TEHSIL,47,412,530,942
GWADAR DISTRICT,GWADAR TEHSIL,48,271,552,823
GWADAR DISTRICT,GWADAR TEHSIL,49,319,570,889
GWADAR DISTRICT,GWADAR TEHSIL,50,242,636,878
GWADAR DISTRICT,GWADAR TEHSIL,51,293,455,748
GWADAR DISTRICT,GWADAR TEHSIL,52,253,410,663
GWADAR DISTRICT,GWADAR TEHSIL,53,210,474,684
GWADAR DISTRICT,GWADAR TEHSIL,54,230,454,684
GWADAR DISTRICT,GWADAR TEHSIL,55,189,473,662
GWADAR DISTRICT,GWADAR TEHSIL,56,150,310,460
GWADAR DISTRICT,GWADAR TEHSIL,57,227,301,528
GWADAR DISTRICT,GWADAR TEHSIL,58,165,325,490
GWADAR DISTRICT,GWADAR TEHSIL,59,245,394,639
GWADAR DISTRICT,GWADAR TEHSIL,60,146,365,511
GWADAR DISTRICT,GWADAR TEHSIL,61,158,237,395
GWADAR DISTRICT,GWADAR TEHSIL,62,167,254,421
GWADAR DISTRICT,GWADAR TEHSIL,63,164,259,423
GWADAR DISTRICT,GWADAR TEHSIL,64,263,281,544
GWADAR DISTRICT,GWADAR TEHSIL,65,126,294,420
GWADAR DISTRICT,GWADAR TEHSIL,66,90,137,227
GWADAR DISTRICT,GWADAR TEHSIL,67,128,145,273
GWADAR DISTRICT,GWADAR TEHSIL,68,98,160,258
GWADAR DISTRICT,GWADAR TEHSIL,69,257,189,446
GWADAR DISTRICT,GWADAR TEHSIL,70,62,165,227
GWADAR DISTRICT,GWADAR TEHSIL,71,69,110,179
GWADAR DISTRICT,GWADAR TEHSIL,72,62,77,139
GWADAR DISTRICT,GWADAR TEHSIL,73,71,99,170
GWADAR DISTRICT,GWADAR TEHSIL,74,124,126,250
GWADAR DISTRICT,GWADAR TEHSIL,>=75,528,782,1310
GWADAR DISTRICT,JIWANI TEHSIL,<1,218,355,573
GWADAR DISTRICT,JIWANI TEHSIL,1,256,495,751
GWADAR DISTRICT,JIWANI TEHSIL,2,263,548,811
GWADAR DISTRICT,JIWANI TEHSIL,3,292,555,847
GWADAR DISTRICT,JIWANI TEHSIL,4,239,501,740
GWADAR DISTRICT,JIWANI TEHSIL,5,240,486,726
GWADAR DISTRICT,JIWANI TEHSIL,6,238,470,708
GWADAR DISTRICT,JIWANI TEHSIL,7,256,500,756
GWADAR DISTRICT,JIWANI TEHSIL,8,244,554,798
GWADAR DISTRICT,JIWANI TEHSIL,9,241,467,708
GWADAR DISTRICT,JIWANI TEHSIL,10,262,489,751
GWADAR DISTRICT,JIWANI TEHSIL,11,222,493,715
GWADAR DISTRICT,JIWANI TEHSIL,12,183,442,625
GWADAR DISTRICT,JIWANI TEHSIL,13,192,421,613
GWADAR DISTRICT,JIWANI TEHSIL,14,159,402,561
GWADAR DISTRICT,JIWANI TEHSIL,15,167,445,612
GWADAR DISTRICT,JIWANI TEHSIL,16,184,441,625
GWADAR DISTRICT,JIWANI TEHSIL,17,176,477,653
GWADAR DISTRICT,JIWANI TEHSIL,18,196,405,601
GWADAR DISTRICT,JIWANI TEHSIL,19,192,430,622
GWADAR DISTRICT,JIWANI TEHSIL,20,193,470,663
GWADAR DISTRICT,JIWANI TEHSIL,21,149,361,510
GWADAR DISTRICT,JIWANI TEHSIL,22,103,316,419
GWADAR DISTRICT,JIWANI TEHSIL,23,120,304,424
GWADAR DISTRICT,JIWANI TEHSIL,24,111,312,423
GWADAR DISTRICT,JIWANI TEHSIL,25,124,349,473
GWADAR DISTRICT,JIWANI TEHSIL,26,140,221,361
GWADAR DISTRICT,JIWANI TEHSIL,27,127,355,482
GWADAR DISTRICT,JIWANI TEHSIL,28,124,326,450
GWADAR DISTRICT,JIWANI TEHSIL,29,130,284,414
GWADAR DISTRICT,JIWANI TEHSIL,30,145,314,459
GWADAR DISTRICT,JIWANI TEHSIL,31,132,323,455
GWADAR DISTRICT,JIWANI TEHSIL,32,88,255,343
GWADAR DISTRICT,JIWANI TEHSIL,33,112,284,396
GWADAR DISTRICT,JIWANI TEHSIL,34,105,161,266
GWADAR DISTRICT,JIWANI TEHSIL,35,98,268,366
GWADAR DISTRICT,JIWANI TEHSIL,36,147,174,321
GWADAR DISTRICT,JIWANI TEHSIL,37,124,256,380
GWADAR DISTRICT,JIWANI TEHSIL,38,74,217,291
GWADAR DISTRICT,JIWANI TEHSIL,39,94,211,305
GWADAR DISTRICT,JIWANI TEHSIL,40,43,192,235
GWADAR DISTRICT,JIWANI TEHSIL,41,87,147,234
GWADAR DISTRICT,JIWANI TEHSIL,42,62,139,201
GWADAR DISTRICT,JIWANI TEHSIL,43,75,144,219
GWADAR DISTRICT,JIWANI TEHSIL,44,64,110,174
GWADAR DISTRICT,JIWANI TEHSIL,45,38,130,168
GWADAR DISTRICT,JIWANI TEHSIL,46,64,88,152
GWADAR DISTRICT,JIWANI TEHSIL,47,42,144,186
GWADAR DISTRICT,JIWANI TEHSIL,48,37,107,144
GWADAR DISTRICT,JIWANI TEHSIL,49,41,110,151
GWADAR DISTRICT,JIWANI TEHSIL,50,54,123,177
GWADAR DISTRICT,JIWANI TEHSIL,51,46,115,161
GWADAR DISTRICT,JIWANI TEHSIL,52,54,99,153
GWADAR DISTRICT,JIWANI TEHSIL,53,46,97,143
GWADAR DISTRICT,JIWANI TEHSIL,54,41,68,109
GWADAR DISTRICT,JIWANI TEHSIL,55,29,90,119
GWADAR DISTRICT,JIWANI TEHSIL,56,46,74,120
GWADAR DISTRICT,JIWANI TEHSIL,57,35,94,129
GWADAR DISTRICT,JIWANI TEHSIL,58,56,77,133
GWADAR DISTRICT,JIWANI TEHSIL,59,37,84,121
GWADAR DISTRICT,JIWANI TEHSIL,60,37,78,115
GWADAR DISTRICT,JIWANI TEHSIL,61,44,61,105
GWADAR DISTRICT,JIWANI TEHSIL,62,38,64,102
GWADAR DISTRICT,JIWANI TEHSIL,63,61,83,144
GWADAR DISTRICT,JIWANI TEHSIL,64,48,69,117
GWADAR DISTRICT,JIWANI TEHSIL,65,33,55,88
GWADAR DISTRICT,JIWANI TEHSIL,66,29,36,65
GWADAR DISTRICT,JIWANI TEHSIL,67,28,38,66
GWADAR DISTRICT,JIWANI TEHSIL,68,34,44,78
GWADAR DISTRICT,JIWANI TEHSIL,69,38,49,87
GWADAR DISTRICT,JIWANI TEHSIL,70,18,33,51
GWADAR DISTRICT,JIWANI TEHSIL,71,12,27,39
GWADAR DISTRICT,JIWANI TEHSIL,72,13,25,38
GWADAR DISTRICT,JIWANI TEHSIL,73,12,18,30
GWADAR DISTRICT,JIWANI TEHSIL,74,13,34,47
GWADAR DISTRICT,JIWANI TEHSIL,>=75,108,185,293
GWADAR DISTRICT,ORMARA TEHSIL,<1,129,341,470
GWADAR DISTRICT,ORMARA TEHSIL,1,172,483,655
GWADAR DISTRICT,ORMARA TEHSIL,2,213,454,667
GWADAR DISTRICT,ORMARA TEHSIL,3,215,461,676
GWADAR DISTRICT,ORMARA TEHSIL,4,243,430,673
GWADAR DISTRICT,ORMARA TEHSIL,5,250,461,711
GWADAR DISTRICT,ORMARA TEHSIL,6,266,424,690
GWADAR DISTRICT,ORMARA TEHSIL,7,269,490,759
GWADAR DISTRICT,ORMARA TEHSIL,8,285,475,760
GWADAR DISTRICT,ORMARA TEHSIL,9,204,471,675
GWADAR DISTRICT,ORMARA TEHSIL,10,292,471,763
GWADAR DISTRICT,ORMARA TEHSIL,11,172,409,581
GWADAR DISTRICT,ORMARA TEHSIL,12,199,398,597
GWADAR DISTRICT,ORMARA TEHSIL,13,131,366,497
GWADAR DISTRICT,ORMARA TEHSIL,14,174,556,730
GWADAR DISTRICT,ORMARA TEHSIL,15,149,349,498
GWADAR DISTRICT,ORMARA TEHSIL,16,122,315,437
GWADAR DISTRICT,ORMARA TEHSIL,17,109,299,408
GWADAR DISTRICT,ORMARA TEHSIL,18,204,346,550
GWADAR DISTRICT,ORMARA TEHSIL,19,114,386,500
GWADAR DISTRICT,ORMARA TEHSIL,20,149,346,495
GWADAR DISTRICT,ORMARA TEHSIL,21,105,353,458
GWADAR DISTRICT,ORMARA TEHSIL,22,74,291,365
GWADAR DISTRICT,ORMARA TEHSIL,23,61,299,360
GWADAR DISTRICT,ORMARA TEHSIL,24,92,286,378
GWADAR DISTRICT,ORMARA TEHSIL,25,135,353,488
GWADAR DISTRICT,ORMARA TEHSIL,26,100,368,468
GWADAR DISTRICT,ORMARA TEHSIL,27,154,376,530
GWADAR DISTRICT,ORMARA TEHSIL,28,92,261,353
GWADAR DISTRICT,ORMARA TEHSIL,29,98,321,419
GWADAR DISTRICT,ORMARA TEHSIL,30,145,248,393
GWADAR DISTRICT,ORMARA TEHSIL,31,98,361,459
GWADAR DISTRICT,ORMARA TEHSIL,32,121,341,462
GWADAR DISTRICT,ORMARA TEHSIL,33,84,228,312
GWADAR DISTRICT,ORMARA TEHSIL,34,83,194,277
GWADAR DISTRICT,ORMARA TEHSIL,35,115,189,304
GWADAR DISTRICT,ORMARA TEHSIL,36,85,244,329
GWADAR DISTRICT,ORMARA TEHSIL,37,176,272,448
GWADAR DISTRICT,ORMARA TEHSIL,38,96,213,309
GWADAR DISTRICT,ORMARA TEHSIL,39,124,237,361
GWADAR DISTRICT,ORMARA TEHSIL,40,83,187,270
GWADAR DISTRICT,ORMARA TEHSIL,41,98,253,351
GWADAR DISTRICT,ORMARA TEHSIL,42,98,221,319
GWADAR DISTRICT,ORMARA TEHSIL,43,59,177,236
GWADAR DISTRICT,ORMARA TEHSIL,44,32,148,180
GWADAR DISTRICT,ORMARA TEHSIL,45,48,135,183
GWADAR DISTRICT,ORMARA TEHSIL,46,49,176,225
GWADAR DISTRICT,ORMARA TEHSIL,47,85,206,291
GWADAR DISTRICT,ORMARA TEHSIL,48,46,130,176
GWADAR DISTRICT,ORMARA TEHSIL,49,45,153,198
GWADAR DISTRICT,ORMARA TEHSIL,50,54,93,147
GWADAR DISTRICT,ORMARA TEHSIL,51,64,164,228
GWADAR DISTRICT,ORMARA TEHSIL,52,73,111,184
GWADAR DISTRICT,ORMARA TEHSIL,53,34,105,139
GWADAR DISTRICT,ORMARA TEHSIL,54,33,74,107
GWADAR DISTRICT,ORMARA TEHSIL,55,36,59,95
GWADAR DISTRICT,ORMARA TEHSIL,56,44,88,132
GWADAR DISTRICT,ORMARA TEHSIL,57,96,151,247
GWADAR DISTRICT,ORMARA TEHSIL,58,39,110,149
GWADAR DISTRICT,ORMARA TEHSIL,59,53,113,166
GWADAR DISTRICT,ORMARA TEHSIL,60,35,44,79
GWADAR DISTRICT,ORMARA TEHSIL,61,31,67,98
GWADAR DISTRICT,ORMARA TEHSIL,62,37,56,93
GWADAR DISTRICT,ORMARA TEHSIL,63,41,60,101
GWADAR DISTRICT,ORMARA TEHSIL,64,56,81,137
GWADAR DISTRICT,ORMARA TEHSIL,65,23,44,67
GWADAR DISTRICT,ORMARA TEHSIL,66,18,24,42
GWADAR DISTRICT,ORMARA TEHSIL,67,32,40,72
GWADAR DISTRICT,ORMARA TEHSIL,68,41,50,91
GWADAR DISTRICT,ORMARA TEHSIL,69,55,56,111
GWADAR DISTRICT,ORMARA TEHSIL,70,23,19,42
GWADAR DISTRICT,ORMARA TEHSIL,71,20,21,41
GWADAR DISTRICT,ORMARA TEHSIL,72,14,10,24
GWADAR DISTRICT,ORMARA TEHSIL,73,14,26,40
GWADAR DISTRICT,ORMARA TEHSIL,74,31,22,53
GWADAR DISTRICT,ORMARA TEHSIL,>=75,142,113,255
GWADAR DISTRICT,PASNI TEHSIL,<1,646,779,1425
GWADAR DISTRICT,PASNI TEHSIL,1,601,794,1395
GWADAR DISTRICT,PASNI TEHSIL,2,726,849,1575
GWADAR DISTRICT,PASNI TEHSIL,3,861,894,1755
GWADAR DISTRICT,PASNI TEHSIL,4,727,848,1575
GWADAR DISTRICT,PASNI TEHSIL,5,903,882,1785
GWADAR DISTRICT,PASNI TEHSIL,6,816,831,1647
GWADAR DISTRICT,PASNI TEHSIL,7,784,964,1748
GWADAR DISTRICT,PASNI TEHSIL,8,941,849,1790
GWADAR DISTRICT,PASNI TEHSIL,9,674,876,1550
GWADAR DISTRICT,PASNI TEHSIL,10,871,853,1724
GWADAR DISTRICT,PASNI TEHSIL,11,625,843,1468
GWADAR DISTRICT,PASNI TEHSIL,12,754,771,1525
GWADAR DISTRICT,PASNI TEHSIL,13,618,786,1404
GWADAR DISTRICT,PASNI TEHSIL,14,699,718,1417
GWADAR DISTRICT,PASNI TEHSIL,15,657,766,1423
GWADAR DISTRICT,PASNI TEHSIL,16,608,753,1361
GWADAR DISTRICT,PASNI TEHSIL,17,652,834,1486
GWADAR DISTRICT,PASNI TEHSIL,18,588,698,1286
GWADAR DISTRICT,PASNI TEHSIL,19,487,726,1213
GWADAR DISTRICT,PASNI TEHSIL,20,584,634,1218
GWADAR DISTRICT,PASNI TEHSIL,21,413,691,1104
GWADAR DISTRICT,PASNI TEHSIL,22,322,623,945
GWADAR DISTRICT,PASNI TEHSIL,23,351,535,886
GWADAR DISTRICT,PASNI TEHSIL,24,321,520,841
GWADAR DISTRICT,PASNI TEHSIL,25,491,619,1110
GWADAR DISTRICT,PASNI TEHSIL,26,293,627,920
GWADAR DISTRICT,PASNI TEHSIL,27,409,699,1108
GWADAR DISTRICT,PASNI TEHSIL,28,403,599,1002
GWADAR DISTRICT,PASNI TEHSIL,29,363,746,1109
GWADAR DISTRICT,PASNI TEHSIL,30,433,577,1010
GWADAR DISTRICT,PASNI TEHSIL,31,398,682,1080
GWADAR DISTRICT,PASNI TEHSIL,32,367,574,941
GWADAR DISTRICT,PASNI TEHSIL,33,324,526,850
GWADAR DISTRICT,PASNI TEHSIL,34,209,434,643
GWADAR DISTRICT,PASNI TEHSIL,35,369,423,792
GWADAR DISTRICT,PASNI TEHSIL,36,217,356,573
GWADAR DISTRICT,PASNI TEHSIL,37,402,518,920
GWADAR DISTRICT,PASNI TEHSIL,38,266,370,636
GWADAR DISTRICT,PASNI TEHSIL,39,293,467,760
GWADAR DISTRICT,PASNI TEHSIL,40,313,403,716
GWADAR DISTRICT,PASNI TEHSIL,41,232,509,741
GWADAR DISTRICT,PASNI TEHSIL,42,265,422,687
GWADAR DISTRICT,PASNI TEHSIL,43,221,359,580
GWADAR DISTRICT,PASNI TEHSIL,44,188,245,433
GWADAR DISTRICT,PASNI TEHSIL,45,217,254,471
GWADAR DISTRICT,PASNI TEHSIL,46,120,251,371
GWADAR DISTRICT,PASNI TEHSIL,47,211,334,545
GWADAR DISTRICT,PASNI TEHSIL,48,123,228,351
GWADAR DISTRICT,PASNI TEHSIL,49,159,296,455
GWADAR DISTRICT,PASNI TEHSIL,50,191,198,389
GWADAR DISTRICT,PASNI TEHSIL,51,146,233,379
GWADAR DISTRICT,PASNI TEHSIL,52,149,213,362
GWADAR DISTRICT,PASNI TEHSIL,53,150,202,352
GWADAR DISTRICT,PASNI TEHSIL,54,159,178,337
GWADAR DISTRICT,PASNI TEHSIL,55,133,121,254
GWADAR DISTRICT,PASNI TEHSIL,56,99,144,243
GWADAR DISTRICT,PASNI TEHSIL,57,147,183,330
GWADAR DISTRICT,PASNI TEHSIL,58,96,158,254
GWADAR DISTRICT,PASNI TEHSIL,59,129,198,327
GWADAR DISTRICT,PASNI TEHSIL,60,132,150,282
GWADAR DISTRICT,PASNI TEHSIL,61,106,167,273
GWADAR DISTRICT,PASNI TEHSIL,62,116,144,260
GWADAR DISTRICT,PASNI TEHSIL,63,112,146,258
GWADAR DISTRICT,PASNI TEHSIL,64,143,154,297
GWADAR DISTRICT,PASNI TEHSIL,65,108,124,232
GWADAR DISTRICT,PASNI TEHSIL,66,59,80,139
GWADAR DISTRICT,PASNI TEHSIL,67,89,88,177
GWADAR DISTRICT,PASNI TEHSIL,68,67,92,159
GWADAR DISTRICT,PASNI TEHSIL,69,134,105,239
GWADAR DISTRICT,PASNI TEHSIL,70,99,81,180
GWADAR DISTRICT,PASNI TEHSIL,71,51,50,101
GWADAR DISTRICT,PASNI TEHSIL,72,56,52,108
GWADAR DISTRICT,PASNI TEHSIL,73,62,51,113
GWADAR DISTRICT,PASNI TEHSIL,74,75,74,149
GWADAR DISTRICT,PASNI TEHSIL,>=75,467,336,803
GWADAR DISTRICT,SUNTSER SUB-TEHSIL,<1,312,0,312
GWADAR DISTRICT,SUNTSER SUB-TEHSIL,1,351,0,351
GWADAR DISTRICT,SUNTSER SUB-TEHSIL,2,344,0,344
GWADAR DISTRICT,SUNTSER SUB-TEHSIL,3,410,0,410
GWADAR DISTRICT,SUNTSER SUB-TEHSIL,4,345,0,345
GWADAR DISTRICT,SUNTSER SUB-TEHSIL,5,417,0,417
GWADAR DISTRICT,SUNTSER SUB-TEHSIL,6,339,0,339
GWADAR DISTRICT,SUNTSER SUB-TEHSIL,7,385,0,385
GWADAR DISTRICT,SUNTSER SUB-TEHSIL,8,353,0,353
GWADAR DISTRICT,SUNTSER SUB-TEHSIL,9,318,0,318
GWADAR DISTRICT,SUNTSER SUB-TEHSIL,10,308,0,308
GWADAR DISTRICT,SUNTSER SUB-TEHSIL,11,282,0,282
GWADAR DISTRICT,SUNTSER SUB-TEHSIL,12,266,0,266
GWADAR DISTRICT,SUNTSER SUB-TEHSIL,13,263,0,263
GWADAR DISTRICT,SUNTSER SUB-TEHSIL,14,221,0,221
GWADAR DISTRICT,SUNTSER SUB-TEHSIL,15,274,0,274
GWADAR DISTRICT,SUNTSER SUB-TEHSIL,16,223,0,223
GWADAR DISTRICT,SUNTSER SUB-TEHSIL,17,293,0,293
GWADAR DISTRICT,SUNTSER SUB-TEHSIL,18,240,0,240
GWADAR DISTRICT,SUNTSER SUB-TEHSIL,19,227,0,227
GWADAR DISTRICT,SUNTSER SUB-TEHSIL,20,201,0,201
GWADAR DISTRICT,SUNTSER SUB-TEHSIL,21,181,0,181
GWADAR DISTRICT,SUNTSER SUB-TEHSIL,22,127,0,127
GWADAR DISTRICT,SUNTSER SUB-TEHSIL,23,146,0,146
GWADAR DISTRICT,SUNTSER SUB-TEHSIL,24,118,0,118
GWADAR DISTRICT,SUNTSER SUB-TEHSIL,25,147,0,147
GWADAR DISTRICT,SUNTSER SUB-TEHSIL,26,112,0,112
GWADAR DISTRICT,SUNTSER SUB-TEHSIL,27,164,0,164
GWADAR DISTRICT,SUNTSER SUB-TEHSIL,28,143,0,143
GWADAR DISTRICT,SUNTSER SUB-TEHSIL,29,156,0,156
GWADAR DISTRICT,SUNTSER SUB-TEHSIL,30,153,0,153
GWADAR DISTRICT,SUNTSER SUB-TEHSIL,31,207,0,207
GWADAR DISTRICT,SUNTSER SUB-TEHSIL,32,168,0,168
GWADAR DISTRICT,SUNTSER SUB-TEHSIL,33,137,0,137
GWADAR DISTRICT,SUNTSER SUB-TEHSIL,34,124,0,124
GWADAR DISTRICT,SUNTSER SUB-TEHSIL,35,144,0,144
GWADAR DISTRICT,SUNTSER SUB-TEHSIL,36,142,0,142
GWADAR DISTRICT,SUNTSER SUB-TEHSIL,37,189,0,189
GWADAR DISTRICT,SUNTSER SUB-TEHSIL,38,113,0,113
GWADAR DISTRICT,SUNTSER SUB-TEHSIL,39,118,0,118
GWADAR DISTRICT,SUNTSER SUB-TEHSIL,40,67,0,67
GWADAR DISTRICT,SUNTSER SUB-TEHSIL,41,93,0,93
GWADAR DISTRICT,SUNTSER SUB-TEHSIL,42,100,0,100
GWADAR DISTRICT,SUNTSER SUB-TEHSIL,43,64,0,64
GWADAR DISTRICT,SUNTSER SUB-TEHSIL,44,67,0,67
GWADAR DISTRICT,SUNTSER SUB-TEHSIL,45,42,0,42
GWADAR DISTRICT,SUNTSER SUB-TEHSIL,46,73,0,73
GWADAR DISTRICT,SUNTSER SUB-TEHSIL,47,61,0,61
GWADAR DISTRICT,SUNTSER SUB-TEHSIL,48,43,0,43
GWADAR DISTRICT,SUNTSER SUB-TEHSIL,49,70,0,70
GWADAR DISTRICT,SUNTSER SUB-TEHSIL,50,46,0,46
GWADAR DISTRICT,SUNTSER SUB-TEHSIL,51,49,0,49
GWADAR DISTRICT,SUNTSER SUB-TEHSIL,52,42,0,42
GWADAR DISTRICT,SUNTSER SUB-TEHSIL,53,37,0,37
GWADAR DISTRICT,SUNTSER SUB-TEHSIL,54,52,0,52
GWADAR DISTRICT,SUNTSER SUB-TEHSIL,55,22,0,22
GWADAR DISTRICT,SUNTSER SUB-TEHSIL,56,47,0,47
GWADAR DISTRICT,SUNTSER SUB-TEHSIL,57,31,0,31
GWADAR DISTRICT,SUNTSER SUB-TEHSIL,58,31,0,31
GWADAR DISTRICT,SUNTSER SUB-TEHSIL,59,47,0,47
GWADAR DISTRICT,SUNTSER SUB-TEHSIL,60,30,0,30
GWADAR DISTRICT,SUNTSER SUB-TEHSIL,61,34,0,34
GWADAR DISTRICT,SUNTSER SUB-TEHSIL,62,48,0,48
GWADAR DISTRICT,SUNTSER SUB-TEHSIL,63,40,0,40
GWADAR DISTRICT,SUNTSER SUB-TEHSIL,64,58,0,58
GWADAR DISTRICT,SUNTSER SUB-TEHSIL,65,19,0,19
GWADAR DISTRICT,SUNTSER SUB-TEHSIL,66,28,0,28
GWADAR DISTRICT,SUNTSER SUB-TEHSIL,67,38,0,38
GWADAR DISTRICT,SUNTSER SUB-TEHSIL,68,36,0,36
GWADAR DISTRICT,SUNTSER SUB-TEHSIL,69,46,0,46
GWADAR DISTRICT,SUNTSER SUB-TEHSIL,70,17,0,17
GWADAR DISTRICT,SUNTSER SUB-TEHSIL,71,23,0,23
GWADAR DISTRICT,SUNTSER SUB-TEHSIL,72,14,0,14
GWADAR DISTRICT,SUNTSER SUB-TEHSIL,73,22,0,22
GWADAR DISTRICT,SUNTSER SUB-TEHSIL,74,30,0,30
GWADAR DISTRICT,SUNTSER SUB-TEHSIL,>=75,158,0,158
HAFIZABAD DISTRICT,HAFIZABAD TEHSIL,<1,9437,6097,15534
HAFIZABAD DISTRICT,HAFIZABAD TEHSIL,1,9908,6344,16252
HAFIZABAD DISTRICT,HAFIZABAD TEHSIL,2,9854,6074,15928
HAFIZABAD DISTRICT,HAFIZABAD TEHSIL,3,10750,6624,17374
HAFIZABAD DISTRICT,HAFIZABAD TEHSIL,4,10959,6618,17577
HAFIZABAD DISTRICT,HAFIZABAD TEHSIL,5,10513,6282,16795
HAFIZABAD DISTRICT,HAFIZABAD TEHSIL,6,10568,6422,16990
HAFIZABAD DISTRICT,HAFIZABAD TEHSIL,7,11137,7053,18190
HAFIZABAD DISTRICT,HAFIZABAD TEHSIL,8,10718,6349,17067
HAFIZABAD DISTRICT,HAFIZABAD TEHSIL,9,10564,6744,17308
HAFIZABAD DISTRICT,HAFIZABAD TEHSIL,10,9988,5940,15928
HAFIZABAD DISTRICT,HAFIZABAD TEHSIL,11,9933,6679,16612
HAFIZABAD DISTRICT,HAFIZABAD TEHSIL,12,9426,5958,15384
HAFIZABAD DISTRICT,HAFIZABAD TEHSIL,13,9140,6223,15363
HAFIZABAD DISTRICT,HAFIZABAD TEHSIL,14,8768,5848,14616
HAFIZABAD DISTRICT,HAFIZABAD TEHSIL,15,8721,5661,14382
HAFIZABAD DISTRICT,HAFIZABAD TEHSIL,16,8816,6032,14848
HAFIZABAD DISTRICT,HAFIZABAD TEHSIL,17,8364,5900,14264
HAFIZABAD DISTRICT,HAFIZABAD TEHSIL,18,8218,5425,13643
HAFIZABAD DISTRICT,HAFIZABAD TEHSIL,19,7998,5669,13667
HAFIZABAD DISTRICT,HAFIZABAD TEHSIL,20,7460,4955,12415
HAFIZABAD DISTRICT,HAFIZABAD TEHSIL,21,7454,5484,12938
HAFIZABAD DISTRICT,HAFIZABAD TEHSIL,22,7243,5232,12475
HAFIZABAD DISTRICT,HAFIZABAD TEHSIL,23,6606,4880,11486
HAFIZABAD DISTRICT,HAFIZABAD TEHSIL,24,6406,4840,11246
HAFIZABAD DISTRICT,HAFIZABAD TEHSIL,25,6463,4338,10801
HAFIZABAD DISTRICT,HAFIZABAD TEHSIL,26,6266,4825,11091
HAFIZABAD DISTRICT,HAFIZABAD TEHSIL,27,5622,4300,9922
HAFIZABAD DISTRICT,HAFIZABAD TEHSIL,28,5925,4377,10302
HAFIZABAD DISTRICT,HAFIZABAD TEHSIL,29,5218,3807,9025
HAFIZABAD DISTRICT,HAFIZABAD TEHSIL,30,6132,4475,10607
HAFIZABAD DISTRICT,HAFIZABAD TEHSIL,31,5060,3699,8759
HAFIZABAD DISTRICT,HAFIZABAD TEHSIL,32,5207,3944,9151
HAFIZABAD DISTRICT,HAFIZABAD TEHSIL,33,4785,3570,8355
HAFIZABAD DISTRICT,HAFIZABAD TEHSIL,34,4693,3434,8127
HAFIZABAD DISTRICT,HAFIZABAD TEHSIL,35,5180,3614,8794
HAFIZABAD DISTRICT,HAFIZABAD TEHSIL,36,5129,3319,8448
HAFIZABAD DISTRICT,HAFIZABAD TEHSIL,37,4417,2799,7216
HAFIZABAD DISTRICT,HAFIZABAD TEHSIL,38,4715,3422,8137
HAFIZABAD DISTRICT,HAFIZABAD TEHSIL,39,4587,2959,7546
HAFIZABAD DISTRICT,HAFIZABAD TEHSIL,40,4732,3443,8175
HAFIZABAD DISTRICT,HAFIZABAD TEHSIL,41,4195,2803,6998
HAFIZABAD DISTRICT,HAFIZABAD TEHSIL,42,3891,2756,6647
HAFIZABAD DISTRICT,HAFIZABAD TEHSIL,43,3595,2476,6071
HAFIZABAD DISTRICT,HAFIZABAD TEHSIL,44,3513,2384,5897
HAFIZABAD DISTRICT,HAFIZABAD TEHSIL,45,3507,2528,6035
HAFIZABAD DISTRICT,HAFIZABAD TEHSIL,46,3304,2142,5446
HAFIZABAD DISTRICT,HAFIZABAD TEHSIL,47,3116,1983,5099
HAFIZABAD DISTRICT,HAFIZABAD TEHSIL,48,3355,2376,5731
HAFIZABAD DISTRICT,HAFIZABAD TEHSIL,49,3255,2143,5398
HAFIZABAD DISTRICT,HAFIZABAD TEHSIL,50,3369,2444,5813
HAFIZABAD DISTRICT,HAFIZABAD TEHSIL,51,3187,2045,5232
HAFIZABAD DISTRICT,HAFIZABAD TEHSIL,52,2807,1957,4764
HAFIZABAD DISTRICT,HAFIZABAD TEHSIL,53,2671,1902,4573
HAFIZABAD DISTRICT,HAFIZABAD TEHSIL,54,2451,1837,4288
HAFIZABAD DISTRICT,HAFIZABAD TEHSIL,55,2415,1831,4246
HAFIZABAD DISTRICT,HAFIZABAD TEHSIL,56,2138,1360,3498
HAFIZABAD DISTRICT,HAFIZABAD TEHSIL,57,1779,1031,2810
HAFIZABAD DISTRICT,HAFIZABAD TEHSIL,58,2079,1296,3375
HAFIZABAD DISTRICT,HAFIZABAD TEHSIL,59,2047,1281,3328
HAFIZABAD DISTRICT,HAFIZABAD TEHSIL,60,2308,1498,3806
HAFIZABAD DISTRICT,HAFIZABAD TEHSIL,61,1939,1133,3072
HAFIZABAD DISTRICT,HAFIZABAD TEHSIL,62,1668,1089,2757
HAFIZABAD DISTRICT,HAFIZABAD TEHSIL,63,1818,1108,2926
HAFIZABAD DISTRICT,HAFIZABAD TEHSIL,64,1698,945,2643
HAFIZABAD DISTRICT,HAFIZABAD TEHSIL,65,1720,1003,2723
HAFIZABAD DISTRICT,HAFIZABAD TEHSIL,66,1302,687,1989
HAFIZABAD DISTRICT,HAFIZABAD TEHSIL,67,1129,489,1618
HAFIZABAD DISTRICT,HAFIZABAD TEHSIL,68,1231,627,1858
HAFIZABAD DISTRICT,HAFIZABAD TEHSIL,69,1316,601,1917
HAFIZABAD DISTRICT,HAFIZABAD TEHSIL,70,1558,759,2317
HAFIZABAD DISTRICT,HAFIZABAD TEHSIL,71,1137,578,1715
HAFIZABAD DISTRICT,HAFIZABAD TEHSIL,72,1006,481,1487
HAFIZABAD DISTRICT,HAFIZABAD TEHSIL,73,997,512,1509
HAFIZABAD DISTRICT,HAFIZABAD TEHSIL,74,958,414,1372
HAFIZABAD DISTRICT,HAFIZABAD TEHSIL,>=75,8510,3710,12220
HAFIZABAD DISTRICT,PINDI BHATTIAN TEHSIL,<1,8808,3373,12181
HAFIZABAD DISTRICT,PINDI BHATTIAN TEHSIL,1,8876,3578,12454
HAFIZABAD DISTRICT,PINDI BHATTIAN TEHSIL,2,9305,3562,12867
HAFIZABAD DISTRICT,PINDI BHATTIAN TEHSIL,3,9923,3911,13834
HAFIZABAD DISTRICT,PINDI BHATTIAN TEHSIL,4,10250,3754,14004
HAFIZABAD DISTRICT,PINDI BHATTIAN TEHSIL,5,9884,3693,13577
HAFIZABAD DISTRICT,PINDI BHATTIAN TEHSIL,6,9998,3712,13710
HAFIZABAD DISTRICT,PINDI BHATTIAN TEHSIL,7,10151,3785,13936
HAFIZABAD DISTRICT,PINDI BHATTIAN TEHSIL,8,10082,3635,13717
HAFIZABAD DISTRICT,PINDI BHATTIAN TEHSIL,9,9333,3737,13070
HAFIZABAD DISTRICT,PINDI BHATTIAN TEHSIL,10,9029,3390,12419
HAFIZABAD DISTRICT,PINDI BHATTIAN TEHSIL,11,8377,3529,11906
HAFIZABAD DISTRICT,PINDI BHATTIAN TEHSIL,12,8116,3161,11277
HAFIZABAD DISTRICT,PINDI BHATTIAN TEHSIL,13,7507,3242,10749
HAFIZABAD DISTRICT,PINDI BHATTIAN TEHSIL,14,7346,3005,10351
HAFIZABAD DISTRICT,PINDI BHATTIAN TEHSIL,15,7218,2923,10141
HAFIZABAD DISTRICT,PINDI BHATTIAN TEHSIL,16,7122,3071,10193
HAFIZABAD DISTRICT,PINDI BHATTIAN TEHSIL,17,6908,2981,9889
HAFIZABAD DISTRICT,PINDI BHATTIAN TEHSIL,18,6968,2838,9806
HAFIZABAD DISTRICT,PINDI BHATTIAN TEHSIL,19,6569,2967,9536
HAFIZABAD DISTRICT,PINDI BHATTIAN TEHSIL,20,6708,2742,9450
HAFIZABAD DISTRICT,PINDI BHATTIAN TEHSIL,21,6205,2822,9027
HAFIZABAD DISTRICT,PINDI BHATTIAN TEHSIL,22,6260,2578,8838
HAFIZABAD DISTRICT,PINDI BHATTIAN TEHSIL,23,5497,2432,7929
HAFIZABAD DISTRICT,PINDI BHATTIAN TEHSIL,24,5267,2322,7589
HAFIZABAD DISTRICT,PINDI BHATTIAN TEHSIL,25,5823,2319,8142
HAFIZABAD DISTRICT,PINDI BHATTIAN TEHSIL,26,5229,2367,7596
HAFIZABAD DISTRICT,PINDI BHATTIAN TEHSIL,27,5053,2190,7243
HAFIZABAD DISTRICT,PINDI BHATTIAN TEHSIL,28,5007,2139,7146
HAFIZABAD DISTRICT,PINDI BHATTIAN TEHSIL,29,5073,2244,7317
HAFIZABAD DISTRICT,PINDI BHATTIAN TEHSIL,30,5340,2083,7423
HAFIZABAD DISTRICT,PINDI BHATTIAN TEHSIL,31,4737,2166,6903
HAFIZABAD DISTRICT,PINDI BHATTIAN TEHSIL,32,4421,2010,6431
HAFIZABAD DISTRICT,PINDI BHATTIAN TEHSIL,33,4206,1904,6110
HAFIZABAD DISTRICT,PINDI BHATTIAN TEHSIL,34,4270,1764,6034
HAFIZABAD DISTRICT,PINDI BHATTIAN TEHSIL,35,4554,1713,6267
HAFIZABAD DISTRICT,PINDI BHATTIAN TEHSIL,36,4658,1723,6381
HAFIZABAD DISTRICT,PINDI BHATTIAN TEHSIL,37,4369,1602,5971
HAFIZABAD DISTRICT,PINDI BHATTIAN TEHSIL,38,3994,1656,5650
HAFIZABAD DISTRICT,PINDI BHATTIAN TEHSIL,39,4171,1599,5770
HAFIZABAD DISTRICT,PINDI BHATTIAN TEHSIL,40,3756,1516,5272
HAFIZABAD DISTRICT,PINDI BHATTIAN TEHSIL,41,4119,1556,5675
HAFIZABAD DISTRICT,PINDI BHATTIAN TEHSIL,42,3609,1227,4836
HAFIZABAD DISTRICT,PINDI BHATTIAN TEHSIL,43,3047,1261,4308
HAFIZABAD DISTRICT,PINDI BHATTIAN TEHSIL,44,2935,1172,4107
HAFIZABAD DISTRICT,PINDI BHATTIAN TEHSIL,45,2883,1148,4031
HAFIZABAD DISTRICT,PINDI BHATTIAN TEHSIL,46,3220,1176,4396
HAFIZABAD DISTRICT,PINDI BHATTIAN TEHSIL,47,3021,1043,4064
HAFIZABAD DISTRICT,PINDI BHATTIAN TEHSIL,48,2784,1111,3895
HAFIZABAD DISTRICT,PINDI BHATTIAN TEHSIL,49,2783,1113,3896
HAFIZABAD DISTRICT,PINDI BHATTIAN TEHSIL,50,2657,1060,3717
HAFIZABAD DISTRICT,PINDI BHATTIAN TEHSIL,51,2891,1189,4080
HAFIZABAD DISTRICT,PINDI BHATTIAN TEHSIL,52,2698,996,3694
HAFIZABAD DISTRICT,PINDI BHATTIAN TEHSIL,53,2482,1015,3497
HAFIZABAD DISTRICT,PINDI BHATTIAN TEHSIL,54,2096,890,2986
HAFIZABAD DISTRICT,PINDI BHATTIAN TEHSIL,55,1850,709,2559
HAFIZABAD DISTRICT,PINDI BHATTIAN TEHSIL,56,2125,700,2825
HAFIZABAD DISTRICT,PINDI BHATTIAN TEHSIL,57,1877,619,2496
HAFIZABAD DISTRICT,PINDI BHATTIAN TEHSIL,58,1709,612,2321
HAFIZABAD DISTRICT,PINDI BHATTIAN TEHSIL,59,1788,623,2411
HAFIZABAD DISTRICT,PINDI BHATTIAN TEHSIL,60,1860,614,2474
HAFIZABAD DISTRICT,PINDI BHATTIAN TEHSIL,61,1839,568,2407
HAFIZABAD DISTRICT,PINDI BHATTIAN TEHSIL,62,1622,515,2137
HAFIZABAD DISTRICT,PINDI BHATTIAN TEHSIL,63,1593,544,2137
HAFIZABAD DISTRICT,PINDI BHATTIAN TEHSIL,64,1506,460,1966
HAFIZABAD DISTRICT,PINDI BHATTIAN TEHSIL,65,1482,432,1914
HAFIZABAD DISTRICT,PINDI BHATTIAN TEHSIL,66,1420,391,1811
HAFIZABAD DISTRICT,PINDI BHATTIAN TEHSIL,67,1171,327,1498
HAFIZABAD DISTRICT,PINDI BHATTIAN TEHSIL,68,1126,321,1447
HAFIZABAD DISTRICT,PINDI BHATTIAN TEHSIL,69,1227,367,1594
HAFIZABAD DISTRICT,PINDI BHATTIAN TEHSIL,70,1263,373,1636
HAFIZABAD DISTRICT,PINDI BHATTIAN TEHSIL,71,1042,309,1351
HAFIZABAD DISTRICT,PINDI BHATTIAN TEHSIL,72,900,263,1163
HAFIZABAD DISTRICT,PINDI BHATTIAN TEHSIL,73,832,247,1079
HAFIZABAD DISTRICT,PINDI BHATTIAN TEHSIL,74,914,225,1139
HAFIZABAD DISTRICT,PINDI BHATTIAN TEHSIL,>=75,7437,1948,9385
HANGU DISTRICT,HANGU TEHSIL,<1,6130,1229,7359
HANGU DISTRICT,HANGU TEHSIL,1,6445,1439,7884
HANGU DISTRICT,HANGU TEHSIL,2,7246,1446,8692
HANGU DISTRICT,HANGU TEHSIL,3,7893,1608,9501
HANGU DISTRICT,HANGU TEHSIL,4,7256,1577,8833
HANGU DISTRICT,HANGU TEHSIL,5,7395,1444,8839
HANGU DISTRICT,HANGU TEHSIL,6,6888,1433,8321
HANGU DISTRICT,HANGU TEHSIL,7,7254,1487,8741
HANGU DISTRICT,HANGU TEHSIL,8,6897,1391,8288
HANGU DISTRICT,HANGU TEHSIL,9,6934,1417,8351
HANGU DISTRICT,HANGU TEHSIL,10,6383,1187,7570
HANGU DISTRICT,HANGU TEHSIL,11,6365,1326,7691
HANGU DISTRICT,HANGU TEHSIL,12,5724,1184,6908
HANGU DISTRICT,HANGU TEHSIL,13,5996,1322,7318
HANGU DISTRICT,HANGU TEHSIL,14,5543,1146,6689
HANGU DISTRICT,HANGU TEHSIL,15,5786,1222,7008
HANGU DISTRICT,HANGU TEHSIL,16,5432,1088,6520
HANGU DISTRICT,HANGU TEHSIL,17,5223,1104,6327
HANGU DISTRICT,HANGU TEHSIL,18,4916,1022,5938
HANGU DISTRICT,HANGU TEHSIL,19,4863,1017,5880
HANGU DISTRICT,HANGU TEHSIL,20,4224,847,5071
HANGU DISTRICT,HANGU TEHSIL,21,4031,891,4922
HANGU DISTRICT,HANGU TEHSIL,22,3615,787,4402
HANGU DISTRICT,HANGU TEHSIL,23,4094,860,4954
HANGU DISTRICT,HANGU TEHSIL,24,3550,802,4352
HANGU DISTRICT,HANGU TEHSIL,25,3833,773,4606
HANGU DISTRICT,HANGU TEHSIL,26,3540,800,4340
HANGU DISTRICT,HANGU TEHSIL,27,3562,871,4433
HANGU DISTRICT,HANGU TEHSIL,28,3181,789,3970
HANGU DISTRICT,HANGU TEHSIL,29,3222,763,3985
HANGU DISTRICT,HANGU TEHSIL,30,3192,724,3916
HANGU DISTRICT,HANGU TEHSIL,31,2901,724,3625
HANGU DISTRICT,HANGU TEHSIL,32,2285,666,2951
HANGU DISTRICT,HANGU TEHSIL,33,2520,680,3200
HANGU DISTRICT,HANGU TEHSIL,34,2091,497,2588
HANGU DISTRICT,HANGU TEHSIL,35,2222,545,2767
HANGU DISTRICT,HANGU TEHSIL,36,1828,441,2269
HANGU DISTRICT,HANGU TEHSIL,37,1799,493,2292
HANGU DISTRICT,HANGU TEHSIL,38,1884,505,2389
HANGU DISTRICT,HANGU TEHSIL,39,1719,450,2169
HANGU DISTRICT,HANGU TEHSIL,40,1989,524,2513
HANGU DISTRICT,HANGU TEHSIL,41,1515,419,1934
HANGU DISTRICT,HANGU TEHSIL,42,1302,358,1660
HANGU DISTRICT,HANGU TEHSIL,43,1481,374,1855
HANGU DISTRICT,HANGU TEHSIL,44,1178,350,1528
HANGU DISTRICT,HANGU TEHSIL,45,1444,348,1792
HANGU DISTRICT,HANGU TEHSIL,46,1120,265,1385
HANGU DISTRICT,HANGU TEHSIL,47,1098,303,1401
HANGU DISTRICT,HANGU TEHSIL,48,1186,299,1485
HANGU DISTRICT,HANGU TEHSIL,49,1121,257,1378
HANGU DISTRICT,HANGU TEHSIL,50,1530,358,1888
HANGU DISTRICT,HANGU TEHSIL,51,1073,262,1335
HANGU DISTRICT,HANGU TEHSIL,52,1004,285,1289
HANGU DISTRICT,HANGU TEHSIL,53,1111,280,1391
HANGU DISTRICT,HANGU TEHSIL,54,919,247,1166
HANGU DISTRICT,HANGU TEHSIL,55,1187,276,1463
HANGU DISTRICT,HANGU TEHSIL,56,855,184,1039
HANGU DISTRICT,HANGU TEHSIL,57,783,212,995
HANGU DISTRICT,HANGU TEHSIL,58,883,224,1107
HANGU DISTRICT,HANGU TEHSIL,59,805,227,1032
HANGU DISTRICT,HANGU TEHSIL,60,1070,224,1294
HANGU DISTRICT,HANGU TEHSIL,61,883,222,1105
HANGU DISTRICT,HANGU TEHSIL,62,813,202,1015
HANGU DISTRICT,HANGU TEHSIL,63,878,214,1092
HANGU DISTRICT,HANGU TEHSIL,64,774,174,948
HANGU DISTRICT,HANGU TEHSIL,65,775,173,948
HANGU DISTRICT,HANGU TEHSIL,66,601,111,712
HANGU DISTRICT,HANGU TEHSIL,67,635,164,799
HANGU DISTRICT,HANGU TEHSIL,68,569,126,695
HANGU DISTRICT,HANGU TEHSIL,69,502,112,614
HANGU DISTRICT,HANGU TEHSIL,70,506,100,606
HANGU DISTRICT,HANGU TEHSIL,71,418,81,499
HANGU DISTRICT,HANGU TEHSIL,72,405,98,503
HANGU DISTRICT,HANGU TEHSIL,73,376,82,458
HANGU DISTRICT,HANGU TEHSIL,74,325,84,409
HANGU DISTRICT,HANGU TEHSIL,>=75,2622,585,3207
HANGU DISTRICT,TALL TEHSIL,<1,5209,1572,6781
HANGU DISTRICT,TALL TEHSIL,1,6185,1409,7594
HANGU DISTRICT,TALL TEHSIL,2,6649,1735,8384
HANGU DISTRICT,TALL TEHSIL,3,7192,1795,8987
HANGU DISTRICT,TALL TEHSIL,4,6987,1715,8702
HANGU DISTRICT,TALL TEHSIL,5,7086,1766,8852
HANGU DISTRICT,TALL TEHSIL,6,6454,1664,8118
HANGU DISTRICT,TALL TEHSIL,7,6658,1796,8454
HANGU DISTRICT,TALL TEHSIL,8,6611,1624,8235
HANGU DISTRICT,TALL TEHSIL,9,6279,1593,7872
HANGU DISTRICT,TALL TEHSIL,10,5877,1564,7441
HANGU DISTRICT,TALL TEHSIL,11,5571,1499,7070
HANGU DISTRICT,TALL TEHSIL,12,5370,1395,6765
HANGU DISTRICT,TALL TEHSIL,13,5231,1514,6745
HANGU DISTRICT,TALL TEHSIL,14,5024,1429,6453
HANGU DISTRICT,TALL TEHSIL,15,4900,1368,6268
HANGU DISTRICT,TALL TEHSIL,16,4722,1352,6074
HANGU DISTRICT,TALL TEHSIL,17,4279,1181,5460
HANGU DISTRICT,TALL TEHSIL,18,4478,1087,5565
HANGU DISTRICT,TALL TEHSIL,19,3948,1082,5030
HANGU DISTRICT,TALL TEHSIL,20,3944,1050,4994
HANGU DISTRICT,TALL TEHSIL,21,3642,990,4632
HANGU DISTRICT,TALL TEHSIL,22,3125,896,4021
HANGU DISTRICT,TALL TEHSIL,23,3172,905,4077
HANGU DISTRICT,TALL TEHSIL,24,2881,822,3703
HANGU DISTRICT,TALL TEHSIL,25,3290,908,4198
HANGU DISTRICT,TALL TEHSIL,26,3093,891,3984
HANGU DISTRICT,TALL TEHSIL,27,2898,874,3772
HANGU DISTRICT,TALL TEHSIL,28,2822,808,3630
HANGU DISTRICT,TALL TEHSIL,29,2707,838,3545
HANGU DISTRICT,TALL TEHSIL,30,2789,826,3615
HANGU DISTRICT,TALL TEHSIL,31,2495,737,3232
HANGU DISTRICT,TALL TEHSIL,32,2045,628,2673
HANGU DISTRICT,TALL TEHSIL,33,2030,638,2668
HANGU DISTRICT,TALL TEHSIL,34,1772,524,2296
HANGU DISTRICT,TALL TEHSIL,35,1952,597,2549
HANGU DISTRICT,TALL TEHSIL,36,1649,467,2116
HANGU DISTRICT,TALL TEHSIL,37,1517,526,2043
HANGU DISTRICT,TALL TEHSIL,38,1711,467,2178
HANGU DISTRICT,TALL TEHSIL,39,1500,489,1989
HANGU DISTRICT,TALL TEHSIL,40,1724,533,2257
HANGU DISTRICT,TALL TEHSIL,41,1376,402,1778
HANGU DISTRICT,TALL TEHSIL,42,1069,369,1438
HANGU DISTRICT,TALL TEHSIL,43,1239,406,1645
HANGU DISTRICT,TALL TEHSIL,44,999,314,1313
HANGU DISTRICT,TALL TEHSIL,45,1123,358,1481
HANGU DISTRICT,TALL TEHSIL,46,1043,298,1341
HANGU DISTRICT,TALL TEHSIL,47,878,331,1209
HANGU DISTRICT,TALL TEHSIL,48,911,275,1186
HANGU DISTRICT,TALL TEHSIL,49,892,289,1181
HANGU DISTRICT,TALL TEHSIL,50,1183,351,1534
HANGU DISTRICT,TALL TEHSIL,51,852,324,1176
HANGU DISTRICT,TALL TEHSIL,52,716,274,990
HANGU DISTRICT,TALL TEHSIL,53,822,266,1088
HANGU DISTRICT,TALL TEHSIL,54,703,233,936
HANGU DISTRICT,TALL TEHSIL,55,854,226,1080
HANGU DISTRICT,TALL TEHSIL,56,688,206,894
HANGU DISTRICT,TALL TEHSIL,57,588,210,798
HANGU DISTRICT,TALL TEHSIL,58,647,171,818
HANGU DISTRICT,TALL TEHSIL,59,602,174,776
HANGU DISTRICT,TALL TEHSIL,60,845,191,1036
HANGU DISTRICT,TALL TEHSIL,61,736,233,969
HANGU DISTRICT,TALL TEHSIL,62,669,217,886
HANGU DISTRICT,TALL TEHSIL,63,715,176,891
HANGU DISTRICT,TALL TEHSIL,64,642,193,835
HANGU DISTRICT,TALL TEHSIL,65,585,118,703
HANGU DISTRICT,TALL TEHSIL,66,552,142,694
HANGU DISTRICT,TALL TEHSIL,67,487,180,667
HANGU DISTRICT,TALL TEHSIL,68,497,116,613
HANGU DISTRICT,TALL TEHSIL,69,424,93,517
HANGU DISTRICT,TALL TEHSIL,70,468,90,558
HANGU DISTRICT,TALL TEHSIL,71,387,108,495
HANGU DISTRICT,TALL TEHSIL,72,357,103,460
HANGU DISTRICT,TALL TEHSIL,73,331,90,421
HANGU DISTRICT,TALL TEHSIL,74,249,71,320
HANGU DISTRICT,TALL TEHSIL,>=75,2114,549,2663
HARIPUR DISTRICT,GHAZI TEHSIL,<1,3779,0,3779
HARIPUR DISTRICT,GHAZI TEHSIL,1,3624,0,3624
HARIPUR DISTRICT,GHAZI TEHSIL,2,3678,0,3678
HARIPUR DISTRICT,GHAZI TEHSIL,3,3897,0,3897
HARIPUR DISTRICT,GHAZI TEHSIL,4,3612,0,3612
HARIPUR DISTRICT,GHAZI TEHSIL,5,3574,0,3574
HARIPUR DISTRICT,GHAZI TEHSIL,6,3525,0,3525
HARIPUR DISTRICT,GHAZI TEHSIL,7,3660,0,3660
HARIPUR DISTRICT,GHAZI TEHSIL,8,3103,0,3103
HARIPUR DISTRICT,GHAZI TEHSIL,9,3780,0,3780
HARIPUR DISTRICT,GHAZI TEHSIL,10,2944,0,2944
HARIPUR DISTRICT,GHAZI TEHSIL,11,3584,0,3584
HARIPUR DISTRICT,GHAZI TEHSIL,12,2727,0,2727
HARIPUR DISTRICT,GHAZI TEHSIL,13,3221,0,3221
HARIPUR DISTRICT,GHAZI TEHSIL,14,2823,0,2823
HARIPUR DISTRICT,GHAZI TEHSIL,15,2873,0,2873
HARIPUR DISTRICT,GHAZI TEHSIL,16,2905,0,2905
HARIPUR DISTRICT,GHAZI TEHSIL,17,2935,0,2935
HARIPUR DISTRICT,GHAZI TEHSIL,18,2519,0,2519
HARIPUR DISTRICT,GHAZI TEHSIL,19,2859,0,2859
HARIPUR DISTRICT,GHAZI TEHSIL,20,2296,0,2296
HARIPUR DISTRICT,GHAZI TEHSIL,21,2838,0,2838
HARIPUR DISTRICT,GHAZI TEHSIL,22,2303,0,2303
HARIPUR DISTRICT,GHAZI TEHSIL,23,2612,0,2612
HARIPUR DISTRICT,GHAZI TEHSIL,24,2576,0,2576
HARIPUR DISTRICT,GHAZI TEHSIL,25,2073,0,2073
HARIPUR DISTRICT,GHAZI TEHSIL,26,2603,0,2603
HARIPUR DISTRICT,GHAZI TEHSIL,27,2507,0,2507
HARIPUR DISTRICT,GHAZI TEHSIL,28,2299,0,2299
HARIPUR DISTRICT,GHAZI TEHSIL,29,2493,0,2493
HARIPUR DISTRICT,GHAZI TEHSIL,30,1910,0,1910
HARIPUR DISTRICT,GHAZI TEHSIL,31,2525,0,2525
HARIPUR DISTRICT,GHAZI TEHSIL,32,2192,0,2192
HARIPUR DISTRICT,GHAZI TEHSIL,33,2080,0,2080
HARIPUR DISTRICT,GHAZI TEHSIL,34,2109,0,2109
HARIPUR DISTRICT,GHAZI TEHSIL,35,1550,0,1550
HARIPUR DISTRICT,GHAZI TEHSIL,36,2141,0,2141
HARIPUR DISTRICT,GHAZI TEHSIL,37,1880,0,1880
HARIPUR DISTRICT,GHAZI TEHSIL,38,1831,0,1831
HARIPUR DISTRICT,GHAZI TEHSIL,39,1840,0,1840
HARIPUR DISTRICT,GHAZI TEHSIL,40,1379,0,1379
HARIPUR DISTRICT,GHAZI TEHSIL,41,1674,0,1674
HARIPUR DISTRICT,GHAZI TEHSIL,42,1491,0,1491
HARIPUR DISTRICT,GHAZI TEHSIL,43,1487,0,1487
HARIPUR DISTRICT,GHAZI TEHSIL,44,1381,0,1381
HARIPUR DISTRICT,GHAZI TEHSIL,45,948,0,948
HARIPUR DISTRICT,GHAZI TEHSIL,46,1334,0,1334
HARIPUR DISTRICT,GHAZI TEHSIL,47,1232,0,1232
HARIPUR DISTRICT,GHAZI TEHSIL,48,1296,0,1296
HARIPUR DISTRICT,GHAZI TEHSIL,49,1255,0,1255
HARIPUR DISTRICT,GHAZI TEHSIL,50,1020,0,1020
HARIPUR DISTRICT,GHAZI TEHSIL,51,1235,0,1235
HARIPUR DISTRICT,GHAZI TEHSIL,52,1111,0,1111
HARIPUR DISTRICT,GHAZI TEHSIL,53,1114,0,1114
HARIPUR DISTRICT,GHAZI TEHSIL,54,1063,0,1063
HARIPUR DISTRICT,GHAZI TEHSIL,55,712,0,712
HARIPUR DISTRICT,GHAZI TEHSIL,56,917,0,917
HARIPUR DISTRICT,GHAZI TEHSIL,57,742,0,742
HARIPUR DISTRICT,GHAZI TEHSIL,58,732,0,732
HARIPUR DISTRICT,GHAZI TEHSIL,59,826,0,826
HARIPUR DISTRICT,GHAZI TEHSIL,60,655,0,655
HARIPUR DISTRICT,GHAZI TEHSIL,61,999,0,999
HARIPUR DISTRICT,GHAZI TEHSIL,62,877,0,877
HARIPUR DISTRICT,GHAZI TEHSIL,63,789,0,789
HARIPUR DISTRICT,GHAZI TEHSIL,64,784,0,784
HARIPUR DISTRICT,GHAZI TEHSIL,65,496,0,496
HARIPUR DISTRICT,GHAZI TEHSIL,66,707,0,707
HARIPUR DISTRICT,GHAZI TEHSIL,67,634,0,634
HARIPUR DISTRICT,GHAZI TEHSIL,68,580,0,580
HARIPUR DISTRICT,GHAZI TEHSIL,69,565,0,565
HARIPUR DISTRICT,GHAZI TEHSIL,70,376,0,376
HARIPUR DISTRICT,GHAZI TEHSIL,71,520,0,520
HARIPUR DISTRICT,GHAZI TEHSIL,72,524,0,524
HARIPUR DISTRICT,GHAZI TEHSIL,73,377,0,377
HARIPUR DISTRICT,GHAZI TEHSIL,74,328,0,328
HARIPUR DISTRICT,GHAZI TEHSIL,>=75,2477,0,2477
HARIPUR DISTRICT,HARIPUR TEHSIL,<1,19011,2915,21926
HARIPUR DISTRICT,HARIPUR TEHSIL,1,19208,3056,22264
HARIPUR DISTRICT,HARIPUR TEHSIL,2,18565,2950,21515
HARIPUR DISTRICT,HARIPUR TEHSIL,3,19358,3150,22508
HARIPUR DISTRICT,HARIPUR TEHSIL,4,17827,2964,20791
HARIPUR DISTRICT,HARIPUR TEHSIL,5,17806,2908,20714
HARIPUR DISTRICT,HARIPUR TEHSIL,6,17694,2957,20651
HARIPUR DISTRICT,HARIPUR TEHSIL,7,18786,3121,21907
HARIPUR DISTRICT,HARIPUR TEHSIL,8,16087,2624,18711
HARIPUR DISTRICT,HARIPUR TEHSIL,9,19038,3228,22266
HARIPUR DISTRICT,HARIPUR TEHSIL,10,14150,2421,16571
HARIPUR DISTRICT,HARIPUR TEHSIL,11,18028,3114,21142
HARIPUR DISTRICT,HARIPUR TEHSIL,12,13919,2436,16355
HARIPUR DISTRICT,HARIPUR TEHSIL,13,16062,2845,18907
HARIPUR DISTRICT,HARIPUR TEHSIL,14,14134,2607,16741
HARIPUR DISTRICT,HARIPUR TEHSIL,15,14538,2542,17080
HARIPUR DISTRICT,HARIPUR TEHSIL,16,14785,2741,17526
HARIPUR DISTRICT,HARIPUR TEHSIL,17,15100,2798,17898
HARIPUR DISTRICT,HARIPUR TEHSIL,18,12514,2242,14756
HARIPUR DISTRICT,HARIPUR TEHSIL,19,15333,2815,18148
HARIPUR DISTRICT,HARIPUR TEHSIL,20,11758,2096,13854
HARIPUR DISTRICT,HARIPUR TEHSIL,21,15105,2818,17923
HARIPUR DISTRICT,HARIPUR TEHSIL,22,12407,2463,14870
HARIPUR DISTRICT,HARIPUR TEHSIL,23,14000,2617,16617
HARIPUR DISTRICT,HARIPUR TEHSIL,24,13261,2427,15688
HARIPUR DISTRICT,HARIPUR TEHSIL,25,10334,2051,12385
HARIPUR DISTRICT,HARIPUR TEHSIL,26,12503,2391,14894
HARIPUR DISTRICT,HARIPUR TEHSIL,27,12199,2367,14566
HARIPUR DISTRICT,HARIPUR TEHSIL,28,10997,2232,13229
HARIPUR DISTRICT,HARIPUR TEHSIL,29,11734,2264,13998
HARIPUR DISTRICT,HARIPUR TEHSIL,30,9434,2038,11472
HARIPUR DISTRICT,HARIPUR TEHSIL,31,11963,2294,14257
HARIPUR DISTRICT,HARIPUR TEHSIL,32,10428,2063,12491
HARIPUR DISTRICT,HARIPUR TEHSIL,33,10595,2017,12612
HARIPUR DISTRICT,HARIPUR TEHSIL,34,10534,1923,12457
HARIPUR DISTRICT,HARIPUR TEHSIL,35,7745,1722,9467
HARIPUR DISTRICT,HARIPUR TEHSIL,36,9664,1854,11518
HARIPUR DISTRICT,HARIPUR TEHSIL,37,8705,1678,10383
HARIPUR DISTRICT,HARIPUR TEHSIL,38,8933,1947,10880
HARIPUR DISTRICT,HARIPUR TEHSIL,39,8814,1633,10447
HARIPUR DISTRICT,HARIPUR TEHSIL,40,6707,1648,8355
HARIPUR DISTRICT,HARIPUR TEHSIL,41,7841,1660,9501
HARIPUR DISTRICT,HARIPUR TEHSIL,42,6934,1593,8527
HARIPUR DISTRICT,HARIPUR TEHSIL,43,7191,1580,8771
HARIPUR DISTRICT,HARIPUR TEHSIL,44,7002,1440,8442
HARIPUR DISTRICT,HARIPUR TEHSIL,45,5109,1241,6350
HARIPUR DISTRICT,HARIPUR TEHSIL,46,6723,1277,8000
HARIPUR DISTRICT,HARIPUR TEHSIL,47,5823,1105,6928
HARIPUR DISTRICT,HARIPUR TEHSIL,48,6390,1212,7602
HARIPUR DISTRICT,HARIPUR TEHSIL,49,6277,1172,7449
HARIPUR DISTRICT,HARIPUR TEHSIL,50,5170,1197,6367
HARIPUR DISTRICT,HARIPUR TEHSIL,51,6308,1146,7454
HARIPUR DISTRICT,HARIPUR TEHSIL,52,5621,1100,6721
HARIPUR DISTRICT,HARIPUR TEHSIL,53,5845,1133,6978
HARIPUR DISTRICT,HARIPUR TEHSIL,54,5500,1094,6594
HARIPUR DISTRICT,HARIPUR TEHSIL,55,3957,859,4816
HARIPUR DISTRICT,HARIPUR TEHSIL,56,4578,879,5457
HARIPUR DISTRICT,HARIPUR TEHSIL,57,3890,764,4654
HARIPUR DISTRICT,HARIPUR TEHSIL,58,4010,774,4784
HARIPUR DISTRICT,HARIPUR TEHSIL,59,4192,736,4928
HARIPUR DISTRICT,HARIPUR TEHSIL,60,3327,842,4169
HARIPUR DISTRICT,HARIPUR TEHSIL,61,4339,800,5139
HARIPUR DISTRICT,HARIPUR TEHSIL,62,4070,692,4762
HARIPUR DISTRICT,HARIPUR TEHSIL,63,3959,796,4755
HARIPUR DISTRICT,HARIPUR TEHSIL,64,3591,642,4233
HARIPUR DISTRICT,HARIPUR TEHSIL,65,2580,538,3118
HARIPUR DISTRICT,HARIPUR TEHSIL,66,3318,535,3853
HARIPUR DISTRICT,HARIPUR TEHSIL,67,2990,469,3459
HARIPUR DISTRICT,HARIPUR TEHSIL,68,2669,466,3135
HARIPUR DISTRICT,HARIPUR TEHSIL,69,2568,453,3021
HARIPUR DISTRICT,HARIPUR TEHSIL,70,1921,437,2358
HARIPUR DISTRICT,HARIPUR TEHSIL,71,2485,372,2857
HARIPUR DISTRICT,HARIPUR TEHSIL,72,2328,374,2702
HARIPUR DISTRICT,HARIPUR TEHSIL,73,1900,359,2259
HARIPUR DISTRICT,HARIPUR TEHSIL,74,1642,298,1940
HARIPUR DISTRICT,HARIPUR TEHSIL,>=75,11687,2088,13775
HARNAI DISTRICT,HARNAI TEHSIL,<1,1235,401,1636
HARNAI DISTRICT,HARNAI TEHSIL,1,1568,366,1934
HARNAI DISTRICT,HARNAI TEHSIL,2,1886,428,2314
HARNAI DISTRICT,HARNAI TEHSIL,3,1780,490,2270
HARNAI DISTRICT,HARNAI TEHSIL,4,2035,431,2466
HARNAI DISTRICT,HARNAI TEHSIL,5,1711,461,2172
HARNAI DISTRICT,HARNAI TEHSIL,6,2003,381,2384
HARNAI DISTRICT,HARNAI TEHSIL,7,1727,437,2164
HARNAI DISTRICT,HARNAI TEHSIL,8,1953,404,2357
HARNAI DISTRICT,HARNAI TEHSIL,9,1538,380,1918
HARNAI DISTRICT,HARNAI TEHSIL,10,1631,327,1958
HARNAI DISTRICT,HARNAI TEHSIL,11,1176,342,1518
HARNAI DISTRICT,HARNAI TEHSIL,12,1222,276,1498
HARNAI DISTRICT,HARNAI TEHSIL,13,964,278,1242
HARNAI DISTRICT,HARNAI TEHSIL,14,968,291,1259
HARNAI DISTRICT,HARNAI TEHSIL,15,983,242,1225
HARNAI DISTRICT,HARNAI TEHSIL,16,775,269,1044
HARNAI DISTRICT,HARNAI TEHSIL,17,709,246,955
HARNAI DISTRICT,HARNAI TEHSIL,18,942,221,1163
HARNAI DISTRICT,HARNAI TEHSIL,19,830,205,1035
HARNAI DISTRICT,HARNAI TEHSIL,20,927,228,1155
HARNAI DISTRICT,HARNAI TEHSIL,21,749,280,1029
HARNAI DISTRICT,HARNAI TEHSIL,22,605,223,828
HARNAI DISTRICT,HARNAI TEHSIL,23,722,247,969
HARNAI DISTRICT,HARNAI TEHSIL,24,635,212,847
HARNAI DISTRICT,HARNAI TEHSIL,25,964,220,1184
HARNAI DISTRICT,HARNAI TEHSIL,26,892,233,1125
HARNAI DISTRICT,HARNAI TEHSIL,27,909,244,1153
HARNAI DISTRICT,HARNAI TEHSIL,28,729,244,973
HARNAI DISTRICT,HARNAI TEHSIL,29,874,253,1127
HARNAI DISTRICT,HARNAI TEHSIL,30,826,183,1009
HARNAI DISTRICT,HARNAI TEHSIL,31,811,223,1034
HARNAI DISTRICT,HARNAI TEHSIL,32,751,204,955
HARNAI DISTRICT,HARNAI TEHSIL,33,721,211,932
HARNAI DISTRICT,HARNAI TEHSIL,34,552,189,741
HARNAI DISTRICT,HARNAI TEHSIL,35,609,147,756
HARNAI DISTRICT,HARNAI TEHSIL,36,436,157,593
HARNAI DISTRICT,HARNAI TEHSIL,37,719,198,917
HARNAI DISTRICT,HARNAI TEHSIL,38,432,134,566
HARNAI DISTRICT,HARNAI TEHSIL,39,590,150,740
HARNAI DISTRICT,HARNAI TEHSIL,40,461,113,574
HARNAI DISTRICT,HARNAI TEHSIL,41,421,131,552
HARNAI DISTRICT,HARNAI TEHSIL,42,377,119,496
HARNAI DISTRICT,HARNAI TEHSIL,43,352,89,441
HARNAI DISTRICT,HARNAI TEHSIL,44,288,80,368
HARNAI DISTRICT,HARNAI TEHSIL,45,334,95,429
HARNAI DISTRICT,HARNAI TEHSIL,46,364,100,464
HARNAI DISTRICT,HARNAI TEHSIL,47,433,113,546
HARNAI DISTRICT,HARNAI TEHSIL,48,279,76,355
HARNAI DISTRICT,HARNAI TEHSIL,49,345,83,428
HARNAI DISTRICT,HARNAI TEHSIL,50,367,61,428
HARNAI DISTRICT,HARNAI TEHSIL,51,325,87,412
HARNAI DISTRICT,HARNAI TEHSIL,52,297,80,377
HARNAI DISTRICT,HARNAI TEHSIL,53,258,64,322
HARNAI DISTRICT,HARNAI TEHSIL,54,226,60,286
HARNAI DISTRICT,HARNAI TEHSIL,55,208,55,263
HARNAI DISTRICT,HARNAI TEHSIL,56,157,47,204
HARNAI DISTRICT,HARNAI TEHSIL,57,247,68,315
HARNAI DISTRICT,HARNAI TEHSIL,58,171,41,212
HARNAI DISTRICT,HARNAI TEHSIL,59,253,89,342
HARNAI DISTRICT,HARNAI TEHSIL,60,204,60,264
HARNAI DISTRICT,HARNAI TEHSIL,61,220,58,278
HARNAI DISTRICT,HARNAI TEHSIL,62,185,33,218
HARNAI DISTRICT,HARNAI TEHSIL,63,191,54,245
HARNAI DISTRICT,HARNAI TEHSIL,64,186,39,225
HARNAI DISTRICT,HARNAI TEHSIL,65,125,30,155
HARNAI DISTRICT,HARNAI TEHSIL,66,126,38,164
HARNAI DISTRICT,HARNAI TEHSIL,67,124,31,155
HARNAI DISTRICT,HARNAI TEHSIL,68,87,18,105
HARNAI DISTRICT,HARNAI TEHSIL,69,127,32,159
HARNAI DISTRICT,HARNAI TEHSIL,70,94,13,107
HARNAI DISTRICT,HARNAI TEHSIL,71,113,24,137
HARNAI DISTRICT,HARNAI TEHSIL,72,100,16,116
HARNAI DISTRICT,HARNAI TEHSIL,73,92,14,106
HARNAI DISTRICT,HARNAI TEHSIL,74,62,11,73
HARNAI DISTRICT,HARNAI TEHSIL,>=75,465,125,590
HARNAI DISTRICT,KHOAST SUB-TEHSIL,<1,373,0,373
HARNAI DISTRICT,KHOAST SUB-TEHSIL,1,439,0,439
HARNAI DISTRICT,KHOAST SUB-TEHSIL,2,435,0,435
HARNAI DISTRICT,KHOAST SUB-TEHSIL,3,469,0,469
HARNAI DISTRICT,KHOAST SUB-TEHSIL,4,500,0,500
HARNAI DISTRICT,KHOAST SUB-TEHSIL,5,493,0,493
HARNAI DISTRICT,KHOAST SUB-TEHSIL,6,493,0,493
HARNAI DISTRICT,KHOAST SUB-TEHSIL,7,451,0,451
HARNAI DISTRICT,KHOAST SUB-TEHSIL,8,472,0,472
HARNAI DISTRICT,KHOAST SUB-TEHSIL,9,350,0,350
HARNAI DISTRICT,KHOAST SUB-TEHSIL,10,391,0,391
HARNAI DISTRICT,KHOAST SUB-TEHSIL,11,294,0,294
HARNAI DISTRICT,KHOAST SUB-TEHSIL,12,285,0,285
HARNAI DISTRICT,KHOAST SUB-TEHSIL,13,224,0,224
HARNAI DISTRICT,KHOAST SUB-TEHSIL,14,211,0,211
HARNAI DISTRICT,KHOAST SUB-TEHSIL,15,209,0,209
HARNAI DISTRICT,KHOAST SUB-TEHSIL,16,191,0,191
HARNAI DISTRICT,KHOAST SUB-TEHSIL,17,181,0,181
HARNAI DISTRICT,KHOAST SUB-TEHSIL,18,238,0,238
HARNAI DISTRICT,KHOAST SUB-TEHSIL,19,174,0,174
HARNAI DISTRICT,KHOAST SUB-TEHSIL,20,222,0,222
HARNAI DISTRICT,KHOAST SUB-TEHSIL,21,171,0,171
HARNAI DISTRICT,KHOAST SUB-TEHSIL,22,156,0,156
HARNAI DISTRICT,KHOAST SUB-TEHSIL,23,191,0,191
HARNAI DISTRICT,KHOAST SUB-TEHSIL,24,161,0,161
HARNAI DISTRICT,KHOAST SUB-TEHSIL,25,245,0,245
HARNAI DISTRICT,KHOAST SUB-TEHSIL,26,202,0,202
HARNAI DISTRICT,KHOAST SUB-TEHSIL,27,189,0,189
HARNAI DISTRICT,KHOAST SUB-TEHSIL,28,170,0,170
HARNAI DISTRICT,KHOAST SUB-TEHSIL,29,205,0,205
HARNAI DISTRICT,KHOAST SUB-TEHSIL,30,198,0,198
HARNAI DISTRICT,KHOAST SUB-TEHSIL,31,189,0,189
HARNAI DISTRICT,KHOAST SUB-TEHSIL,32,146,0,146
HARNAI DISTRICT,KHOAST SUB-TEHSIL,33,170,0,170
HARNAI DISTRICT,KHOAST SUB-TEHSIL,34,97,0,97
HARNAI DISTRICT,KHOAST SUB-TEHSIL,35,136,0,136
HARNAI DISTRICT,KHOAST SUB-TEHSIL,36,108,0,108
HARNAI DISTRICT,KHOAST SUB-TEHSIL,37,174,0,174
HARNAI DISTRICT,KHOAST SUB-TEHSIL,38,140,0,140
HARNAI DISTRICT,KHOAST SUB-TEHSIL,39,106,0,106
HARNAI DISTRICT,KHOAST SUB-TEHSIL,40,120,0,120
HARNAI DISTRICT,KHOAST SUB-TEHSIL,41,121,0,121
HARNAI DISTRICT,KHOAST SUB-TEHSIL,42,92,0,92
HARNAI DISTRICT,KHOAST SUB-TEHSIL,43,104,0,104
HARNAI DISTRICT,KHOAST SUB-TEHSIL,44,70,0,70
HARNAI DISTRICT,KHOAST SUB-TEHSIL,45,67,0,67
HARNAI DISTRICT,KHOAST SUB-TEHSIL,46,87,0,87
HARNAI DISTRICT,KHOAST SUB-TEHSIL,47,106,0,106
HARNAI DISTRICT,KHOAST SUB-TEHSIL,48,64,0,64
HARNAI DISTRICT,KHOAST SUB-TEHSIL,49,62,0,62
HARNAI DISTRICT,KHOAST SUB-TEHSIL,50,80,0,80
HARNAI DISTRICT,KHOAST SUB-TEHSIL,51,57,0,57
HARNAI DISTRICT,KHOAST SUB-TEHSIL,52,60,0,60
HARNAI DISTRICT,KHOAST SUB-TEHSIL,53,55,0,55
HARNAI DISTRICT,KHOAST SUB-TEHSIL,54,52,0,52
HARNAI DISTRICT,KHOAST SUB-TEHSIL,55,38,0,38
HARNAI DISTRICT,KHOAST SUB-TEHSIL,56,39,0,39
HARNAI DISTRICT,KHOAST SUB-TEHSIL,57,49,0,49
HARNAI DISTRICT,KHOAST SUB-TEHSIL,58,33,0,33
HARNAI DISTRICT,KHOAST SUB-TEHSIL,59,36,0,36
HARNAI DISTRICT,KHOAST SUB-TEHSIL,60,54,0,54
HARNAI DISTRICT,KHOAST SUB-TEHSIL,61,46,0,46
HARNAI DISTRICT,KHOAST SUB-TEHSIL,62,43,0,43
HARNAI DISTRICT,KHOAST SUB-TEHSIL,63,35,0,35
HARNAI DISTRICT,KHOAST SUB-TEHSIL,64,37,0,37
HARNAI DISTRICT,KHOAST SUB-TEHSIL,65,29,0,29
HARNAI DISTRICT,KHOAST SUB-TEHSIL,66,45,0,45
HARNAI DISTRICT,KHOAST SUB-TEHSIL,67,56,0,56
HARNAI DISTRICT,KHOAST SUB-TEHSIL,68,22,0,22
HARNAI DISTRICT,KHOAST SUB-TEHSIL,69,32,0,32
HARNAI DISTRICT,KHOAST SUB-TEHSIL,70,27,0,27
HARNAI DISTRICT,KHOAST SUB-TEHSIL,71,24,0,24
HARNAI DISTRICT,KHOAST SUB-TEHSIL,72,35,0,35
HARNAI DISTRICT,KHOAST SUB-TEHSIL,73,20,0,20
HARNAI DISTRICT,KHOAST SUB-TEHSIL,74,17,0,17
HARNAI DISTRICT,KHOAST SUB-TEHSIL,>=75,116,0,116
HARNAI DISTRICT,SHAHRIG TEHSIL,<1,296,300,596
HARNAI DISTRICT,SHAHRIG TEHSIL,1,364,264,628
HARNAI DISTRICT,SHAHRIG TEHSIL,2,367,387,754
HARNAI DISTRICT,SHAHRIG TEHSIL,3,378,316,694
HARNAI DISTRICT,SHAHRIG TEHSIL,4,362,351,713
HARNAI DISTRICT,SHAHRIG TEHSIL,5,383,322,705
HARNAI DISTRICT,SHAHRIG TEHSIL,6,343,343,686
HARNAI DISTRICT,SHAHRIG TEHSIL,7,355,275,630
HARNAI DISTRICT,SHAHRIG TEHSIL,8,324,327,651
HARNAI DISTRICT,SHAHRIG TEHSIL,9,288,270,558
HARNAI DISTRICT,SHAHRIG TEHSIL,10,263,284,547
HARNAI DISTRICT,SHAHRIG TEHSIL,11,221,218,439
HARNAI DISTRICT,SHAHRIG TEHSIL,12,214,206,420
HARNAI DISTRICT,SHAHRIG TEHSIL,13,185,194,379
HARNAI DISTRICT,SHAHRIG TEHSIL,14,166,184,350
HARNAI DISTRICT,SHAHRIG TEHSIL,15,184,180,364
HARNAI DISTRICT,SHAHRIG TEHSIL,16,167,196,363
HARNAI DISTRICT,SHAHRIG TEHSIL,17,177,195,372
HARNAI DISTRICT,SHAHRIG TEHSIL,18,195,241,436
HARNAI DISTRICT,SHAHRIG TEHSIL,19,160,220,380
HARNAI DISTRICT,SHAHRIG TEHSIL,20,148,264,412
HARNAI DISTRICT,SHAHRIG TEHSIL,21,140,293,433
HARNAI DISTRICT,SHAHRIG TEHSIL,22,121,226,347
HARNAI DISTRICT,SHAHRIG TEHSIL,23,129,233,362
HARNAI DISTRICT,SHAHRIG TEHSIL,24,117,253,370
HARNAI DISTRICT,SHAHRIG TEHSIL,25,152,342,494
HARNAI DISTRICT,SHAHRIG TEHSIL,26,168,261,429
HARNAI DISTRICT,SHAHRIG TEHSIL,27,181,223,404
HARNAI DISTRICT,SHAHRIG TEHSIL,28,138,263,401
HARNAI DISTRICT,SHAHRIG TEHSIL,29,221,217,438
HARNAI DISTRICT,SHAHRIG TEHSIL,30,135,263,398
HARNAI DISTRICT,SHAHRIG TEHSIL,31,118,242,360
HARNAI DISTRICT,SHAHRIG TEHSIL,32,130,169,299
HARNAI DISTRICT,SHAHRIG TEHSIL,33,111,165,276
HARNAI DISTRICT,SHAHRIG TEHSIL,34,90,141,231
HARNAI DISTRICT,SHAHRIG TEHSIL,35,89,165,254
HARNAI DISTRICT,SHAHRIG TEHSIL,36,63,134,197
HARNAI DISTRICT,SHAHRIG TEHSIL,37,142,125,267
HARNAI DISTRICT,SHAHRIG TEHSIL,38,66,144,210
HARNAI DISTRICT,SHAHRIG TEHSIL,39,121,122,243
HARNAI DISTRICT,SHAHRIG TEHSIL,40,81,176,257
HARNAI DISTRICT,SHAHRIG TEHSIL,41,73,118,191
HARNAI DISTRICT,SHAHRIG TEHSIL,42,85,94,179
HARNAI DISTRICT,SHAHRIG TEHSIL,43,62,84,146
HARNAI DISTRICT,SHAHRIG TEHSIL,44,41,70,111
HARNAI DISTRICT,SHAHRIG TEHSIL,45,49,83,132
HARNAI DISTRICT,SHAHRIG TEHSIL,46,40,62,102
HARNAI DISTRICT,SHAHRIG TEHSIL,47,95,54,149
HARNAI DISTRICT,SHAHRIG TEHSIL,48,48,62,110
HARNAI DISTRICT,SHAHRIG TEHSIL,49,69,51,120
HARNAI DISTRICT,SHAHRIG TEHSIL,50,42,79,121
HARNAI DISTRICT,SHAHRIG TEHSIL,51,41,60,101
HARNAI DISTRICT,SHAHRIG TEHSIL,52,58,40,98
HARNAI DISTRICT,SHAHRIG TEHSIL,53,48,41,89
HARNAI DISTRICT,SHAHRIG TEHSIL,54,51,45,96
HARNAI DISTRICT,SHAHRIG TEHSIL,55,37,51,88
HARNAI DISTRICT,SHAHRIG TEHSIL,56,31,46,77
HARNAI DISTRICT,SHAHRIG TEHSIL,57,65,31,96
HARNAI DISTRICT,SHAHRIG TEHSIL,58,33,49,82
HARNAI DISTRICT,SHAHRIG TEHSIL,59,35,32,67
HARNAI DISTRICT,SHAHRIG TEHSIL,60,34,65,99
HARNAI DISTRICT,SHAHRIG TEHSIL,61,32,35,67
HARNAI DISTRICT,SHAHRIG TEHSIL,62,38,22,60
HARNAI DISTRICT,SHAHRIG TEHSIL,63,26,31,57
HARNAI DISTRICT,SHAHRIG TEHSIL,64,21,25,46
HARNAI DISTRICT,SHAHRIG TEHSIL,65,22,25,47
HARNAI DISTRICT,SHAHRIG TEHSIL,66,23,24,47
HARNAI DISTRICT,SHAHRIG TEHSIL,67,30,15,45
HARNAI DISTRICT,SHAHRIG TEHSIL,68,14,18,32
HARNAI DISTRICT,SHAHRIG TEHSIL,69,17,9,26
HARNAI DISTRICT,SHAHRIG TEHSIL,70,14,18,32
HARNAI DISTRICT,SHAHRIG TEHSIL,71,26,9,35
HARNAI DISTRICT,SHAHRIG TEHSIL,72,21,13,34
HARNAI DISTRICT,SHAHRIG TEHSIL,73,7,13,20
HARNAI DISTRICT,SHAHRIG TEHSIL,74,10,5,15
HARNAI DISTRICT,SHAHRIG TEHSIL,>=75,67,86,153
HYDERABAD DISTRICT,HYDERABAD CITY TALUKA,<1,0,14334,14334
HYDERABAD DISTRICT,HYDERABAD CITY TALUKA,1,0,15512,15512
HYDERABAD DISTRICT,HYDERABAD CITY TALUKA,2,0,16511,16511
HYDERABAD DISTRICT,HYDERABAD CITY TALUKA,3,0,17917,17917
HYDERABAD DISTRICT,HYDERABAD CITY TALUKA,4,0,16841,16841
HYDERABAD DISTRICT,HYDERABAD CITY TALUKA,5,0,17209,17209
HYDERABAD DISTRICT,HYDERABAD CITY TALUKA,6,0,15854,15854
HYDERABAD DISTRICT,HYDERABAD CITY TALUKA,7,0,16712,16712
HYDERABAD DISTRICT,HYDERABAD CITY TALUKA,8,0,15280,15280
HYDERABAD DISTRICT,HYDERABAD CITY TALUKA,9,0,15738,15738
HYDERABAD DISTRICT,HYDERABAD CITY TALUKA,10,0,14590,14590
HYDERABAD DISTRICT,HYDERABAD CITY TALUKA,11,0,15694,15694
HYDERABAD DISTRICT,HYDERABAD CITY TALUKA,12,0,14351,14351
HYDERABAD DISTRICT,HYDERABAD CITY TALUKA,13,0,14590,14590
HYDERABAD DISTRICT,HYDERABAD CITY TALUKA,14,0,13739,13739
HYDERABAD DISTRICT,HYDERABAD CITY TALUKA,15,0,15065,15065
HYDERABAD DISTRICT,HYDERABAD CITY TALUKA,16,0,15422,15422
HYDERABAD DISTRICT,HYDERABAD CITY TALUKA,17,0,15804,15804
HYDERABAD DISTRICT,HYDERABAD CITY TALUKA,18,0,15155,15155
HYDERABAD DISTRICT,HYDERABAD CITY TALUKA,19,0,14372,14372
HYDERABAD DISTRICT,HYDERABAD CITY TALUKA,20,0,14841,14841
HYDERABAD DISTRICT,HYDERABAD CITY TALUKA,21,0,14802,14802
HYDERABAD DISTRICT,HYDERABAD CITY TALUKA,22,0,14593,14593
HYDERABAD DISTRICT,HYDERABAD CITY TALUKA,23,0,13444,13444
HYDERABAD DISTRICT,HYDERABAD CITY TALUKA,24,0,13561,13561
HYDERABAD DISTRICT,HYDERABAD CITY TALUKA,25,0,13214,13214
HYDERABAD DISTRICT,HYDERABAD CITY TALUKA,26,0,13746,13746
HYDERABAD DISTRICT,HYDERABAD CITY TALUKA,27,0,12677,12677
HYDERABAD DISTRICT,HYDERABAD CITY TALUKA,28,0,13938,13938
HYDERABAD DISTRICT,HYDERABAD CITY TALUKA,29,0,12255,12255
HYDERABAD DISTRICT,HYDERABAD CITY TALUKA,30,0,13671,13671
HYDERABAD DISTRICT,HYDERABAD CITY TALUKA,31,0,12687,12687
HYDERABAD DISTRICT,HYDERABAD CITY TALUKA,32,0,12660,12660
HYDERABAD DISTRICT,HYDERABAD CITY TALUKA,33,0,11964,11964
HYDERABAD DISTRICT,HYDERABAD CITY TALUKA,34,0,10930,10930
HYDERABAD DISTRICT,HYDERABAD CITY TALUKA,35,0,10562,10562
HYDERABAD DISTRICT,HYDERABAD CITY TALUKA,36,0,9866,9866
HYDERABAD DISTRICT,HYDERABAD CITY TALUKA,37,0,9016,9016
HYDERABAD DISTRICT,HYDERABAD CITY TALUKA,38,0,10632,10632
HYDERABAD DISTRICT,HYDERABAD CITY TALUKA,39,0,9676,9676
HYDERABAD DISTRICT,HYDERABAD CITY TALUKA,40,0,9425,9425
HYDERABAD DISTRICT,HYDERABAD CITY TALUKA,41,0,9123,9123
HYDERABAD DISTRICT,HYDERABAD CITY TALUKA,42,0,8295,8295
HYDERABAD DISTRICT,HYDERABAD CITY TALUKA,43,0,8380,8380
HYDERABAD DISTRICT,HYDERABAD CITY TALUKA,44,0,7477,7477
HYDERABAD DISTRICT,HYDERABAD CITY TALUKA,45,0,6979,6979
HYDERABAD DISTRICT,HYDERABAD CITY TALUKA,46,0,6637,6637
HYDERABAD DISTRICT,HYDERABAD CITY TALUKA,47,0,6135,6135
HYDERABAD DISTRICT,HYDERABAD CITY TALUKA,48,0,7118,7118
HYDERABAD DISTRICT,HYDERABAD CITY TALUKA,49,0,6747,6747
HYDERABAD DISTRICT,HYDERABAD CITY TALUKA,50,0,6244,6244
HYDERABAD DISTRICT,HYDERABAD CITY TALUKA,51,0,6077,6077
HYDERABAD DISTRICT,HYDERABAD CITY TALUKA,52,0,5757,5757
HYDERABAD DISTRICT,HYDERABAD CITY TALUKA,53,0,5708,5708
HYDERABAD DISTRICT,HYDERABAD CITY TALUKA,54,0,4832,4832
HYDERABAD DISTRICT,HYDERABAD CITY TALUKA,55,0,4758,4758
HYDERABAD DISTRICT,HYDERABAD CITY TALUKA,56,0,4050,4050
HYDERABAD DISTRICT,HYDERABAD CITY TALUKA,57,0,3753,3753
HYDERABAD DISTRICT,HYDERABAD CITY TALUKA,58,0,3819,3819
HYDERABAD DISTRICT,HYDERABAD CITY TALUKA,59,0,3545,3545
HYDERABAD DISTRICT,HYDERABAD CITY TALUKA,60,0,3180,3180
HYDERABAD DISTRICT,HYDERABAD CITY TALUKA,61,0,3798,3798
HYDERABAD DISTRICT,HYDERABAD CITY TALUKA,62,0,3469,3469
HYDERABAD DISTRICT,HYDERABAD CITY TALUKA,63,0,3526,3526
HYDERABAD DISTRICT,HYDERABAD CITY TALUKA,64,0,2736,2736
HYDERABAD DISTRICT,HYDERABAD CITY TALUKA,65,0,2443,2443
HYDERABAD DISTRICT,HYDERABAD CITY TALUKA,66,0,2050,2050
HYDERABAD DISTRICT,HYDERABAD CITY TALUKA,67,0,1794,1794
HYDERABAD DISTRICT,HYDERABAD CITY TALUKA,68,0,2232,2232
HYDERABAD DISTRICT,HYDERABAD CITY TALUKA,69,0,1717,1717
HYDERABAD DISTRICT,HYDERABAD CITY TALUKA,70,0,1522,1522
HYDERABAD DISTRICT,HYDERABAD CITY TALUKA,71,0,1483,1483
HYDERABAD DISTRICT,HYDERABAD CITY TALUKA,72,0,1334,1334
HYDERABAD DISTRICT,HYDERABAD CITY TALUKA,73,0,1531,1531
HYDERABAD DISTRICT,HYDERABAD CITY TALUKA,74,0,987,987
HYDERABAD DISTRICT,HYDERABAD CITY TALUKA,>=75,0,7067,7067
HYDERABAD DISTRICT,HYDERABAD TALUKA,<1,8582,1894,10476
HYDERABAD DISTRICT,HYDERABAD TALUKA,1,9599,2212,11811
HYDERABAD DISTRICT,HYDERABAD TALUKA,2,11215,2357,13572
HYDERABAD DISTRICT,HYDERABAD TALUKA,3,12562,2553,15115
HYDERABAD DISTRICT,HYDERABAD TALUKA,4,12554,2582,15136
HYDERABAD DISTRICT,HYDERABAD TALUKA,5,12835,2532,15367
HYDERABAD DISTRICT,HYDERABAD TALUKA,6,12194,2443,14637
HYDERABAD DISTRICT,HYDERABAD TALUKA,7,11198,2543,13741
HYDERABAD DISTRICT,HYDERABAD TALUKA,8,12660,2401,15061
HYDERABAD DISTRICT,HYDERABAD TALUKA,9,9721,2266,11987
HYDERABAD DISTRICT,HYDERABAD TALUKA,10,11425,2334,13759
HYDERABAD DISTRICT,HYDERABAD TALUKA,11,7919,2081,10000
HYDERABAD DISTRICT,HYDERABAD TALUKA,12,9321,2050,11371
HYDERABAD DISTRICT,HYDERABAD TALUKA,13,7351,2002,9353
HYDERABAD DISTRICT,HYDERABAD TALUKA,14,7507,1898,9405
HYDERABAD DISTRICT,HYDERABAD TALUKA,15,8123,2060,10183
HYDERABAD DISTRICT,HYDERABAD TALUKA,16,7688,1993,9681
HYDERABAD DISTRICT,HYDERABAD TALUKA,17,6630,2092,8722
HYDERABAD DISTRICT,HYDERABAD TALUKA,18,8643,2192,10835
HYDERABAD DISTRICT,HYDERABAD TALUKA,19,6924,2237,9161
HYDERABAD DISTRICT,HYDERABAD TALUKA,20,8239,2001,10240
HYDERABAD DISTRICT,HYDERABAD TALUKA,21,6058,2135,8193
HYDERABAD DISTRICT,HYDERABAD TALUKA,22,6389,1765,8154
HYDERABAD DISTRICT,HYDERABAD TALUKA,23,5415,1857,7272
HYDERABAD DISTRICT,HYDERABAD TALUKA,24,5243,1630,6873
HYDERABAD DISTRICT,HYDERABAD TALUKA,25,6571,1516,8087
HYDERABAD DISTRICT,HYDERABAD TALUKA,26,5722,1568,7290
HYDERABAD DISTRICT,HYDERABAD TALUKA,27,5686,1551,7237
HYDERABAD DISTRICT,HYDERABAD TALUKA,28,6024,1599,7623
HYDERABAD DISTRICT,HYDERABAD TALUKA,29,5787,1566,7353
HYDERABAD DISTRICT,HYDERABAD TALUKA,30,5877,1465,7342
HYDERABAD DISTRICT,HYDERABAD TALUKA,31,5682,1568,7250
HYDERABAD DISTRICT,HYDERABAD TALUKA,32,5058,1419,6477
HYDERABAD DISTRICT,HYDERABAD TALUKA,33,5022,1411,6433
HYDERABAD DISTRICT,HYDERABAD TALUKA,34,4589,1262,5851
HYDERABAD DISTRICT,HYDERABAD TALUKA,35,4904,1083,5987
HYDERABAD DISTRICT,HYDERABAD TALUKA,36,4664,1220,5884
HYDERABAD DISTRICT,HYDERABAD TALUKA,37,5080,1166,6246
HYDERABAD DISTRICT,HYDERABAD TALUKA,38,4400,1178,5578
HYDERABAD DISTRICT,HYDERABAD TALUKA,39,4644,1126,5770
HYDERABAD DISTRICT,HYDERABAD TALUKA,40,4022,996,5018
HYDERABAD DISTRICT,HYDERABAD TALUKA,41,3713,1083,4796
HYDERABAD DISTRICT,HYDERABAD TALUKA,42,3343,895,4238
HYDERABAD DISTRICT,HYDERABAD TALUKA,43,3114,905,4019
HYDERABAD DISTRICT,HYDERABAD TALUKA,44,3069,893,3962
HYDERABAD DISTRICT,HYDERABAD TALUKA,45,2980,735,3715
HYDERABAD DISTRICT,HYDERABAD TALUKA,46,2883,869,3752
HYDERABAD DISTRICT,HYDERABAD TALUKA,47,3055,736,3791
HYDERABAD DISTRICT,HYDERABAD TALUKA,48,2776,756,3532
HYDERABAD DISTRICT,HYDERABAD TALUKA,49,2863,765,3628
HYDERABAD DISTRICT,HYDERABAD TALUKA,50,2481,635,3116
HYDERABAD DISTRICT,HYDERABAD TALUKA,51,2295,720,3015
HYDERABAD DISTRICT,HYDERABAD TALUKA,52,2133,636,2769
HYDERABAD DISTRICT,HYDERABAD TALUKA,53,1659,521,2180
HYDERABAD DISTRICT,HYDERABAD TALUKA,54,1632,498,2130
HYDERABAD DISTRICT,HYDERABAD TALUKA,55,1592,431,2023
HYDERABAD DISTRICT,HYDERABAD TALUKA,56,1459,489,1948
HYDERABAD DISTRICT,HYDERABAD TALUKA,57,1658,402,2060
HYDERABAD DISTRICT,HYDERABAD TALUKA,58,1482,439,1921
HYDERABAD DISTRICT,HYDERABAD TALUKA,59,1514,415,1929
HYDERABAD DISTRICT,HYDERABAD TALUKA,60,1637,345,1982
HYDERABAD DISTRICT,HYDERABAD TALUKA,61,1385,425,1810
HYDERABAD DISTRICT,HYDERABAD TALUKA,62,1403,367,1770
HYDERABAD DISTRICT,HYDERABAD TALUKA,63,1343,345,1688
HYDERABAD DISTRICT,HYDERABAD TALUKA,64,1341,298,1639
HYDERABAD DISTRICT,HYDERABAD TALUKA,65,1109,225,1334
HYDERABAD DISTRICT,HYDERABAD TALUKA,66,901,194,1095
HYDERABAD DISTRICT,HYDERABAD TALUKA,67,968,225,1193
HYDERABAD DISTRICT,HYDERABAD TALUKA,68,823,212,1035
HYDERABAD DISTRICT,HYDERABAD TALUKA,69,868,209,1077
HYDERABAD DISTRICT,HYDERABAD TALUKA,70,727,153,880
HYDERABAD DISTRICT,HYDERABAD TALUKA,71,585,144,729
HYDERABAD DISTRICT,HYDERABAD TALUKA,72,527,138,665
HYDERABAD DISTRICT,HYDERABAD TALUKA,73,497,123,620
HYDERABAD DISTRICT,HYDERABAD TALUKA,74,478,104,582
HYDERABAD DISTRICT,HYDERABAD TALUKA,>=75,3390,762,4152
HYDERABAD DISTRICT,LATIFABAD TALUKA,<1,0,14989,14989
HYDERABAD DISTRICT,LATIFABAD TALUKA,1,0,15523,15523
HYDERABAD DISTRICT,LATIFABAD TALUKA,2,0,16815,16815
HYDERABAD DISTRICT,LATIFABAD TALUKA,3,0,18215,18215
HYDERABAD DISTRICT,LATIFABAD TALUKA,4,0,17203,17203
HYDERABAD DISTRICT,LATIFABAD TALUKA,5,0,17631,17631
HYDERABAD DISTRICT,LATIFABAD TALUKA,6,0,16662,16662
HYDERABAD DISTRICT,LATIFABAD TALUKA,7,0,17159,17159
HYDERABAD DISTRICT,LATIFABAD TALUKA,8,0,15772,15772
HYDERABAD DISTRICT,LATIFABAD TALUKA,9,0,16288,16288
HYDERABAD DISTRICT,LATIFABAD TALUKA,10,0,14455,14455
HYDERABAD DISTRICT,LATIFABAD TALUKA,11,0,15713,15713
HYDERABAD DISTRICT,LATIFABAD TALUKA,12,0,14009,14009
HYDERABAD DISTRICT,LATIFABAD TALUKA,13,0,14420,14420
HYDERABAD DISTRICT,LATIFABAD TALUKA,14,0,13342,13342
HYDERABAD DISTRICT,LATIFABAD TALUKA,15,0,14352,14352
HYDERABAD DISTRICT,LATIFABAD TALUKA,16,0,14544,14544
HYDERABAD DISTRICT,LATIFABAD TALUKA,17,0,15180,15180
HYDERABAD DISTRICT,LATIFABAD TALUKA,18,0,14075,14075
HYDERABAD DISTRICT,LATIFABAD TALUKA,19,0,14563,14563
HYDERABAD DISTRICT,LATIFABAD TALUKA,20,0,13738,13738
HYDERABAD DISTRICT,LATIFABAD TALUKA,21,0,14350,14350
HYDERABAD DISTRICT,LATIFABAD TALUKA,22,0,13963,13963
HYDERABAD DISTRICT,LATIFABAD TALUKA,23,0,12822,12822
HYDERABAD DISTRICT,LATIFABAD TALUKA,24,0,12847,12847
HYDERABAD DISTRICT,LATIFABAD TALUKA,25,0,12171,12171
HYDERABAD DISTRICT,LATIFABAD TALUKA,26,0,13029,13029
HYDERABAD DISTRICT,LATIFABAD TALUKA,27,0,12110,12110
HYDERABAD DISTRICT,LATIFABAD TALUKA,28,0,12744,12744
HYDERABAD DISTRICT,LATIFABAD TALUKA,29,0,12010,12010
HYDERABAD DISTRICT,LATIFABAD TALUKA,30,0,12230,12230
HYDERABAD DISTRICT,LATIFABAD TALUKA,31,0,12405,12405
HYDERABAD DISTRICT,LATIFABAD TALUKA,32,0,11586,11586
HYDERABAD DISTRICT,LATIFABAD TALUKA,33,0,11099,11099
HYDERABAD DISTRICT,LATIFABAD TALUKA,34,0,10613,10613
HYDERABAD DISTRICT,LATIFABAD TALUKA,35,0,9421,9421
HYDERABAD DISTRICT,LATIFABAD TALUKA,36,0,9866,9866
HYDERABAD DISTRICT,LATIFABAD TALUKA,37,0,8977,8977
HYDERABAD DISTRICT,LATIFABAD TALUKA,38,0,10032,10032
HYDERABAD DISTRICT,LATIFABAD TALUKA,39,0,9307,9307
HYDERABAD DISTRICT,LATIFABAD TALUKA,40,0,8817,8817
HYDERABAD DISTRICT,LATIFABAD TALUKA,41,0,8594,8594
HYDERABAD DISTRICT,LATIFABAD TALUKA,42,0,7719,7719
HYDERABAD DISTRICT,LATIFABAD TALUKA,43,0,7855,7855
HYDERABAD DISTRICT,LATIFABAD TALUKA,44,0,7440,7440
HYDERABAD DISTRICT,LATIFABAD TALUKA,45,0,6411,6411
HYDERABAD DISTRICT,LATIFABAD TALUKA,46,0,6800,6800
HYDERABAD DISTRICT,LATIFABAD TALUKA,47,0,6014,6014
HYDERABAD DISTRICT,LATIFABAD TALUKA,48,0,6694,6694
HYDERABAD DISTRICT,LATIFABAD TALUKA,49,0,6539,6539
HYDERABAD DISTRICT,LATIFABAD TALUKA,50,0,5607,5607
HYDERABAD DISTRICT,LATIFABAD TALUKA,51,0,6061,6061
HYDERABAD DISTRICT,LATIFABAD TALUKA,52,0,5468,5468
HYDERABAD DISTRICT,LATIFABAD TALUKA,53,0,5277,5277
HYDERABAD DISTRICT,LATIFABAD TALUKA,54,0,4793,4793
HYDERABAD DISTRICT,LATIFABAD TALUKA,55,0,4157,4157
HYDERABAD DISTRICT,LATIFABAD TALUKA,56,0,4114,4114
HYDERABAD DISTRICT,LATIFABAD TALUKA,57,0,3649,3649
HYDERABAD DISTRICT,LATIFABAD TALUKA,58,0,3524,3524
HYDERABAD DISTRICT,LATIFABAD TALUKA,59,0,3306,3306
HYDERABAD DISTRICT,LATIFABAD TALUKA,60,0,2880,2880
HYDERABAD DISTRICT,LATIFABAD TALUKA,61,0,3475,3475
HYDERABAD DISTRICT,LATIFABAD TALUKA,62,0,3366,3366
HYDERABAD DISTRICT,LATIFABAD TALUKA,63,0,3236,3236
HYDERABAD DISTRICT,LATIFABAD TALUKA,64,0,2645,2645
HYDERABAD DISTRICT,LATIFABAD TALUKA,65,0,2226,2226
HYDERABAD DISTRICT,LATIFABAD TALUKA,66,0,1925,1925
HYDERABAD DISTRICT,LATIFABAD TALUKA,67,0,1803,1803
HYDERABAD DISTRICT,LATIFABAD TALUKA,68,0,2105,2105
HYDERABAD DISTRICT,LATIFABAD TALUKA,69,0,1704,1704
HYDERABAD DISTRICT,LATIFABAD TALUKA,70,0,1376,1376
HYDERABAD DISTRICT,LATIFABAD TALUKA,71,0,1400,1400
HYDERABAD DISTRICT,LATIFABAD TALUKA,72,0,1421,1421
HYDERABAD DISTRICT,LATIFABAD TALUKA,73,0,1408,1408
HYDERABAD DISTRICT,LATIFABAD TALUKA,74,0,955,955
HYDERABAD DISTRICT,LATIFABAD TALUKA,>=75,0,6696,6696
HYDERABAD DISTRICT,QASIMABAD TALUKA,<1,0,6340,6340
HYDERABAD DISTRICT,QASIMABAD TALUKA,1,0,6934,6934
HYDERABAD DISTRICT,QASIMABAD TALUKA,2,0,7396,7396
HYDERABAD DISTRICT,QASIMABAD TALUKA,3,0,8525,8525
HYDERABAD DISTRICT,QASIMABAD TALUKA,4,0,8053,8053
HYDERABAD DISTRICT,QASIMABAD TALUKA,5,0,8315,8315
HYDERABAD DISTRICT,QASIMABAD TALUKA,6,0,7461,7461
HYDERABAD DISTRICT,QASIMABAD TALUKA,7,0,8034,8034
HYDERABAD DISTRICT,QASIMABAD TALUKA,8,0,7497,7497
HYDERABAD DISTRICT,QASIMABAD TALUKA,9,0,7404,7404
HYDERABAD DISTRICT,QASIMABAD TALUKA,10,0,6701,6701
HYDERABAD DISTRICT,QASIMABAD TALUKA,11,0,6755,6755
HYDERABAD DISTRICT,QASIMABAD TALUKA,12,0,6338,6338
HYDERABAD DISTRICT,QASIMABAD TALUKA,13,0,6246,6246
HYDERABAD DISTRICT,QASIMABAD TALUKA,14,0,5774,5774
HYDERABAD DISTRICT,QASIMABAD TALUKA,15,0,6362,6362
HYDERABAD DISTRICT,QASIMABAD TALUKA,16,0,6327,6327
HYDERABAD DISTRICT,QASIMABAD TALUKA,17,0,6902,6902
HYDERABAD DISTRICT,QASIMABAD TALUKA,18,0,6626,6626
HYDERABAD DISTRICT,QASIMABAD TALUKA,19,0,6882,6882
HYDERABAD DISTRICT,QASIMABAD TALUKA,20,0,6370,6370
HYDERABAD DISTRICT,QASIMABAD TALUKA,21,0,6748,6748
HYDERABAD DISTRICT,QASIMABAD TALUKA,22,0,6769,6769
HYDERABAD DISTRICT,QASIMABAD TALUKA,23,0,6154,6154
HYDERABAD DISTRICT,QASIMABAD TALUKA,24,0,5835,5835
HYDERABAD DISTRICT,QASIMABAD TALUKA,25,0,5339,5339
HYDERABAD DISTRICT,QASIMABAD TALUKA,26,0,5448,5448
HYDERABAD DISTRICT,QASIMABAD TALUKA,27,0,5394,5394
HYDERABAD DISTRICT,QASIMABAD TALUKA,28,0,5634,5634
HYDERABAD DISTRICT,QASIMABAD TALUKA,29,0,4971,4971
HYDERABAD DISTRICT,QASIMABAD TALUKA,30,0,5141,5141
HYDERABAD DISTRICT,QASIMABAD TALUKA,31,0,5083,5083
HYDERABAD DISTRICT,QASIMABAD TALUKA,32,0,4816,4816
HYDERABAD DISTRICT,QASIMABAD TALUKA,33,0,4585,4585
HYDERABAD DISTRICT,QASIMABAD TALUKA,34,0,4098,4098
HYDERABAD DISTRICT,QASIMABAD TALUKA,35,0,4016,4016
HYDERABAD DISTRICT,QASIMABAD TALUKA,36,0,4045,4045
HYDERABAD DISTRICT,QASIMABAD TALUKA,37,0,3518,3518
HYDERABAD DISTRICT,QASIMABAD TALUKA,38,0,4065,4065
HYDERABAD DISTRICT,QASIMABAD TALUKA,39,0,3599,3599
HYDERABAD DISTRICT,QASIMABAD TALUKA,40,0,3754,3754
HYDERABAD DISTRICT,QASIMABAD TALUKA,41,0,3370,3370
HYDERABAD DISTRICT,QASIMABAD TALUKA,42,0,3199,3199
HYDERABAD DISTRICT,QASIMABAD TALUKA,43,0,3060,3060
HYDERABAD DISTRICT,QASIMABAD TALUKA,44,0,2759,2759
HYDERABAD DISTRICT,QASIMABAD TALUKA,45,0,2758,2758
HYDERABAD DISTRICT,QASIMABAD TALUKA,46,0,2550,2550
HYDERABAD DISTRICT,QASIMABAD TALUKA,47,0,2240,2240
HYDERABAD DISTRICT,QASIMABAD TALUKA,48,0,2661,2661
HYDERABAD DISTRICT,QASIMABAD TALUKA,49,0,2368,2368
HYDERABAD DISTRICT,QASIMABAD TALUKA,50,0,2505,2505
HYDERABAD DISTRICT,QASIMABAD TALUKA,51,0,2217,2217
HYDERABAD DISTRICT,QASIMABAD TALUKA,52,0,2112,2112
HYDERABAD DISTRICT,QASIMABAD TALUKA,53,0,1978,1978
HYDERABAD DISTRICT,QASIMABAD TALUKA,54,0,1817,1817
HYDERABAD DISTRICT,QASIMABAD TALUKA,55,0,1753,1753
HYDERABAD DISTRICT,QASIMABAD TALUKA,56,0,1575,1575
HYDERABAD DISTRICT,QASIMABAD TALUKA,57,0,1354,1354
HYDERABAD DISTRICT,QASIMABAD TALUKA,58,0,1543,1543
HYDERABAD DISTRICT,QASIMABAD TALUKA,59,0,1421,1421
HYDERABAD DISTRICT,QASIMABAD TALUKA,60,0,1263,1263
HYDERABAD DISTRICT,QASIMABAD TALUKA,61,0,1172,1172
HYDERABAD DISTRICT,QASIMABAD TALUKA,62,0,1295,1295
HYDERABAD DISTRICT,QASIMABAD TALUKA,63,0,1245,1245
HYDERABAD DISTRICT,QASIMABAD TALUKA,64,0,1196,1196
HYDERABAD DISTRICT,QASIMABAD TALUKA,65,0,1034,1034
HYDERABAD DISTRICT,QASIMABAD TALUKA,66,0,805,805
HYDERABAD DISTRICT,QASIMABAD TALUKA,67,0,657,657
HYDERABAD DISTRICT,QASIMABAD TALUKA,68,0,705,705
HYDERABAD DISTRICT,QASIMABAD TALUKA,69,0,635,635
HYDERABAD DISTRICT,QASIMABAD TALUKA,70,0,571,571
HYDERABAD DISTRICT,QASIMABAD TALUKA,71,0,526,526
HYDERABAD DISTRICT,QASIMABAD TALUKA,72,0,501,501
HYDERABAD DISTRICT,QASIMABAD TALUKA,73,0,456,456
HYDERABAD DISTRICT,QASIMABAD TALUKA,74,0,391,391
HYDERABAD DISTRICT,QASIMABAD TALUKA,>=75,0,2833,2833
JACOBABAD DISTRICT,GARHI KHAIRO TALUKA,<1,4097,307,4404
JACOBABAD DISTRICT,GARHI KHAIRO TALUKA,1,4306,295,4601
JACOBABAD DISTRICT,GARHI KHAIRO TALUKA,2,5440,380,5820
JACOBABAD DISTRICT,GARHI KHAIRO TALUKA,3,5639,436,6075
JACOBABAD DISTRICT,GARHI KHAIRO TALUKA,4,6067,384,6451
JACOBABAD DISTRICT,GARHI KHAIRO TALUKA,5,5397,428,5825
JACOBABAD DISTRICT,GARHI KHAIRO TALUKA,6,5795,382,6177
JACOBABAD DISTRICT,GARHI KHAIRO TALUKA,7,5436,453,5889
JACOBABAD DISTRICT,GARHI KHAIRO TALUKA,8,6454,394,6848
JACOBABAD DISTRICT,GARHI KHAIRO TALUKA,9,4303,403,4706
JACOBABAD DISTRICT,GARHI KHAIRO TALUKA,10,5384,336,5720
JACOBABAD DISTRICT,GARHI KHAIRO TALUKA,11,3250,338,3588
JACOBABAD DISTRICT,GARHI KHAIRO TALUKA,12,4183,325,4508
JACOBABAD DISTRICT,GARHI KHAIRO TALUKA,13,2726,324,3050
JACOBABAD DISTRICT,GARHI KHAIRO TALUKA,14,3273,308,3581
JACOBABAD DISTRICT,GARHI KHAIRO TALUKA,15,2916,309,3225
JACOBABAD DISTRICT,GARHI KHAIRO TALUKA,16,3071,260,3331
JACOBABAD DISTRICT,GARHI KHAIRO TALUKA,17,2395,347,2742
JACOBABAD DISTRICT,GARHI KHAIRO TALUKA,18,3237,268,3505
JACOBABAD DISTRICT,GARHI KHAIRO TALUKA,19,2418,266,2684
JACOBABAD DISTRICT,GARHI KHAIRO TALUKA,20,2619,232,2851
JACOBABAD DISTRICT,GARHI KHAIRO TALUKA,21,1892,201,2093
JACOBABAD DISTRICT,GARHI KHAIRO TALUKA,22,1743,152,1895
JACOBABAD DISTRICT,GARHI KHAIRO TALUKA,23,1492,216,1708
JACOBABAD DISTRICT,GARHI KHAIRO TALUKA,24,1434,155,1589
JACOBABAD DISTRICT,GARHI KHAIRO TALUKA,25,2016,153,2169
JACOBABAD DISTRICT,GARHI KHAIRO TALUKA,26,1581,174,1755
JACOBABAD DISTRICT,GARHI KHAIRO TALUKA,27,1960,231,2191
JACOBABAD DISTRICT,GARHI KHAIRO TALUKA,28,1656,167,1823
JACOBABAD DISTRICT,GARHI KHAIRO TALUKA,29,2080,212,2292
JACOBABAD DISTRICT,GARHI KHAIRO TALUKA,30,1695,130,1825
JACOBABAD DISTRICT,GARHI KHAIRO TALUKA,31,1864,192,2056
JACOBABAD DISTRICT,GARHI KHAIRO TALUKA,32,1857,194,2051
JACOBABAD DISTRICT,GARHI KHAIRO TALUKA,33,1611,182,1793
JACOBABAD DISTRICT,GARHI KHAIRO TALUKA,34,1557,155,1712
JACOBABAD DISTRICT,GARHI KHAIRO TALUKA,35,1510,154,1664
JACOBABAD DISTRICT,GARHI KHAIRO TALUKA,36,1605,133,1738
JACOBABAD DISTRICT,GARHI KHAIRO TALUKA,37,2171,198,2369
JACOBABAD DISTRICT,GARHI KHAIRO TALUKA,38,1482,121,1603
JACOBABAD DISTRICT,GARHI KHAIRO TALUKA,39,1644,160,1804
JACOBABAD DISTRICT,GARHI KHAIRO TALUKA,40,1170,104,1274
JACOBABAD DISTRICT,GARHI KHAIRO TALUKA,41,1290,100,1390
JACOBABAD DISTRICT,GARHI KHAIRO TALUKA,42,1263,133,1396
JACOBABAD DISTRICT,GARHI KHAIRO TALUKA,43,1043,109,1152
JACOBABAD DISTRICT,GARHI KHAIRO TALUKA,44,1014,110,1124
JACOBABAD DISTRICT,GARHI KHAIRO TALUKA,45,946,80,1026
JACOBABAD DISTRICT,GARHI KHAIRO TALUKA,46,1026,72,1098
JACOBABAD DISTRICT,GARHI KHAIRO TALUKA,47,1395,121,1516
JACOBABAD DISTRICT,GARHI KHAIRO TALUKA,48,954,82,1036
JACOBABAD DISTRICT,GARHI KHAIRO TALUKA,49,1133,97,1230
JACOBABAD DISTRICT,GARHI KHAIRO TALUKA,50,727,65,792
JACOBABAD DISTRICT,GARHI KHAIRO TALUKA,51,887,89,976
JACOBABAD DISTRICT,GARHI KHAIRO TALUKA,52,820,79,899
JACOBABAD DISTRICT,GARHI KHAIRO TALUKA,53,623,62,685
JACOBABAD DISTRICT,GARHI KHAIRO TALUKA,54,531,47,578
JACOBABAD DISTRICT,GARHI KHAIRO TALUKA,55,550,50,600
JACOBABAD DISTRICT,GARHI KHAIRO TALUKA,56,623,43,666
JACOBABAD DISTRICT,GARHI KHAIRO TALUKA,57,886,79,965
JACOBABAD DISTRICT,GARHI KHAIRO TALUKA,58,490,46,536
JACOBABAD DISTRICT,GARHI KHAIRO TALUKA,59,578,58,636
JACOBABAD DISTRICT,GARHI KHAIRO TALUKA,60,462,42,504
JACOBABAD DISTRICT,GARHI KHAIRO TALUKA,61,491,50,541
JACOBABAD DISTRICT,GARHI KHAIRO TALUKA,62,586,62,648
JACOBABAD DISTRICT,GARHI KHAIRO TALUKA,63,434,36,470
JACOBABAD DISTRICT,GARHI KHAIRO TALUKA,64,411,32,443
JACOBABAD DISTRICT,GARHI KHAIRO TALUKA,65,396,24,420
JACOBABAD DISTRICT,GARHI KHAIRO TALUKA,66,471,32,503
JACOBABAD DISTRICT,GARHI KHAIRO TALUKA,67,493,38,531
JACOBABAD DISTRICT,GARHI KHAIRO TALUKA,68,323,28,351
JACOBABAD DISTRICT,GARHI KHAIRO TALUKA,69,341,25,366
JACOBABAD DISTRICT,GARHI KHAIRO TALUKA,70,248,20,268
JACOBABAD DISTRICT,GARHI KHAIRO TALUKA,71,299,26,325
JACOBABAD DISTRICT,GARHI KHAIRO TALUKA,72,306,19,325
JACOBABAD DISTRICT,GARHI KHAIRO TALUKA,73,186,14,200
JACOBABAD DISTRICT,GARHI KHAIRO TALUKA,74,160,11,171
JACOBABAD DISTRICT,GARHI KHAIRO TALUKA,>=75,1588,79,1667
JACOBABAD DISTRICT,JACOBABAD TALUKA,<1,4483,4140,8623
JACOBABAD DISTRICT,JACOBABAD TALUKA,1,6158,4862,11020
JACOBABAD DISTRICT,JACOBABAD TALUKA,2,7104,5619,12723
JACOBABAD DISTRICT,JACOBABAD TALUKA,3,7942,6338,14280
JACOBABAD DISTRICT,JACOBABAD TALUKA,4,7955,6224,14179
JACOBABAD DISTRICT,JACOBABAD TALUKA,5,7488,6172,13660
JACOBABAD DISTRICT,JACOBABAD TALUKA,6,7480,5483,12963
JACOBABAD DISTRICT,JACOBABAD TALUKA,7,7484,6530,14014
JACOBABAD DISTRICT,JACOBABAD TALUKA,8,8233,6083,14316
JACOBABAD DISTRICT,JACOBABAD TALUKA,9,6397,5613,12010
JACOBABAD DISTRICT,JACOBABAD TALUKA,10,7093,5239,12332
JACOBABAD DISTRICT,JACOBABAD TALUKA,11,4443,4595,9038
JACOBABAD DISTRICT,JACOBABAD TALUKA,12,5405,4908,10313
JACOBABAD DISTRICT,JACOBABAD TALUKA,13,3878,4285,8163
JACOBABAD DISTRICT,JACOBABAD TALUKA,14,4161,4276,8437
JACOBABAD DISTRICT,JACOBABAD TALUKA,15,3766,4356,8122
JACOBABAD DISTRICT,JACOBABAD TALUKA,16,4001,4337,8338
JACOBABAD DISTRICT,JACOBABAD TALUKA,17,3163,4435,7598
JACOBABAD DISTRICT,JACOBABAD TALUKA,18,3967,4517,8484
JACOBABAD DISTRICT,JACOBABAD TALUKA,19,2906,3790,6696
JACOBABAD DISTRICT,JACOBABAD TALUKA,20,3353,3624,6977
JACOBABAD DISTRICT,JACOBABAD TALUKA,21,2464,3291,5755
JACOBABAD DISTRICT,JACOBABAD TALUKA,22,2461,3192,5653
JACOBABAD DISTRICT,JACOBABAD TALUKA,23,2108,2924,5032
JACOBABAD DISTRICT,JACOBABAD TALUKA,24,1976,2776,4752
JACOBABAD DISTRICT,JACOBABAD TALUKA,25,2838,2933,5771
JACOBABAD DISTRICT,JACOBABAD TALUKA,26,2231,2766,4997
JACOBABAD DISTRICT,JACOBABAD TALUKA,27,2616,3249,5865
JACOBABAD DISTRICT,JACOBABAD TALUKA,28,2606,3098,5704
JACOBABAD DISTRICT,JACOBABAD TALUKA,29,2869,3133,6002
JACOBABAD DISTRICT,JACOBABAD TALUKA,30,2702,2889,5591
JACOBABAD DISTRICT,JACOBABAD TALUKA,31,2481,3009,5490
JACOBABAD DISTRICT,JACOBABAD TALUKA,32,2226,2628,4854
JACOBABAD DISTRICT,JACOBABAD TALUKA,33,2203,2602,4805
JACOBABAD DISTRICT,JACOBABAD TALUKA,34,2102,2372,4474
JACOBABAD DISTRICT,JACOBABAD TALUKA,35,2232,2330,4562
JACOBABAD DISTRICT,JACOBABAD TALUKA,36,2094,2028,4122
JACOBABAD DISTRICT,JACOBABAD TALUKA,37,2615,2430,5045
JACOBABAD DISTRICT,JACOBABAD TALUKA,38,2018,2202,4220
JACOBABAD DISTRICT,JACOBABAD TALUKA,39,2184,2345,4529
JACOBABAD DISTRICT,JACOBABAD TALUKA,40,1773,1910,3683
JACOBABAD DISTRICT,JACOBABAD TALUKA,41,1518,1749,3267
JACOBABAD DISTRICT,JACOBABAD TALUKA,42,1473,1615,3088
JACOBABAD DISTRICT,JACOBABAD TALUKA,43,1336,1579,2915
JACOBABAD DISTRICT,JACOBABAD TALUKA,44,1179,1478,2657
JACOBABAD DISTRICT,JACOBABAD TALUKA,45,1212,1479,2691
JACOBABAD DISTRICT,JACOBABAD TALUKA,46,1164,1249,2413
JACOBABAD DISTRICT,JACOBABAD TALUKA,47,1310,1553,2863
JACOBABAD DISTRICT,JACOBABAD TALUKA,48,1143,1485,2628
JACOBABAD DISTRICT,JACOBABAD TALUKA,49,1241,1504,2745
JACOBABAD DISTRICT,JACOBABAD TALUKA,50,1115,1212,2327
JACOBABAD DISTRICT,JACOBABAD TALUKA,51,999,1236,2235
JACOBABAD DISTRICT,JACOBABAD TALUKA,52,886,1094,1980
JACOBABAD DISTRICT,JACOBABAD TALUKA,53,833,1047,1880
JACOBABAD DISTRICT,JACOBABAD TALUKA,54,685,899,1584
JACOBABAD DISTRICT,JACOBABAD TALUKA,55,737,824,1561
JACOBABAD DISTRICT,JACOBABAD TALUKA,56,666,708,1374
JACOBABAD DISTRICT,JACOBABAD TALUKA,57,875,894,1769
JACOBABAD DISTRICT,JACOBABAD TALUKA,58,594,713,1307
JACOBABAD DISTRICT,JACOBABAD TALUKA,59,678,763,1441
JACOBABAD DISTRICT,JACOBABAD TALUKA,60,696,659,1355
JACOBABAD DISTRICT,JACOBABAD TALUKA,61,586,732,1318
JACOBABAD DISTRICT,JACOBABAD TALUKA,62,584,712,1296
JACOBABAD DISTRICT,JACOBABAD TALUKA,63,513,670,1183
JACOBABAD DISTRICT,JACOBABAD TALUKA,64,470,553,1023
JACOBABAD DISTRICT,JACOBABAD TALUKA,65,457,545,1002
JACOBABAD DISTRICT,JACOBABAD TALUKA,66,450,425,875
JACOBABAD DISTRICT,JACOBABAD TALUKA,67,569,520,1089
JACOBABAD DISTRICT,JACOBABAD TALUKA,68,334,414,748
JACOBABAD DISTRICT,JACOBABAD TALUKA,69,389,381,770
JACOBABAD DISTRICT,JACOBABAD TALUKA,70,290,274,564
JACOBABAD DISTRICT,JACOBABAD TALUKA,71,299,307,606
JACOBABAD DISTRICT,JACOBABAD TALUKA,72,268,279,547
JACOBABAD DISTRICT,JACOBABAD TALUKA,73,226,239,465
JACOBABAD DISTRICT,JACOBABAD TALUKA,74,202,163,365
JACOBABAD DISTRICT,JACOBABAD TALUKA,>=75,1844,1611,3455
JACOBABAD DISTRICT,THUL TALUKA,<1,10589,2646,13235
JACOBABAD DISTRICT,THUL TALUKA,1,11621,2861,14482
JACOBABAD DISTRICT,THUL TALUKA,2,15221,3314,18535
JACOBABAD DISTRICT,THUL TALUKA,3,15580,3485,19065
JACOBABAD DISTRICT,THUL TALUKA,4,16283,3628,19911
JACOBABAD DISTRICT,THUL TALUKA,5,15373,3405,18778
JACOBABAD DISTRICT,THUL TALUKA,6,15317,3224,18541
JACOBABAD DISTRICT,THUL TALUKA,7,14354,3483,17837
JACOBABAD DISTRICT,THUL TALUKA,8,16711,3463,20174
JACOBABAD DISTRICT,THUL TALUKA,9,12031,3125,15156
JACOBABAD DISTRICT,THUL TALUKA,10,14158,3125,17283
JACOBABAD DISTRICT,THUL TALUKA,11,8683,2310,10993
JACOBABAD DISTRICT,THUL TALUKA,12,10093,2507,12600
JACOBABAD DISTRICT,THUL TALUKA,13,7103,2136,9239
JACOBABAD DISTRICT,THUL TALUKA,14,7391,2107,9498
JACOBABAD DISTRICT,THUL TALUKA,15,6788,2178,8966
JACOBABAD DISTRICT,THUL TALUKA,16,6506,2009,8515
JACOBABAD DISTRICT,THUL TALUKA,17,5873,2094,7967
JACOBABAD DISTRICT,THUL TALUKA,18,7830,2001,9831
JACOBABAD DISTRICT,THUL TALUKA,19,5889,1904,7793
JACOBABAD DISTRICT,THUL TALUKA,20,6138,1822,7960
JACOBABAD DISTRICT,THUL TALUKA,21,4475,1409,5884
JACOBABAD DISTRICT,THUL TALUKA,22,4406,1377,5783
JACOBABAD DISTRICT,THUL TALUKA,23,3870,1330,5200
JACOBABAD DISTRICT,THUL TALUKA,24,4027,1197,5224
JACOBABAD DISTRICT,THUL TALUKA,25,4876,1389,6265
JACOBABAD DISTRICT,THUL TALUKA,26,4330,1086,5416
JACOBABAD DISTRICT,THUL TALUKA,27,5111,1363,6474
JACOBABAD DISTRICT,THUL TALUKA,28,4622,1160,5782
JACOBABAD DISTRICT,THUL TALUKA,29,5694,1399,7093
JACOBABAD DISTRICT,THUL TALUKA,30,4509,1247,5756
JACOBABAD DISTRICT,THUL TALUKA,31,4934,1163,6097
JACOBABAD DISTRICT,THUL TALUKA,32,4670,1205,5875
JACOBABAD DISTRICT,THUL TALUKA,33,4411,1164,5575
JACOBABAD DISTRICT,THUL TALUKA,34,3714,963,4677
JACOBABAD DISTRICT,THUL TALUKA,35,3725,980,4705
JACOBABAD DISTRICT,THUL TALUKA,36,4265,907,5172
JACOBABAD DISTRICT,THUL TALUKA,37,5650,1315,6965
JACOBABAD DISTRICT,THUL TALUKA,38,3638,890,4528
JACOBABAD DISTRICT,THUL TALUKA,39,4093,963,5056
JACOBABAD DISTRICT,THUL TALUKA,40,2798,777,3575
JACOBABAD DISTRICT,THUL TALUKA,41,3060,699,3759
JACOBABAD DISTRICT,THUL TALUKA,42,3229,776,4005
JACOBABAD DISTRICT,THUL TALUKA,43,2238,661,2899
JACOBABAD DISTRICT,THUL TALUKA,44,2169,574,2743
JACOBABAD DISTRICT,THUL TALUKA,45,2089,632,2721
JACOBABAD DISTRICT,THUL TALUKA,46,2295,555,2850
JACOBABAD DISTRICT,THUL TALUKA,47,3197,747,3944
JACOBABAD DISTRICT,THUL TALUKA,48,2178,530,2708
JACOBABAD DISTRICT,THUL TALUKA,49,2322,587,2909
JACOBABAD DISTRICT,THUL TALUKA,50,1810,560,2370
JACOBABAD DISTRICT,THUL TALUKA,51,2064,505,2569
JACOBABAD DISTRICT,THUL TALUKA,52,2240,535,2775
JACOBABAD DISTRICT,THUL TALUKA,53,1483,432,1915
JACOBABAD DISTRICT,THUL TALUKA,54,1321,340,1661
JACOBABAD DISTRICT,THUL TALUKA,55,1346,371,1717
JACOBABAD DISTRICT,THUL TALUKA,56,1383,304,1687
JACOBABAD DISTRICT,THUL TALUKA,57,2071,473,2544
JACOBABAD DISTRICT,THUL TALUKA,58,1017,254,1271
JACOBABAD DISTRICT,THUL TALUKA,59,1212,294,1506
JACOBABAD DISTRICT,THUL TALUKA,60,1072,298,1370
JACOBABAD DISTRICT,THUL TALUKA,61,1138,221,1359
JACOBABAD DISTRICT,THUL TALUKA,62,1395,329,1724
JACOBABAD DISTRICT,THUL TALUKA,63,966,258,1224
JACOBABAD DISTRICT,THUL TALUKA,64,911,221,1132
JACOBABAD DISTRICT,THUL TALUKA,65,802,186,988
JACOBABAD DISTRICT,THUL TALUKA,66,984,215,1199
JACOBABAD DISTRICT,THUL TALUKA,67,1291,292,1583
JACOBABAD DISTRICT,THUL TALUKA,68,650,150,800
JACOBABAD DISTRICT,THUL TALUKA,69,729,128,857
JACOBABAD DISTRICT,THUL TALUKA,70,506,116,622
JACOBABAD DISTRICT,THUL TALUKA,71,638,126,764
JACOBABAD DISTRICT,THUL TALUKA,72,641,128,769
JACOBABAD DISTRICT,THUL TALUKA,73,420,113,533
JACOBABAD DISTRICT,THUL TALUKA,74,343,84,427
JACOBABAD DISTRICT,THUL TALUKA,>=75,3351,696,4047
JAFFARABAD DISTRICT,GANDHAKA TEHSIL,<1,1731,0,1731
JAFFARABAD DISTRICT,GANDHAKA TEHSIL,1,2377,0,2377
JAFFARABAD DISTRICT,GANDHAKA TEHSIL,2,2931,0,2931
JAFFARABAD DISTRICT,GANDHAKA TEHSIL,3,2857,0,2857
JAFFARABAD DISTRICT,GANDHAKA TEHSIL,4,3238,0,3238
JAFFARABAD DISTRICT,GANDHAKA TEHSIL,5,2866,0,2866
JAFFARABAD DISTRICT,GANDHAKA TEHSIL,6,3205,0,3205
JAFFARABAD DISTRICT,GANDHAKA TEHSIL,7,2603,0,2603
JAFFARABAD DISTRICT,GANDHAKA TEHSIL,8,3120,0,3120
JAFFARABAD DISTRICT,GANDHAKA TEHSIL,9,2323,0,2323
JAFFARABAD DISTRICT,GANDHAKA TEHSIL,10,2758,0,2758
JAFFARABAD DISTRICT,GANDHAKA TEHSIL,11,1788,0,1788
JAFFARABAD DISTRICT,GANDHAKA TEHSIL,12,2084,0,2084
JAFFARABAD DISTRICT,GANDHAKA TEHSIL,13,1409,0,1409
JAFFARABAD DISTRICT,GANDHAKA TEHSIL,14,1670,0,1670
JAFFARABAD DISTRICT,GANDHAKA TEHSIL,15,1381,0,1381
JAFFARABAD DISTRICT,GANDHAKA TEHSIL,16,1511,0,1511
JAFFARABAD DISTRICT,GANDHAKA TEHSIL,17,1194,0,1194
JAFFARABAD DISTRICT,GANDHAKA TEHSIL,18,1650,0,1650
JAFFARABAD DISTRICT,GANDHAKA TEHSIL,19,1250,0,1250
JAFFARABAD DISTRICT,GANDHAKA TEHSIL,20,1300,0,1300
JAFFARABAD DISTRICT,GANDHAKA TEHSIL,21,984,0,984
JAFFARABAD DISTRICT,GANDHAKA TEHSIL,22,882,0,882
JAFFARABAD DISTRICT,GANDHAKA TEHSIL,23,840,0,840
JAFFARABAD DISTRICT,GANDHAKA TEHSIL,24,832,0,832
JAFFARABAD DISTRICT,GANDHAKA TEHSIL,25,978,0,978
JAFFARABAD DISTRICT,GANDHAKA TEHSIL,26,856,0,856
JAFFARABAD DISTRICT,GANDHAKA TEHSIL,27,1136,0,1136
JAFFARABAD DISTRICT,GANDHAKA TEHSIL,28,981,0,981
JAFFARABAD DISTRICT,GANDHAKA TEHSIL,29,1058,0,1058
JAFFARABAD DISTRICT,GANDHAKA TEHSIL,30,933,0,933
JAFFARABAD DISTRICT,GANDHAKA TEHSIL,31,1021,0,1021
JAFFARABAD DISTRICT,GANDHAKA TEHSIL,32,1005,0,1005
JAFFARABAD DISTRICT,GANDHAKA TEHSIL,33,875,0,875
JAFFARABAD DISTRICT,GANDHAKA TEHSIL,34,776,0,776
JAFFARABAD DISTRICT,GANDHAKA TEHSIL,35,789,0,789
JAFFARABAD DISTRICT,GANDHAKA TEHSIL,36,802,0,802
JAFFARABAD DISTRICT,GANDHAKA TEHSIL,37,1179,0,1179
JAFFARABAD DISTRICT,GANDHAKA TEHSIL,38,685,0,685
JAFFARABAD DISTRICT,GANDHAKA TEHSIL,39,900,0,900
JAFFARABAD DISTRICT,GANDHAKA TEHSIL,40,618,0,618
JAFFARABAD DISTRICT,GANDHAKA TEHSIL,41,659,0,659
JAFFARABAD DISTRICT,GANDHAKA TEHSIL,42,703,0,703
JAFFARABAD DISTRICT,GANDHAKA TEHSIL,43,450,0,450
JAFFARABAD DISTRICT,GANDHAKA TEHSIL,44,482,0,482
JAFFARABAD DISTRICT,GANDHAKA TEHSIL,45,454,0,454
JAFFARABAD DISTRICT,GANDHAKA TEHSIL,46,475,0,475
JAFFARABAD DISTRICT,GANDHAKA TEHSIL,47,682,0,682
JAFFARABAD DISTRICT,GANDHAKA TEHSIL,48,478,0,478
JAFFARABAD DISTRICT,GANDHAKA TEHSIL,49,466,0,466
JAFFARABAD DISTRICT,GANDHAKA TEHSIL,50,338,0,338
JAFFARABAD DISTRICT,GANDHAKA TEHSIL,51,434,0,434
JAFFARABAD DISTRICT,GANDHAKA TEHSIL,52,432,0,432
JAFFARABAD DISTRICT,GANDHAKA TEHSIL,53,347,0,347
JAFFARABAD DISTRICT,GANDHAKA TEHSIL,54,312,0,312
JAFFARABAD DISTRICT,GANDHAKA TEHSIL,55,220,0,220
JAFFARABAD DISTRICT,GANDHAKA TEHSIL,56,292,0,292
JAFFARABAD DISTRICT,GANDHAKA TEHSIL,57,441,0,441
JAFFARABAD DISTRICT,GANDHAKA TEHSIL,58,253,0,253
JAFFARABAD DISTRICT,GANDHAKA TEHSIL,59,267,0,267
JAFFARABAD DISTRICT,GANDHAKA TEHSIL,60,236,0,236
JAFFARABAD DISTRICT,GANDHAKA TEHSIL,61,237,0,237
JAFFARABAD DISTRICT,GANDHAKA TEHSIL,62,273,0,273
JAFFARABAD DISTRICT,GANDHAKA TEHSIL,63,202,0,202
JAFFARABAD DISTRICT,GANDHAKA TEHSIL,64,227,0,227
JAFFARABAD DISTRICT,GANDHAKA TEHSIL,65,165,0,165
JAFFARABAD DISTRICT,GANDHAKA TEHSIL,66,176,0,176
JAFFARABAD DISTRICT,GANDHAKA TEHSIL,67,240,0,240
JAFFARABAD DISTRICT,GANDHAKA TEHSIL,68,122,0,122
JAFFARABAD DISTRICT,GANDHAKA TEHSIL,69,148,0,148
JAFFARABAD DISTRICT,GANDHAKA TEHSIL,70,133,0,133
JAFFARABAD DISTRICT,GANDHAKA TEHSIL,71,121,0,121
JAFFARABAD DISTRICT,GANDHAKA TEHSIL,72,119,0,119
JAFFARABAD DISTRICT,GANDHAKA TEHSIL,73,91,0,91
JAFFARABAD DISTRICT,GANDHAKA TEHSIL,74,90,0,90
JAFFARABAD DISTRICT,GANDHAKA TEHSIL,>=75,740,0,740
JAFFARABAD DISTRICT,JHAT PAT TEHSIL,<1,5219,2012,7231
JAFFARABAD DISTRICT,JHAT PAT TEHSIL,1,6248,2703,8951
JAFFARABAD DISTRICT,JHAT PAT TEHSIL,2,7419,3088,10507
JAFFARABAD DISTRICT,JHAT PAT TEHSIL,3,7594,3559,11153
JAFFARABAD DISTRICT,JHAT PAT TEHSIL,4,7465,3139,10604
JAFFARABAD DISTRICT,JHAT PAT TEHSIL,5,7439,3201,10640
JAFFARABAD DISTRICT,JHAT PAT TEHSIL,6,7199,2733,9932
JAFFARABAD DISTRICT,JHAT PAT TEHSIL,7,7087,3289,10376
JAFFARABAD DISTRICT,JHAT PAT TEHSIL,8,7358,2793,10151
JAFFARABAD DISTRICT,JHAT PAT TEHSIL,9,5544,2607,8151
JAFFARABAD DISTRICT,JHAT PAT TEHSIL,10,5783,2282,8065
JAFFARABAD DISTRICT,JHAT PAT TEHSIL,11,3880,2092,5972
JAFFARABAD DISTRICT,JHAT PAT TEHSIL,12,4546,2059,6605
JAFFARABAD DISTRICT,JHAT PAT TEHSIL,13,3191,1758,4949
JAFFARABAD DISTRICT,JHAT PAT TEHSIL,14,3497,1644,5141
JAFFARABAD DISTRICT,JHAT PAT TEHSIL,15,2929,1742,4671
JAFFARABAD DISTRICT,JHAT PAT TEHSIL,16,3149,1586,4735
JAFFARABAD DISTRICT,JHAT PAT TEHSIL,17,2637,1763,4400
JAFFARABAD DISTRICT,JHAT PAT TEHSIL,18,4015,1754,5769
JAFFARABAD DISTRICT,JHAT PAT TEHSIL,19,2893,1591,4484
JAFFARABAD DISTRICT,JHAT PAT TEHSIL,20,2743,1311,4054
JAFFARABAD DISTRICT,JHAT PAT TEHSIL,21,2119,1237,3356
JAFFARABAD DISTRICT,JHAT PAT TEHSIL,22,2064,1154,3218
JAFFARABAD DISTRICT,JHAT PAT TEHSIL,23,1786,1137,2923
JAFFARABAD DISTRICT,JHAT PAT TEHSIL,24,1869,1129,2998
JAFFARABAD DISTRICT,JHAT PAT TEHSIL,25,2328,1123,3451
JAFFARABAD DISTRICT,JHAT PAT TEHSIL,26,1846,986,2832
JAFFARABAD DISTRICT,JHAT PAT TEHSIL,27,2416,1382,3798
JAFFARABAD DISTRICT,JHAT PAT TEHSIL,28,2114,1091,3205
JAFFARABAD DISTRICT,JHAT PAT TEHSIL,29,2434,1370,3804
JAFFARABAD DISTRICT,JHAT PAT TEHSIL,30,2197,897,3094
JAFFARABAD DISTRICT,JHAT PAT TEHSIL,31,2092,1117,3209
JAFFARABAD DISTRICT,JHAT PAT TEHSIL,32,2143,1116,3259
JAFFARABAD DISTRICT,JHAT PAT TEHSIL,33,1862,895,2757
JAFFARABAD DISTRICT,JHAT PAT TEHSIL,34,1737,875,2612
JAFFARABAD DISTRICT,JHAT PAT TEHSIL,35,1859,879,2738
JAFFARABAD DISTRICT,JHAT PAT TEHSIL,36,1708,751,2459
JAFFARABAD DISTRICT,JHAT PAT TEHSIL,37,2465,1190,3655
JAFFARABAD DISTRICT,JHAT PAT TEHSIL,38,1705,725,2430
JAFFARABAD DISTRICT,JHAT PAT TEHSIL,39,1898,865,2763
JAFFARABAD DISTRICT,JHAT PAT TEHSIL,40,1460,617,2077
JAFFARABAD DISTRICT,JHAT PAT TEHSIL,41,1280,615,1895
JAFFARABAD DISTRICT,JHAT PAT TEHSIL,42,1371,658,2029
JAFFARABAD DISTRICT,JHAT PAT TEHSIL,43,1057,552,1609
JAFFARABAD DISTRICT,JHAT PAT TEHSIL,44,893,479,1372
JAFFARABAD DISTRICT,JHAT PAT TEHSIL,45,997,397,1394
JAFFARABAD DISTRICT,JHAT PAT TEHSIL,46,877,410,1287
JAFFARABAD DISTRICT,JHAT PAT TEHSIL,47,1357,739,2096
JAFFARABAD DISTRICT,JHAT PAT TEHSIL,48,897,483,1380
JAFFARABAD DISTRICT,JHAT PAT TEHSIL,49,1016,556,1572
JAFFARABAD DISTRICT,JHAT PAT TEHSIL,50,955,414,1369
JAFFARABAD DISTRICT,JHAT PAT TEHSIL,51,909,490,1399
JAFFARABAD DISTRICT,JHAT PAT TEHSIL,52,886,484,1370
JAFFARABAD DISTRICT,JHAT PAT TEHSIL,53,714,335,1049
JAFFARABAD DISTRICT,JHAT PAT TEHSIL,54,648,306,954
JAFFARABAD DISTRICT,JHAT PAT TEHSIL,55,632,297,929
JAFFARABAD DISTRICT,JHAT PAT TEHSIL,56,560,252,812
JAFFARABAD DISTRICT,JHAT PAT TEHSIL,57,900,492,1392
JAFFARABAD DISTRICT,JHAT PAT TEHSIL,58,478,252,730
JAFFARABAD DISTRICT,JHAT PAT TEHSIL,59,612,333,945
JAFFARABAD DISTRICT,JHAT PAT TEHSIL,60,507,208,715
JAFFARABAD DISTRICT,JHAT PAT TEHSIL,61,506,310,816
JAFFARABAD DISTRICT,JHAT PAT TEHSIL,62,538,296,834
JAFFARABAD DISTRICT,JHAT PAT TEHSIL,63,512,207,719
JAFFARABAD DISTRICT,JHAT PAT TEHSIL,64,444,175,619
JAFFARABAD DISTRICT,JHAT PAT TEHSIL,65,384,165,549
JAFFARABAD DISTRICT,JHAT PAT TEHSIL,66,394,161,555
JAFFARABAD DISTRICT,JHAT PAT TEHSIL,67,551,269,820
JAFFARABAD DISTRICT,JHAT PAT TEHSIL,68,296,119,415
JAFFARABAD DISTRICT,JHAT PAT TEHSIL,69,345,142,487
JAFFARABAD DISTRICT,JHAT PAT TEHSIL,70,266,104,370
JAFFARABAD DISTRICT,JHAT PAT TEHSIL,71,267,120,387
JAFFARABAD DISTRICT,JHAT PAT TEHSIL,72,234,94,328
JAFFARABAD DISTRICT,JHAT PAT TEHSIL,73,208,72,280
JAFFARABAD DISTRICT,JHAT PAT TEHSIL,74,175,51,226
JAFFARABAD DISTRICT,JHAT PAT TEHSIL,>=75,1546,679,2225
JAFFARABAD DISTRICT,USTA MUHAMMAD TEHSIL,<1,2846,1729,4575
JAFFARABAD DISTRICT,USTA MUHAMMAD TEHSIL,1,3503,2322,5825
JAFFARABAD DISTRICT,USTA MUHAMMAD TEHSIL,2,4405,2596,7001
JAFFARABAD DISTRICT,USTA MUHAMMAD TEHSIL,3,4421,2983,7404
JAFFARABAD DISTRICT,USTA MUHAMMAD TEHSIL,4,4774,2839,7613
JAFFARABAD DISTRICT,USTA MUHAMMAD TEHSIL,5,4495,2775,7270
JAFFARABAD DISTRICT,USTA MUHAMMAD TEHSIL,6,4545,2533,7078
JAFFARABAD DISTRICT,USTA MUHAMMAD TEHSIL,7,4072,2952,7024
JAFFARABAD DISTRICT,USTA MUHAMMAD TEHSIL,8,4667,2596,7263
JAFFARABAD DISTRICT,USTA MUHAMMAD TEHSIL,9,3251,2454,5705
JAFFARABAD DISTRICT,USTA MUHAMMAD TEHSIL,10,4011,2186,6197
JAFFARABAD DISTRICT,USTA MUHAMMAD TEHSIL,11,2400,1959,4359
JAFFARABAD DISTRICT,USTA MUHAMMAD TEHSIL,12,2997,1934,4931
JAFFARABAD DISTRICT,USTA MUHAMMAD TEHSIL,13,2011,1716,3727
JAFFARABAD DISTRICT,USTA MUHAMMAD TEHSIL,14,2429,1635,4064
JAFFARABAD DISTRICT,USTA MUHAMMAD TEHSIL,15,2044,1695,3739
JAFFARABAD DISTRICT,USTA MUHAMMAD TEHSIL,16,2362,1599,3961
JAFFARABAD DISTRICT,USTA MUHAMMAD TEHSIL,17,1686,1603,3289
JAFFARABAD DISTRICT,USTA MUHAMMAD TEHSIL,18,2499,1584,4083
JAFFARABAD DISTRICT,USTA MUHAMMAD TEHSIL,19,1602,1487,3089
JAFFARABAD DISTRICT,USTA MUHAMMAD TEHSIL,20,1957,1251,3208
JAFFARABAD DISTRICT,USTA MUHAMMAD TEHSIL,21,1409,1264,2673
JAFFARABAD DISTRICT,USTA MUHAMMAD TEHSIL,22,1239,1057,2296
JAFFARABAD DISTRICT,USTA MUHAMMAD TEHSIL,23,1124,1078,2202
JAFFARABAD DISTRICT,USTA MUHAMMAD TEHSIL,24,1169,1011,2180
JAFFARABAD DISTRICT,USTA MUHAMMAD TEHSIL,25,1368,1053,2421
JAFFARABAD DISTRICT,USTA MUHAMMAD TEHSIL,26,1287,988,2275
JAFFARABAD DISTRICT,USTA MUHAMMAD TEHSIL,27,1573,1401,2974
JAFFARABAD DISTRICT,USTA MUHAMMAD TEHSIL,28,1290,939,2229
JAFFARABAD DISTRICT,USTA MUHAMMAD TEHSIL,29,1523,1239,2762
JAFFARABAD DISTRICT,USTA MUHAMMAD TEHSIL,30,1287,874,2161
JAFFARABAD DISTRICT,USTA MUHAMMAD TEHSIL,31,1429,1276,2705
JAFFARABAD DISTRICT,USTA MUHAMMAD TEHSIL,32,1449,1193,2642
JAFFARABAD DISTRICT,USTA MUHAMMAD TEHSIL,33,1114,965,2079
JAFFARABAD DISTRICT,USTA MUHAMMAD TEHSIL,34,1189,939,2128
JAFFARABAD DISTRICT,USTA MUHAMMAD TEHSIL,35,1091,777,1868
JAFFARABAD DISTRICT,USTA MUHAMMAD TEHSIL,36,1468,1045,2513
JAFFARABAD DISTRICT,USTA MUHAMMAD TEHSIL,37,1715,1364,3079
JAFFARABAD DISTRICT,USTA MUHAMMAD TEHSIL,38,1032,787,1819
JAFFARABAD DISTRICT,USTA MUHAMMAD TEHSIL,39,1222,848,2070
JAFFARABAD DISTRICT,USTA MUHAMMAD TEHSIL,40,902,556,1458
JAFFARABAD DISTRICT,USTA MUHAMMAD TEHSIL,41,1005,738,1743
JAFFARABAD DISTRICT,USTA MUHAMMAD TEHSIL,42,910,681,1591
JAFFARABAD DISTRICT,USTA MUHAMMAD TEHSIL,43,635,535,1170
JAFFARABAD DISTRICT,USTA MUHAMMAD TEHSIL,44,629,457,1086
JAFFARABAD DISTRICT,USTA MUHAMMAD TEHSIL,45,531,392,923
JAFFARABAD DISTRICT,USTA MUHAMMAD TEHSIL,46,885,509,1394
JAFFARABAD DISTRICT,USTA MUHAMMAD TEHSIL,47,957,640,1597
JAFFARABAD DISTRICT,USTA MUHAMMAD TEHSIL,48,550,435,985
JAFFARABAD DISTRICT,USTA MUHAMMAD TEHSIL,49,569,535,1104
JAFFARABAD DISTRICT,USTA MUHAMMAD TEHSIL,50,496,334,830
JAFFARABAD DISTRICT,USTA MUHAMMAD TEHSIL,51,652,492,1144
JAFFARABAD DISTRICT,USTA MUHAMMAD TEHSIL,52,567,455,1022
JAFFARABAD DISTRICT,USTA MUHAMMAD TEHSIL,53,438,318,756
JAFFARABAD DISTRICT,USTA MUHAMMAD TEHSIL,54,415,320,735
JAFFARABAD DISTRICT,USTA MUHAMMAD TEHSIL,55,339,234,573
JAFFARABAD DISTRICT,USTA MUHAMMAD TEHSIL,56,526,309,835
JAFFARABAD DISTRICT,USTA MUHAMMAD TEHSIL,57,653,526,1179
JAFFARABAD DISTRICT,USTA MUHAMMAD TEHSIL,58,318,241,559
JAFFARABAD DISTRICT,USTA MUHAMMAD TEHSIL,59,376,286,662
JAFFARABAD DISTRICT,USTA MUHAMMAD TEHSIL,60,349,186,535
JAFFARABAD DISTRICT,USTA MUHAMMAD TEHSIL,61,389,292,681
JAFFARABAD DISTRICT,USTA MUHAMMAD TEHSIL,62,442,298,740
JAFFARABAD DISTRICT,USTA MUHAMMAD TEHSIL,63,273,217,490
JAFFARABAD DISTRICT,USTA MUHAMMAD TEHSIL,64,310,192,502
JAFFARABAD DISTRICT,USTA MUHAMMAD TEHSIL,65,219,167,386
JAFFARABAD DISTRICT,USTA MUHAMMAD TEHSIL,66,341,215,556
JAFFARABAD DISTRICT,USTA MUHAMMAD TEHSIL,67,373,284,657
JAFFARABAD DISTRICT,USTA MUHAMMAD TEHSIL,68,209,127,336
JAFFARABAD DISTRICT,USTA MUHAMMAD TEHSIL,69,199,152,351
JAFFARABAD DISTRICT,USTA MUHAMMAD TEHSIL,70,171,79,250
JAFFARABAD DISTRICT,USTA MUHAMMAD TEHSIL,71,217,136,353
JAFFARABAD DISTRICT,USTA MUHAMMAD TEHSIL,72,166,97,263
JAFFARABAD DISTRICT,USTA MUHAMMAD TEHSIL,73,114,63,177
JAFFARABAD DISTRICT,USTA MUHAMMAD TEHSIL,74,125,78,203
JAFFARABAD DISTRICT,USTA MUHAMMAD TEHSIL,>=75,1026,651,1677
JAMSHORO DISTRICT,KOTRI TALUKA,<1,2887,6352,9239
JAMSHORO DISTRICT,KOTRI TALUKA,1,3668,7357,11025
JAMSHORO DISTRICT,KOTRI TALUKA,2,3850,8269,12119
JAMSHORO DISTRICT,KOTRI TALUKA,3,4608,9280,13888
JAMSHORO DISTRICT,KOTRI TALUKA,4,4360,8610,12970
JAMSHORO DISTRICT,KOTRI TALUKA,5,4542,9186,13728
JAMSHORO DISTRICT,KOTRI TALUKA,6,4262,8303,12565
JAMSHORO DISTRICT,KOTRI TALUKA,7,4276,8688,12964
JAMSHORO DISTRICT,KOTRI TALUKA,8,4173,8174,12347
JAMSHORO DISTRICT,KOTRI TALUKA,9,3532,7970,11502
JAMSHORO DISTRICT,KOTRI TALUKA,10,3720,7313,11033
JAMSHORO DISTRICT,KOTRI TALUKA,11,2949,6913,9862
JAMSHORO DISTRICT,KOTRI TALUKA,12,3235,6829,10064
JAMSHORO DISTRICT,KOTRI TALUKA,13,2675,6275,8950
JAMSHORO DISTRICT,KOTRI TALUKA,14,2689,5861,8550
JAMSHORO DISTRICT,KOTRI TALUKA,15,2931,6390,9321
JAMSHORO DISTRICT,KOTRI TALUKA,16,2724,5978,8702
JAMSHORO DISTRICT,KOTRI TALUKA,17,3070,6257,9327
JAMSHORO DISTRICT,KOTRI TALUKA,18,2850,6262,9112
JAMSHORO DISTRICT,KOTRI TALUKA,19,3204,6049,9253
JAMSHORO DISTRICT,KOTRI TALUKA,20,3518,5949,9467
JAMSHORO DISTRICT,KOTRI TALUKA,21,3687,5738,9425
JAMSHORO DISTRICT,KOTRI TALUKA,22,3227,5681,8908
JAMSHORO DISTRICT,KOTRI TALUKA,23,3006,5221,8227
JAMSHORO DISTRICT,KOTRI TALUKA,24,2618,4765,7383
JAMSHORO DISTRICT,KOTRI TALUKA,25,2718,5168,7886
JAMSHORO DISTRICT,KOTRI TALUKA,26,2472,4688,7160
JAMSHORO DISTRICT,KOTRI TALUKA,27,2564,5039,7603
JAMSHORO DISTRICT,KOTRI TALUKA,28,2565,4847,7412
JAMSHORO DISTRICT,KOTRI TALUKA,29,2450,5134,7584
JAMSHORO DISTRICT,KOTRI TALUKA,30,2511,4772,7283
JAMSHORO DISTRICT,KOTRI TALUKA,31,2421,4603,7024
JAMSHORO DISTRICT,KOTRI TALUKA,32,2395,4497,6892
JAMSHORO DISTRICT,KOTRI TALUKA,33,2099,3953,6052
JAMSHORO DISTRICT,KOTRI TALUKA,34,1931,3717,5648
JAMSHORO DISTRICT,KOTRI TALUKA,35,2075,3890,5965
JAMSHORO DISTRICT,KOTRI TALUKA,36,1738,3173,4911
JAMSHORO DISTRICT,KOTRI TALUKA,37,1926,3645,5571
JAMSHORO DISTRICT,KOTRI TALUKA,38,1765,3438,5203
JAMSHORO DISTRICT,KOTRI TALUKA,39,1836,3548,5384
JAMSHORO DISTRICT,KOTRI TALUKA,40,1654,3252,4906
JAMSHORO DISTRICT,KOTRI TALUKA,41,1522,2989,4511
JAMSHORO DISTRICT,KOTRI TALUKA,42,1449,2891,4340
JAMSHORO DISTRICT,KOTRI TALUKA,43,1257,2644,3901
JAMSHORO DISTRICT,KOTRI TALUKA,44,1195,2434,3629
JAMSHORO DISTRICT,KOTRI TALUKA,45,1214,2474,3688
JAMSHORO DISTRICT,KOTRI TALUKA,46,1001,2211,3212
JAMSHORO DISTRICT,KOTRI TALUKA,47,1198,2488,3686
JAMSHORO DISTRICT,KOTRI TALUKA,48,1034,2157,3191
JAMSHORO DISTRICT,KOTRI TALUKA,49,1067,2314,3381
JAMSHORO DISTRICT,KOTRI TALUKA,50,963,2035,2998
JAMSHORO DISTRICT,KOTRI TALUKA,51,928,1969,2897
JAMSHORO DISTRICT,KOTRI TALUKA,52,932,1862,2794
JAMSHORO DISTRICT,KOTRI TALUKA,53,766,1656,2422
JAMSHORO DISTRICT,KOTRI TALUKA,54,642,1456,2098
JAMSHORO DISTRICT,KOTRI TALUKA,55,671,1447,2118
JAMSHORO DISTRICT,KOTRI TALUKA,56,517,1223,1740
JAMSHORO DISTRICT,KOTRI TALUKA,57,643,1298,1941
JAMSHORO DISTRICT,KOTRI TALUKA,58,506,1225,1731
JAMSHORO DISTRICT,KOTRI TALUKA,59,610,1165,1775
JAMSHORO DISTRICT,KOTRI TALUKA,60,548,1078,1626
JAMSHORO DISTRICT,KOTRI TALUKA,61,547,1155,1702
JAMSHORO DISTRICT,KOTRI TALUKA,62,504,1089,1593
JAMSHORO DISTRICT,KOTRI TALUKA,63,487,1017,1504
JAMSHORO DISTRICT,KOTRI TALUKA,64,437,862,1299
JAMSHORO DISTRICT,KOTRI TALUKA,65,402,809,1211
JAMSHORO DISTRICT,KOTRI TALUKA,66,323,622,945
JAMSHORO DISTRICT,KOTRI TALUKA,67,307,624,931
JAMSHORO DISTRICT,KOTRI TALUKA,68,333,636,969
JAMSHORO DISTRICT,KOTRI TALUKA,69,303,549,852
JAMSHORO DISTRICT,KOTRI TALUKA,70,250,447,697
JAMSHORO DISTRICT,KOTRI TALUKA,71,229,451,680
JAMSHORO DISTRICT,KOTRI TALUKA,72,181,401,582
JAMSHORO DISTRICT,KOTRI TALUKA,73,192,409,601
JAMSHORO DISTRICT,KOTRI TALUKA,74,166,311,477
JAMSHORO DISTRICT,KOTRI TALUKA,>=75,1227,2699,3926
JAMSHORO DISTRICT,MANJHAND TALUKA,<1,2432,467,2899
JAMSHORO DISTRICT,MANJHAND TALUKA,1,3304,568,3872
JAMSHORO DISTRICT,MANJHAND TALUKA,2,3904,596,4500
JAMSHORO DISTRICT,MANJHAND TALUKA,3,4269,703,4972
JAMSHORO DISTRICT,MANJHAND TALUKA,4,4288,662,4950
JAMSHORO DISTRICT,MANJHAND TALUKA,5,4404,647,5051
JAMSHORO DISTRICT,MANJHAND TALUKA,6,4385,570,4955
JAMSHORO DISTRICT,MANJHAND TALUKA,7,3582,636,4218
JAMSHORO DISTRICT,MANJHAND TALUKA,8,4390,675,5065
JAMSHORO DISTRICT,MANJHAND TALUKA,9,3066,547,3613
JAMSHORO DISTRICT,MANJHAND TALUKA,10,3969,621,4590
JAMSHORO DISTRICT,MANJHAND TALUKA,11,2503,490,2993
JAMSHORO DISTRICT,MANJHAND TALUKA,12,2898,507,3405
JAMSHORO DISTRICT,MANJHAND TALUKA,13,2224,438,2662
JAMSHORO DISTRICT,MANJHAND TALUKA,14,2329,437,2766
JAMSHORO DISTRICT,MANJHAND TALUKA,15,2391,509,2900
JAMSHORO DISTRICT,MANJHAND TALUKA,16,2397,480,2877
JAMSHORO DISTRICT,MANJHAND TALUKA,17,2054,469,2523
JAMSHORO DISTRICT,MANJHAND TALUKA,18,2632,468,3100
JAMSHORO DISTRICT,MANJHAND TALUKA,19,1870,368,2238
JAMSHORO DISTRICT,MANJHAND TALUKA,20,2400,504,2904
JAMSHORO DISTRICT,MANJHAND TALUKA,21,1594,331,1925
JAMSHORO DISTRICT,MANJHAND TALUKA,22,1822,370,2192
JAMSHORO DISTRICT,MANJHAND TALUKA,23,1563,303,1866
JAMSHORO DISTRICT,MANJHAND TALUKA,24,1647,327,1974
JAMSHORO DISTRICT,MANJHAND TALUKA,25,2017,385,2402
JAMSHORO DISTRICT,MANJHAND TALUKA,26,1681,291,1972
JAMSHORO DISTRICT,MANJHAND TALUKA,27,1713,349,2062
JAMSHORO DISTRICT,MANJHAND TALUKA,28,1786,294,2080
JAMSHORO DISTRICT,MANJHAND TALUKA,29,1799,297,2096
JAMSHORO DISTRICT,MANJHAND TALUKA,30,1916,323,2239
JAMSHORO DISTRICT,MANJHAND TALUKA,31,1742,303,2045
JAMSHORO DISTRICT,MANJHAND TALUKA,32,1602,249,1851
JAMSHORO DISTRICT,MANJHAND TALUKA,33,1461,229,1690
JAMSHORO DISTRICT,MANJHAND TALUKA,34,1389,256,1645
JAMSHORO DISTRICT,MANJHAND TALUKA,35,1587,274,1861
JAMSHORO DISTRICT,MANJHAND TALUKA,36,1405,271,1676
JAMSHORO DISTRICT,MANJHAND TALUKA,37,1573,260,1833
JAMSHORO DISTRICT,MANJHAND TALUKA,38,1372,226,1598
JAMSHORO DISTRICT,MANJHAND TALUKA,39,1477,266,1743
JAMSHORO DISTRICT,MANJHAND TALUKA,40,1375,270,1645
JAMSHORO DISTRICT,MANJHAND TALUKA,41,1292,203,1495
JAMSHORO DISTRICT,MANJHAND TALUKA,42,1125,238,1363
JAMSHORO DISTRICT,MANJHAND TALUKA,43,1074,202,1276
JAMSHORO DISTRICT,MANJHAND TALUKA,44,1042,196,1238
JAMSHORO DISTRICT,MANJHAND TALUKA,45,1047,176,1223
JAMSHORO DISTRICT,MANJHAND TALUKA,46,952,176,1128
JAMSHORO DISTRICT,MANJHAND TALUKA,47,1007,190,1197
JAMSHORO DISTRICT,MANJHAND TALUKA,48,961,180,1141
JAMSHORO DISTRICT,MANJHAND TALUKA,49,884,171,1055
JAMSHORO DISTRICT,MANJHAND TALUKA,50,856,181,1037
JAMSHORO DISTRICT,MANJHAND TALUKA,51,781,151,932
JAMSHORO DISTRICT,MANJHAND TALUKA,52,698,152,850
JAMSHORO DISTRICT,MANJHAND TALUKA,53,578,114,692
JAMSHORO DISTRICT,MANJHAND TALUKA,54,592,102,694
JAMSHORO DISTRICT,MANJHAND TALUKA,55,509,106,615
JAMSHORO DISTRICT,MANJHAND TALUKA,56,508,78,586
JAMSHORO DISTRICT,MANJHAND TALUKA,57,568,104,672
JAMSHORO DISTRICT,MANJHAND TALUKA,58,516,92,608
JAMSHORO DISTRICT,MANJHAND TALUKA,59,477,104,581
JAMSHORO DISTRICT,MANJHAND TALUKA,60,489,84,573
JAMSHORO DISTRICT,MANJHAND TALUKA,61,427,75,502
JAMSHORO DISTRICT,MANJHAND TALUKA,62,422,74,496
JAMSHORO DISTRICT,MANJHAND TALUKA,63,377,84,461
JAMSHORO DISTRICT,MANJHAND TALUKA,64,442,69,511
JAMSHORO DISTRICT,MANJHAND TALUKA,65,371,56,427
JAMSHORO DISTRICT,MANJHAND TALUKA,66,275,39,314
JAMSHORO DISTRICT,MANJHAND TALUKA,67,288,68,356
JAMSHORO DISTRICT,MANJHAND TALUKA,68,255,41,296
JAMSHORO DISTRICT,MANJHAND TALUKA,69,323,59,382
JAMSHORO DISTRICT,MANJHAND TALUKA,70,256,34,290
JAMSHORO DISTRICT,MANJHAND TALUKA,71,191,43,234
JAMSHORO DISTRICT,MANJHAND TALUKA,72,194,41,235
JAMSHORO DISTRICT,MANJHAND TALUKA,73,186,37,223
JAMSHORO DISTRICT,MANJHAND TALUKA,74,183,37,220
JAMSHORO DISTRICT,MANJHAND TALUKA,>=75,1212,203,1415
JAMSHORO DISTRICT,SEHWAN TALUKA,<1,3846,2115,5961
JAMSHORO DISTRICT,SEHWAN TALUKA,1,4278,2501,6779
JAMSHORO DISTRICT,SEHWAN TALUKA,2,5425,3017,8442
JAMSHORO DISTRICT,SEHWAN TALUKA,3,5807,3500,9307
JAMSHORO DISTRICT,SEHWAN TALUKA,4,6045,3338,9383
JAMSHORO DISTRICT,SEHWAN TALUKA,5,6168,3545,9713
JAMSHORO DISTRICT,SEHWAN TALUKA,6,5952,3461,9413
JAMSHORO DISTRICT,SEHWAN TALUKA,7,4906,3204,8110
JAMSHORO DISTRICT,SEHWAN TALUKA,8,6165,3605,9770
JAMSHORO DISTRICT,SEHWAN TALUKA,9,4316,2770,7086
JAMSHORO DISTRICT,SEHWAN TALUKA,10,5675,3222,8897
JAMSHORO DISTRICT,SEHWAN TALUKA,11,3537,2277,5814
JAMSHORO DISTRICT,SEHWAN TALUKA,12,4369,2685,7054
JAMSHORO DISTRICT,SEHWAN TALUKA,13,3081,2109,5190
JAMSHORO DISTRICT,SEHWAN TALUKA,14,3506,2153,5659
JAMSHORO DISTRICT,SEHWAN TALUKA,15,3643,2617,6260
JAMSHORO DISTRICT,SEHWAN TALUKA,16,3362,2176,5538
JAMSHORO DISTRICT,SEHWAN TALUKA,17,2790,2103,4893
JAMSHORO DISTRICT,SEHWAN TALUKA,18,3511,2248,5759
JAMSHORO DISTRICT,SEHWAN TALUKA,19,2554,1816,4370
JAMSHORO DISTRICT,SEHWAN TALUKA,20,3378,2250,5628
JAMSHORO DISTRICT,SEHWAN TALUKA,21,2335,1670,4005
JAMSHORO DISTRICT,SEHWAN TALUKA,22,2400,1871,4271
JAMSHORO DISTRICT,SEHWAN TALUKA,23,2051,1597,3648
JAMSHORO DISTRICT,SEHWAN TALUKA,24,2160,1526,3686
JAMSHORO DISTRICT,SEHWAN TALUKA,25,2901,1891,4792
JAMSHORO DISTRICT,SEHWAN TALUKA,26,2363,1602,3965
JAMSHORO DISTRICT,SEHWAN TALUKA,27,2315,1484,3799
JAMSHORO DISTRICT,SEHWAN TALUKA,28,2250,1612,3862
JAMSHORO DISTRICT,SEHWAN TALUKA,29,2268,1557,3825
JAMSHORO DISTRICT,SEHWAN TALUKA,30,2391,1764,4155
JAMSHORO DISTRICT,SEHWAN TALUKA,31,2223,1461,3684
JAMSHORO DISTRICT,SEHWAN TALUKA,32,2031,1352,3383
JAMSHORO DISTRICT,SEHWAN TALUKA,33,2051,1378,3429
JAMSHORO DISTRICT,SEHWAN TALUKA,34,2014,1253,3267
JAMSHORO DISTRICT,SEHWAN TALUKA,35,2271,1401,3672
JAMSHORO DISTRICT,SEHWAN TALUKA,36,1973,1270,3243
JAMSHORO DISTRICT,SEHWAN TALUKA,37,2141,1159,3300
JAMSHORO DISTRICT,SEHWAN TALUKA,38,1696,1176,2872
JAMSHORO DISTRICT,SEHWAN TALUKA,39,1825,1200,3025
JAMSHORO DISTRICT,SEHWAN TALUKA,40,1839,1294,3133
JAMSHORO DISTRICT,SEHWAN TALUKA,41,1643,1093,2736
JAMSHORO DISTRICT,SEHWAN TALUKA,42,1525,877,2402
JAMSHORO DISTRICT,SEHWAN TALUKA,43,1373,891,2264
JAMSHORO DISTRICT,SEHWAN TALUKA,44,1382,882,2264
JAMSHORO DISTRICT,SEHWAN TALUKA,45,1395,948,2343
JAMSHORO DISTRICT,SEHWAN TALUKA,46,1250,827,2077
JAMSHORO DISTRICT,SEHWAN TALUKA,47,1365,788,2153
JAMSHORO DISTRICT,SEHWAN TALUKA,48,1163,751,1914
JAMSHORO DISTRICT,SEHWAN TALUKA,49,1159,777,1936
JAMSHORO DISTRICT,SEHWAN TALUKA,50,1202,735,1937
JAMSHORO DISTRICT,SEHWAN TALUKA,51,977,672,1649
JAMSHORO DISTRICT,SEHWAN TALUKA,52,978,600,1578
JAMSHORO DISTRICT,SEHWAN TALUKA,53,818,593,1411
JAMSHORO DISTRICT,SEHWAN TALUKA,54,837,528,1365
JAMSHORO DISTRICT,SEHWAN TALUKA,55,818,624,1442
JAMSHORO DISTRICT,SEHWAN TALUKA,56,749,450,1199
JAMSHORO DISTRICT,SEHWAN TALUKA,57,755,427,1182
JAMSHORO DISTRICT,SEHWAN TALUKA,58,668,408,1076
JAMSHORO DISTRICT,SEHWAN TALUKA,59,631,378,1009
JAMSHORO DISTRICT,SEHWAN TALUKA,60,632,431,1063
JAMSHORO DISTRICT,SEHWAN TALUKA,61,611,413,1024
JAMSHORO DISTRICT,SEHWAN TALUKA,62,733,374,1107
JAMSHORO DISTRICT,SEHWAN TALUKA,63,608,335,943
JAMSHORO DISTRICT,SEHWAN TALUKA,64,536,317,853
JAMSHORO DISTRICT,SEHWAN TALUKA,65,527,297,824
JAMSHORO DISTRICT,SEHWAN TALUKA,66,450,270,720
JAMSHORO DISTRICT,SEHWAN TALUKA,67,581,249,830
JAMSHORO DISTRICT,SEHWAN TALUKA,68,397,240,637
JAMSHORO DISTRICT,SEHWAN TALUKA,69,360,196,556
JAMSHORO DISTRICT,SEHWAN TALUKA,70,384,205,589
JAMSHORO DISTRICT,SEHWAN TALUKA,71,301,187,488
JAMSHORO DISTRICT,SEHWAN TALUKA,72,388,165,553
JAMSHORO DISTRICT,SEHWAN TALUKA,73,298,165,463
JAMSHORO DISTRICT,SEHWAN TALUKA,74,263,113,376
JAMSHORO DISTRICT,SEHWAN TALUKA,>=75,1898,914,2812
JAMSHORO DISTRICT,THANO BULA KHAN TALUKA,<1,2906,290,3196
JAMSHORO DISTRICT,THANO BULA KHAN TALUKA,1,3099,257,3356
JAMSHORO DISTRICT,THANO BULA KHAN TALUKA,2,3692,304,3996
JAMSHORO DISTRICT,THANO BULA KHAN TALUKA,3,4218,353,4571
JAMSHORO DISTRICT,THANO BULA KHAN TALUKA,4,4253,346,4599
JAMSHORO DISTRICT,THANO BULA KHAN TALUKA,5,4342,365,4707
JAMSHORO DISTRICT,THANO BULA KHAN TALUKA,6,4443,358,4801
JAMSHORO DISTRICT,THANO BULA KHAN TALUKA,7,3507,432,3939
JAMSHORO DISTRICT,THANO BULA KHAN TALUKA,8,4454,395,4849
JAMSHORO DISTRICT,THANO BULA KHAN TALUKA,9,3288,374,3662
JAMSHORO DISTRICT,THANO BULA KHAN TALUKA,10,3893,332,4225
JAMSHORO DISTRICT,THANO BULA KHAN TALUKA,11,2613,388,3001
JAMSHORO DISTRICT,THANO BULA KHAN TALUKA,12,3028,336,3364
JAMSHORO DISTRICT,THANO BULA KHAN TALUKA,13,2263,348,2611
JAMSHORO DISTRICT,THANO BULA KHAN TALUKA,14,2394,335,2729
JAMSHORO DISTRICT,THANO BULA KHAN TALUKA,15,2494,351,2845
JAMSHORO DISTRICT,THANO BULA KHAN TALUKA,16,2376,347,2723
JAMSHORO DISTRICT,THANO BULA KHAN TALUKA,17,1925,377,2302
JAMSHORO DISTRICT,THANO BULA KHAN TALUKA,18,3107,343,3450
JAMSHORO DISTRICT,THANO BULA KHAN TALUKA,19,2355,331,2686
JAMSHORO DISTRICT,THANO BULA KHAN TALUKA,20,2870,321,3191
JAMSHORO DISTRICT,THANO BULA KHAN TALUKA,21,2067,328,2395
JAMSHORO DISTRICT,THANO BULA KHAN TALUKA,22,2236,258,2494
JAMSHORO DISTRICT,THANO BULA KHAN TALUKA,23,1999,276,2275
JAMSHORO DISTRICT,THANO BULA KHAN TALUKA,24,1870,295,2165
JAMSHORO DISTRICT,THANO BULA KHAN TALUKA,25,2488,291,2779
JAMSHORO DISTRICT,THANO BULA KHAN TALUKA,26,2027,260,2287
JAMSHORO DISTRICT,THANO BULA KHAN TALUKA,27,2265,243,2508
JAMSHORO DISTRICT,THANO BULA KHAN TALUKA,28,2256,256,2512
JAMSHORO DISTRICT,THANO BULA KHAN TALUKA,29,2393,285,2678
JAMSHORO DISTRICT,THANO BULA KHAN TALUKA,30,2271,231,2502
JAMSHORO DISTRICT,THANO BULA KHAN TALUKA,31,2219,264,2483
JAMSHORO DISTRICT,THANO BULA KHAN TALUKA,32,1788,232,2020
JAMSHORO DISTRICT,THANO BULA KHAN TALUKA,33,1812,215,2027
JAMSHORO DISTRICT,THANO BULA KHAN TALUKA,34,1562,210,1772
JAMSHORO DISTRICT,THANO BULA KHAN TALUKA,35,1833,216,2049
JAMSHORO DISTRICT,THANO BULA KHAN TALUKA,36,1351,168,1519
JAMSHORO DISTRICT,THANO BULA KHAN TALUKA,37,1623,238,1861
JAMSHORO DISTRICT,THANO BULA KHAN TALUKA,38,1456,183,1639
JAMSHORO DISTRICT,THANO BULA KHAN TALUKA,39,1680,223,1903
JAMSHORO DISTRICT,THANO BULA KHAN TALUKA,40,1490,149,1639
JAMSHORO DISTRICT,THANO BULA KHAN TALUKA,41,1442,181,1623
JAMSHORO DISTRICT,THANO BULA KHAN TALUKA,42,1515,173,1688
JAMSHORO DISTRICT,THANO BULA KHAN TALUKA,43,1227,163,1390
JAMSHORO DISTRICT,THANO BULA KHAN TALUKA,44,1184,147,1331
JAMSHORO DISTRICT,THANO BULA KHAN TALUKA,45,1147,119,1266
JAMSHORO DISTRICT,THANO BULA KHAN TALUKA,46,925,111,1036
JAMSHORO DISTRICT,THANO BULA KHAN TALUKA,47,1055,132,1187
JAMSHORO DISTRICT,THANO BULA KHAN TALUKA,48,919,127,1046
JAMSHORO DISTRICT,THANO BULA KHAN TALUKA,49,1023,114,1137
JAMSHORO DISTRICT,THANO BULA KHAN TALUKA,50,899,107,1006
JAMSHORO DISTRICT,THANO BULA KHAN TALUKA,51,748,112,860
JAMSHORO DISTRICT,THANO BULA KHAN TALUKA,52,798,93,891
JAMSHORO DISTRICT,THANO BULA KHAN TALUKA,53,614,70,684
JAMSHORO DISTRICT,THANO BULA KHAN TALUKA,54,610,77,687
JAMSHORO DISTRICT,THANO BULA KHAN TALUKA,55,645,83,728
JAMSHORO DISTRICT,THANO BULA KHAN TALUKA,56,461,59,520
JAMSHORO DISTRICT,THANO BULA KHAN TALUKA,57,560,80,640
JAMSHORO DISTRICT,THANO BULA KHAN TALUKA,58,488,78,566
JAMSHORO DISTRICT,THANO BULA KHAN TALUKA,59,551,70,621
JAMSHORO DISTRICT,THANO BULA KHAN TALUKA,60,583,75,658
JAMSHORO DISTRICT,THANO BULA KHAN TALUKA,61,463,50,513
JAMSHORO DISTRICT,THANO BULA KHAN TALUKA,62,499,66,565
JAMSHORO DISTRICT,THANO BULA KHAN TALUKA,63,454,61,515
JAMSHORO DISTRICT,THANO BULA KHAN TALUKA,64,545,62,607
JAMSHORO DISTRICT,THANO BULA KHAN TALUKA,65,390,44,434
JAMSHORO DISTRICT,THANO BULA KHAN TALUKA,66,308,38,346
JAMSHORO DISTRICT,THANO BULA KHAN TALUKA,67,311,45,356
JAMSHORO DISTRICT,THANO BULA KHAN TALUKA,68,326,41,367
JAMSHORO DISTRICT,THANO BULA KHAN TALUKA,69,476,41,517
JAMSHORO DISTRICT,THANO BULA KHAN TALUKA,70,310,27,337
JAMSHORO DISTRICT,THANO BULA KHAN TALUKA,71,220,22,242
JAMSHORO DISTRICT,THANO BULA KHAN TALUKA,72,213,19,232
JAMSHORO DISTRICT,THANO BULA KHAN TALUKA,73,223,16,239
JAMSHORO DISTRICT,THANO BULA KHAN TALUKA,74,288,19,307
JAMSHORO DISTRICT,THANO BULA KHAN TALUKA,>=75,1692,118,1810
JHAL MAGSI DISTRICT,GANDAWA TEHSIL,<1,1266,149,1415
JHAL MAGSI DISTRICT,GANDAWA TEHSIL,1,1413,241,1654
JHAL MAGSI DISTRICT,GANDAWA TEHSIL,2,1792,207,1999
JHAL MAGSI DISTRICT,GANDAWA TEHSIL,3,1636,249,1885
JHAL MAGSI DISTRICT,GANDAWA TEHSIL,4,1925,293,2218
JHAL MAGSI DISTRICT,GANDAWA TEHSIL,5,1613,240,1853
JHAL MAGSI DISTRICT,GANDAWA TEHSIL,6,1667,245,1912
JHAL MAGSI DISTRICT,GANDAWA TEHSIL,7,1635,297,1932
JHAL MAGSI DISTRICT,GANDAWA TEHSIL,8,1795,259,2054
JHAL MAGSI DISTRICT,GANDAWA TEHSIL,9,1356,261,1617
JHAL MAGSI DISTRICT,GANDAWA TEHSIL,10,1447,245,1692
JHAL MAGSI DISTRICT,GANDAWA TEHSIL,11,939,213,1152
JHAL MAGSI DISTRICT,GANDAWA TEHSIL,12,1163,182,1345
JHAL MAGSI DISTRICT,GANDAWA TEHSIL,13,795,190,985
JHAL MAGSI DISTRICT,GANDAWA TEHSIL,14,854,190,1044
JHAL MAGSI DISTRICT,GANDAWA TEHSIL,15,829,206,1035
JHAL MAGSI DISTRICT,GANDAWA TEHSIL,16,785,176,961
JHAL MAGSI DISTRICT,GANDAWA TEHSIL,17,723,202,925
JHAL MAGSI DISTRICT,GANDAWA TEHSIL,18,959,171,1130
JHAL MAGSI DISTRICT,GANDAWA TEHSIL,19,809,139,948
JHAL MAGSI DISTRICT,GANDAWA TEHSIL,20,836,152,988
JHAL MAGSI DISTRICT,GANDAWA TEHSIL,21,641,156,797
JHAL MAGSI DISTRICT,GANDAWA TEHSIL,22,519,136,655
JHAL MAGSI DISTRICT,GANDAWA TEHSIL,23,515,127,642
JHAL MAGSI DISTRICT,GANDAWA TEHSIL,24,467,102,569
JHAL MAGSI DISTRICT,GANDAWA TEHSIL,25,658,123,781
JHAL MAGSI DISTRICT,GANDAWA TEHSIL,26,488,87,575
JHAL MAGSI DISTRICT,GANDAWA TEHSIL,27,661,140,801
JHAL MAGSI DISTRICT,GANDAWA TEHSIL,28,628,91,719
JHAL MAGSI DISTRICT,GANDAWA TEHSIL,29,676,159,835
JHAL MAGSI DISTRICT,GANDAWA TEHSIL,30,624,108,732
JHAL MAGSI DISTRICT,GANDAWA TEHSIL,31,582,132,714
JHAL MAGSI DISTRICT,GANDAWA TEHSIL,32,483,93,576
JHAL MAGSI DISTRICT,GANDAWA TEHSIL,33,428,68,496
JHAL MAGSI DISTRICT,GANDAWA TEHSIL,34,366,69,435
JHAL MAGSI DISTRICT,GANDAWA TEHSIL,35,473,83,556
JHAL MAGSI DISTRICT,GANDAWA TEHSIL,36,352,62,414
JHAL MAGSI DISTRICT,GANDAWA TEHSIL,37,495,103,598
JHAL MAGSI DISTRICT,GANDAWA TEHSIL,38,397,69,466
JHAL MAGSI DISTRICT,GANDAWA TEHSIL,39,420,91,511
JHAL MAGSI DISTRICT,GANDAWA TEHSIL,40,434,62,496
JHAL MAGSI DISTRICT,GANDAWA TEHSIL,41,354,72,426
JHAL MAGSI DISTRICT,GANDAWA TEHSIL,42,380,78,458
JHAL MAGSI DISTRICT,GANDAWA TEHSIL,43,286,69,355
JHAL MAGSI DISTRICT,GANDAWA TEHSIL,44,284,55,339
JHAL MAGSI DISTRICT,GANDAWA TEHSIL,45,330,46,376
JHAL MAGSI DISTRICT,GANDAWA TEHSIL,46,267,47,314
JHAL MAGSI DISTRICT,GANDAWA TEHSIL,47,329,72,401
JHAL MAGSI DISTRICT,GANDAWA TEHSIL,48,278,40,318
JHAL MAGSI DISTRICT,GANDAWA TEHSIL,49,249,69,318
JHAL MAGSI DISTRICT,GANDAWA TEHSIL,50,296,49,345
JHAL MAGSI DISTRICT,GANDAWA TEHSIL,51,238,45,283
JHAL MAGSI DISTRICT,GANDAWA TEHSIL,52,221,51,272
JHAL MAGSI DISTRICT,GANDAWA TEHSIL,53,176,32,208
JHAL MAGSI DISTRICT,GANDAWA TEHSIL,54,150,37,187
JHAL MAGSI DISTRICT,GANDAWA TEHSIL,55,201,24,225
JHAL MAGSI DISTRICT,GANDAWA TEHSIL,56,136,23,159
JHAL MAGSI DISTRICT,GANDAWA TEHSIL,57,220,48,268
JHAL MAGSI DISTRICT,GANDAWA TEHSIL,58,151,27,178
JHAL MAGSI DISTRICT,GANDAWA TEHSIL,59,172,40,212
JHAL MAGSI DISTRICT,GANDAWA TEHSIL,60,212,26,238
JHAL MAGSI DISTRICT,GANDAWA TEHSIL,61,136,13,149
JHAL MAGSI DISTRICT,GANDAWA TEHSIL,62,141,28,169
JHAL MAGSI DISTRICT,GANDAWA TEHSIL,63,143,20,163
JHAL MAGSI DISTRICT,GANDAWA TEHSIL,64,150,31,181
JHAL MAGSI DISTRICT,GANDAWA TEHSIL,65,145,15,160
JHAL MAGSI DISTRICT,GANDAWA TEHSIL,66,77,12,89
JHAL MAGSI DISTRICT,GANDAWA TEHSIL,67,102,26,128
JHAL MAGSI DISTRICT,GANDAWA TEHSIL,68,101,14,115
JHAL MAGSI DISTRICT,GANDAWA TEHSIL,69,118,28,146
JHAL MAGSI DISTRICT,GANDAWA TEHSIL,70,94,11,105
JHAL MAGSI DISTRICT,GANDAWA TEHSIL,71,58,5,63
JHAL MAGSI DISTRICT,GANDAWA TEHSIL,72,62,12,74
JHAL MAGSI DISTRICT,GANDAWA TEHSIL,73,55,13,68
JHAL MAGSI DISTRICT,GANDAWA TEHSIL,74,67,17,84
JHAL MAGSI DISTRICT,GANDAWA TEHSIL,>=75,442,52,494
JHAL MAGSI DISTRICT,JHAL MAGSI TEHSIL,<1,2602,0,2602
JHAL MAGSI DISTRICT,JHAL MAGSI TEHSIL,1,3155,0,3155
JHAL MAGSI DISTRICT,JHAL MAGSI TEHSIL,2,4041,0,4041
JHAL MAGSI DISTRICT,JHAL MAGSI TEHSIL,3,3860,0,3860
JHAL MAGSI DISTRICT,JHAL MAGSI TEHSIL,4,4195,0,4195
JHAL MAGSI DISTRICT,JHAL MAGSI TEHSIL,5,3700,0,3700
JHAL MAGSI DISTRICT,JHAL MAGSI TEHSIL,6,4099,0,4099
JHAL MAGSI DISTRICT,JHAL MAGSI TEHSIL,7,3281,0,3281
JHAL MAGSI DISTRICT,JHAL MAGSI TEHSIL,8,3868,0,3868
JHAL MAGSI DISTRICT,JHAL MAGSI TEHSIL,9,2727,0,2727
JHAL MAGSI DISTRICT,JHAL MAGSI TEHSIL,10,3182,0,3182
JHAL MAGSI DISTRICT,JHAL MAGSI TEHSIL,11,2005,0,2005
JHAL MAGSI DISTRICT,JHAL MAGSI TEHSIL,12,2284,0,2284
JHAL MAGSI DISTRICT,JHAL MAGSI TEHSIL,13,1613,0,1613
JHAL MAGSI DISTRICT,JHAL MAGSI TEHSIL,14,1764,0,1764
JHAL MAGSI DISTRICT,JHAL MAGSI TEHSIL,15,1441,0,1441
JHAL MAGSI DISTRICT,JHAL MAGSI TEHSIL,16,1532,0,1532
JHAL MAGSI DISTRICT,JHAL MAGSI TEHSIL,17,1139,0,1139
JHAL MAGSI DISTRICT,JHAL MAGSI TEHSIL,18,1806,0,1806
JHAL MAGSI DISTRICT,JHAL MAGSI TEHSIL,19,1364,0,1364
JHAL MAGSI DISTRICT,JHAL MAGSI TEHSIL,20,1569,0,1569
JHAL MAGSI DISTRICT,JHAL MAGSI TEHSIL,21,1046,0,1046
JHAL MAGSI DISTRICT,JHAL MAGSI TEHSIL,22,942,0,942
JHAL MAGSI DISTRICT,JHAL MAGSI TEHSIL,23,956,0,956
JHAL MAGSI DISTRICT,JHAL MAGSI TEHSIL,24,834,0,834
JHAL MAGSI DISTRICT,JHAL MAGSI TEHSIL,25,1236,0,1236
JHAL MAGSI DISTRICT,JHAL MAGSI TEHSIL,26,898,0,898
JHAL MAGSI DISTRICT,JHAL MAGSI TEHSIL,27,1091,0,1091
JHAL MAGSI DISTRICT,JHAL MAGSI TEHSIL,28,1184,0,1184
JHAL MAGSI DISTRICT,JHAL MAGSI TEHSIL,29,1241,0,1241
JHAL MAGSI DISTRICT,JHAL MAGSI TEHSIL,30,1290,0,1290
JHAL MAGSI DISTRICT,JHAL MAGSI TEHSIL,31,1116,0,1116
JHAL MAGSI DISTRICT,JHAL MAGSI TEHSIL,32,1003,0,1003
JHAL MAGSI DISTRICT,JHAL MAGSI TEHSIL,33,956,0,956
JHAL MAGSI DISTRICT,JHAL MAGSI TEHSIL,34,803,0,803
JHAL MAGSI DISTRICT,JHAL MAGSI TEHSIL,35,1091,0,1091
JHAL MAGSI DISTRICT,JHAL MAGSI TEHSIL,36,810,0,810
JHAL MAGSI DISTRICT,JHAL MAGSI TEHSIL,37,1139,0,1139
JHAL MAGSI DISTRICT,JHAL MAGSI TEHSIL,38,857,0,857
JHAL MAGSI DISTRICT,JHAL MAGSI TEHSIL,39,929,0,929
JHAL MAGSI DISTRICT,JHAL MAGSI TEHSIL,40,940,0,940
JHAL MAGSI DISTRICT,JHAL MAGSI TEHSIL,41,724,0,724
JHAL MAGSI DISTRICT,JHAL MAGSI TEHSIL,42,699,0,699
JHAL MAGSI DISTRICT,JHAL MAGSI TEHSIL,43,560,0,560
JHAL MAGSI DISTRICT,JHAL MAGSI TEHSIL,44,505,0,505
JHAL MAGSI DISTRICT,JHAL MAGSI TEHSIL,45,583,0,583
JHAL MAGSI DISTRICT,JHAL MAGSI TEHSIL,46,460,0,460
JHAL MAGSI DISTRICT,JHAL MAGSI TEHSIL,47,656,0,656
JHAL MAGSI DISTRICT,JHAL MAGSI TEHSIL,48,492,0,492
JHAL MAGSI DISTRICT,JHAL MAGSI TEHSIL,49,558,0,558
JHAL MAGSI DISTRICT,JHAL MAGSI TEHSIL,50,596,0,596
JHAL MAGSI DISTRICT,JHAL MAGSI TEHSIL,51,484,0,484
JHAL MAGSI DISTRICT,JHAL MAGSI TEHSIL,52,427,0,427
JHAL MAGSI DISTRICT,JHAL MAGSI TEHSIL,53,378,0,378
JHAL MAGSI DISTRICT,JHAL MAGSI TEHSIL,54,364,0,364
JHAL MAGSI DISTRICT,JHAL MAGSI TEHSIL,55,327,0,327
JHAL MAGSI DISTRICT,JHAL MAGSI TEHSIL,56,317,0,317
JHAL MAGSI DISTRICT,JHAL MAGSI TEHSIL,57,446,0,446
JHAL MAGSI DISTRICT,JHAL MAGSI TEHSIL,58,286,0,286
JHAL MAGSI DISTRICT,JHAL MAGSI TEHSIL,59,311,0,311
JHAL MAGSI DISTRICT,JHAL MAGSI TEHSIL,60,347,0,347
JHAL MAGSI DISTRICT,JHAL MAGSI TEHSIL,61,220,0,220
JHAL MAGSI DISTRICT,JHAL MAGSI TEHSIL,62,268,0,268
JHAL MAGSI DISTRICT,JHAL MAGSI TEHSIL,63,258,0,258
JHAL MAGSI DISTRICT,JHAL MAGSI TEHSIL,64,255,0,255
JHAL MAGSI DISTRICT,JHAL MAGSI TEHSIL,65,217,0,217
JHAL MAGSI DISTRICT,JHAL MAGSI TEHSIL,66,145,0,145
JHAL MAGSI DISTRICT,JHAL MAGSI TEHSIL,67,236,0,236
JHAL MAGSI DISTRICT,JHAL MAGSI TEHSIL,68,132,0,132
JHAL MAGSI DISTRICT,JHAL MAGSI TEHSIL,69,185,0,185
JHAL MAGSI DISTRICT,JHAL MAGSI TEHSIL,70,167,0,167
JHAL MAGSI DISTRICT,JHAL MAGSI TEHSIL,71,91,0,91
JHAL MAGSI DISTRICT,JHAL MAGSI TEHSIL,72,137,0,137
JHAL MAGSI DISTRICT,JHAL MAGSI TEHSIL,73,93,0,93
JHAL MAGSI DISTRICT,JHAL MAGSI TEHSIL,74,133,0,133
JHAL MAGSI DISTRICT,JHAL MAGSI TEHSIL,>=75,633,0,633
JHAL MAGSI DISTRICT,MIRPUR SUB-TEHSIL,<1,135,0,135
JHAL MAGSI DISTRICT,MIRPUR SUB-TEHSIL,1,301,0,301
JHAL MAGSI DISTRICT,MIRPUR SUB-TEHSIL,2,353,0,353
JHAL MAGSI DISTRICT,MIRPUR SUB-TEHSIL,3,344,0,344
JHAL MAGSI DISTRICT,MIRPUR SUB-TEHSIL,4,391,0,391
JHAL MAGSI DISTRICT,MIRPUR SUB-TEHSIL,5,375,0,375
JHAL MAGSI DISTRICT,MIRPUR SUB-TEHSIL,6,383,0,383
JHAL MAGSI DISTRICT,MIRPUR SUB-TEHSIL,7,333,0,333
JHAL MAGSI DISTRICT,MIRPUR SUB-TEHSIL,8,455,0,455
JHAL MAGSI DISTRICT,MIRPUR SUB-TEHSIL,9,309,0,309
JHAL MAGSI DISTRICT,MIRPUR SUB-TEHSIL,10,366,0,366
JHAL MAGSI DISTRICT,MIRPUR SUB-TEHSIL,11,205,0,205
JHAL MAGSI DISTRICT,MIRPUR SUB-TEHSIL,12,309,0,309
JHAL MAGSI DISTRICT,MIRPUR SUB-TEHSIL,13,175,0,175
JHAL MAGSI DISTRICT,MIRPUR SUB-TEHSIL,14,245,0,245
JHAL MAGSI DISTRICT,MIRPUR SUB-TEHSIL,15,169,0,169
JHAL MAGSI DISTRICT,MIRPUR SUB-TEHSIL,16,207,0,207
JHAL MAGSI DISTRICT,MIRPUR SUB-TEHSIL,17,123,0,123
JHAL MAGSI DISTRICT,MIRPUR SUB-TEHSIL,18,234,0,234
JHAL MAGSI DISTRICT,MIRPUR SUB-TEHSIL,19,123,0,123
JHAL MAGSI DISTRICT,MIRPUR SUB-TEHSIL,20,212,0,212
JHAL MAGSI DISTRICT,MIRPUR SUB-TEHSIL,21,124,0,124
JHAL MAGSI DISTRICT,MIRPUR SUB-TEHSIL,22,128,0,128
JHAL MAGSI DISTRICT,MIRPUR SUB-TEHSIL,23,110,0,110
JHAL MAGSI DISTRICT,MIRPUR SUB-TEHSIL,24,85,0,85
JHAL MAGSI DISTRICT,MIRPUR SUB-TEHSIL,25,179,0,179
JHAL MAGSI DISTRICT,MIRPUR SUB-TEHSIL,26,114,0,114
JHAL MAGSI DISTRICT,MIRPUR SUB-TEHSIL,27,120,0,120
JHAL MAGSI DISTRICT,MIRPUR SUB-TEHSIL,28,113,0,113
JHAL MAGSI DISTRICT,MIRPUR SUB-TEHSIL,29,140,0,140
JHAL MAGSI DISTRICT,MIRPUR SUB-TEHSIL,30,144,0,144
JHAL MAGSI DISTRICT,MIRPUR SUB-TEHSIL,31,76,0,76
JHAL MAGSI DISTRICT,MIRPUR SUB-TEHSIL,32,105,0,105
JHAL MAGSI DISTRICT,MIRPUR SUB-TEHSIL,33,100,0,100
JHAL MAGSI DISTRICT,MIRPUR SUB-TEHSIL,34,81,0,81
JHAL MAGSI DISTRICT,MIRPUR SUB-TEHSIL,35,138,0,138
JHAL MAGSI DISTRICT,MIRPUR SUB-TEHSIL,36,72,0,72
JHAL MAGSI DISTRICT,MIRPUR SUB-TEHSIL,37,121,0,121
JHAL MAGSI DISTRICT,MIRPUR SUB-TEHSIL,38,95,0,95
JHAL MAGSI DISTRICT,MIRPUR SUB-TEHSIL,39,103,0,103
JHAL MAGSI DISTRICT,MIRPUR SUB-TEHSIL,40,103,0,103
JHAL MAGSI DISTRICT,MIRPUR SUB-TEHSIL,41,87,0,87
JHAL MAGSI DISTRICT,MIRPUR SUB-TEHSIL,42,89,0,89
JHAL MAGSI DISTRICT,MIRPUR SUB-TEHSIL,43,66,0,66
JHAL MAGSI DISTRICT,MIRPUR SUB-TEHSIL,44,60,0,60
JHAL MAGSI DISTRICT,MIRPUR SUB-TEHSIL,45,88,0,88
JHAL MAGSI DISTRICT,MIRPUR SUB-TEHSIL,46,57,0,57
JHAL MAGSI DISTRICT,MIRPUR SUB-TEHSIL,47,66,0,66
JHAL MAGSI DISTRICT,MIRPUR SUB-TEHSIL,48,58,0,58
JHAL MAGSI DISTRICT,MIRPUR SUB-TEHSIL,49,61,0,61
JHAL MAGSI DISTRICT,MIRPUR SUB-TEHSIL,50,74,0,74
JHAL MAGSI DISTRICT,MIRPUR SUB-TEHSIL,51,56,0,56
JHAL MAGSI DISTRICT,MIRPUR SUB-TEHSIL,52,52,0,52
JHAL MAGSI DISTRICT,MIRPUR SUB-TEHSIL,53,43,0,43
JHAL MAGSI DISTRICT,MIRPUR SUB-TEHSIL,54,49,0,49
JHAL MAGSI DISTRICT,MIRPUR SUB-TEHSIL,55,45,0,45
JHAL MAGSI DISTRICT,MIRPUR SUB-TEHSIL,56,36,0,36
JHAL MAGSI DISTRICT,MIRPUR SUB-TEHSIL,57,38,0,38
JHAL MAGSI DISTRICT,MIRPUR SUB-TEHSIL,58,21,0,21
JHAL MAGSI DISTRICT,MIRPUR SUB-TEHSIL,59,29,0,29
JHAL MAGSI DISTRICT,MIRPUR SUB-TEHSIL,60,37,0,37
JHAL MAGSI DISTRICT,MIRPUR SUB-TEHSIL,61,22,0,22
JHAL MAGSI DISTRICT,MIRPUR SUB-TEHSIL,62,32,0,32
JHAL MAGSI DISTRICT,MIRPUR SUB-TEHSIL,63,18,0,18
JHAL MAGSI DISTRICT,MIRPUR SUB-TEHSIL,64,47,0,47
JHAL MAGSI DISTRICT,MIRPUR SUB-TEHSIL,65,18,0,18
JHAL MAGSI DISTRICT,MIRPUR SUB-TEHSIL,66,13,0,13
JHAL MAGSI DISTRICT,MIRPUR SUB-TEHSIL,67,19,0,19
JHAL MAGSI DISTRICT,MIRPUR SUB-TEHSIL,68,22,0,22
JHAL MAGSI DISTRICT,MIRPUR SUB-TEHSIL,69,17,0,17
JHAL MAGSI DISTRICT,MIRPUR SUB-TEHSIL,70,18,0,18
JHAL MAGSI DISTRICT,MIRPUR SUB-TEHSIL,71,9,0,9
JHAL MAGSI DISTRICT,MIRPUR SUB-TEHSIL,72,15,0,15
JHAL MAGSI DISTRICT,MIRPUR SUB-TEHSIL,73,6,0,6
JHAL MAGSI DISTRICT,MIRPUR SUB-TEHSIL,74,9,0,9
JHAL MAGSI DISTRICT,MIRPUR SUB-TEHSIL,>=75,66,0,66
JHANG DISTRICT,18-HAZARI TEHSIL,<1,6844,703,7547
JHANG DISTRICT,18-HAZARI TEHSIL,1,7449,808,8257
JHANG DISTRICT,18-HAZARI TEHSIL,2,7520,753,8273
JHANG DISTRICT,18-HAZARI TEHSIL,3,8284,884,9168
JHANG DISTRICT,18-HAZARI TEHSIL,4,8281,886,9167
JHANG DISTRICT,18-HAZARI TEHSIL,5,7830,780,8610
JHANG DISTRICT,18-HAZARI TEHSIL,6,7768,808,8576
JHANG DISTRICT,18-HAZARI TEHSIL,7,8719,862,9581
JHANG DISTRICT,18-HAZARI TEHSIL,8,7703,828,8531
JHANG DISTRICT,18-HAZARI TEHSIL,9,8308,788,9096
JHANG DISTRICT,18-HAZARI TEHSIL,10,6526,673,7199
JHANG DISTRICT,18-HAZARI TEHSIL,11,7073,703,7776
JHANG DISTRICT,18-HAZARI TEHSIL,12,6284,590,6874
JHANG DISTRICT,18-HAZARI TEHSIL,13,5922,651,6573
JHANG DISTRICT,18-HAZARI TEHSIL,14,5919,581,6500
JHANG DISTRICT,18-HAZARI TEHSIL,15,5462,605,6067
JHANG DISTRICT,18-HAZARI TEHSIL,16,5507,533,6040
JHANG DISTRICT,18-HAZARI TEHSIL,17,5492,574,6066
JHANG DISTRICT,18-HAZARI TEHSIL,18,5122,489,5611
JHANG DISTRICT,18-HAZARI TEHSIL,19,5437,549,5986
JHANG DISTRICT,18-HAZARI TEHSIL,20,4392,424,4816
JHANG DISTRICT,18-HAZARI TEHSIL,21,4835,550,5385
JHANG DISTRICT,18-HAZARI TEHSIL,22,4433,465,4898
JHANG DISTRICT,18-HAZARI TEHSIL,23,4285,545,4830
JHANG DISTRICT,18-HAZARI TEHSIL,24,4103,465,4568
JHANG DISTRICT,18-HAZARI TEHSIL,25,3761,380,4141
JHANG DISTRICT,18-HAZARI TEHSIL,26,3957,445,4402
JHANG DISTRICT,18-HAZARI TEHSIL,27,4151,458,4609
JHANG DISTRICT,18-HAZARI TEHSIL,28,3529,403,3932
JHANG DISTRICT,18-HAZARI TEHSIL,29,4337,462,4799
JHANG DISTRICT,18-HAZARI TEHSIL,30,2982,311,3293
JHANG DISTRICT,18-HAZARI TEHSIL,31,3907,399,4306
JHANG DISTRICT,18-HAZARI TEHSIL,32,3572,349,3921
JHANG DISTRICT,18-HAZARI TEHSIL,33,3091,334,3425
JHANG DISTRICT,18-HAZARI TEHSIL,34,3286,368,3654
JHANG DISTRICT,18-HAZARI TEHSIL,35,2833,267,3100
JHANG DISTRICT,18-HAZARI TEHSIL,36,3501,323,3824
JHANG DISTRICT,18-HAZARI TEHSIL,37,3400,353,3753
JHANG DISTRICT,18-HAZARI TEHSIL,38,2777,285,3062
JHANG DISTRICT,18-HAZARI TEHSIL,39,3059,307,3366
JHANG DISTRICT,18-HAZARI TEHSIL,40,1869,176,2045
JHANG DISTRICT,18-HAZARI TEHSIL,41,2710,252,2962
JHANG DISTRICT,18-HAZARI TEHSIL,42,2472,248,2720
JHANG DISTRICT,18-HAZARI TEHSIL,43,2137,233,2370
JHANG DISTRICT,18-HAZARI TEHSIL,44,2137,233,2370
JHANG DISTRICT,18-HAZARI TEHSIL,45,1801,166,1967
JHANG DISTRICT,18-HAZARI TEHSIL,46,2324,238,2562
JHANG DISTRICT,18-HAZARI TEHSIL,47,2265,260,2525
JHANG DISTRICT,18-HAZARI TEHSIL,48,2090,231,2321
JHANG DISTRICT,18-HAZARI TEHSIL,49,2413,233,2646
JHANG DISTRICT,18-HAZARI TEHSIL,50,1609,135,1744
JHANG DISTRICT,18-HAZARI TEHSIL,51,2401,226,2627
JHANG DISTRICT,18-HAZARI TEHSIL,52,1994,225,2219
JHANG DISTRICT,18-HAZARI TEHSIL,53,1852,185,2037
JHANG DISTRICT,18-HAZARI TEHSIL,54,1677,183,1860
JHANG DISTRICT,18-HAZARI TEHSIL,55,1279,110,1389
JHANG DISTRICT,18-HAZARI TEHSIL,56,1538,161,1699
JHANG DISTRICT,18-HAZARI TEHSIL,57,1493,191,1684
JHANG DISTRICT,18-HAZARI TEHSIL,58,1140,109,1249
JHANG DISTRICT,18-HAZARI TEHSIL,59,1288,143,1431
JHANG DISTRICT,18-HAZARI TEHSIL,60,904,70,974
JHANG DISTRICT,18-HAZARI TEHSIL,61,1469,130,1599
JHANG DISTRICT,18-HAZARI TEHSIL,62,1204,168,1372
JHANG DISTRICT,18-HAZARI TEHSIL,63,1196,115,1311
JHANG DISTRICT,18-HAZARI TEHSIL,64,981,102,1083
JHANG DISTRICT,18-HAZARI TEHSIL,65,858,64,922
JHANG DISTRICT,18-HAZARI TEHSIL,66,1063,95,1158
JHANG DISTRICT,18-HAZARI TEHSIL,67,934,122,1056
JHANG DISTRICT,18-HAZARI TEHSIL,68,853,84,937
JHANG DISTRICT,18-HAZARI TEHSIL,69,873,64,937
JHANG DISTRICT,18-HAZARI TEHSIL,70,592,39,631
JHANG DISTRICT,18-HAZARI TEHSIL,71,881,82,963
JHANG DISTRICT,18-HAZARI TEHSIL,72,662,78,740
JHANG DISTRICT,18-HAZARI TEHSIL,73,636,57,693
JHANG DISTRICT,18-HAZARI TEHSIL,74,490,34,524
JHANG DISTRICT,18-HAZARI TEHSIL,>=75,4434,371,4805
JHANG DISTRICT,AHMADPUR SIAL TEHSIL,<1,9860,1778,11638
JHANG DISTRICT,AHMADPUR SIAL TEHSIL,1,11023,2005,13028
JHANG DISTRICT,AHMADPUR SIAL TEHSIL,2,11131,1888,13019
JHANG DISTRICT,AHMADPUR SIAL TEHSIL,3,12173,2092,14265
JHANG DISTRICT,AHMADPUR SIAL TEHSIL,4,12793,2085,14878
JHANG DISTRICT,AHMADPUR SIAL TEHSIL,5,11614,1966,13580
JHANG DISTRICT,AHMADPUR SIAL TEHSIL,6,11283,1956,13239
JHANG DISTRICT,AHMADPUR SIAL TEHSIL,7,12276,2110,14386
JHANG DISTRICT,AHMADPUR SIAL TEHSIL,8,11397,1861,13258
JHANG DISTRICT,AHMADPUR SIAL TEHSIL,9,11477,1996,13473
JHANG DISTRICT,AHMADPUR SIAL TEHSIL,10,9583,1574,11157
JHANG DISTRICT,AHMADPUR SIAL TEHSIL,11,9506,1869,11375
JHANG DISTRICT,AHMADPUR SIAL TEHSIL,12,8479,1532,10011
JHANG DISTRICT,AHMADPUR SIAL TEHSIL,13,7970,1692,9662
JHANG DISTRICT,AHMADPUR SIAL TEHSIL,14,7563,1486,9049
JHANG DISTRICT,AHMADPUR SIAL TEHSIL,15,6982,1366,8348
JHANG DISTRICT,AHMADPUR SIAL TEHSIL,16,7225,1433,8658
JHANG DISTRICT,AHMADPUR SIAL TEHSIL,17,6808,1428,8236
JHANG DISTRICT,AHMADPUR SIAL TEHSIL,18,6862,1239,8101
JHANG DISTRICT,AHMADPUR SIAL TEHSIL,19,6655,1314,7969
JHANG DISTRICT,AHMADPUR SIAL TEHSIL,20,6075,1136,7211
JHANG DISTRICT,AHMADPUR SIAL TEHSIL,21,6062,1203,7265
JHANG DISTRICT,AHMADPUR SIAL TEHSIL,22,5880,1105,6985
JHANG DISTRICT,AHMADPUR SIAL TEHSIL,23,5637,1124,6761
JHANG DISTRICT,AHMADPUR SIAL TEHSIL,24,5768,1097,6865
JHANG DISTRICT,AHMADPUR SIAL TEHSIL,25,5103,933,6036
JHANG DISTRICT,AHMADPUR SIAL TEHSIL,26,5534,1108,6642
JHANG DISTRICT,AHMADPUR SIAL TEHSIL,27,5121,1035,6156
JHANG DISTRICT,AHMADPUR SIAL TEHSIL,28,5058,960,6018
JHANG DISTRICT,AHMADPUR SIAL TEHSIL,29,5384,1103,6487
JHANG DISTRICT,AHMADPUR SIAL TEHSIL,30,4286,776,5062
JHANG DISTRICT,AHMADPUR SIAL TEHSIL,31,5508,1048,6556
JHANG DISTRICT,AHMADPUR SIAL TEHSIL,32,4489,866,5355
JHANG DISTRICT,AHMADPUR SIAL TEHSIL,33,3947,910,4857
JHANG DISTRICT,AHMADPUR SIAL TEHSIL,34,4535,946,5481
JHANG DISTRICT,AHMADPUR SIAL TEHSIL,35,3591,637,4228
JHANG DISTRICT,AHMADPUR SIAL TEHSIL,36,5332,964,6296
JHANG DISTRICT,AHMADPUR SIAL TEHSIL,37,4312,893,5205
JHANG DISTRICT,AHMADPUR SIAL TEHSIL,38,3659,689,4348
JHANG DISTRICT,AHMADPUR SIAL TEHSIL,39,3681,770,4451
JHANG DISTRICT,AHMADPUR SIAL TEHSIL,40,2594,428,3022
JHANG DISTRICT,AHMADPUR SIAL TEHSIL,41,3768,714,4482
JHANG DISTRICT,AHMADPUR SIAL TEHSIL,42,3191,630,3821
JHANG DISTRICT,AHMADPUR SIAL TEHSIL,43,2738,560,3298
JHANG DISTRICT,AHMADPUR SIAL TEHSIL,44,2923,585,3508
JHANG DISTRICT,AHMADPUR SIAL TEHSIL,45,2169,377,2546
JHANG DISTRICT,AHMADPUR SIAL TEHSIL,46,3387,637,4024
JHANG DISTRICT,AHMADPUR SIAL TEHSIL,47,2982,495,3477
JHANG DISTRICT,AHMADPUR SIAL TEHSIL,48,2895,572,3467
JHANG DISTRICT,AHMADPUR SIAL TEHSIL,49,2930,605,3535
JHANG DISTRICT,AHMADPUR SIAL TEHSIL,50,2148,384,2532
JHANG DISTRICT,AHMADPUR SIAL TEHSIL,51,3145,608,3753
JHANG DISTRICT,AHMADPUR SIAL TEHSIL,52,2587,487,3074
JHANG DISTRICT,AHMADPUR SIAL TEHSIL,53,2342,468,2810
JHANG DISTRICT,AHMADPUR SIAL TEHSIL,54,2122,444,2566
JHANG DISTRICT,AHMADPUR SIAL TEHSIL,55,1491,283,1774
JHANG DISTRICT,AHMADPUR SIAL TEHSIL,56,2171,402,2573
JHANG DISTRICT,AHMADPUR SIAL TEHSIL,57,1779,307,2086
JHANG DISTRICT,AHMADPUR SIAL TEHSIL,58,1413,313,1726
JHANG DISTRICT,AHMADPUR SIAL TEHSIL,59,1596,320,1916
JHANG DISTRICT,AHMADPUR SIAL TEHSIL,60,1197,218,1415
JHANG DISTRICT,AHMADPUR SIAL TEHSIL,61,1961,355,2316
JHANG DISTRICT,AHMADPUR SIAL TEHSIL,62,1669,312,1981
JHANG DISTRICT,AHMADPUR SIAL TEHSIL,63,1521,283,1804
JHANG DISTRICT,AHMADPUR SIAL TEHSIL,64,1422,263,1685
JHANG DISTRICT,AHMADPUR SIAL TEHSIL,65,1167,186,1353
JHANG DISTRICT,AHMADPUR SIAL TEHSIL,66,1671,310,1981
JHANG DISTRICT,AHMADPUR SIAL TEHSIL,67,1352,223,1575
JHANG DISTRICT,AHMADPUR SIAL TEHSIL,68,1115,199,1314
JHANG DISTRICT,AHMADPUR SIAL TEHSIL,69,1090,178,1268
JHANG DISTRICT,AHMADPUR SIAL TEHSIL,70,765,130,895
JHANG DISTRICT,AHMADPUR SIAL TEHSIL,71,1200,176,1376
JHANG DISTRICT,AHMADPUR SIAL TEHSIL,72,901,163,1064
JHANG DISTRICT,AHMADPUR SIAL TEHSIL,73,703,113,816
JHANG DISTRICT,AHMADPUR SIAL TEHSIL,74,610,86,696
JHANG DISTRICT,AHMADPUR SIAL TEHSIL,>=75,5563,847,6410
JHANG DISTRICT,JHANG TEHSIL,<1,27789,9871,37660
JHANG DISTRICT,JHANG TEHSIL,1,28503,10775,39278
JHANG DISTRICT,JHANG TEHSIL,2,29423,10094,39517
JHANG DISTRICT,JHANG TEHSIL,3,31781,11017,42798
JHANG DISTRICT,JHANG TEHSIL,4,32869,10589,43458
JHANG DISTRICT,JHANG TEHSIL,5,31451,10445,41896
JHANG DISTRICT,JHANG TEHSIL,6,30322,10297,40619
JHANG DISTRICT,JHANG TEHSIL,7,32271,10971,43242
JHANG DISTRICT,JHANG TEHSIL,8,30597,9734,40331
JHANG DISTRICT,JHANG TEHSIL,9,29729,11120,40849
JHANG DISTRICT,JHANG TEHSIL,10,26569,8793,35362
JHANG DISTRICT,JHANG TEHSIL,11,25300,10937,36237
JHANG DISTRICT,JHANG TEHSIL,12,23079,8721,31800
JHANG DISTRICT,JHANG TEHSIL,13,21815,10027,31842
JHANG DISTRICT,JHANG TEHSIL,14,21312,9070,30382
JHANG DISTRICT,JHANG TEHSIL,15,20388,9191,29579
JHANG DISTRICT,JHANG TEHSIL,16,20413,9389,29802
JHANG DISTRICT,JHANG TEHSIL,17,20605,10077,30682
JHANG DISTRICT,JHANG TEHSIL,18,20032,8316,28348
JHANG DISTRICT,JHANG TEHSIL,19,18808,9386,28194
JHANG DISTRICT,JHANG TEHSIL,20,18258,7479,25737
JHANG DISTRICT,JHANG TEHSIL,21,16946,9034,25980
JHANG DISTRICT,JHANG TEHSIL,22,16988,7918,24906
JHANG DISTRICT,JHANG TEHSIL,23,15581,8081,23662
JHANG DISTRICT,JHANG TEHSIL,24,14689,7706,22395
JHANG DISTRICT,JHANG TEHSIL,25,16213,6512,22725
JHANG DISTRICT,JHANG TEHSIL,26,14879,7728,22607
JHANG DISTRICT,JHANG TEHSIL,27,15174,7832,23006
JHANG DISTRICT,JHANG TEHSIL,28,14908,7161,22069
JHANG DISTRICT,JHANG TEHSIL,29,15552,7413,22965
JHANG DISTRICT,JHANG TEHSIL,30,14347,5902,20249
JHANG DISTRICT,JHANG TEHSIL,31,14244,7246,21490
JHANG DISTRICT,JHANG TEHSIL,32,13613,6681,20294
JHANG DISTRICT,JHANG TEHSIL,33,12131,6408,18539
JHANG DISTRICT,JHANG TEHSIL,34,12230,5957,18187
JHANG DISTRICT,JHANG TEHSIL,35,12237,4780,17017
JHANG DISTRICT,JHANG TEHSIL,36,13155,5942,19097
JHANG DISTRICT,JHANG TEHSIL,37,12671,5361,18032
JHANG DISTRICT,JHANG TEHSIL,38,10762,5391,16153
JHANG DISTRICT,JHANG TEHSIL,39,11358,5197,16555
JHANG DISTRICT,JHANG TEHSIL,40,9613,4016,13629
JHANG DISTRICT,JHANG TEHSIL,41,10152,4791,14943
JHANG DISTRICT,JHANG TEHSIL,42,9573,4249,13822
JHANG DISTRICT,JHANG TEHSIL,43,8080,4255,12335
JHANG DISTRICT,JHANG TEHSIL,44,8137,4094,12231
JHANG DISTRICT,JHANG TEHSIL,45,7797,3202,10999
JHANG DISTRICT,JHANG TEHSIL,46,8835,3986,12821
JHANG DISTRICT,JHANG TEHSIL,47,9031,3598,12629
JHANG DISTRICT,JHANG TEHSIL,48,8259,3965,12224
JHANG DISTRICT,JHANG TEHSIL,49,9025,3871,12896
JHANG DISTRICT,JHANG TEHSIL,50,7779,3174,10953
JHANG DISTRICT,JHANG TEHSIL,51,8827,3924,12751
JHANG DISTRICT,JHANG TEHSIL,52,8184,3586,11770
JHANG DISTRICT,JHANG TEHSIL,53,7404,3477,10881
JHANG DISTRICT,JHANG TEHSIL,54,6534,3368,9902
JHANG DISTRICT,JHANG TEHSIL,55,5696,2406,8102
JHANG DISTRICT,JHANG TEHSIL,56,5949,2719,8668
JHANG DISTRICT,JHANG TEHSIL,57,5607,2170,7777
JHANG DISTRICT,JHANG TEHSIL,58,4213,2208,6421
JHANG DISTRICT,JHANG TEHSIL,59,4871,2247,7118
JHANG DISTRICT,JHANG TEHSIL,60,4468,1687,6155
JHANG DISTRICT,JHANG TEHSIL,61,5325,2315,7640
JHANG DISTRICT,JHANG TEHSIL,62,4952,2088,7040
JHANG DISTRICT,JHANG TEHSIL,63,4656,2069,6725
JHANG DISTRICT,JHANG TEHSIL,64,4207,1739,5946
JHANG DISTRICT,JHANG TEHSIL,65,3850,1294,5144
JHANG DISTRICT,JHANG TEHSIL,66,4385,1486,5871
JHANG DISTRICT,JHANG TEHSIL,67,3911,1209,5120
JHANG DISTRICT,JHANG TEHSIL,68,3465,1202,4667
JHANG DISTRICT,JHANG TEHSIL,69,3229,1084,4313
JHANG DISTRICT,JHANG TEHSIL,70,3019,851,3870
JHANG DISTRICT,JHANG TEHSIL,71,3388,1024,4412
JHANG DISTRICT,JHANG TEHSIL,72,2850,990,3840
JHANG DISTRICT,JHANG TEHSIL,73,2561,828,3389
JHANG DISTRICT,JHANG TEHSIL,74,1749,650,2399
JHANG DISTRICT,JHANG TEHSIL,>=75,16804,5070,21874
JHANG DISTRICT,SHORKOT TEHSIL,<1,12606,1616,14222
JHANG DISTRICT,SHORKOT TEHSIL,1,13199,1960,15159
JHANG DISTRICT,SHORKOT TEHSIL,2,13117,1784,14901
JHANG DISTRICT,SHORKOT TEHSIL,3,14803,2014,16817
JHANG DISTRICT,SHORKOT TEHSIL,4,14967,1898,16865
JHANG DISTRICT,SHORKOT TEHSIL,5,14435,1965,16400
JHANG DISTRICT,SHORKOT TEHSIL,6,14087,1915,16002
JHANG DISTRICT,SHORKOT TEHSIL,7,15334,1953,17287
JHANG DISTRICT,SHORKOT TEHSIL,8,14168,1816,15984
JHANG DISTRICT,SHORKOT TEHSIL,9,13875,2099,15974
JHANG DISTRICT,SHORKOT TEHSIL,10,12543,1664,14207
JHANG DISTRICT,SHORKOT TEHSIL,11,11797,2023,13820
JHANG DISTRICT,SHORKOT TEHSIL,12,11287,1619,12906
JHANG DISTRICT,SHORKOT TEHSIL,13,10193,1894,12087
JHANG DISTRICT,SHORKOT TEHSIL,14,10219,1631,11850
JHANG DISTRICT,SHORKOT TEHSIL,15,9588,1622,11210
JHANG DISTRICT,SHORKOT TEHSIL,16,9502,1508,11010
JHANG DISTRICT,SHORKOT TEHSIL,17,9198,1552,10750
JHANG DISTRICT,SHORKOT TEHSIL,18,9282,1257,10539
JHANG DISTRICT,SHORKOT TEHSIL,19,8843,1548,10391
JHANG DISTRICT,SHORKOT TEHSIL,20,8846,1152,9998
JHANG DISTRICT,SHORKOT TEHSIL,21,8176,1449,9625
JHANG DISTRICT,SHORKOT TEHSIL,22,8289,1266,9555
JHANG DISTRICT,SHORKOT TEHSIL,23,7495,1367,8862
JHANG DISTRICT,SHORKOT TEHSIL,24,7034,1273,8307
JHANG DISTRICT,SHORKOT TEHSIL,25,7427,1035,8462
JHANG DISTRICT,SHORKOT TEHSIL,26,6969,1195,8164
JHANG DISTRICT,SHORKOT TEHSIL,27,6506,1265,7771
JHANG DISTRICT,SHORKOT TEHSIL,28,6590,1132,7722
JHANG DISTRICT,SHORKOT TEHSIL,29,6567,1264,7831
JHANG DISTRICT,SHORKOT TEHSIL,30,6548,955,7503
JHANG DISTRICT,SHORKOT TEHSIL,31,6097,1312,7409
JHANG DISTRICT,SHORKOT TEHSIL,32,5563,1047,6610
JHANG DISTRICT,SHORKOT TEHSIL,33,5341,1158,6499
JHANG DISTRICT,SHORKOT TEHSIL,34,5681,1175,6856
JHANG DISTRICT,SHORKOT TEHSIL,35,5554,783,6337
JHANG DISTRICT,SHORKOT TEHSIL,36,6278,1124,7402
JHANG DISTRICT,SHORKOT TEHSIL,37,5232,1043,6275
JHANG DISTRICT,SHORKOT TEHSIL,38,5013,1072,6085
JHANG DISTRICT,SHORKOT TEHSIL,39,4906,950,5856
JHANG DISTRICT,SHORKOT TEHSIL,40,4370,660,5030
JHANG DISTRICT,SHORKOT TEHSIL,41,4808,869,5677
JHANG DISTRICT,SHORKOT TEHSIL,42,4022,671,4693
JHANG DISTRICT,SHORKOT TEHSIL,43,3762,693,4455
JHANG DISTRICT,SHORKOT TEHSIL,44,3705,743,4448
JHANG DISTRICT,SHORKOT TEHSIL,45,3428,454,3882
JHANG DISTRICT,SHORKOT TEHSIL,46,4124,661,4785
JHANG DISTRICT,SHORKOT TEHSIL,47,3801,602,4403
JHANG DISTRICT,SHORKOT TEHSIL,48,3709,650,4359
JHANG DISTRICT,SHORKOT TEHSIL,49,3769,697,4466
JHANG DISTRICT,SHORKOT TEHSIL,50,3401,452,3853
JHANG DISTRICT,SHORKOT TEHSIL,51,4062,687,4749
JHANG DISTRICT,SHORKOT TEHSIL,52,3529,550,4079
JHANG DISTRICT,SHORKOT TEHSIL,53,3377,527,3904
JHANG DISTRICT,SHORKOT TEHSIL,54,3008,551,3559
JHANG DISTRICT,SHORKOT TEHSIL,55,2463,336,2799
JHANG DISTRICT,SHORKOT TEHSIL,56,2937,438,3375
JHANG DISTRICT,SHORKOT TEHSIL,57,2375,369,2744
JHANG DISTRICT,SHORKOT TEHSIL,58,2038,354,2392
JHANG DISTRICT,SHORKOT TEHSIL,59,2128,389,2517
JHANG DISTRICT,SHORKOT TEHSIL,60,2015,209,2224
JHANG DISTRICT,SHORKOT TEHSIL,61,2448,388,2836
JHANG DISTRICT,SHORKOT TEHSIL,62,2167,313,2480
JHANG DISTRICT,SHORKOT TEHSIL,63,2045,316,2361
JHANG DISTRICT,SHORKOT TEHSIL,64,2000,271,2271
JHANG DISTRICT,SHORKOT TEHSIL,65,1678,154,1832
JHANG DISTRICT,SHORKOT TEHSIL,66,2094,261,2355
JHANG DISTRICT,SHORKOT TEHSIL,67,1698,182,1880
JHANG DISTRICT,SHORKOT TEHSIL,68,1513,185,1698
JHANG DISTRICT,SHORKOT TEHSIL,69,1460,178,1638
JHANG DISTRICT,SHORKOT TEHSIL,70,1339,138,1477
JHANG DISTRICT,SHORKOT TEHSIL,71,1543,191,1734
JHANG DISTRICT,SHORKOT TEHSIL,72,1248,173,1421
JHANG DISTRICT,SHORKOT TEHSIL,73,1048,162,1210
JHANG DISTRICT,SHORKOT TEHSIL,74,802,102,904
JHANG DISTRICT,SHORKOT TEHSIL,>=75,7695,872,8567
JHELUM DISTRICT,DINA TEHSIL,<1,3200,1314,4514
JHELUM DISTRICT,DINA TEHSIL,1,3686,1542,5228
JHELUM DISTRICT,DINA TEHSIL,2,3434,1527,4961
JHELUM DISTRICT,DINA TEHSIL,3,3670,1550,5220
JHELUM DISTRICT,DINA TEHSIL,4,3485,1436,4921
JHELUM DISTRICT,DINA TEHSIL,5,3438,1545,4983
JHELUM DISTRICT,DINA TEHSIL,6,3661,1470,5131
JHELUM DISTRICT,DINA TEHSIL,7,3776,1729,5505
JHELUM DISTRICT,DINA TEHSIL,8,3308,1390,4698
JHELUM DISTRICT,DINA TEHSIL,9,4074,1710,5784
JHELUM DISTRICT,DINA TEHSIL,10,3172,1362,4534
JHELUM DISTRICT,DINA TEHSIL,11,4135,1689,5824
JHELUM DISTRICT,DINA TEHSIL,12,3158,1364,4522
JHELUM DISTRICT,DINA TEHSIL,13,3772,1531,5303
JHELUM DISTRICT,DINA TEHSIL,14,3445,1372,4817
JHELUM DISTRICT,DINA TEHSIL,15,3391,1346,4737
JHELUM DISTRICT,DINA TEHSIL,16,3625,1400,5025
JHELUM DISTRICT,DINA TEHSIL,17,3736,1467,5203
JHELUM DISTRICT,DINA TEHSIL,18,2871,1116,3987
JHELUM DISTRICT,DINA TEHSIL,19,3695,1449,5144
JHELUM DISTRICT,DINA TEHSIL,20,2714,1104,3818
JHELUM DISTRICT,DINA TEHSIL,21,3679,1578,5257
JHELUM DISTRICT,DINA TEHSIL,22,2973,1296,4269
JHELUM DISTRICT,DINA TEHSIL,23,3146,1570,4716
JHELUM DISTRICT,DINA TEHSIL,24,3052,1594,4646
JHELUM DISTRICT,DINA TEHSIL,25,2306,1204,3510
JHELUM DISTRICT,DINA TEHSIL,26,2815,1575,4390
JHELUM DISTRICT,DINA TEHSIL,27,2803,1627,4430
JHELUM DISTRICT,DINA TEHSIL,28,2458,1449,3907
JHELUM DISTRICT,DINA TEHSIL,29,2747,1595,4342
JHELUM DISTRICT,DINA TEHSIL,30,2082,1197,3279
JHELUM DISTRICT,DINA TEHSIL,31,2664,1535,4199
JHELUM DISTRICT,DINA TEHSIL,32,2385,1427,3812
JHELUM DISTRICT,DINA TEHSIL,33,2412,1441,3853
JHELUM DISTRICT,DINA TEHSIL,34,2293,1336,3629
JHELUM DISTRICT,DINA TEHSIL,35,1713,1006,2719
JHELUM DISTRICT,DINA TEHSIL,36,2108,1189,3297
JHELUM DISTRICT,DINA TEHSIL,37,1991,1084,3075
JHELUM DISTRICT,DINA TEHSIL,38,2100,1202,3302
JHELUM DISTRICT,DINA TEHSIL,39,2011,1116,3127
JHELUM DISTRICT,DINA TEHSIL,40,1676,819,2495
JHELUM DISTRICT,DINA TEHSIL,41,1912,854,2766
JHELUM DISTRICT,DINA TEHSIL,42,1588,878,2466
JHELUM DISTRICT,DINA TEHSIL,43,1734,797,2531
JHELUM DISTRICT,DINA TEHSIL,44,1532,698,2230
JHELUM DISTRICT,DINA TEHSIL,45,1251,563,1814
JHELUM DISTRICT,DINA TEHSIL,46,1553,666,2219
JHELUM DISTRICT,DINA TEHSIL,47,1453,583,2036
JHELUM DISTRICT,DINA TEHSIL,48,1575,698,2273
JHELUM DISTRICT,DINA TEHSIL,49,1454,666,2120
JHELUM DISTRICT,DINA TEHSIL,50,1304,520,1824
JHELUM DISTRICT,DINA TEHSIL,51,1538,566,2104
JHELUM DISTRICT,DINA TEHSIL,52,1450,562,2012
JHELUM DISTRICT,DINA TEHSIL,53,1464,553,2017
JHELUM DISTRICT,DINA TEHSIL,54,1382,467,1849
JHELUM DISTRICT,DINA TEHSIL,55,1003,424,1427
JHELUM DISTRICT,DINA TEHSIL,56,1146,448,1594
JHELUM DISTRICT,DINA TEHSIL,57,1002,337,1339
JHELUM DISTRICT,DINA TEHSIL,58,1173,405,1578
JHELUM DISTRICT,DINA TEHSIL,59,1112,350,1462
JHELUM DISTRICT,DINA TEHSIL,60,907,360,1267
JHELUM DISTRICT,DINA TEHSIL,61,1125,386,1511
JHELUM DISTRICT,DINA TEHSIL,62,1063,369,1432
JHELUM DISTRICT,DINA TEHSIL,63,1114,346,1460
JHELUM DISTRICT,DINA TEHSIL,64,944,315,1259
JHELUM DISTRICT,DINA TEHSIL,65,758,278,1036
JHELUM DISTRICT,DINA TEHSIL,66,780,266,1046
JHELUM DISTRICT,DINA TEHSIL,67,732,212,944
JHELUM DISTRICT,DINA TEHSIL,68,759,240,999
JHELUM DISTRICT,DINA TEHSIL,69,677,197,874
JHELUM DISTRICT,DINA TEHSIL,70,579,166,745
JHELUM DISTRICT,DINA TEHSIL,71,588,197,785
JHELUM DISTRICT,DINA TEHSIL,72,625,181,806
JHELUM DISTRICT,DINA TEHSIL,73,573,152,725
JHELUM DISTRICT,DINA TEHSIL,74,487,135,622
JHELUM DISTRICT,DINA TEHSIL,>=75,4025,1155,5180
JHELUM DISTRICT,JHELUM TEHSIL,<1,5595,3614,9209
JHELUM DISTRICT,JHELUM TEHSIL,1,5635,4095,9730
JHELUM DISTRICT,JHELUM TEHSIL,2,5749,3808,9557
JHELUM DISTRICT,JHELUM TEHSIL,3,6092,4123,10215
JHELUM DISTRICT,JHELUM TEHSIL,4,5618,3918,9536
JHELUM DISTRICT,JHELUM TEHSIL,5,5690,3864,9554
JHELUM DISTRICT,JHELUM TEHSIL,6,5831,4115,9946
JHELUM DISTRICT,JHELUM TEHSIL,7,6154,4249,10403
JHELUM DISTRICT,JHELUM TEHSIL,8,5430,3787,9217
JHELUM DISTRICT,JHELUM TEHSIL,9,6296,4467,10763
JHELUM DISTRICT,JHELUM TEHSIL,10,4943,3439,8382
JHELUM DISTRICT,JHELUM TEHSIL,11,6425,4454,10879
JHELUM DISTRICT,JHELUM TEHSIL,12,5089,3514,8603
JHELUM DISTRICT,JHELUM TEHSIL,13,5732,4118,9850
JHELUM DISTRICT,JHELUM TEHSIL,14,5218,3766,8984
JHELUM DISTRICT,JHELUM TEHSIL,15,5265,3732,8997
JHELUM DISTRICT,JHELUM TEHSIL,16,5379,3784,9163
JHELUM DISTRICT,JHELUM TEHSIL,17,5699,4018,9717
JHELUM DISTRICT,JHELUM TEHSIL,18,4382,3126,7508
JHELUM DISTRICT,JHELUM TEHSIL,19,5537,3961,9498
JHELUM DISTRICT,JHELUM TEHSIL,20,4230,3031,7261
JHELUM DISTRICT,JHELUM TEHSIL,21,5623,4128,9751
JHELUM DISTRICT,JHELUM TEHSIL,22,4392,3250,7642
JHELUM DISTRICT,JHELUM TEHSIL,23,4780,3716,8496
JHELUM DISTRICT,JHELUM TEHSIL,24,4734,3775,8509
JHELUM DISTRICT,JHELUM TEHSIL,25,3588,2863,6451
JHELUM DISTRICT,JHELUM TEHSIL,26,4377,3652,8029
JHELUM DISTRICT,JHELUM TEHSIL,27,4401,3579,7980
JHELUM DISTRICT,JHELUM TEHSIL,28,3776,3397,7173
JHELUM DISTRICT,JHELUM TEHSIL,29,4265,3728,7993
JHELUM DISTRICT,JHELUM TEHSIL,30,3286,2725,6011
JHELUM DISTRICT,JHELUM TEHSIL,31,4157,3781,7938
JHELUM DISTRICT,JHELUM TEHSIL,32,3593,3344,6937
JHELUM DISTRICT,JHELUM TEHSIL,33,3830,3295,7125
JHELUM DISTRICT,JHELUM TEHSIL,34,3569,3034,6603
JHELUM DISTRICT,JHELUM TEHSIL,35,2735,2142,4877
JHELUM DISTRICT,JHELUM TEHSIL,36,3273,2878,6151
JHELUM DISTRICT,JHELUM TEHSIL,37,3019,2589,5608
JHELUM DISTRICT,JHELUM TEHSIL,38,3273,2847,6120
JHELUM DISTRICT,JHELUM TEHSIL,39,3091,2518,5609
JHELUM DISTRICT,JHELUM TEHSIL,40,2569,2121,4690
JHELUM DISTRICT,JHELUM TEHSIL,41,2752,2418,5170
JHELUM DISTRICT,JHELUM TEHSIL,42,2523,2104,4627
JHELUM DISTRICT,JHELUM TEHSIL,43,2524,2120,4644
JHELUM DISTRICT,JHELUM TEHSIL,44,2287,1983,4270
JHELUM DISTRICT,JHELUM TEHSIL,45,1952,1485,3437
JHELUM DISTRICT,JHELUM TEHSIL,46,2400,1858,4258
JHELUM DISTRICT,JHELUM TEHSIL,47,1979,1587,3566
JHELUM DISTRICT,JHELUM TEHSIL,48,2470,1874,4344
JHELUM DISTRICT,JHELUM TEHSIL,49,2349,1873,4222
JHELUM DISTRICT,JHELUM TEHSIL,50,2023,1576,3599
JHELUM DISTRICT,JHELUM TEHSIL,51,2169,1731,3900
JHELUM DISTRICT,JHELUM TEHSIL,52,2086,1689,3775
JHELUM DISTRICT,JHELUM TEHSIL,53,2254,1677,3931
JHELUM DISTRICT,JHELUM TEHSIL,54,2029,1595,3624
JHELUM DISTRICT,JHELUM TEHSIL,55,1613,1278,2891
JHELUM DISTRICT,JHELUM TEHSIL,56,1694,1310,3004
JHELUM DISTRICT,JHELUM TEHSIL,57,1538,1163,2701
JHELUM DISTRICT,JHELUM TEHSIL,58,1683,1274,2957
JHELUM DISTRICT,JHELUM TEHSIL,59,1662,1226,2888
JHELUM DISTRICT,JHELUM TEHSIL,60,1476,959,2435
JHELUM DISTRICT,JHELUM TEHSIL,61,1658,1260,2918
JHELUM DISTRICT,JHELUM TEHSIL,62,1630,1117,2747
JHELUM DISTRICT,JHELUM TEHSIL,63,1647,1061,2708
JHELUM DISTRICT,JHELUM TEHSIL,64,1379,968,2347
JHELUM DISTRICT,JHELUM TEHSIL,65,1122,758,1880
JHELUM DISTRICT,JHELUM TEHSIL,66,1125,683,1808
JHELUM DISTRICT,JHELUM TEHSIL,67,1055,653,1708
JHELUM DISTRICT,JHELUM TEHSIL,68,1040,730,1770
JHELUM DISTRICT,JHELUM TEHSIL,69,989,627,1616
JHELUM DISTRICT,JHELUM TEHSIL,70,837,479,1316
JHELUM DISTRICT,JHELUM TEHSIL,71,824,538,1362
JHELUM DISTRICT,JHELUM TEHSIL,72,845,494,1339
JHELUM DISTRICT,JHELUM TEHSIL,73,771,470,1241
JHELUM DISTRICT,JHELUM TEHSIL,74,713,393,1106
JHELUM DISTRICT,JHELUM TEHSIL,>=75,5343,3115,8458
JHELUM DISTRICT,PIND DADAN KHAN TEHSIL,<1,5919,1392,7311
JHELUM DISTRICT,PIND DADAN KHAN TEHSIL,1,6055,1386,7441
JHELUM DISTRICT,PIND DADAN KHAN TEHSIL,2,6235,1475,7710
JHELUM DISTRICT,PIND DADAN KHAN TEHSIL,3,6724,1364,8088
JHELUM DISTRICT,PIND DADAN KHAN TEHSIL,4,6188,1338,7526
JHELUM DISTRICT,PIND DADAN KHAN TEHSIL,5,6264,1375,7639
JHELUM DISTRICT,PIND DADAN KHAN TEHSIL,6,6266,1337,7603
JHELUM DISTRICT,PIND DADAN KHAN TEHSIL,7,6350,1426,7776
JHELUM DISTRICT,PIND DADAN KHAN TEHSIL,8,5723,1222,6945
JHELUM DISTRICT,PIND DADAN KHAN TEHSIL,9,6564,1416,7980
JHELUM DISTRICT,PIND DADAN KHAN TEHSIL,10,5342,1153,6495
JHELUM DISTRICT,PIND DADAN KHAN TEHSIL,11,6427,1462,7889
JHELUM DISTRICT,PIND DADAN KHAN TEHSIL,12,5400,1189,6589
JHELUM DISTRICT,PIND DADAN KHAN TEHSIL,13,5950,1377,7327
JHELUM DISTRICT,PIND DADAN KHAN TEHSIL,14,5353,1241,6594
JHELUM DISTRICT,PIND DADAN KHAN TEHSIL,15,5401,1355,6756
JHELUM DISTRICT,PIND DADAN KHAN TEHSIL,16,5734,1307,7041
JHELUM DISTRICT,PIND DADAN KHAN TEHSIL,17,5742,1315,7057
JHELUM DISTRICT,PIND DADAN KHAN TEHSIL,18,4869,1143,6012
JHELUM DISTRICT,PIND DADAN KHAN TEHSIL,19,5811,1428,7239
JHELUM DISTRICT,PIND DADAN KHAN TEHSIL,20,4716,1134,5850
JHELUM DISTRICT,PIND DADAN KHAN TEHSIL,21,5779,1500,7279
JHELUM DISTRICT,PIND DADAN KHAN TEHSIL,22,4902,1172,6074
JHELUM DISTRICT,PIND DADAN KHAN TEHSIL,23,5136,1308,6444
JHELUM DISTRICT,PIND DADAN KHAN TEHSIL,24,5099,1345,6444
JHELUM DISTRICT,PIND DADAN KHAN TEHSIL,25,3998,948,4946
JHELUM DISTRICT,PIND DADAN KHAN TEHSIL,26,4643,1228,5871
JHELUM DISTRICT,PIND DADAN KHAN TEHSIL,27,4547,1210,5757
JHELUM DISTRICT,PIND DADAN KHAN TEHSIL,28,4276,1102,5378
JHELUM DISTRICT,PIND DADAN KHAN TEHSIL,29,4414,1184,5598
JHELUM DISTRICT,PIND DADAN KHAN TEHSIL,30,3754,954,4708
JHELUM DISTRICT,PIND DADAN KHAN TEHSIL,31,4084,1138,5222
JHELUM DISTRICT,PIND DADAN KHAN TEHSIL,32,3620,927,4547
JHELUM DISTRICT,PIND DADAN KHAN TEHSIL,33,3742,1069,4811
JHELUM DISTRICT,PIND DADAN KHAN TEHSIL,34,3882,949,4831
JHELUM DISTRICT,PIND DADAN KHAN TEHSIL,35,3250,726,3976
JHELUM DISTRICT,PIND DADAN KHAN TEHSIL,36,3670,967,4637
JHELUM DISTRICT,PIND DADAN KHAN TEHSIL,37,3050,863,3913
JHELUM DISTRICT,PIND DADAN KHAN TEHSIL,38,3356,891,4247
JHELUM DISTRICT,PIND DADAN KHAN TEHSIL,39,3207,813,4020
JHELUM DISTRICT,PIND DADAN KHAN TEHSIL,40,2651,619,3270
JHELUM DISTRICT,PIND DADAN KHAN TEHSIL,41,2810,820,3630
JHELUM DISTRICT,PIND DADAN KHAN TEHSIL,42,2454,676,3130
JHELUM DISTRICT,PIND DADAN KHAN TEHSIL,43,2523,719,3242
JHELUM DISTRICT,PIND DADAN KHAN TEHSIL,44,2505,728,3233
JHELUM DISTRICT,PIND DADAN KHAN TEHSIL,45,2201,490,2691
JHELUM DISTRICT,PIND DADAN KHAN TEHSIL,46,2437,687,3124
JHELUM DISTRICT,PIND DADAN KHAN TEHSIL,47,2211,570,2781
JHELUM DISTRICT,PIND DADAN KHAN TEHSIL,48,2612,652,3264
JHELUM DISTRICT,PIND DADAN KHAN TEHSIL,49,2534,652,3186
JHELUM DISTRICT,PIND DADAN KHAN TEHSIL,50,2317,517,2834
JHELUM DISTRICT,PIND DADAN KHAN TEHSIL,51,2583,612,3195
JHELUM DISTRICT,PIND DADAN KHAN TEHSIL,52,2549,606,3155
JHELUM DISTRICT,PIND DADAN KHAN TEHSIL,53,2609,592,3201
JHELUM DISTRICT,PIND DADAN KHAN TEHSIL,54,2425,558,2983
JHELUM DISTRICT,PIND DADAN KHAN TEHSIL,55,1863,390,2253
JHELUM DISTRICT,PIND DADAN KHAN TEHSIL,56,2115,481,2596
JHELUM DISTRICT,PIND DADAN KHAN TEHSIL,57,1682,394,2076
JHELUM DISTRICT,PIND DADAN KHAN TEHSIL,58,1921,459,2380
JHELUM DISTRICT,PIND DADAN KHAN TEHSIL,59,1903,410,2313
JHELUM DISTRICT,PIND DADAN KHAN TEHSIL,60,1507,316,1823
JHELUM DISTRICT,PIND DADAN KHAN TEHSIL,61,1668,415,2083
JHELUM DISTRICT,PIND DADAN KHAN TEHSIL,62,1624,405,2029
JHELUM DISTRICT,PIND DADAN KHAN TEHSIL,63,1724,392,2116
JHELUM DISTRICT,PIND DADAN KHAN TEHSIL,64,1597,311,1908
JHELUM DISTRICT,PIND DADAN KHAN TEHSIL,65,1215,233,1448
JHELUM DISTRICT,PIND DADAN KHAN TEHSIL,66,1167,260,1427
JHELUM DISTRICT,PIND DADAN KHAN TEHSIL,67,1124,232,1356
JHELUM DISTRICT,PIND DADAN KHAN TEHSIL,68,1060,233,1293
JHELUM DISTRICT,PIND DADAN KHAN TEHSIL,69,1059,205,1264
JHELUM DISTRICT,PIND DADAN KHAN TEHSIL,70,968,137,1105
JHELUM DISTRICT,PIND DADAN KHAN TEHSIL,71,946,173,1119
JHELUM DISTRICT,PIND DADAN KHAN TEHSIL,72,936,167,1103
JHELUM DISTRICT,PIND DADAN KHAN TEHSIL,73,807,151,958
JHELUM DISTRICT,PIND DADAN KHAN TEHSIL,74,719,124,843
JHELUM DISTRICT,PIND DADAN KHAN TEHSIL,>=75,5975,883,6858
JHELUM DISTRICT,SOHAWA TEHSIL,<1,3845,504,4349
JHELUM DISTRICT,SOHAWA TEHSIL,1,4051,561,4612
JHELUM DISTRICT,SOHAWA TEHSIL,2,4002,550,4552
JHELUM DISTRICT,SOHAWA TEHSIL,3,4189,557,4746
JHELUM DISTRICT,SOHAWA TEHSIL,4,3925,544,4469
JHELUM DISTRICT,SOHAWA TEHSIL,5,3798,564,4362
JHELUM DISTRICT,SOHAWA TEHSIL,6,3902,591,4493
JHELUM DISTRICT,SOHAWA TEHSIL,7,4058,640,4698
JHELUM DISTRICT,SOHAWA TEHSIL,8,3638,541,4179
JHELUM DISTRICT,SOHAWA TEHSIL,9,4483,615,5098
JHELUM DISTRICT,SOHAWA TEHSIL,10,3330,516,3846
JHELUM DISTRICT,SOHAWA TEHSIL,11,4360,630,4990
JHELUM DISTRICT,SOHAWA TEHSIL,12,3378,548,3926
JHELUM DISTRICT,SOHAWA TEHSIL,13,3897,671,4568
JHELUM DISTRICT,SOHAWA TEHSIL,14,3553,564,4117
JHELUM DISTRICT,SOHAWA TEHSIL,15,3557,594,4151
JHELUM DISTRICT,SOHAWA TEHSIL,16,3643,547,4190
JHELUM DISTRICT,SOHAWA TEHSIL,17,3756,619,4375
JHELUM DISTRICT,SOHAWA TEHSIL,18,2818,440,3258
JHELUM DISTRICT,SOHAWA TEHSIL,19,3605,579,4184
JHELUM DISTRICT,SOHAWA TEHSIL,20,2716,405,3121
JHELUM DISTRICT,SOHAWA TEHSIL,21,3540,596,4136
JHELUM DISTRICT,SOHAWA TEHSIL,22,2854,446,3300
JHELUM DISTRICT,SOHAWA TEHSIL,23,3223,478,3701
JHELUM DISTRICT,SOHAWA TEHSIL,24,2955,511,3466
JHELUM DISTRICT,SOHAWA TEHSIL,25,2348,367,2715
JHELUM DISTRICT,SOHAWA TEHSIL,26,2810,458,3268
JHELUM DISTRICT,SOHAWA TEHSIL,27,2807,477,3284
JHELUM DISTRICT,SOHAWA TEHSIL,28,2540,402,2942
JHELUM DISTRICT,SOHAWA TEHSIL,29,2863,401,3264
JHELUM DISTRICT,SOHAWA TEHSIL,30,2176,368,2544
JHELUM DISTRICT,SOHAWA TEHSIL,31,2719,417,3136
JHELUM DISTRICT,SOHAWA TEHSIL,32,2460,374,2834
JHELUM DISTRICT,SOHAWA TEHSIL,33,2502,386,2888
JHELUM DISTRICT,SOHAWA TEHSIL,34,2440,379,2819
JHELUM DISTRICT,SOHAWA TEHSIL,35,1786,272,2058
JHELUM DISTRICT,SOHAWA TEHSIL,36,2207,314,2521
JHELUM DISTRICT,SOHAWA TEHSIL,37,2080,283,2363
JHELUM DISTRICT,SOHAWA TEHSIL,38,2336,380,2716
JHELUM DISTRICT,SOHAWA TEHSIL,39,2217,299,2516
JHELUM DISTRICT,SOHAWA TEHSIL,40,1612,314,1926
JHELUM DISTRICT,SOHAWA TEHSIL,41,1962,291,2253
JHELUM DISTRICT,SOHAWA TEHSIL,42,1689,293,1982
JHELUM DISTRICT,SOHAWA TEHSIL,43,1676,299,1975
JHELUM DISTRICT,SOHAWA TEHSIL,44,1692,283,1975
JHELUM DISTRICT,SOHAWA TEHSIL,45,1276,222,1498
JHELUM DISTRICT,SOHAWA TEHSIL,46,1515,254,1769
JHELUM DISTRICT,SOHAWA TEHSIL,47,1418,201,1619
JHELUM DISTRICT,SOHAWA TEHSIL,48,1669,294,1963
JHELUM DISTRICT,SOHAWA TEHSIL,49,1702,247,1949
JHELUM DISTRICT,SOHAWA TEHSIL,50,1319,227,1546
JHELUM DISTRICT,SOHAWA TEHSIL,51,1612,248,1860
JHELUM DISTRICT,SOHAWA TEHSIL,52,1548,224,1772
JHELUM DISTRICT,SOHAWA TEHSIL,53,1613,228,1841
JHELUM DISTRICT,SOHAWA TEHSIL,54,1515,228,1743
JHELUM DISTRICT,SOHAWA TEHSIL,55,1166,193,1359
JHELUM DISTRICT,SOHAWA TEHSIL,56,1187,163,1350
JHELUM DISTRICT,SOHAWA TEHSIL,57,1152,140,1292
JHELUM DISTRICT,SOHAWA TEHSIL,58,1220,173,1393
JHELUM DISTRICT,SOHAWA TEHSIL,59,1238,142,1380
JHELUM DISTRICT,SOHAWA TEHSIL,60,943,165,1108
JHELUM DISTRICT,SOHAWA TEHSIL,61,1297,141,1438
JHELUM DISTRICT,SOHAWA TEHSIL,62,1190,153,1343
JHELUM DISTRICT,SOHAWA TEHSIL,63,1276,152,1428
JHELUM DISTRICT,SOHAWA TEHSIL,64,1117,126,1243
JHELUM DISTRICT,SOHAWA TEHSIL,65,897,129,1026
JHELUM DISTRICT,SOHAWA TEHSIL,66,881,87,968
JHELUM DISTRICT,SOHAWA TEHSIL,67,877,82,959
JHELUM DISTRICT,SOHAWA TEHSIL,68,1000,113,1113
JHELUM DISTRICT,SOHAWA TEHSIL,69,812,117,929
JHELUM DISTRICT,SOHAWA TEHSIL,70,663,98,761
JHELUM DISTRICT,SOHAWA TEHSIL,71,707,74,781
JHELUM DISTRICT,SOHAWA TEHSIL,72,734,70,804
JHELUM DISTRICT,SOHAWA TEHSIL,73,688,64,752
JHELUM DISTRICT,SOHAWA TEHSIL,74,541,56,597
JHELUM DISTRICT,SOHAWA TEHSIL,>=75,4909,506,5415
KACHHI DISTRICT,BALANARI SUB-TEHSIL,<1,1161,0,1161
KACHHI DISTRICT,BALANARI SUB-TEHSIL,1,1245,0,1245
KACHHI DISTRICT,BALANARI SUB-TEHSIL,2,1539,0,1539
KACHHI DISTRICT,BALANARI SUB-TEHSIL,3,1557,0,1557
KACHHI DISTRICT,BALANARI SUB-TEHSIL,4,1621,0,1621
KACHHI DISTRICT,BALANARI SUB-TEHSIL,5,1547,0,1547
KACHHI DISTRICT,BALANARI SUB-TEHSIL,6,1532,0,1532
KACHHI DISTRICT,BALANARI SUB-TEHSIL,7,1561,0,1561
KACHHI DISTRICT,BALANARI SUB-TEHSIL,8,1614,0,1614
KACHHI DISTRICT,BALANARI SUB-TEHSIL,9,1317,0,1317
KACHHI DISTRICT,BALANARI SUB-TEHSIL,10,1381,0,1381
KACHHI DISTRICT,BALANARI SUB-TEHSIL,11,1024,0,1024
KACHHI DISTRICT,BALANARI SUB-TEHSIL,12,1084,0,1084
KACHHI DISTRICT,BALANARI SUB-TEHSIL,13,866,0,866
KACHHI DISTRICT,BALANARI SUB-TEHSIL,14,874,0,874
KACHHI DISTRICT,BALANARI SUB-TEHSIL,15,844,0,844
KACHHI DISTRICT,BALANARI SUB-TEHSIL,16,771,0,771
KACHHI DISTRICT,BALANARI SUB-TEHSIL,17,760,0,760
KACHHI DISTRICT,BALANARI SUB-TEHSIL,18,879,0,879
KACHHI DISTRICT,BALANARI SUB-TEHSIL,19,729,0,729
KACHHI DISTRICT,BALANARI SUB-TEHSIL,20,733,0,733
KACHHI DISTRICT,BALANARI SUB-TEHSIL,21,580,0,580
KACHHI DISTRICT,BALANARI SUB-TEHSIL,22,569,0,569
KACHHI DISTRICT,BALANARI SUB-TEHSIL,23,543,0,543
KACHHI DISTRICT,BALANARI SUB-TEHSIL,24,416,0,416
KACHHI DISTRICT,BALANARI SUB-TEHSIL,25,656,0,656
KACHHI DISTRICT,BALANARI SUB-TEHSIL,26,466,0,466
KACHHI DISTRICT,BALANARI SUB-TEHSIL,27,730,0,730
KACHHI DISTRICT,BALANARI SUB-TEHSIL,28,605,0,605
KACHHI DISTRICT,BALANARI SUB-TEHSIL,29,792,0,792
KACHHI DISTRICT,BALANARI SUB-TEHSIL,30,597,0,597
KACHHI DISTRICT,BALANARI SUB-TEHSIL,31,616,0,616
KACHHI DISTRICT,BALANARI SUB-TEHSIL,32,589,0,589
KACHHI DISTRICT,BALANARI SUB-TEHSIL,33,547,0,547
KACHHI DISTRICT,BALANARI SUB-TEHSIL,34,438,0,438
KACHHI DISTRICT,BALANARI SUB-TEHSIL,35,514,0,514
KACHHI DISTRICT,BALANARI SUB-TEHSIL,36,360,0,360
KACHHI DISTRICT,BALANARI SUB-TEHSIL,37,712,0,712
KACHHI DISTRICT,BALANARI SUB-TEHSIL,38,376,0,376
KACHHI DISTRICT,BALANARI SUB-TEHSIL,39,443,0,443
KACHHI DISTRICT,BALANARI SUB-TEHSIL,40,404,0,404
KACHHI DISTRICT,BALANARI SUB-TEHSIL,41,337,0,337
KACHHI DISTRICT,BALANARI SUB-TEHSIL,42,461,0,461
KACHHI DISTRICT,BALANARI SUB-TEHSIL,43,271,0,271
KACHHI DISTRICT,BALANARI SUB-TEHSIL,44,250,0,250
KACHHI DISTRICT,BALANARI SUB-TEHSIL,45,341,0,341
KACHHI DISTRICT,BALANARI SUB-TEHSIL,46,271,0,271
KACHHI DISTRICT,BALANARI SUB-TEHSIL,47,480,0,480
KACHHI DISTRICT,BALANARI SUB-TEHSIL,48,270,0,270
KACHHI DISTRICT,BALANARI SUB-TEHSIL,49,336,0,336
KACHHI DISTRICT,BALANARI SUB-TEHSIL,50,279,0,279
KACHHI DISTRICT,BALANARI SUB-TEHSIL,51,302,0,302
KACHHI DISTRICT,BALANARI SUB-TEHSIL,52,303,0,303
KACHHI DISTRICT,BALANARI SUB-TEHSIL,53,208,0,208
KACHHI DISTRICT,BALANARI SUB-TEHSIL,54,191,0,191
KACHHI DISTRICT,BALANARI SUB-TEHSIL,55,190,0,190
KACHHI DISTRICT,BALANARI SUB-TEHSIL,56,168,0,168
KACHHI DISTRICT,BALANARI SUB-TEHSIL,57,318,0,318
KACHHI DISTRICT,BALANARI SUB-TEHSIL,58,165,0,165
KACHHI DISTRICT,BALANARI SUB-TEHSIL,59,186,0,186
KACHHI DISTRICT,BALANARI SUB-TEHSIL,60,174,0,174
KACHHI DISTRICT,BALANARI SUB-TEHSIL,61,248,0,248
KACHHI DISTRICT,BALANARI SUB-TEHSIL,62,173,0,173
KACHHI DISTRICT,BALANARI SUB-TEHSIL,63,169,0,169
KACHHI DISTRICT,BALANARI SUB-TEHSIL,64,161,0,161
KACHHI DISTRICT,BALANARI SUB-TEHSIL,65,107,0,107
KACHHI DISTRICT,BALANARI SUB-TEHSIL,66,174,0,174
KACHHI DISTRICT,BALANARI SUB-TEHSIL,67,164,0,164
KACHHI DISTRICT,BALANARI SUB-TEHSIL,68,75,0,75
KACHHI DISTRICT,BALANARI SUB-TEHSIL,69,112,0,112
KACHHI DISTRICT,BALANARI SUB-TEHSIL,70,84,0,84
KACHHI DISTRICT,BALANARI SUB-TEHSIL,71,132,0,132
KACHHI DISTRICT,BALANARI SUB-TEHSIL,72,80,0,80
KACHHI DISTRICT,BALANARI SUB-TEHSIL,73,47,0,47
KACHHI DISTRICT,BALANARI SUB-TEHSIL,74,64,0,64
KACHHI DISTRICT,BALANARI SUB-TEHSIL,>=75,458,0,458
KACHHI DISTRICT,BHAG TEHSIL,<1,1747,387,2134
KACHHI DISTRICT,BHAG TEHSIL,1,1827,415,2242
KACHHI DISTRICT,BHAG TEHSIL,2,2412,546,2958
KACHHI DISTRICT,BHAG TEHSIL,3,2371,612,2983
KACHHI DISTRICT,BHAG TEHSIL,4,2442,539,2981
KACHHI DISTRICT,BHAG TEHSIL,5,2183,573,2756
KACHHI DISTRICT,BHAG TEHSIL,6,2309,469,2778
KACHHI DISTRICT,BHAG TEHSIL,7,2206,570,2776
KACHHI DISTRICT,BHAG TEHSIL,8,2339,520,2859
KACHHI DISTRICT,BHAG TEHSIL,9,1756,464,2220
KACHHI DISTRICT,BHAG TEHSIL,10,1906,435,2341
KACHHI DISTRICT,BHAG TEHSIL,11,1279,398,1677
KACHHI DISTRICT,BHAG TEHSIL,12,1483,383,1866
KACHHI DISTRICT,BHAG TEHSIL,13,1060,346,1406
KACHHI DISTRICT,BHAG TEHSIL,14,1128,368,1496
KACHHI DISTRICT,BHAG TEHSIL,15,1082,373,1455
KACHHI DISTRICT,BHAG TEHSIL,16,1042,344,1386
KACHHI DISTRICT,BHAG TEHSIL,17,845,339,1184
KACHHI DISTRICT,BHAG TEHSIL,18,1128,303,1431
KACHHI DISTRICT,BHAG TEHSIL,19,936,316,1252
KACHHI DISTRICT,BHAG TEHSIL,20,1047,276,1323
KACHHI DISTRICT,BHAG TEHSIL,21,802,291,1093
KACHHI DISTRICT,BHAG TEHSIL,22,750,261,1011
KACHHI DISTRICT,BHAG TEHSIL,23,589,268,857
KACHHI DISTRICT,BHAG TEHSIL,24,607,214,821
KACHHI DISTRICT,BHAG TEHSIL,25,835,272,1107
KACHHI DISTRICT,BHAG TEHSIL,26,659,266,925
KACHHI DISTRICT,BHAG TEHSIL,27,830,264,1094
KACHHI DISTRICT,BHAG TEHSIL,28,697,241,938
KACHHI DISTRICT,BHAG TEHSIL,29,742,281,1023
KACHHI DISTRICT,BHAG TEHSIL,30,821,226,1047
KACHHI DISTRICT,BHAG TEHSIL,31,717,252,969
KACHHI DISTRICT,BHAG TEHSIL,32,685,230,915
KACHHI DISTRICT,BHAG TEHSIL,33,589,206,795
KACHHI DISTRICT,BHAG TEHSIL,34,591,216,807
KACHHI DISTRICT,BHAG TEHSIL,35,638,177,815
KACHHI DISTRICT,BHAG TEHSIL,36,489,176,665
KACHHI DISTRICT,BHAG TEHSIL,37,686,227,913
KACHHI DISTRICT,BHAG TEHSIL,38,504,186,690
KACHHI DISTRICT,BHAG TEHSIL,39,552,196,748
KACHHI DISTRICT,BHAG TEHSIL,40,551,127,678
KACHHI DISTRICT,BHAG TEHSIL,41,439,154,593
KACHHI DISTRICT,BHAG TEHSIL,42,453,161,614
KACHHI DISTRICT,BHAG TEHSIL,43,380,130,510
KACHHI DISTRICT,BHAG TEHSIL,44,351,132,483
KACHHI DISTRICT,BHAG TEHSIL,45,390,102,492
KACHHI DISTRICT,BHAG TEHSIL,46,344,147,491
KACHHI DISTRICT,BHAG TEHSIL,47,433,158,591
KACHHI DISTRICT,BHAG TEHSIL,48,329,119,448
KACHHI DISTRICT,BHAG TEHSIL,49,386,140,526
KACHHI DISTRICT,BHAG TEHSIL,50,402,95,497
KACHHI DISTRICT,BHAG TEHSIL,51,356,122,478
KACHHI DISTRICT,BHAG TEHSIL,52,343,98,441
KACHHI DISTRICT,BHAG TEHSIL,53,275,71,346
KACHHI DISTRICT,BHAG TEHSIL,54,245,77,322
KACHHI DISTRICT,BHAG TEHSIL,55,233,74,307
KACHHI DISTRICT,BHAG TEHSIL,56,170,71,241
KACHHI DISTRICT,BHAG TEHSIL,57,309,91,400
KACHHI DISTRICT,BHAG TEHSIL,58,188,84,272
KACHHI DISTRICT,BHAG TEHSIL,59,194,85,279
KACHHI DISTRICT,BHAG TEHSIL,60,251,66,317
KACHHI DISTRICT,BHAG TEHSIL,61,215,90,305
KACHHI DISTRICT,BHAG TEHSIL,62,215,65,280
KACHHI DISTRICT,BHAG TEHSIL,63,180,62,242
KACHHI DISTRICT,BHAG TEHSIL,64,186,56,242
KACHHI DISTRICT,BHAG TEHSIL,65,161,62,223
KACHHI DISTRICT,BHAG TEHSIL,66,150,64,214
KACHHI DISTRICT,BHAG TEHSIL,67,142,55,197
KACHHI DISTRICT,BHAG TEHSIL,68,103,28,131
KACHHI DISTRICT,BHAG TEHSIL,69,137,38,175
KACHHI DISTRICT,BHAG TEHSIL,70,129,34,163
KACHHI DISTRICT,BHAG TEHSIL,71,117,32,149
KACHHI DISTRICT,BHAG TEHSIL,72,87,36,123
KACHHI DISTRICT,BHAG TEHSIL,73,85,18,103
KACHHI DISTRICT,BHAG TEHSIL,74,85,30,115
KACHHI DISTRICT,BHAG TEHSIL,>=75,534,200,734
KACHHI DISTRICT,DHADAR TEHSIL,<1,636,282,918
KACHHI DISTRICT,DHADAR TEHSIL,1,837,500,1337
KACHHI DISTRICT,DHADAR TEHSIL,2,1060,493,1553
KACHHI DISTRICT,DHADAR TEHSIL,3,1053,519,1572
KACHHI DISTRICT,DHADAR TEHSIL,4,1098,514,1612
KACHHI DISTRICT,DHADAR TEHSIL,5,972,464,1436
KACHHI DISTRICT,DHADAR TEHSIL,6,987,466,1453
KACHHI DISTRICT,DHADAR TEHSIL,7,935,533,1468
KACHHI DISTRICT,DHADAR TEHSIL,8,1058,492,1550
KACHHI DISTRICT,DHADAR TEHSIL,9,746,514,1260
KACHHI DISTRICT,DHADAR TEHSIL,10,847,399,1246
KACHHI DISTRICT,DHADAR TEHSIL,11,555,380,935
KACHHI DISTRICT,DHADAR TEHSIL,12,657,372,1029
KACHHI DISTRICT,DHADAR TEHSIL,13,453,326,779
KACHHI DISTRICT,DHADAR TEHSIL,14,584,325,909
KACHHI DISTRICT,DHADAR TEHSIL,15,441,341,782
KACHHI DISTRICT,DHADAR TEHSIL,16,484,280,764
KACHHI DISTRICT,DHADAR TEHSIL,17,419,289,708
KACHHI DISTRICT,DHADAR TEHSIL,18,584,287,871
KACHHI DISTRICT,DHADAR TEHSIL,19,439,311,750
KACHHI DISTRICT,DHADAR TEHSIL,20,543,296,839
KACHHI DISTRICT,DHADAR TEHSIL,21,411,277,688
KACHHI DISTRICT,DHADAR TEHSIL,22,391,260,651
KACHHI DISTRICT,DHADAR TEHSIL,23,342,256,598
KACHHI DISTRICT,DHADAR TEHSIL,24,316,202,518
KACHHI DISTRICT,DHADAR TEHSIL,25,457,239,696
KACHHI DISTRICT,DHADAR TEHSIL,26,271,180,451
KACHHI DISTRICT,DHADAR TEHSIL,27,421,309,730
KACHHI DISTRICT,DHADAR TEHSIL,28,306,260,566
KACHHI DISTRICT,DHADAR TEHSIL,29,436,242,678
KACHHI DISTRICT,DHADAR TEHSIL,30,416,219,635
KACHHI DISTRICT,DHADAR TEHSIL,31,400,216,616
KACHHI DISTRICT,DHADAR TEHSIL,32,402,201,603
KACHHI DISTRICT,DHADAR TEHSIL,33,351,191,542
KACHHI DISTRICT,DHADAR TEHSIL,34,288,151,439
KACHHI DISTRICT,DHADAR TEHSIL,35,350,210,560
KACHHI DISTRICT,DHADAR TEHSIL,36,213,143,356
KACHHI DISTRICT,DHADAR TEHSIL,37,431,211,642
KACHHI DISTRICT,DHADAR TEHSIL,38,236,147,383
KACHHI DISTRICT,DHADAR TEHSIL,39,299,193,492
KACHHI DISTRICT,DHADAR TEHSIL,40,262,153,415
KACHHI DISTRICT,DHADAR TEHSIL,41,201,123,324
KACHHI DISTRICT,DHADAR TEHSIL,42,249,151,400
KACHHI DISTRICT,DHADAR TEHSIL,43,181,93,274
KACHHI DISTRICT,DHADAR TEHSIL,44,167,98,265
KACHHI DISTRICT,DHADAR TEHSIL,45,185,137,322
KACHHI DISTRICT,DHADAR TEHSIL,46,138,95,233
KACHHI DISTRICT,DHADAR TEHSIL,47,276,145,421
KACHHI DISTRICT,DHADAR TEHSIL,48,151,118,269
KACHHI DISTRICT,DHADAR TEHSIL,49,209,150,359
KACHHI DISTRICT,DHADAR TEHSIL,50,198,100,298
KACHHI DISTRICT,DHADAR TEHSIL,51,200,71,271
KACHHI DISTRICT,DHADAR TEHSIL,52,175,93,268
KACHHI DISTRICT,DHADAR TEHSIL,53,128,73,201
KACHHI DISTRICT,DHADAR TEHSIL,54,139,54,193
KACHHI DISTRICT,DHADAR TEHSIL,55,119,66,185
KACHHI DISTRICT,DHADAR TEHSIL,56,84,42,126
KACHHI DISTRICT,DHADAR TEHSIL,57,188,93,281
KACHHI DISTRICT,DHADAR TEHSIL,58,82,49,131
KACHHI DISTRICT,DHADAR TEHSIL,59,147,84,231
KACHHI DISTRICT,DHADAR TEHSIL,60,124,63,187
KACHHI DISTRICT,DHADAR TEHSIL,61,134,57,191
KACHHI DISTRICT,DHADAR TEHSIL,62,123,61,184
KACHHI DISTRICT,DHADAR TEHSIL,63,98,49,147
KACHHI DISTRICT,DHADAR TEHSIL,64,95,43,138
KACHHI DISTRICT,DHADAR TEHSIL,65,80,39,119
KACHHI DISTRICT,DHADAR TEHSIL,66,87,40,127
KACHHI DISTRICT,DHADAR TEHSIL,67,119,74,193
KACHHI DISTRICT,DHADAR TEHSIL,68,40,22,62
KACHHI DISTRICT,DHADAR TEHSIL,69,53,40,93
KACHHI DISTRICT,DHADAR TEHSIL,70,58,29,87
KACHHI DISTRICT,DHADAR TEHSIL,71,80,17,97
KACHHI DISTRICT,DHADAR TEHSIL,72,68,33,101
KACHHI DISTRICT,DHADAR TEHSIL,73,43,13,56
KACHHI DISTRICT,DHADAR TEHSIL,74,36,20,56
KACHHI DISTRICT,DHADAR TEHSIL,>=75,307,162,469
KACHHI DISTRICT,KHATTAN SUB-TEHSIL,<1,501,0,501
KACHHI DISTRICT,KHATTAN SUB-TEHSIL,1,500,0,500
KACHHI DISTRICT,KHATTAN SUB-TEHSIL,2,503,0,503
KACHHI DISTRICT,KHATTAN SUB-TEHSIL,3,630,0,630
KACHHI DISTRICT,KHATTAN SUB-TEHSIL,4,513,0,513
KACHHI DISTRICT,KHATTAN SUB-TEHSIL,5,608,0,608
KACHHI DISTRICT,KHATTAN SUB-TEHSIL,6,564,0,564
KACHHI DISTRICT,KHATTAN SUB-TEHSIL,7,527,0,527
KACHHI DISTRICT,KHATTAN SUB-TEHSIL,8,495,0,495
KACHHI DISTRICT,KHATTAN SUB-TEHSIL,9,531,0,531
KACHHI DISTRICT,KHATTAN SUB-TEHSIL,10,521,0,521
KACHHI DISTRICT,KHATTAN SUB-TEHSIL,11,455,0,455
KACHHI DISTRICT,KHATTAN SUB-TEHSIL,12,404,0,404
KACHHI DISTRICT,KHATTAN SUB-TEHSIL,13,414,0,414
KACHHI DISTRICT,KHATTAN SUB-TEHSIL,14,380,0,380
KACHHI DISTRICT,KHATTAN SUB-TEHSIL,15,409,0,409
KACHHI DISTRICT,KHATTAN SUB-TEHSIL,16,309,0,309
KACHHI DISTRICT,KHATTAN SUB-TEHSIL,17,317,0,317
KACHHI DISTRICT,KHATTAN SUB-TEHSIL,18,269,0,269
KACHHI DISTRICT,KHATTAN SUB-TEHSIL,19,197,0,197
KACHHI DISTRICT,KHATTAN SUB-TEHSIL,20,233,0,233
KACHHI DISTRICT,KHATTAN SUB-TEHSIL,21,195,0,195
KACHHI DISTRICT,KHATTAN SUB-TEHSIL,22,194,0,194
KACHHI DISTRICT,KHATTAN SUB-TEHSIL,23,163,0,163
KACHHI DISTRICT,KHATTAN SUB-TEHSIL,24,122,0,122
KACHHI DISTRICT,KHATTAN SUB-TEHSIL,25,189,0,189
KACHHI DISTRICT,KHATTAN SUB-TEHSIL,26,164,0,164
KACHHI DISTRICT,KHATTAN SUB-TEHSIL,27,188,0,188
KACHHI DISTRICT,KHATTAN SUB-TEHSIL,28,161,0,161
KACHHI DISTRICT,KHATTAN SUB-TEHSIL,29,159,0,159
KACHHI DISTRICT,KHATTAN SUB-TEHSIL,30,212,0,212
KACHHI DISTRICT,KHATTAN SUB-TEHSIL,31,151,0,151
KACHHI DISTRICT,KHATTAN SUB-TEHSIL,32,139,0,139
KACHHI DISTRICT,KHATTAN SUB-TEHSIL,33,136,0,136
KACHHI DISTRICT,KHATTAN SUB-TEHSIL,34,119,0,119
KACHHI DISTRICT,KHATTAN SUB-TEHSIL,35,182,0,182
KACHHI DISTRICT,KHATTAN SUB-TEHSIL,36,88,0,88
KACHHI DISTRICT,KHATTAN SUB-TEHSIL,37,119,0,119
KACHHI DISTRICT,KHATTAN SUB-TEHSIL,38,128,0,128
KACHHI DISTRICT,KHATTAN SUB-TEHSIL,39,102,0,102
KACHHI DISTRICT,KHATTAN SUB-TEHSIL,40,148,0,148
KACHHI DISTRICT,KHATTAN SUB-TEHSIL,41,116,0,116
KACHHI DISTRICT,KHATTAN SUB-TEHSIL,42,86,0,86
KACHHI DISTRICT,KHATTAN SUB-TEHSIL,43,85,0,85
KACHHI DISTRICT,KHATTAN SUB-TEHSIL,44,53,0,53
KACHHI DISTRICT,KHATTAN SUB-TEHSIL,45,115,0,115
KACHHI DISTRICT,KHATTAN SUB-TEHSIL,46,49,0,49
KACHHI DISTRICT,KHATTAN SUB-TEHSIL,47,67,0,67
KACHHI DISTRICT,KHATTAN SUB-TEHSIL,48,57,0,57
KACHHI DISTRICT,KHATTAN SUB-TEHSIL,49,62,0,62
KACHHI DISTRICT,KHATTAN SUB-TEHSIL,50,105,0,105
KACHHI DISTRICT,KHATTAN SUB-TEHSIL,51,68,0,68
KACHHI DISTRICT,KHATTAN SUB-TEHSIL,52,52,0,52
KACHHI DISTRICT,KHATTAN SUB-TEHSIL,53,80,0,80
KACHHI DISTRICT,KHATTAN SUB-TEHSIL,54,56,0,56
KACHHI DISTRICT,KHATTAN SUB-TEHSIL,55,50,0,50
KACHHI DISTRICT,KHATTAN SUB-TEHSIL,56,49,0,49
KACHHI DISTRICT,KHATTAN SUB-TEHSIL,57,66,0,66
KACHHI DISTRICT,KHATTAN SUB-TEHSIL,58,42,0,42
KACHHI DISTRICT,KHATTAN SUB-TEHSIL,59,49,0,49
KACHHI DISTRICT,KHATTAN SUB-TEHSIL,60,47,0,47
KACHHI DISTRICT,KHATTAN SUB-TEHSIL,61,42,0,42
KACHHI DISTRICT,KHATTAN SUB-TEHSIL,62,31,0,31
KACHHI DISTRICT,KHATTAN SUB-TEHSIL,63,42,0,42
KACHHI DISTRICT,KHATTAN SUB-TEHSIL,64,42,0,42
KACHHI DISTRICT,KHATTAN SUB-TEHSIL,65,22,0,22
KACHHI DISTRICT,KHATTAN SUB-TEHSIL,66,27,0,27
KACHHI DISTRICT,KHATTAN SUB-TEHSIL,67,27,0,27
KACHHI DISTRICT,KHATTAN SUB-TEHSIL,68,21,0,21
KACHHI DISTRICT,KHATTAN SUB-TEHSIL,69,36,0,36
KACHHI DISTRICT,KHATTAN SUB-TEHSIL,70,27,0,27
KACHHI DISTRICT,KHATTAN SUB-TEHSIL,71,23,0,23
KACHHI DISTRICT,KHATTAN SUB-TEHSIL,72,17,0,17
KACHHI DISTRICT,KHATTAN SUB-TEHSIL,73,18,0,18
KACHHI DISTRICT,KHATTAN SUB-TEHSIL,74,27,0,27
KACHHI DISTRICT,KHATTAN SUB-TEHSIL,>=75,118,0,118
KACHHI DISTRICT,MACH SUB-TEHSIL,<1,642,404,1046
KACHHI DISTRICT,MACH SUB-TEHSIL,1,692,518,1210
KACHHI DISTRICT,MACH SUB-TEHSIL,2,809,632,1441
KACHHI DISTRICT,MACH SUB-TEHSIL,3,870,707,1577
KACHHI DISTRICT,MACH SUB-TEHSIL,4,813,608,1421
KACHHI DISTRICT,MACH SUB-TEHSIL,5,798,640,1438
KACHHI DISTRICT,MACH SUB-TEHSIL,6,721,518,1239
KACHHI DISTRICT,MACH SUB-TEHSIL,7,817,595,1412
KACHHI DISTRICT,MACH SUB-TEHSIL,8,732,549,1281
KACHHI DISTRICT,MACH SUB-TEHSIL,9,695,476,1171
KACHHI DISTRICT,MACH SUB-TEHSIL,10,604,485,1089
KACHHI DISTRICT,MACH SUB-TEHSIL,11,479,428,907
KACHHI DISTRICT,MACH SUB-TEHSIL,12,468,428,896
KACHHI DISTRICT,MACH SUB-TEHSIL,13,418,422,840
KACHHI DISTRICT,MACH SUB-TEHSIL,14,383,408,791
KACHHI DISTRICT,MACH SUB-TEHSIL,15,350,394,744
KACHHI DISTRICT,MACH SUB-TEHSIL,16,286,397,683
KACHHI DISTRICT,MACH SUB-TEHSIL,17,325,412,737
KACHHI DISTRICT,MACH SUB-TEHSIL,18,381,376,757
KACHHI DISTRICT,MACH SUB-TEHSIL,19,373,361,734
KACHHI DISTRICT,MACH SUB-TEHSIL,20,365,361,726
KACHHI DISTRICT,MACH SUB-TEHSIL,21,358,350,708
KACHHI DISTRICT,MACH SUB-TEHSIL,22,362,325,687
KACHHI DISTRICT,MACH SUB-TEHSIL,23,286,313,599
KACHHI DISTRICT,MACH SUB-TEHSIL,24,246,349,595
KACHHI DISTRICT,MACH SUB-TEHSIL,25,334,341,675
KACHHI DISTRICT,MACH SUB-TEHSIL,26,214,342,556
KACHHI DISTRICT,MACH SUB-TEHSIL,27,390,347,737
KACHHI DISTRICT,MACH SUB-TEHSIL,28,237,277,514
KACHHI DISTRICT,MACH SUB-TEHSIL,29,276,340,616
KACHHI DISTRICT,MACH SUB-TEHSIL,30,301,312,613
KACHHI DISTRICT,MACH SUB-TEHSIL,31,262,289,551
KACHHI DISTRICT,MACH SUB-TEHSIL,32,273,299,572
KACHHI DISTRICT,MACH SUB-TEHSIL,33,217,263,480
KACHHI DISTRICT,MACH SUB-TEHSIL,34,208,247,455
KACHHI DISTRICT,MACH SUB-TEHSIL,35,283,267,550
KACHHI DISTRICT,MACH SUB-TEHSIL,36,184,233,417
KACHHI DISTRICT,MACH SUB-TEHSIL,37,291,262,553
KACHHI DISTRICT,MACH SUB-TEHSIL,38,184,227,411
KACHHI DISTRICT,MACH SUB-TEHSIL,39,239,250,489
KACHHI DISTRICT,MACH SUB-TEHSIL,40,190,183,373
KACHHI DISTRICT,MACH SUB-TEHSIL,41,149,162,311
KACHHI DISTRICT,MACH SUB-TEHSIL,42,184,133,317
KACHHI DISTRICT,MACH SUB-TEHSIL,43,113,142,255
KACHHI DISTRICT,MACH SUB-TEHSIL,44,111,133,244
KACHHI DISTRICT,MACH SUB-TEHSIL,45,152,138,290
KACHHI DISTRICT,MACH SUB-TEHSIL,46,70,125,195
KACHHI DISTRICT,MACH SUB-TEHSIL,47,173,143,316
KACHHI DISTRICT,MACH SUB-TEHSIL,48,113,143,256
KACHHI DISTRICT,MACH SUB-TEHSIL,49,132,142,274
KACHHI DISTRICT,MACH SUB-TEHSIL,50,99,133,232
KACHHI DISTRICT,MACH SUB-TEHSIL,51,98,130,228
KACHHI DISTRICT,MACH SUB-TEHSIL,52,130,114,244
KACHHI DISTRICT,MACH SUB-TEHSIL,53,100,108,208
KACHHI DISTRICT,MACH SUB-TEHSIL,54,77,83,160
KACHHI DISTRICT,MACH SUB-TEHSIL,55,77,83,160
KACHHI DISTRICT,MACH SUB-TEHSIL,56,67,106,173
KACHHI DISTRICT,MACH SUB-TEHSIL,57,106,88,194
KACHHI DISTRICT,MACH SUB-TEHSIL,58,52,67,119
KACHHI DISTRICT,MACH SUB-TEHSIL,59,84,72,156
KACHHI DISTRICT,MACH SUB-TEHSIL,60,96,77,173
KACHHI DISTRICT,MACH SUB-TEHSIL,61,65,77,142
KACHHI DISTRICT,MACH SUB-TEHSIL,62,104,82,186
KACHHI DISTRICT,MACH SUB-TEHSIL,63,85,72,157
KACHHI DISTRICT,MACH SUB-TEHSIL,64,60,61,121
KACHHI DISTRICT,MACH SUB-TEHSIL,65,38,49,87
KACHHI DISTRICT,MACH SUB-TEHSIL,66,43,47,90
KACHHI DISTRICT,MACH SUB-TEHSIL,67,88,51,139
KACHHI DISTRICT,MACH SUB-TEHSIL,68,43,44,87
KACHHI DISTRICT,MACH SUB-TEHSIL,69,45,32,77
KACHHI DISTRICT,MACH SUB-TEHSIL,70,35,35,70
KACHHI DISTRICT,MACH SUB-TEHSIL,71,51,34,85
KACHHI DISTRICT,MACH SUB-TEHSIL,72,43,29,72
KACHHI DISTRICT,MACH SUB-TEHSIL,73,35,40,75
KACHHI DISTRICT,MACH SUB-TEHSIL,74,17,20,37
KACHHI DISTRICT,MACH SUB-TEHSIL,>=75,198,210,408
KACHHI DISTRICT,SANNI SUB-TEHSIL,<1,2556,0,2556
KACHHI DISTRICT,SANNI SUB-TEHSIL,1,2799,0,2799
KACHHI DISTRICT,SANNI SUB-TEHSIL,2,3614,0,3614
KACHHI DISTRICT,SANNI SUB-TEHSIL,3,3118,0,3118
KACHHI DISTRICT,SANNI SUB-TEHSIL,4,4008,0,4008
KACHHI DISTRICT,SANNI SUB-TEHSIL,5,3246,0,3246
KACHHI DISTRICT,SANNI SUB-TEHSIL,6,4446,0,4446
KACHHI DISTRICT,SANNI SUB-TEHSIL,7,3401,0,3401
KACHHI DISTRICT,SANNI SUB-TEHSIL,8,4724,0,4724
KACHHI DISTRICT,SANNI SUB-TEHSIL,9,3496,0,3496
KACHHI DISTRICT,SANNI SUB-TEHSIL,10,4731,0,4731
KACHHI DISTRICT,SANNI SUB-TEHSIL,11,3016,0,3016
KACHHI DISTRICT,SANNI SUB-TEHSIL,12,3294,0,3294
KACHHI DISTRICT,SANNI SUB-TEHSIL,13,2384,0,2384
KACHHI DISTRICT,SANNI SUB-TEHSIL,14,3002,0,3002
KACHHI DISTRICT,SANNI SUB-TEHSIL,15,2324,0,2324
KACHHI DISTRICT,SANNI SUB-TEHSIL,16,2722,0,2722
KACHHI DISTRICT,SANNI SUB-TEHSIL,17,1662,0,1662
KACHHI DISTRICT,SANNI SUB-TEHSIL,18,2310,0,2310
KACHHI DISTRICT,SANNI SUB-TEHSIL,19,1651,0,1651
KACHHI DISTRICT,SANNI SUB-TEHSIL,20,2081,0,2081
KACHHI DISTRICT,SANNI SUB-TEHSIL,21,1412,0,1412
KACHHI DISTRICT,SANNI SUB-TEHSIL,22,1024,0,1024
KACHHI DISTRICT,SANNI SUB-TEHSIL,23,1118,0,1118
KACHHI DISTRICT,SANNI SUB-TEHSIL,24,834,0,834
KACHHI DISTRICT,SANNI SUB-TEHSIL,25,1360,0,1360
KACHHI DISTRICT,SANNI SUB-TEHSIL,26,1035,0,1035
KACHHI DISTRICT,SANNI SUB-TEHSIL,27,1044,0,1044
KACHHI DISTRICT,SANNI SUB-TEHSIL,28,1147,0,1147
KACHHI DISTRICT,SANNI SUB-TEHSIL,29,1022,0,1022
KACHHI DISTRICT,SANNI SUB-TEHSIL,30,1385,0,1385
KACHHI DISTRICT,SANNI SUB-TEHSIL,31,1052,0,1052
KACHHI DISTRICT,SANNI SUB-TEHSIL,32,813,0,813
KACHHI DISTRICT,SANNI SUB-TEHSIL,33,921,0,921
KACHHI DISTRICT,SANNI SUB-TEHSIL,34,847,0,847
KACHHI DISTRICT,SANNI SUB-TEHSIL,35,996,0,996
KACHHI DISTRICT,SANNI SUB-TEHSIL,36,843,0,843
KACHHI DISTRICT,SANNI SUB-TEHSIL,37,910,0,910
KACHHI DISTRICT,SANNI SUB-TEHSIL,38,951,0,951
KACHHI DISTRICT,SANNI SUB-TEHSIL,39,796,0,796
KACHHI DISTRICT,SANNI SUB-TEHSIL,40,987,0,987
KACHHI DISTRICT,SANNI SUB-TEHSIL,41,620,0,620
KACHHI DISTRICT,SANNI SUB-TEHSIL,42,506,0,506
KACHHI DISTRICT,SANNI SUB-TEHSIL,43,599,0,599
KACHHI DISTRICT,SANNI SUB-TEHSIL,44,400,0,400
KACHHI DISTRICT,SANNI SUB-TEHSIL,45,617,0,617
KACHHI DISTRICT,SANNI SUB-TEHSIL,46,443,0,443
KACHHI DISTRICT,SANNI SUB-TEHSIL,47,476,0,476
KACHHI DISTRICT,SANNI SUB-TEHSIL,48,581,0,581
KACHHI DISTRICT,SANNI SUB-TEHSIL,49,533,0,533
KACHHI DISTRICT,SANNI SUB-TEHSIL,50,629,0,629
KACHHI DISTRICT,SANNI SUB-TEHSIL,51,352,0,352
KACHHI DISTRICT,SANNI SUB-TEHSIL,52,378,0,378
KACHHI DISTRICT,SANNI SUB-TEHSIL,53,399,0,399
KACHHI DISTRICT,SANNI SUB-TEHSIL,54,361,0,361
KACHHI DISTRICT,SANNI SUB-TEHSIL,55,356,0,356
KACHHI DISTRICT,SANNI SUB-TEHSIL,56,247,0,247
KACHHI DISTRICT,SANNI SUB-TEHSIL,57,325,0,325
KACHHI DISTRICT,SANNI SUB-TEHSIL,58,224,0,224
KACHHI DISTRICT,SANNI SUB-TEHSIL,59,241,0,241
KACHHI DISTRICT,SANNI SUB-TEHSIL,60,337,0,337
KACHHI DISTRICT,SANNI SUB-TEHSIL,61,211,0,211
KACHHI DISTRICT,SANNI SUB-TEHSIL,62,232,0,232
KACHHI DISTRICT,SANNI SUB-TEHSIL,63,218,0,218
KACHHI DISTRICT,SANNI SUB-TEHSIL,64,261,0,261
KACHHI DISTRICT,SANNI SUB-TEHSIL,65,221,0,221
KACHHI DISTRICT,SANNI SUB-TEHSIL,66,163,0,163
KACHHI DISTRICT,SANNI SUB-TEHSIL,67,182,0,182
KACHHI DISTRICT,SANNI SUB-TEHSIL,68,146,0,146
KACHHI DISTRICT,SANNI SUB-TEHSIL,69,166,0,166
KACHHI DISTRICT,SANNI SUB-TEHSIL,70,181,0,181
KACHHI DISTRICT,SANNI SUB-TEHSIL,71,128,0,128
KACHHI DISTRICT,SANNI SUB-TEHSIL,72,91,0,91
KACHHI DISTRICT,SANNI SUB-TEHSIL,73,102,0,102
KACHHI DISTRICT,SANNI SUB-TEHSIL,74,101,0,101
KACHHI DISTRICT,SANNI SUB-TEHSIL,>=75,792,0,792
KALAT DISTRICT,GAZG SUB-TEHSIL,<1,150,0,150
KALAT DISTRICT,GAZG SUB-TEHSIL,1,121,0,121
KALAT DISTRICT,GAZG SUB-TEHSIL,2,241,0,241
KALAT DISTRICT,GAZG SUB-TEHSIL,3,185,0,185
KALAT DISTRICT,GAZG SUB-TEHSIL,4,263,0,263
KALAT DISTRICT,GAZG SUB-TEHSIL,5,183,0,183
KALAT DISTRICT,GAZG SUB-TEHSIL,6,252,0,252
KALAT DISTRICT,GAZG SUB-TEHSIL,7,167,0,167
KALAT DISTRICT,GAZG SUB-TEHSIL,8,252,0,252
KALAT DISTRICT,GAZG SUB-TEHSIL,9,170,0,170
KALAT DISTRICT,GAZG SUB-TEHSIL,10,280,0,280
KALAT DISTRICT,GAZG SUB-TEHSIL,11,115,0,115
KALAT DISTRICT,GAZG SUB-TEHSIL,12,168,0,168
KALAT DISTRICT,GAZG SUB-TEHSIL,13,94,0,94
KALAT DISTRICT,GAZG SUB-TEHSIL,14,146,0,146
KALAT DISTRICT,GAZG SUB-TEHSIL,15,147,0,147
KALAT DISTRICT,GAZG SUB-TEHSIL,16,118,0,118
KALAT DISTRICT,GAZG SUB-TEHSIL,17,92,0,92
KALAT DISTRICT,GAZG SUB-TEHSIL,18,124,0,124
KALAT DISTRICT,GAZG SUB-TEHSIL,19,79,0,79
KALAT DISTRICT,GAZG SUB-TEHSIL,20,110,0,110
KALAT DISTRICT,GAZG SUB-TEHSIL,21,61,0,61
KALAT DISTRICT,GAZG SUB-TEHSIL,22,63,0,63
KALAT DISTRICT,GAZG SUB-TEHSIL,23,45,0,45
KALAT DISTRICT,GAZG SUB-TEHSIL,24,49,0,49
KALAT DISTRICT,GAZG SUB-TEHSIL,25,92,0,92
KALAT DISTRICT,GAZG SUB-TEHSIL,26,40,0,40
KALAT DISTRICT,GAZG SUB-TEHSIL,27,68,0,68
KALAT DISTRICT,GAZG SUB-TEHSIL,28,83,0,83
KALAT DISTRICT,GAZG SUB-TEHSIL,29,67,0,67
KALAT DISTRICT,GAZG SUB-TEHSIL,30,131,0,131
KALAT DISTRICT,GAZG SUB-TEHSIL,31,65,0,65
KALAT DISTRICT,GAZG SUB-TEHSIL,32,66,0,66
KALAT DISTRICT,GAZG SUB-TEHSIL,33,63,0,63
KALAT DISTRICT,GAZG SUB-TEHSIL,34,52,0,52
KALAT DISTRICT,GAZG SUB-TEHSIL,35,78,0,78
KALAT DISTRICT,GAZG SUB-TEHSIL,36,54,0,54
KALAT DISTRICT,GAZG SUB-TEHSIL,37,53,0,53
KALAT DISTRICT,GAZG SUB-TEHSIL,38,81,0,81
KALAT DISTRICT,GAZG SUB-TEHSIL,39,55,0,55
KALAT DISTRICT,GAZG SUB-TEHSIL,40,112,0,112
KALAT DISTRICT,GAZG SUB-TEHSIL,41,61,0,61
KALAT DISTRICT,GAZG SUB-TEHSIL,42,41,0,41
KALAT DISTRICT,GAZG SUB-TEHSIL,43,38,0,38
KALAT DISTRICT,GAZG SUB-TEHSIL,44,38,0,38
KALAT DISTRICT,GAZG SUB-TEHSIL,45,46,0,46
KALAT DISTRICT,GAZG SUB-TEHSIL,46,33,0,33
KALAT DISTRICT,GAZG SUB-TEHSIL,47,39,0,39
KALAT DISTRICT,GAZG SUB-TEHSIL,48,32,0,32
KALAT DISTRICT,GAZG SUB-TEHSIL,49,25,0,25
KALAT DISTRICT,GAZG SUB-TEHSIL,50,52,0,52
KALAT DISTRICT,GAZG SUB-TEHSIL,51,24,0,24
KALAT DISTRICT,GAZG SUB-TEHSIL,52,24,0,24
KALAT DISTRICT,GAZG SUB-TEHSIL,53,36,0,36
KALAT DISTRICT,GAZG SUB-TEHSIL,54,26,0,26
KALAT DISTRICT,GAZG SUB-TEHSIL,55,36,0,36
KALAT DISTRICT,GAZG SUB-TEHSIL,56,17,0,17
KALAT DISTRICT,GAZG SUB-TEHSIL,57,17,0,17
KALAT DISTRICT,GAZG SUB-TEHSIL,58,24,0,24
KALAT DISTRICT,GAZG SUB-TEHSIL,59,12,0,12
KALAT DISTRICT,GAZG SUB-TEHSIL,60,31,0,31
KALAT DISTRICT,GAZG SUB-TEHSIL,61,33,0,33
KALAT DISTRICT,GAZG SUB-TEHSIL,62,15,0,15
KALAT DISTRICT,GAZG SUB-TEHSIL,63,17,0,17
KALAT DISTRICT,GAZG SUB-TEHSIL,64,7,0,7
KALAT DISTRICT,GAZG SUB-TEHSIL,65,13,0,13
KALAT DISTRICT,GAZG SUB-TEHSIL,66,14,0,14
KALAT DISTRICT,GAZG SUB-TEHSIL,67,14,0,14
KALAT DISTRICT,GAZG SUB-TEHSIL,68,11,0,11
KALAT DISTRICT,GAZG SUB-TEHSIL,69,8,0,8
KALAT DISTRICT,GAZG SUB-TEHSIL,70,10,0,10
KALAT DISTRICT,GAZG SUB-TEHSIL,71,18,0,18
KALAT DISTRICT,GAZG SUB-TEHSIL,72,4,0,4
KALAT DISTRICT,GAZG SUB-TEHSIL,73,9,0,9
KALAT DISTRICT,GAZG SUB-TEHSIL,74,2,0,2
KALAT DISTRICT,GAZG SUB-TEHSIL,>=75,59,0,59
KALAT DISTRICT,JOHAN SUB-TEHSIL,<1,281,0,281
KALAT DISTRICT,JOHAN SUB-TEHSIL,1,325,0,325
KALAT DISTRICT,JOHAN SUB-TEHSIL,2,468,0,468
KALAT DISTRICT,JOHAN SUB-TEHSIL,3,412,0,412
KALAT DISTRICT,JOHAN SUB-TEHSIL,4,480,0,480
KALAT DISTRICT,JOHAN SUB-TEHSIL,5,408,0,408
KALAT DISTRICT,JOHAN SUB-TEHSIL,6,457,0,457
KALAT DISTRICT,JOHAN SUB-TEHSIL,7,374,0,374
KALAT DISTRICT,JOHAN SUB-TEHSIL,8,471,0,471
KALAT DISTRICT,JOHAN SUB-TEHSIL,9,316,0,316
KALAT DISTRICT,JOHAN SUB-TEHSIL,10,467,0,467
KALAT DISTRICT,JOHAN SUB-TEHSIL,11,212,0,212
KALAT DISTRICT,JOHAN SUB-TEHSIL,12,313,0,313
KALAT DISTRICT,JOHAN SUB-TEHSIL,13,221,0,221
KALAT DISTRICT,JOHAN SUB-TEHSIL,14,231,0,231
KALAT DISTRICT,JOHAN SUB-TEHSIL,15,193,0,193
KALAT DISTRICT,JOHAN SUB-TEHSIL,16,197,0,197
KALAT DISTRICT,JOHAN SUB-TEHSIL,17,145,0,145
KALAT DISTRICT,JOHAN SUB-TEHSIL,18,217,0,217
KALAT DISTRICT,JOHAN SUB-TEHSIL,19,132,0,132
KALAT DISTRICT,JOHAN SUB-TEHSIL,20,255,0,255
KALAT DISTRICT,JOHAN SUB-TEHSIL,21,130,0,130
KALAT DISTRICT,JOHAN SUB-TEHSIL,22,144,0,144
KALAT DISTRICT,JOHAN SUB-TEHSIL,23,124,0,124
KALAT DISTRICT,JOHAN SUB-TEHSIL,24,97,0,97
KALAT DISTRICT,JOHAN SUB-TEHSIL,25,224,0,224
KALAT DISTRICT,JOHAN SUB-TEHSIL,26,89,0,89
KALAT DISTRICT,JOHAN SUB-TEHSIL,27,141,0,141
KALAT DISTRICT,JOHAN SUB-TEHSIL,28,96,0,96
KALAT DISTRICT,JOHAN SUB-TEHSIL,29,119,0,119
KALAT DISTRICT,JOHAN SUB-TEHSIL,30,238,0,238
KALAT DISTRICT,JOHAN SUB-TEHSIL,31,129,0,129
KALAT DISTRICT,JOHAN SUB-TEHSIL,32,105,0,105
KALAT DISTRICT,JOHAN SUB-TEHSIL,33,120,0,120
KALAT DISTRICT,JOHAN SUB-TEHSIL,34,93,0,93
KALAT DISTRICT,JOHAN SUB-TEHSIL,35,152,0,152
KALAT DISTRICT,JOHAN SUB-TEHSIL,36,76,0,76
KALAT DISTRICT,JOHAN SUB-TEHSIL,37,117,0,117
KALAT DISTRICT,JOHAN SUB-TEHSIL,38,108,0,108
KALAT DISTRICT,JOHAN SUB-TEHSIL,39,89,0,89
KALAT DISTRICT,JOHAN SUB-TEHSIL,40,173,0,173
KALAT DISTRICT,JOHAN SUB-TEHSIL,41,92,0,92
KALAT DISTRICT,JOHAN SUB-TEHSIL,42,101,0,101
KALAT DISTRICT,JOHAN SUB-TEHSIL,43,80,0,80
KALAT DISTRICT,JOHAN SUB-TEHSIL,44,73,0,73
KALAT DISTRICT,JOHAN SUB-TEHSIL,45,76,0,76
KALAT DISTRICT,JOHAN SUB-TEHSIL,46,42,0,42
KALAT DISTRICT,JOHAN SUB-TEHSIL,47,73,0,73
KALAT DISTRICT,JOHAN SUB-TEHSIL,48,45,0,45
KALAT DISTRICT,JOHAN SUB-TEHSIL,49,65,0,65
KALAT DISTRICT,JOHAN SUB-TEHSIL,50,98,0,98
KALAT DISTRICT,JOHAN SUB-TEHSIL,51,48,0,48
KALAT DISTRICT,JOHAN SUB-TEHSIL,52,35,0,35
KALAT DISTRICT,JOHAN SUB-TEHSIL,53,51,0,51
KALAT DISTRICT,JOHAN SUB-TEHSIL,54,39,0,39
KALAT DISTRICT,JOHAN SUB-TEHSIL,55,47,0,47
KALAT DISTRICT,JOHAN SUB-TEHSIL,56,33,0,33
KALAT DISTRICT,JOHAN SUB-TEHSIL,57,39,0,39
KALAT DISTRICT,JOHAN SUB-TEHSIL,58,25,0,25
KALAT DISTRICT,JOHAN SUB-TEHSIL,59,25,0,25
KALAT DISTRICT,JOHAN SUB-TEHSIL,60,51,0,51
KALAT DISTRICT,JOHAN SUB-TEHSIL,61,30,0,30
KALAT DISTRICT,JOHAN SUB-TEHSIL,62,29,0,29
KALAT DISTRICT,JOHAN SUB-TEHSIL,63,36,0,36
KALAT DISTRICT,JOHAN SUB-TEHSIL,64,19,0,19
KALAT DISTRICT,JOHAN SUB-TEHSIL,65,27,0,27
KALAT DISTRICT,JOHAN SUB-TEHSIL,66,36,0,36
KALAT DISTRICT,JOHAN SUB-TEHSIL,67,22,0,22
KALAT DISTRICT,JOHAN SUB-TEHSIL,68,22,0,22
KALAT DISTRICT,JOHAN SUB-TEHSIL,69,9,0,9
KALAT DISTRICT,JOHAN SUB-TEHSIL,70,31,0,31
KALAT DISTRICT,JOHAN SUB-TEHSIL,71,27,0,27
KALAT DISTRICT,JOHAN SUB-TEHSIL,72,17,0,17
KALAT DISTRICT,JOHAN SUB-TEHSIL,73,13,0,13
KALAT DISTRICT,JOHAN SUB-TEHSIL,74,13,0,13
KALAT DISTRICT,JOHAN SUB-TEHSIL,>=75,100,0,100
KALAT DISTRICT,KALAT TEHSIL,<1,2800,1110,3910
KALAT DISTRICT,KALAT TEHSIL,1,3272,985,4257
KALAT DISTRICT,KALAT TEHSIL,2,4005,1152,5157
KALAT DISTRICT,KALAT TEHSIL,3,3618,1230,4848
KALAT DISTRICT,KALAT TEHSIL,4,4027,1251,5278
KALAT DISTRICT,KALAT TEHSIL,5,3555,1190,4745
KALAT DISTRICT,KALAT TEHSIL,6,3733,1062,4795
KALAT DISTRICT,KALAT TEHSIL,7,3357,1140,4497
KALAT DISTRICT,KALAT TEHSIL,8,3906,1152,5058
KALAT DISTRICT,KALAT TEHSIL,9,2905,1092,3997
KALAT DISTRICT,KALAT TEHSIL,10,3433,1041,4474
KALAT DISTRICT,KALAT TEHSIL,11,2233,914,3147
KALAT DISTRICT,KALAT TEHSIL,12,2547,901,3448
KALAT DISTRICT,KALAT TEHSIL,13,1902,897,2799
KALAT DISTRICT,KALAT TEHSIL,14,2023,905,2928
KALAT DISTRICT,KALAT TEHSIL,15,1868,826,2694
KALAT DISTRICT,KALAT TEHSIL,16,1726,902,2628
KALAT DISTRICT,KALAT TEHSIL,17,1435,790,2225
KALAT DISTRICT,KALAT TEHSIL,18,1892,792,2684
KALAT DISTRICT,KALAT TEHSIL,19,1287,688,1975
KALAT DISTRICT,KALAT TEHSIL,20,1887,659,2546
KALAT DISTRICT,KALAT TEHSIL,21,1303,657,1960
KALAT DISTRICT,KALAT TEHSIL,22,1158,537,1695
KALAT DISTRICT,KALAT TEHSIL,23,1098,575,1673
KALAT DISTRICT,KALAT TEHSIL,24,957,556,1513
KALAT DISTRICT,KALAT TEHSIL,25,1543,589,2132
KALAT DISTRICT,KALAT TEHSIL,26,942,556,1498
KALAT DISTRICT,KALAT TEHSIL,27,1181,670,1851
KALAT DISTRICT,KALAT TEHSIL,28,1328,613,1941
KALAT DISTRICT,KALAT TEHSIL,29,1227,571,1798
KALAT DISTRICT,KALAT TEHSIL,30,1592,590,2182
KALAT DISTRICT,KALAT TEHSIL,31,1222,594,1816
KALAT DISTRICT,KALAT TEHSIL,32,1063,468,1531
KALAT DISTRICT,KALAT TEHSIL,33,1121,464,1585
KALAT DISTRICT,KALAT TEHSIL,34,838,398,1236
KALAT DISTRICT,KALAT TEHSIL,35,1124,367,1491
KALAT DISTRICT,KALAT TEHSIL,36,716,378,1094
KALAT DISTRICT,KALAT TEHSIL,37,990,434,1424
KALAT DISTRICT,KALAT TEHSIL,38,885,371,1256
KALAT DISTRICT,KALAT TEHSIL,39,834,402,1236
KALAT DISTRICT,KALAT TEHSIL,40,974,335,1309
KALAT DISTRICT,KALAT TEHSIL,41,664,339,1003
KALAT DISTRICT,KALAT TEHSIL,42,583,249,832
KALAT DISTRICT,KALAT TEHSIL,43,576,283,859
KALAT DISTRICT,KALAT TEHSIL,44,512,252,764
KALAT DISTRICT,KALAT TEHSIL,45,653,240,893
KALAT DISTRICT,KALAT TEHSIL,46,437,242,679
KALAT DISTRICT,KALAT TEHSIL,47,515,265,780
KALAT DISTRICT,KALAT TEHSIL,48,542,291,833
KALAT DISTRICT,KALAT TEHSIL,49,533,270,803
KALAT DISTRICT,KALAT TEHSIL,50,641,226,867
KALAT DISTRICT,KALAT TEHSIL,51,465,240,705
KALAT DISTRICT,KALAT TEHSIL,52,379,229,608
KALAT DISTRICT,KALAT TEHSIL,53,417,187,604
KALAT DISTRICT,KALAT TEHSIL,54,392,200,592
KALAT DISTRICT,KALAT TEHSIL,55,354,148,502
KALAT DISTRICT,KALAT TEHSIL,56,291,134,425
KALAT DISTRICT,KALAT TEHSIL,57,308,170,478
KALAT DISTRICT,KALAT TEHSIL,58,251,168,419
KALAT DISTRICT,KALAT TEHSIL,59,247,170,417
KALAT DISTRICT,KALAT TEHSIL,60,393,144,537
KALAT DISTRICT,KALAT TEHSIL,61,298,155,453
KALAT DISTRICT,KALAT TEHSIL,62,220,113,333
KALAT DISTRICT,KALAT TEHSIL,63,238,139,377
KALAT DISTRICT,KALAT TEHSIL,64,226,104,330
KALAT DISTRICT,KALAT TEHSIL,65,259,82,341
KALAT DISTRICT,KALAT TEHSIL,66,258,96,354
KALAT DISTRICT,KALAT TEHSIL,67,202,83,285
KALAT DISTRICT,KALAT TEHSIL,68,145,79,224
KALAT DISTRICT,KALAT TEHSIL,69,141,84,225
KALAT DISTRICT,KALAT TEHSIL,70,194,52,246
KALAT DISTRICT,KALAT TEHSIL,71,194,71,265
KALAT DISTRICT,KALAT TEHSIL,72,121,46,167
KALAT DISTRICT,KALAT TEHSIL,73,115,43,158
KALAT DISTRICT,KALAT TEHSIL,74,103,32,135
KALAT DISTRICT,KALAT TEHSIL,>=75,924,366,1290
KALAT DISTRICT,MANGOCHAR TEHSIL,<1,2263,0,2263
KALAT DISTRICT,MANGOCHAR TEHSIL,1,2283,0,2283
KALAT DISTRICT,MANGOCHAR TEHSIL,2,2880,0,2880
KALAT DISTRICT,MANGOCHAR TEHSIL,3,2588,0,2588
KALAT DISTRICT,MANGOCHAR TEHSIL,4,2847,0,2847
KALAT DISTRICT,MANGOCHAR TEHSIL,5,2496,0,2496
KALAT DISTRICT,MANGOCHAR TEHSIL,6,2631,0,2631
KALAT DISTRICT,MANGOCHAR TEHSIL,7,2504,0,2504
KALAT DISTRICT,MANGOCHAR TEHSIL,8,2648,0,2648
KALAT DISTRICT,MANGOCHAR TEHSIL,9,2239,0,2239
KALAT DISTRICT,MANGOCHAR TEHSIL,10,2282,0,2282
KALAT DISTRICT,MANGOCHAR TEHSIL,11,1777,0,1777
KALAT DISTRICT,MANGOCHAR TEHSIL,12,1681,0,1681
KALAT DISTRICT,MANGOCHAR TEHSIL,13,1541,0,1541
KALAT DISTRICT,MANGOCHAR TEHSIL,14,1615,0,1615
KALAT DISTRICT,MANGOCHAR TEHSIL,15,1402,0,1402
KALAT DISTRICT,MANGOCHAR TEHSIL,16,1326,0,1326
KALAT DISTRICT,MANGOCHAR TEHSIL,17,1204,0,1204
KALAT DISTRICT,MANGOCHAR TEHSIL,18,1287,0,1287
KALAT DISTRICT,MANGOCHAR TEHSIL,19,1101,0,1101
KALAT DISTRICT,MANGOCHAR TEHSIL,20,1215,0,1215
KALAT DISTRICT,MANGOCHAR TEHSIL,21,983,0,983
KALAT DISTRICT,MANGOCHAR TEHSIL,22,852,0,852
KALAT DISTRICT,MANGOCHAR TEHSIL,23,847,0,847
KALAT DISTRICT,MANGOCHAR TEHSIL,24,883,0,883
KALAT DISTRICT,MANGOCHAR TEHSIL,25,1000,0,1000
KALAT DISTRICT,MANGOCHAR TEHSIL,26,827,0,827
KALAT DISTRICT,MANGOCHAR TEHSIL,27,875,0,875
KALAT DISTRICT,MANGOCHAR TEHSIL,28,936,0,936
KALAT DISTRICT,MANGOCHAR TEHSIL,29,920,0,920
KALAT DISTRICT,MANGOCHAR TEHSIL,30,1011,0,1011
KALAT DISTRICT,MANGOCHAR TEHSIL,31,813,0,813
KALAT DISTRICT,MANGOCHAR TEHSIL,32,783,0,783
KALAT DISTRICT,MANGOCHAR TEHSIL,33,740,0,740
KALAT DISTRICT,MANGOCHAR TEHSIL,34,646,0,646
KALAT DISTRICT,MANGOCHAR TEHSIL,35,657,0,657
KALAT DISTRICT,MANGOCHAR TEHSIL,36,577,0,577
KALAT DISTRICT,MANGOCHAR TEHSIL,37,692,0,692
KALAT DISTRICT,MANGOCHAR TEHSIL,38,547,0,547
KALAT DISTRICT,MANGOCHAR TEHSIL,39,553,0,553
KALAT DISTRICT,MANGOCHAR TEHSIL,40,530,0,530
KALAT DISTRICT,MANGOCHAR TEHSIL,41,479,0,479
KALAT DISTRICT,MANGOCHAR TEHSIL,42,361,0,361
KALAT DISTRICT,MANGOCHAR TEHSIL,43,372,0,372
KALAT DISTRICT,MANGOCHAR TEHSIL,44,355,0,355
KALAT DISTRICT,MANGOCHAR TEHSIL,45,343,0,343
KALAT DISTRICT,MANGOCHAR TEHSIL,46,353,0,353
KALAT DISTRICT,MANGOCHAR TEHSIL,47,396,0,396
KALAT DISTRICT,MANGOCHAR TEHSIL,48,398,0,398
KALAT DISTRICT,MANGOCHAR TEHSIL,49,398,0,398
KALAT DISTRICT,MANGOCHAR TEHSIL,50,347,0,347
KALAT DISTRICT,MANGOCHAR TEHSIL,51,317,0,317
KALAT DISTRICT,MANGOCHAR TEHSIL,52,251,0,251
KALAT DISTRICT,MANGOCHAR TEHSIL,53,239,0,239
KALAT DISTRICT,MANGOCHAR TEHSIL,54,211,0,211
KALAT DISTRICT,MANGOCHAR TEHSIL,55,183,0,183
KALAT DISTRICT,MANGOCHAR TEHSIL,56,202,0,202
KALAT DISTRICT,MANGOCHAR TEHSIL,57,197,0,197
KALAT DISTRICT,MANGOCHAR TEHSIL,58,179,0,179
KALAT DISTRICT,MANGOCHAR TEHSIL,59,177,0,177
KALAT DISTRICT,MANGOCHAR TEHSIL,60,209,0,209
KALAT DISTRICT,MANGOCHAR TEHSIL,61,155,0,155
KALAT DISTRICT,MANGOCHAR TEHSIL,62,168,0,168
KALAT DISTRICT,MANGOCHAR TEHSIL,63,153,0,153
KALAT DISTRICT,MANGOCHAR TEHSIL,64,152,0,152
KALAT DISTRICT,MANGOCHAR TEHSIL,65,157,0,157
KALAT DISTRICT,MANGOCHAR TEHSIL,66,154,0,154
KALAT DISTRICT,MANGOCHAR TEHSIL,67,115,0,115
KALAT DISTRICT,MANGOCHAR TEHSIL,68,104,0,104
KALAT DISTRICT,MANGOCHAR TEHSIL,69,92,0,92
KALAT DISTRICT,MANGOCHAR TEHSIL,70,122,0,122
KALAT DISTRICT,MANGOCHAR TEHSIL,71,80,0,80
KALAT DISTRICT,MANGOCHAR TEHSIL,72,85,0,85
KALAT DISTRICT,MANGOCHAR TEHSIL,73,67,0,67
KALAT DISTRICT,MANGOCHAR TEHSIL,74,50,0,50
KALAT DISTRICT,MANGOCHAR TEHSIL,>=75,575,0,575
KALAT DISTRICT,SURAB TEHSIL,<1,7164,1523,8687
KALAT DISTRICT,SURAB TEHSIL,1,6509,1712,8221
KALAT DISTRICT,SURAB TEHSIL,2,8033,1830,9863
KALAT DISTRICT,SURAB TEHSIL,3,6710,1760,8470
KALAT DISTRICT,SURAB TEHSIL,4,8032,1642,9674
KALAT DISTRICT,SURAB TEHSIL,5,6587,1565,8152
KALAT DISTRICT,SURAB TEHSIL,6,7967,1442,9409
KALAT DISTRICT,SURAB TEHSIL,7,6161,1484,7645
KALAT DISTRICT,SURAB TEHSIL,8,7797,1412,9209
KALAT DISTRICT,SURAB TEHSIL,9,6571,1368,7939
KALAT DISTRICT,SURAB TEHSIL,10,7503,1245,8748
KALAT DISTRICT,SURAB TEHSIL,11,5416,1112,6528
KALAT DISTRICT,SURAB TEHSIL,12,5309,1030,6339
KALAT DISTRICT,SURAB TEHSIL,13,4563,962,5525
KALAT DISTRICT,SURAB TEHSIL,14,4921,880,5801
KALAT DISTRICT,SURAB TEHSIL,15,3789,873,4662
KALAT DISTRICT,SURAB TEHSIL,16,3841,776,4617
KALAT DISTRICT,SURAB TEHSIL,17,3108,691,3799
KALAT DISTRICT,SURAB TEHSIL,18,2683,621,3304
KALAT DISTRICT,SURAB TEHSIL,19,1899,505,2404
KALAT DISTRICT,SURAB TEHSIL,20,2306,551,2857
KALAT DISTRICT,SURAB TEHSIL,21,1808,479,2287
KALAT DISTRICT,SURAB TEHSIL,22,1598,422,2020
KALAT DISTRICT,SURAB TEHSIL,23,1455,373,1828
KALAT DISTRICT,SURAB TEHSIL,24,1431,354,1785
KALAT DISTRICT,SURAB TEHSIL,25,1906,434,2340
KALAT DISTRICT,SURAB TEHSIL,26,1477,368,1845
KALAT DISTRICT,SURAB TEHSIL,27,1646,408,2054
KALAT DISTRICT,SURAB TEHSIL,28,1941,413,2354
KALAT DISTRICT,SURAB TEHSIL,29,1781,401,2182
KALAT DISTRICT,SURAB TEHSIL,30,2111,419,2530
KALAT DISTRICT,SURAB TEHSIL,31,1647,398,2045
KALAT DISTRICT,SURAB TEHSIL,32,1340,324,1664
KALAT DISTRICT,SURAB TEHSIL,33,1523,321,1844
KALAT DISTRICT,SURAB TEHSIL,34,1285,291,1576
KALAT DISTRICT,SURAB TEHSIL,35,1503,285,1788
KALAT DISTRICT,SURAB TEHSIL,36,1251,257,1508
KALAT DISTRICT,SURAB TEHSIL,37,1116,258,1374
KALAT DISTRICT,SURAB TEHSIL,38,1593,274,1867
KALAT DISTRICT,SURAB TEHSIL,39,1257,247,1504
KALAT DISTRICT,SURAB TEHSIL,40,1695,285,1980
KALAT DISTRICT,SURAB TEHSIL,41,935,210,1145
KALAT DISTRICT,SURAB TEHSIL,42,730,166,896
KALAT DISTRICT,SURAB TEHSIL,43,884,198,1082
KALAT DISTRICT,SURAB TEHSIL,44,767,166,933
KALAT DISTRICT,SURAB TEHSIL,45,901,199,1100
KALAT DISTRICT,SURAB TEHSIL,46,725,139,864
KALAT DISTRICT,SURAB TEHSIL,47,662,190,852
KALAT DISTRICT,SURAB TEHSIL,48,859,149,1008
KALAT DISTRICT,SURAB TEHSIL,49,724,168,892
KALAT DISTRICT,SURAB TEHSIL,50,861,121,982
KALAT DISTRICT,SURAB TEHSIL,51,531,131,662
KALAT DISTRICT,SURAB TEHSIL,52,403,97,500
KALAT DISTRICT,SURAB TEHSIL,53,489,107,596
KALAT DISTRICT,SURAB TEHSIL,54,488,92,580
KALAT DISTRICT,SURAB TEHSIL,55,550,102,652
KALAT DISTRICT,SURAB TEHSIL,56,388,76,464
KALAT DISTRICT,SURAB TEHSIL,57,347,80,427
KALAT DISTRICT,SURAB TEHSIL,58,360,77,437
KALAT DISTRICT,SURAB TEHSIL,59,371,74,445
KALAT DISTRICT,SURAB TEHSIL,60,499,97,596
KALAT DISTRICT,SURAB TEHSIL,61,358,106,464
KALAT DISTRICT,SURAB TEHSIL,62,294,71,365
KALAT DISTRICT,SURAB TEHSIL,63,325,71,396
KALAT DISTRICT,SURAB TEHSIL,64,313,57,370
KALAT DISTRICT,SURAB TEHSIL,65,320,54,374
KALAT DISTRICT,SURAB TEHSIL,66,266,77,343
KALAT DISTRICT,SURAB TEHSIL,67,229,72,301
KALAT DISTRICT,SURAB TEHSIL,68,229,38,267
KALAT DISTRICT,SURAB TEHSIL,69,206,53,259
KALAT DISTRICT,SURAB TEHSIL,70,241,31,272
KALAT DISTRICT,SURAB TEHSIL,71,213,36,249
KALAT DISTRICT,SURAB TEHSIL,72,155,29,184
KALAT DISTRICT,SURAB TEHSIL,73,140,22,162
KALAT DISTRICT,SURAB TEHSIL,74,130,17,147
KALAT DISTRICT,SURAB TEHSIL,>=75,1134,229,1363
KAMBAR SHAHDAD KOT DISTRICT,KAMBAR ALI KHAN TALUKA,<1,7215,2297,9512
KAMBAR SHAHDAD KOT DISTRICT,KAMBAR ALI KHAN TALUKA,1,7967,2816,10783
KAMBAR SHAHDAD KOT DISTRICT,KAMBAR ALI KHAN TALUKA,2,10557,3353,13910
KAMBAR SHAHDAD KOT DISTRICT,KAMBAR ALI KHAN TALUKA,3,11393,3757,15150
KAMBAR SHAHDAD KOT DISTRICT,KAMBAR ALI KHAN TALUKA,4,12396,3932,16328
KAMBAR SHAHDAD KOT DISTRICT,KAMBAR ALI KHAN TALUKA,5,11745,3740,15485
KAMBAR SHAHDAD KOT DISTRICT,KAMBAR ALI KHAN TALUKA,6,11960,3606,15566
KAMBAR SHAHDAD KOT DISTRICT,KAMBAR ALI KHAN TALUKA,7,9972,3388,13360
KAMBAR SHAHDAD KOT DISTRICT,KAMBAR ALI KHAN TALUKA,8,11798,3644,15442
KAMBAR SHAHDAD KOT DISTRICT,KAMBAR ALI KHAN TALUKA,9,9063,3021,12084
KAMBAR SHAHDAD KOT DISTRICT,KAMBAR ALI KHAN TALUKA,10,10248,3157,13405
KAMBAR SHAHDAD KOT DISTRICT,KAMBAR ALI KHAN TALUKA,11,6859,2338,9197
KAMBAR SHAHDAD KOT DISTRICT,KAMBAR ALI KHAN TALUKA,12,7924,2521,10445
KAMBAR SHAHDAD KOT DISTRICT,KAMBAR ALI KHAN TALUKA,13,6244,2229,8473
KAMBAR SHAHDAD KOT DISTRICT,KAMBAR ALI KHAN TALUKA,14,6619,2208,8827
KAMBAR SHAHDAD KOT DISTRICT,KAMBAR ALI KHAN TALUKA,15,6420,2338,8758
KAMBAR SHAHDAD KOT DISTRICT,KAMBAR ALI KHAN TALUKA,16,6236,2069,8305
KAMBAR SHAHDAD KOT DISTRICT,KAMBAR ALI KHAN TALUKA,17,5431,2270,7701
KAMBAR SHAHDAD KOT DISTRICT,KAMBAR ALI KHAN TALUKA,18,6580,2233,8813
KAMBAR SHAHDAD KOT DISTRICT,KAMBAR ALI KHAN TALUKA,19,4977,1947,6924
KAMBAR SHAHDAD KOT DISTRICT,KAMBAR ALI KHAN TALUKA,20,6277,2248,8525
KAMBAR SHAHDAD KOT DISTRICT,KAMBAR ALI KHAN TALUKA,21,4438,1661,6099
KAMBAR SHAHDAD KOT DISTRICT,KAMBAR ALI KHAN TALUKA,22,4553,1756,6309
KAMBAR SHAHDAD KOT DISTRICT,KAMBAR ALI KHAN TALUKA,23,4129,1640,5769
KAMBAR SHAHDAD KOT DISTRICT,KAMBAR ALI KHAN TALUKA,24,3500,1395,4895
KAMBAR SHAHDAD KOT DISTRICT,KAMBAR ALI KHAN TALUKA,25,4862,1767,6629
KAMBAR SHAHDAD KOT DISTRICT,KAMBAR ALI KHAN TALUKA,26,3356,1392,4748
KAMBAR SHAHDAD KOT DISTRICT,KAMBAR ALI KHAN TALUKA,27,3431,1420,4851
KAMBAR SHAHDAD KOT DISTRICT,KAMBAR ALI KHAN TALUKA,28,4065,1582,5647
KAMBAR SHAHDAD KOT DISTRICT,KAMBAR ALI KHAN TALUKA,29,3496,1371,4867
KAMBAR SHAHDAD KOT DISTRICT,KAMBAR ALI KHAN TALUKA,30,4304,1733,6037
KAMBAR SHAHDAD KOT DISTRICT,KAMBAR ALI KHAN TALUKA,31,3320,1225,4545
KAMBAR SHAHDAD KOT DISTRICT,KAMBAR ALI KHAN TALUKA,32,3224,1240,4464
KAMBAR SHAHDAD KOT DISTRICT,KAMBAR ALI KHAN TALUKA,33,3227,1218,4445
KAMBAR SHAHDAD KOT DISTRICT,KAMBAR ALI KHAN TALUKA,34,2769,1000,3769
KAMBAR SHAHDAD KOT DISTRICT,KAMBAR ALI KHAN TALUKA,35,3679,1277,4956
KAMBAR SHAHDAD KOT DISTRICT,KAMBAR ALI KHAN TALUKA,36,2565,1009,3574
KAMBAR SHAHDAD KOT DISTRICT,KAMBAR ALI KHAN TALUKA,37,2863,1046,3909
KAMBAR SHAHDAD KOT DISTRICT,KAMBAR ALI KHAN TALUKA,38,2981,1168,4149
KAMBAR SHAHDAD KOT DISTRICT,KAMBAR ALI KHAN TALUKA,39,2716,1021,3737
KAMBAR SHAHDAD KOT DISTRICT,KAMBAR ALI KHAN TALUKA,40,3222,1207,4429
KAMBAR SHAHDAD KOT DISTRICT,KAMBAR ALI KHAN TALUKA,41,2268,780,3048
KAMBAR SHAHDAD KOT DISTRICT,KAMBAR ALI KHAN TALUKA,42,2171,758,2929
KAMBAR SHAHDAD KOT DISTRICT,KAMBAR ALI KHAN TALUKA,43,1861,730,2591
KAMBAR SHAHDAD KOT DISTRICT,KAMBAR ALI KHAN TALUKA,44,1818,631,2449
KAMBAR SHAHDAD KOT DISTRICT,KAMBAR ALI KHAN TALUKA,45,2114,786,2900
KAMBAR SHAHDAD KOT DISTRICT,KAMBAR ALI KHAN TALUKA,46,1556,512,2068
KAMBAR SHAHDAD KOT DISTRICT,KAMBAR ALI KHAN TALUKA,47,1778,556,2334
KAMBAR SHAHDAD KOT DISTRICT,KAMBAR ALI KHAN TALUKA,48,1839,554,2393
KAMBAR SHAHDAD KOT DISTRICT,KAMBAR ALI KHAN TALUKA,49,1550,590,2140
KAMBAR SHAHDAD KOT DISTRICT,KAMBAR ALI KHAN TALUKA,50,2103,688,2791
KAMBAR SHAHDAD KOT DISTRICT,KAMBAR ALI KHAN TALUKA,51,1402,477,1879
KAMBAR SHAHDAD KOT DISTRICT,KAMBAR ALI KHAN TALUKA,52,1350,469,1819
KAMBAR SHAHDAD KOT DISTRICT,KAMBAR ALI KHAN TALUKA,53,1289,462,1751
KAMBAR SHAHDAD KOT DISTRICT,KAMBAR ALI KHAN TALUKA,54,1145,408,1553
KAMBAR SHAHDAD KOT DISTRICT,KAMBAR ALI KHAN TALUKA,55,1454,506,1960
KAMBAR SHAHDAD KOT DISTRICT,KAMBAR ALI KHAN TALUKA,56,1076,341,1417
KAMBAR SHAHDAD KOT DISTRICT,KAMBAR ALI KHAN TALUKA,57,1182,359,1541
KAMBAR SHAHDAD KOT DISTRICT,KAMBAR ALI KHAN TALUKA,58,1045,320,1365
KAMBAR SHAHDAD KOT DISTRICT,KAMBAR ALI KHAN TALUKA,59,922,287,1209
KAMBAR SHAHDAD KOT DISTRICT,KAMBAR ALI KHAN TALUKA,60,1391,422,1813
KAMBAR SHAHDAD KOT DISTRICT,KAMBAR ALI KHAN TALUKA,61,962,305,1267
KAMBAR SHAHDAD KOT DISTRICT,KAMBAR ALI KHAN TALUKA,62,1049,377,1426
KAMBAR SHAHDAD KOT DISTRICT,KAMBAR ALI KHAN TALUKA,63,933,301,1234
KAMBAR SHAHDAD KOT DISTRICT,KAMBAR ALI KHAN TALUKA,64,825,256,1081
KAMBAR SHAHDAD KOT DISTRICT,KAMBAR ALI KHAN TALUKA,65,851,288,1139
KAMBAR SHAHDAD KOT DISTRICT,KAMBAR ALI KHAN TALUKA,66,706,237,943
KAMBAR SHAHDAD KOT DISTRICT,KAMBAR ALI KHAN TALUKA,67,685,227,912
KAMBAR SHAHDAD KOT DISTRICT,KAMBAR ALI KHAN TALUKA,68,551,180,731
KAMBAR SHAHDAD KOT DISTRICT,KAMBAR ALI KHAN TALUKA,69,518,191,709
KAMBAR SHAHDAD KOT DISTRICT,KAMBAR ALI KHAN TALUKA,70,651,224,875
KAMBAR SHAHDAD KOT DISTRICT,KAMBAR ALI KHAN TALUKA,71,457,128,585
KAMBAR SHAHDAD KOT DISTRICT,KAMBAR ALI KHAN TALUKA,72,534,164,698
KAMBAR SHAHDAD KOT DISTRICT,KAMBAR ALI KHAN TALUKA,73,445,127,572
KAMBAR SHAHDAD KOT DISTRICT,KAMBAR ALI KHAN TALUKA,74,355,101,456
KAMBAR SHAHDAD KOT DISTRICT,KAMBAR ALI KHAN TALUKA,>=75,2987,988,3975
KAMBAR SHAHDAD KOT DISTRICT,MIRO KHAN TALUKA,<1,3261,752,4013
KAMBAR SHAHDAD KOT DISTRICT,MIRO KHAN TALUKA,1,3156,1105,4261
KAMBAR SHAHDAD KOT DISTRICT,MIRO KHAN TALUKA,2,4336,1237,5573
KAMBAR SHAHDAD KOT DISTRICT,MIRO KHAN TALUKA,3,4386,1479,5865
KAMBAR SHAHDAD KOT DISTRICT,MIRO KHAN TALUKA,4,4914,1502,6416
KAMBAR SHAHDAD KOT DISTRICT,MIRO KHAN TALUKA,5,4819,1484,6303
KAMBAR SHAHDAD KOT DISTRICT,MIRO KHAN TALUKA,6,4668,1554,6222
KAMBAR SHAHDAD KOT DISTRICT,MIRO KHAN TALUKA,7,3949,1411,5360
KAMBAR SHAHDAD KOT DISTRICT,MIRO KHAN TALUKA,8,4777,1630,6407
KAMBAR SHAHDAD KOT DISTRICT,MIRO KHAN TALUKA,9,3418,1190,4608
KAMBAR SHAHDAD KOT DISTRICT,MIRO KHAN TALUKA,10,4244,1448,5692
KAMBAR SHAHDAD KOT DISTRICT,MIRO KHAN TALUKA,11,2799,964,3763
KAMBAR SHAHDAD KOT DISTRICT,MIRO KHAN TALUKA,12,3203,1203,4406
KAMBAR SHAHDAD KOT DISTRICT,MIRO KHAN TALUKA,13,2490,991,3481
KAMBAR SHAHDAD KOT DISTRICT,MIRO KHAN TALUKA,14,2509,1062,3571
KAMBAR SHAHDAD KOT DISTRICT,MIRO KHAN TALUKA,15,2451,1087,3538
KAMBAR SHAHDAD KOT DISTRICT,MIRO KHAN TALUKA,16,2319,1050,3369
KAMBAR SHAHDAD KOT DISTRICT,MIRO KHAN TALUKA,17,1922,880,2802
KAMBAR SHAHDAD KOT DISTRICT,MIRO KHAN TALUKA,18,2671,998,3669
KAMBAR SHAHDAD KOT DISTRICT,MIRO KHAN TALUKA,19,2179,829,3008
KAMBAR SHAHDAD KOT DISTRICT,MIRO KHAN TALUKA,20,2493,918,3411
KAMBAR SHAHDAD KOT DISTRICT,MIRO KHAN TALUKA,21,1752,689,2441
KAMBAR SHAHDAD KOT DISTRICT,MIRO KHAN TALUKA,22,1776,692,2468
KAMBAR SHAHDAD KOT DISTRICT,MIRO KHAN TALUKA,23,1530,612,2142
KAMBAR SHAHDAD KOT DISTRICT,MIRO KHAN TALUKA,24,1289,562,1851
KAMBAR SHAHDAD KOT DISTRICT,MIRO KHAN TALUKA,25,1838,699,2537
KAMBAR SHAHDAD KOT DISTRICT,MIRO KHAN TALUKA,26,1243,571,1814
KAMBAR SHAHDAD KOT DISTRICT,MIRO KHAN TALUKA,27,1467,627,2094
KAMBAR SHAHDAD KOT DISTRICT,MIRO KHAN TALUKA,28,1563,636,2199
KAMBAR SHAHDAD KOT DISTRICT,MIRO KHAN TALUKA,29,1510,515,2025
KAMBAR SHAHDAD KOT DISTRICT,MIRO KHAN TALUKA,30,1517,684,2201
KAMBAR SHAHDAD KOT DISTRICT,MIRO KHAN TALUKA,31,1269,473,1742
KAMBAR SHAHDAD KOT DISTRICT,MIRO KHAN TALUKA,32,1452,517,1969
KAMBAR SHAHDAD KOT DISTRICT,MIRO KHAN TALUKA,33,1243,492,1735
KAMBAR SHAHDAD KOT DISTRICT,MIRO KHAN TALUKA,34,1042,408,1450
KAMBAR SHAHDAD KOT DISTRICT,MIRO KHAN TALUKA,35,1441,572,2013
KAMBAR SHAHDAD KOT DISTRICT,MIRO KHAN TALUKA,36,947,367,1314
KAMBAR SHAHDAD KOT DISTRICT,MIRO KHAN TALUKA,37,1366,475,1841
KAMBAR SHAHDAD KOT DISTRICT,MIRO KHAN TALUKA,38,1140,497,1637
KAMBAR SHAHDAD KOT DISTRICT,MIRO KHAN TALUKA,39,1117,427,1544
KAMBAR SHAHDAD KOT DISTRICT,MIRO KHAN TALUKA,40,1225,486,1711
KAMBAR SHAHDAD KOT DISTRICT,MIRO KHAN TALUKA,41,799,300,1099
KAMBAR SHAHDAD KOT DISTRICT,MIRO KHAN TALUKA,42,972,351,1323
KAMBAR SHAHDAD KOT DISTRICT,MIRO KHAN TALUKA,43,719,340,1059
KAMBAR SHAHDAD KOT DISTRICT,MIRO KHAN TALUKA,44,643,271,914
KAMBAR SHAHDAD KOT DISTRICT,MIRO KHAN TALUKA,45,911,342,1253
KAMBAR SHAHDAD KOT DISTRICT,MIRO KHAN TALUKA,46,533,194,727
KAMBAR SHAHDAD KOT DISTRICT,MIRO KHAN TALUKA,47,836,270,1106
KAMBAR SHAHDAD KOT DISTRICT,MIRO KHAN TALUKA,48,695,272,967
KAMBAR SHAHDAD KOT DISTRICT,MIRO KHAN TALUKA,49,675,237,912
KAMBAR SHAHDAD KOT DISTRICT,MIRO KHAN TALUKA,50,756,358,1114
KAMBAR SHAHDAD KOT DISTRICT,MIRO KHAN TALUKA,51,501,190,691
KAMBAR SHAHDAD KOT DISTRICT,MIRO KHAN TALUKA,52,631,200,831
KAMBAR SHAHDAD KOT DISTRICT,MIRO KHAN TALUKA,53,503,207,710
KAMBAR SHAHDAD KOT DISTRICT,MIRO KHAN TALUKA,54,369,160,529
KAMBAR SHAHDAD KOT DISTRICT,MIRO KHAN TALUKA,55,563,259,822
KAMBAR SHAHDAD KOT DISTRICT,MIRO KHAN TALUKA,56,335,134,469
KAMBAR SHAHDAD KOT DISTRICT,MIRO KHAN TALUKA,57,546,187,733
KAMBAR SHAHDAD KOT DISTRICT,MIRO KHAN TALUKA,58,327,136,463
KAMBAR SHAHDAD KOT DISTRICT,MIRO KHAN TALUKA,59,326,125,451
KAMBAR SHAHDAD KOT DISTRICT,MIRO KHAN TALUKA,60,470,216,686
KAMBAR SHAHDAD KOT DISTRICT,MIRO KHAN TALUKA,61,324,115,439
KAMBAR SHAHDAD KOT DISTRICT,MIRO KHAN TALUKA,62,410,142,552
KAMBAR SHAHDAD KOT DISTRICT,MIRO KHAN TALUKA,63,328,135,463
KAMBAR SHAHDAD KOT DISTRICT,MIRO KHAN TALUKA,64,305,112,417
KAMBAR SHAHDAD KOT DISTRICT,MIRO KHAN TALUKA,65,367,136,503
KAMBAR SHAHDAD KOT DISTRICT,MIRO KHAN TALUKA,66,291,86,377
KAMBAR SHAHDAD KOT DISTRICT,MIRO KHAN TALUKA,67,327,91,418
KAMBAR SHAHDAD KOT DISTRICT,MIRO KHAN TALUKA,68,191,78,269
KAMBAR SHAHDAD KOT DISTRICT,MIRO KHAN TALUKA,69,208,83,291
KAMBAR SHAHDAD KOT DISTRICT,MIRO KHAN TALUKA,70,235,117,352
KAMBAR SHAHDAD KOT DISTRICT,MIRO KHAN TALUKA,71,167,50,217
KAMBAR SHAHDAD KOT DISTRICT,MIRO KHAN TALUKA,72,203,76,279
KAMBAR SHAHDAD KOT DISTRICT,MIRO KHAN TALUKA,73,139,60,199
KAMBAR SHAHDAD KOT DISTRICT,MIRO KHAN TALUKA,74,124,59,183
KAMBAR SHAHDAD KOT DISTRICT,MIRO KHAN TALUKA,>=75,1202,448,1650
KAMBAR SHAHDAD KOT DISTRICT,NASIRABAD TALUKA,<1,2331,692,3023
KAMBAR SHAHDAD KOT DISTRICT,NASIRABAD TALUKA,1,2953,921,3874
KAMBAR SHAHDAD KOT DISTRICT,NASIRABAD TALUKA,2,3752,1142,4894
KAMBAR SHAHDAD KOT DISTRICT,NASIRABAD TALUKA,3,4308,1308,5616
KAMBAR SHAHDAD KOT DISTRICT,NASIRABAD TALUKA,4,4568,1304,5872
KAMBAR SHAHDAD KOT DISTRICT,NASIRABAD TALUKA,5,4564,1344,5908
KAMBAR SHAHDAD KOT DISTRICT,NASIRABAD TALUKA,6,4166,1235,5401
KAMBAR SHAHDAD KOT DISTRICT,NASIRABAD TALUKA,7,3892,1248,5140
KAMBAR SHAHDAD KOT DISTRICT,NASIRABAD TALUKA,8,4260,1350,5610
KAMBAR SHAHDAD KOT DISTRICT,NASIRABAD TALUKA,9,3606,1173,4779
KAMBAR SHAHDAD KOT DISTRICT,NASIRABAD TALUKA,10,3699,1164,4863
KAMBAR SHAHDAD KOT DISTRICT,NASIRABAD TALUKA,11,2574,892,3466
KAMBAR SHAHDAD KOT DISTRICT,NASIRABAD TALUKA,12,3051,915,3966
KAMBAR SHAHDAD KOT DISTRICT,NASIRABAD TALUKA,13,2493,867,3360
KAMBAR SHAHDAD KOT DISTRICT,NASIRABAD TALUKA,14,2651,886,3537
KAMBAR SHAHDAD KOT DISTRICT,NASIRABAD TALUKA,15,2658,920,3578
KAMBAR SHAHDAD KOT DISTRICT,NASIRABAD TALUKA,16,2639,805,3444
KAMBAR SHAHDAD KOT DISTRICT,NASIRABAD TALUKA,17,2373,783,3156
KAMBAR SHAHDAD KOT DISTRICT,NASIRABAD TALUKA,18,2425,861,3286
KAMBAR SHAHDAD KOT DISTRICT,NASIRABAD TALUKA,19,2071,817,2888
KAMBAR SHAHDAD KOT DISTRICT,NASIRABAD TALUKA,20,2377,729,3106
KAMBAR SHAHDAD KOT DISTRICT,NASIRABAD TALUKA,21,1716,632,2348
KAMBAR SHAHDAD KOT DISTRICT,NASIRABAD TALUKA,22,1825,659,2484
KAMBAR SHAHDAD KOT DISTRICT,NASIRABAD TALUKA,23,1524,606,2130
KAMBAR SHAHDAD KOT DISTRICT,NASIRABAD TALUKA,24,1467,539,2006
KAMBAR SHAHDAD KOT DISTRICT,NASIRABAD TALUKA,25,1687,565,2252
KAMBAR SHAHDAD KOT DISTRICT,NASIRABAD TALUKA,26,1453,575,2028
KAMBAR SHAHDAD KOT DISTRICT,NASIRABAD TALUKA,27,1566,601,2167
KAMBAR SHAHDAD KOT DISTRICT,NASIRABAD TALUKA,28,1659,672,2331
KAMBAR SHAHDAD KOT DISTRICT,NASIRABAD TALUKA,29,1447,605,2052
KAMBAR SHAHDAD KOT DISTRICT,NASIRABAD TALUKA,30,1542,552,2094
KAMBAR SHAHDAD KOT DISTRICT,NASIRABAD TALUKA,31,1503,489,1992
KAMBAR SHAHDAD KOT DISTRICT,NASIRABAD TALUKA,32,1325,506,1831
KAMBAR SHAHDAD KOT DISTRICT,NASIRABAD TALUKA,33,1325,463,1788
KAMBAR SHAHDAD KOT DISTRICT,NASIRABAD TALUKA,34,1244,423,1667
KAMBAR SHAHDAD KOT DISTRICT,NASIRABAD TALUKA,35,1261,427,1688
KAMBAR SHAHDAD KOT DISTRICT,NASIRABAD TALUKA,36,1311,371,1682
KAMBAR SHAHDAD KOT DISTRICT,NASIRABAD TALUKA,37,1225,495,1720
KAMBAR SHAHDAD KOT DISTRICT,NASIRABAD TALUKA,38,1118,432,1550
KAMBAR SHAHDAD KOT DISTRICT,NASIRABAD TALUKA,39,1161,378,1539
KAMBAR SHAHDAD KOT DISTRICT,NASIRABAD TALUKA,40,997,337,1334
KAMBAR SHAHDAD KOT DISTRICT,NASIRABAD TALUKA,41,964,331,1295
KAMBAR SHAHDAD KOT DISTRICT,NASIRABAD TALUKA,42,856,339,1195
KAMBAR SHAHDAD KOT DISTRICT,NASIRABAD TALUKA,43,754,272,1026
KAMBAR SHAHDAD KOT DISTRICT,NASIRABAD TALUKA,44,708,270,978
KAMBAR SHAHDAD KOT DISTRICT,NASIRABAD TALUKA,45,829,245,1074
KAMBAR SHAHDAD KOT DISTRICT,NASIRABAD TALUKA,46,875,251,1126
KAMBAR SHAHDAD KOT DISTRICT,NASIRABAD TALUKA,47,733,314,1047
KAMBAR SHAHDAD KOT DISTRICT,NASIRABAD TALUKA,48,726,262,988
KAMBAR SHAHDAD KOT DISTRICT,NASIRABAD TALUKA,49,667,235,902
KAMBAR SHAHDAD KOT DISTRICT,NASIRABAD TALUKA,50,730,225,955
KAMBAR SHAHDAD KOT DISTRICT,NASIRABAD TALUKA,51,642,206,848
KAMBAR SHAHDAD KOT DISTRICT,NASIRABAD TALUKA,52,544,215,759
KAMBAR SHAHDAD KOT DISTRICT,NASIRABAD TALUKA,53,508,178,686
KAMBAR SHAHDAD KOT DISTRICT,NASIRABAD TALUKA,54,483,158,641
KAMBAR SHAHDAD KOT DISTRICT,NASIRABAD TALUKA,55,575,189,764
KAMBAR SHAHDAD KOT DISTRICT,NASIRABAD TALUKA,56,536,147,683
KAMBAR SHAHDAD KOT DISTRICT,NASIRABAD TALUKA,57,462,200,662
KAMBAR SHAHDAD KOT DISTRICT,NASIRABAD TALUKA,58,399,135,534
KAMBAR SHAHDAD KOT DISTRICT,NASIRABAD TALUKA,59,386,152,538
KAMBAR SHAHDAD KOT DISTRICT,NASIRABAD TALUKA,60,469,144,613
KAMBAR SHAHDAD KOT DISTRICT,NASIRABAD TALUKA,61,444,116,560
KAMBAR SHAHDAD KOT DISTRICT,NASIRABAD TALUKA,62,446,146,592
KAMBAR SHAHDAD KOT DISTRICT,NASIRABAD TALUKA,63,384,122,506
KAMBAR SHAHDAD KOT DISTRICT,NASIRABAD TALUKA,64,347,131,478
KAMBAR SHAHDAD KOT DISTRICT,NASIRABAD TALUKA,65,319,115,434
KAMBAR SHAHDAD KOT DISTRICT,NASIRABAD TALUKA,66,334,90,424
KAMBAR SHAHDAD KOT DISTRICT,NASIRABAD TALUKA,67,269,98,367
KAMBAR SHAHDAD KOT DISTRICT,NASIRABAD TALUKA,68,244,72,316
KAMBAR SHAHDAD KOT DISTRICT,NASIRABAD TALUKA,69,208,95,303
KAMBAR SHAHDAD KOT DISTRICT,NASIRABAD TALUKA,70,208,65,273
KAMBAR SHAHDAD KOT DISTRICT,NASIRABAD TALUKA,71,206,59,265
KAMBAR SHAHDAD KOT DISTRICT,NASIRABAD TALUKA,72,231,64,295
KAMBAR SHAHDAD KOT DISTRICT,NASIRABAD TALUKA,73,171,56,227
KAMBAR SHAHDAD KOT DISTRICT,NASIRABAD TALUKA,74,133,49,182
KAMBAR SHAHDAD KOT DISTRICT,NASIRABAD TALUKA,>=75,1034,390,1424
KAMBAR SHAHDAD KOT DISTRICT,QUBO SAEED KHAN TALUKA,<1,1532,780,2312
KAMBAR SHAHDAD KOT DISTRICT,QUBO SAEED KHAN TALUKA,1,1635,863,2498
KAMBAR SHAHDAD KOT DISTRICT,QUBO SAEED KHAN TALUKA,2,2412,1049,3461
KAMBAR SHAHDAD KOT DISTRICT,QUBO SAEED KHAN TALUKA,3,2456,1142,3598
KAMBAR SHAHDAD KOT DISTRICT,QUBO SAEED KHAN TALUKA,4,2674,1137,3811
KAMBAR SHAHDAD KOT DISTRICT,QUBO SAEED KHAN TALUKA,5,2398,1131,3529
KAMBAR SHAHDAD KOT DISTRICT,QUBO SAEED KHAN TALUKA,6,2476,1067,3543
KAMBAR SHAHDAD KOT DISTRICT,QUBO SAEED KHAN TALUKA,7,2072,1038,3110
KAMBAR SHAHDAD KOT DISTRICT,QUBO SAEED KHAN TALUKA,8,2578,1056,3634
KAMBAR SHAHDAD KOT DISTRICT,QUBO SAEED KHAN TALUKA,9,1732,905,2637
KAMBAR SHAHDAD KOT DISTRICT,QUBO SAEED KHAN TALUKA,10,2274,922,3196
KAMBAR SHAHDAD KOT DISTRICT,QUBO SAEED KHAN TALUKA,11,1321,662,1983
KAMBAR SHAHDAD KOT DISTRICT,QUBO SAEED KHAN TALUKA,12,1647,731,2378
KAMBAR SHAHDAD KOT DISTRICT,QUBO SAEED KHAN TALUKA,13,1134,614,1748
KAMBAR SHAHDAD KOT DISTRICT,QUBO SAEED KHAN TALUKA,14,1209,595,1804
KAMBAR SHAHDAD KOT DISTRICT,QUBO SAEED KHAN TALUKA,15,1246,585,1831
KAMBAR SHAHDAD KOT DISTRICT,QUBO SAEED KHAN TALUKA,16,1062,506,1568
KAMBAR SHAHDAD KOT DISTRICT,QUBO SAEED KHAN TALUKA,17,917,675,1592
KAMBAR SHAHDAD KOT DISTRICT,QUBO SAEED KHAN TALUKA,18,1098,530,1628
KAMBAR SHAHDAD KOT DISTRICT,QUBO SAEED KHAN TALUKA,19,912,469,1381
KAMBAR SHAHDAD KOT DISTRICT,QUBO SAEED KHAN TALUKA,20,1054,469,1523
KAMBAR SHAHDAD KOT DISTRICT,QUBO SAEED KHAN TALUKA,21,726,399,1125
KAMBAR SHAHDAD KOT DISTRICT,QUBO SAEED KHAN TALUKA,22,663,334,997
KAMBAR SHAHDAD KOT DISTRICT,QUBO SAEED KHAN TALUKA,23,531,314,845
KAMBAR SHAHDAD KOT DISTRICT,QUBO SAEED KHAN TALUKA,24,579,294,873
KAMBAR SHAHDAD KOT DISTRICT,QUBO SAEED KHAN TALUKA,25,725,319,1044
KAMBAR SHAHDAD KOT DISTRICT,QUBO SAEED KHAN TALUKA,26,578,318,896
KAMBAR SHAHDAD KOT DISTRICT,QUBO SAEED KHAN TALUKA,27,792,392,1184
KAMBAR SHAHDAD KOT DISTRICT,QUBO SAEED KHAN TALUKA,28,755,344,1099
KAMBAR SHAHDAD KOT DISTRICT,QUBO SAEED KHAN TALUKA,29,835,442,1277
KAMBAR SHAHDAD KOT DISTRICT,QUBO SAEED KHAN TALUKA,30,596,293,889
KAMBAR SHAHDAD KOT DISTRICT,QUBO SAEED KHAN TALUKA,31,672,413,1085
KAMBAR SHAHDAD KOT DISTRICT,QUBO SAEED KHAN TALUKA,32,768,377,1145
KAMBAR SHAHDAD KOT DISTRICT,QUBO SAEED KHAN TALUKA,33,660,311,971
KAMBAR SHAHDAD KOT DISTRICT,QUBO SAEED KHAN TALUKA,34,689,343,1032
KAMBAR SHAHDAD KOT DISTRICT,QUBO SAEED KHAN TALUKA,35,607,301,908
KAMBAR SHAHDAD KOT DISTRICT,QUBO SAEED KHAN TALUKA,36,669,346,1015
KAMBAR SHAHDAD KOT DISTRICT,QUBO SAEED KHAN TALUKA,37,891,385,1276
KAMBAR SHAHDAD KOT DISTRICT,QUBO SAEED KHAN TALUKA,38,544,247,791
KAMBAR SHAHDAD KOT DISTRICT,QUBO SAEED KHAN TALUKA,39,657,288,945
KAMBAR SHAHDAD KOT DISTRICT,QUBO SAEED KHAN TALUKA,40,373,161,534
KAMBAR SHAHDAD KOT DISTRICT,QUBO SAEED KHAN TALUKA,41,480,225,705
KAMBAR SHAHDAD KOT DISTRICT,QUBO SAEED KHAN TALUKA,42,521,255,776
KAMBAR SHAHDAD KOT DISTRICT,QUBO SAEED KHAN TALUKA,43,377,147,524
KAMBAR SHAHDAD KOT DISTRICT,QUBO SAEED KHAN TALUKA,44,310,177,487
KAMBAR SHAHDAD KOT DISTRICT,QUBO SAEED KHAN TALUKA,45,319,129,448
KAMBAR SHAHDAD KOT DISTRICT,QUBO SAEED KHAN TALUKA,46,368,179,547
KAMBAR SHAHDAD KOT DISTRICT,QUBO SAEED KHAN TALUKA,47,518,227,745
KAMBAR SHAHDAD KOT DISTRICT,QUBO SAEED KHAN TALUKA,48,309,165,474
KAMBAR SHAHDAD KOT DISTRICT,QUBO SAEED KHAN TALUKA,49,344,166,510
KAMBAR SHAHDAD KOT DISTRICT,QUBO SAEED KHAN TALUKA,50,234,108,342
KAMBAR SHAHDAD KOT DISTRICT,QUBO SAEED KHAN TALUKA,51,350,158,508
KAMBAR SHAHDAD KOT DISTRICT,QUBO SAEED KHAN TALUKA,52,367,148,515
KAMBAR SHAHDAD KOT DISTRICT,QUBO SAEED KHAN TALUKA,53,220,92,312
KAMBAR SHAHDAD KOT DISTRICT,QUBO SAEED KHAN TALUKA,54,193,89,282
KAMBAR SHAHDAD KOT DISTRICT,QUBO SAEED KHAN TALUKA,55,171,92,263
KAMBAR SHAHDAD KOT DISTRICT,QUBO SAEED KHAN TALUKA,56,246,84,330
KAMBAR SHAHDAD KOT DISTRICT,QUBO SAEED KHAN TALUKA,57,337,159,496
KAMBAR SHAHDAD KOT DISTRICT,QUBO SAEED KHAN TALUKA,58,181,107,288
KAMBAR SHAHDAD KOT DISTRICT,QUBO SAEED KHAN TALUKA,59,159,67,226
KAMBAR SHAHDAD KOT DISTRICT,QUBO SAEED KHAN TALUKA,60,171,67,238
KAMBAR SHAHDAD KOT DISTRICT,QUBO SAEED KHAN TALUKA,61,204,107,311
KAMBAR SHAHDAD KOT DISTRICT,QUBO SAEED KHAN TALUKA,62,255,141,396
KAMBAR SHAHDAD KOT DISTRICT,QUBO SAEED KHAN TALUKA,63,181,84,265
KAMBAR SHAHDAD KOT DISTRICT,QUBO SAEED KHAN TALUKA,64,180,68,248
KAMBAR SHAHDAD KOT DISTRICT,QUBO SAEED KHAN TALUKA,65,153,85,238
KAMBAR SHAHDAD KOT DISTRICT,QUBO SAEED KHAN TALUKA,66,185,73,258
KAMBAR SHAHDAD KOT DISTRICT,QUBO SAEED KHAN TALUKA,67,281,119,400
KAMBAR SHAHDAD KOT DISTRICT,QUBO SAEED KHAN TALUKA,68,134,53,187
KAMBAR SHAHDAD KOT DISTRICT,QUBO SAEED KHAN TALUKA,69,146,59,205
KAMBAR SHAHDAD KOT DISTRICT,QUBO SAEED KHAN TALUKA,70,93,41,134
KAMBAR SHAHDAD KOT DISTRICT,QUBO SAEED KHAN TALUKA,71,128,51,179
KAMBAR SHAHDAD KOT DISTRICT,QUBO SAEED KHAN TALUKA,72,120,55,175
KAMBAR SHAHDAD KOT DISTRICT,QUBO SAEED KHAN TALUKA,73,71,20,91
KAMBAR SHAHDAD KOT DISTRICT,QUBO SAEED KHAN TALUKA,74,81,27,108
KAMBAR SHAHDAD KOT DISTRICT,QUBO SAEED KHAN TALUKA,>=75,608,252,860
KAMBAR SHAHDAD KOT DISTRICT,SHAHDAD KOT TALUKA,<1,2068,2818,4886
KAMBAR SHAHDAD KOT DISTRICT,SHAHDAD KOT TALUKA,1,2610,3029,5639
KAMBAR SHAHDAD KOT DISTRICT,SHAHDAD KOT TALUKA,2,2993,3635,6628
KAMBAR SHAHDAD KOT DISTRICT,SHAHDAD KOT TALUKA,3,3270,4159,7429
KAMBAR SHAHDAD KOT DISTRICT,SHAHDAD KOT TALUKA,4,3564,4095,7659
KAMBAR SHAHDAD KOT DISTRICT,SHAHDAD KOT TALUKA,5,3278,4124,7402
KAMBAR SHAHDAD KOT DISTRICT,SHAHDAD KOT TALUKA,6,3347,3805,7152
KAMBAR SHAHDAD KOT DISTRICT,SHAHDAD KOT TALUKA,7,2791,4070,6861
KAMBAR SHAHDAD KOT DISTRICT,SHAHDAD KOT TALUKA,8,3470,3981,7451
KAMBAR SHAHDAD KOT DISTRICT,SHAHDAD KOT TALUKA,9,2523,3459,5982
KAMBAR SHAHDAD KOT DISTRICT,SHAHDAD KOT TALUKA,10,3051,3440,6491
KAMBAR SHAHDAD KOT DISTRICT,SHAHDAD KOT TALUKA,11,1903,2927,4830
KAMBAR SHAHDAD KOT DISTRICT,SHAHDAD KOT TALUKA,12,2404,2997,5401
KAMBAR SHAHDAD KOT DISTRICT,SHAHDAD KOT TALUKA,13,1779,2737,4516
KAMBAR SHAHDAD KOT DISTRICT,SHAHDAD KOT TALUKA,14,1968,2790,4758
KAMBAR SHAHDAD KOT DISTRICT,SHAHDAD KOT TALUKA,15,1799,2919,4718
KAMBAR SHAHDAD KOT DISTRICT,SHAHDAD KOT TALUKA,16,1825,2804,4629
KAMBAR SHAHDAD KOT DISTRICT,SHAHDAD KOT TALUKA,17,1503,2871,4374
KAMBAR SHAHDAD KOT DISTRICT,SHAHDAD KOT TALUKA,18,1704,2549,4253
KAMBAR SHAHDAD KOT DISTRICT,SHAHDAD KOT TALUKA,19,1362,2381,3743
KAMBAR SHAHDAD KOT DISTRICT,SHAHDAD KOT TALUKA,20,1559,2290,3849
KAMBAR SHAHDAD KOT DISTRICT,SHAHDAD KOT TALUKA,21,1171,2159,3330
KAMBAR SHAHDAD KOT DISTRICT,SHAHDAD KOT TALUKA,22,1022,1848,2870
KAMBAR SHAHDAD KOT DISTRICT,SHAHDAD KOT TALUKA,23,884,1728,2612
KAMBAR SHAHDAD KOT DISTRICT,SHAHDAD KOT TALUKA,24,897,1571,2468
KAMBAR SHAHDAD KOT DISTRICT,SHAHDAD KOT TALUKA,25,1092,1719,2811
KAMBAR SHAHDAD KOT DISTRICT,SHAHDAD KOT TALUKA,26,938,1711,2649
KAMBAR SHAHDAD KOT DISTRICT,SHAHDAD KOT TALUKA,27,1134,1743,2877
KAMBAR SHAHDAD KOT DISTRICT,SHAHDAD KOT TALUKA,28,1085,1746,2831
KAMBAR SHAHDAD KOT DISTRICT,SHAHDAD KOT TALUKA,29,1188,1899,3087
KAMBAR SHAHDAD KOT DISTRICT,SHAHDAD KOT TALUKA,30,988,1579,2567
KAMBAR SHAHDAD KOT DISTRICT,SHAHDAD KOT TALUKA,31,1074,1722,2796
KAMBAR SHAHDAD KOT DISTRICT,SHAHDAD KOT TALUKA,32,1066,1705,2771
KAMBAR SHAHDAD KOT DISTRICT,SHAHDAD KOT TALUKA,33,917,1475,2392
KAMBAR SHAHDAD KOT DISTRICT,SHAHDAD KOT TALUKA,34,983,1337,2320
KAMBAR SHAHDAD KOT DISTRICT,SHAHDAD KOT TALUKA,35,891,1323,2214
KAMBAR SHAHDAD KOT DISTRICT,SHAHDAD KOT TALUKA,36,979,1324,2303
KAMBAR SHAHDAD KOT DISTRICT,SHAHDAD KOT TALUKA,37,1023,1558,2581
KAMBAR SHAHDAD KOT DISTRICT,SHAHDAD KOT TALUKA,38,764,1206,1970
KAMBAR SHAHDAD KOT DISTRICT,SHAHDAD KOT TALUKA,39,830,1404,2234
KAMBAR SHAHDAD KOT DISTRICT,SHAHDAD KOT TALUKA,40,724,1002,1726
KAMBAR SHAHDAD KOT DISTRICT,SHAHDAD KOT TALUKA,41,753,1069,1822
KAMBAR SHAHDAD KOT DISTRICT,SHAHDAD KOT TALUKA,42,721,1115,1836
KAMBAR SHAHDAD KOT DISTRICT,SHAHDAD KOT TALUKA,43,543,879,1422
KAMBAR SHAHDAD KOT DISTRICT,SHAHDAD KOT TALUKA,44,549,831,1380
KAMBAR SHAHDAD KOT DISTRICT,SHAHDAD KOT TALUKA,45,478,793,1271
KAMBAR SHAHDAD KOT DISTRICT,SHAHDAD KOT TALUKA,46,607,733,1340
KAMBAR SHAHDAD KOT DISTRICT,SHAHDAD KOT TALUKA,47,634,978,1612
KAMBAR SHAHDAD KOT DISTRICT,SHAHDAD KOT TALUKA,48,510,716,1226
KAMBAR SHAHDAD KOT DISTRICT,SHAHDAD KOT TALUKA,49,523,769,1292
KAMBAR SHAHDAD KOT DISTRICT,SHAHDAD KOT TALUKA,50,452,655,1107
KAMBAR SHAHDAD KOT DISTRICT,SHAHDAD KOT TALUKA,51,557,714,1271
KAMBAR SHAHDAD KOT DISTRICT,SHAHDAD KOT TALUKA,52,450,757,1207
KAMBAR SHAHDAD KOT DISTRICT,SHAHDAD KOT TALUKA,53,325,544,869
KAMBAR SHAHDAD KOT DISTRICT,SHAHDAD KOT TALUKA,54,348,560,908
KAMBAR SHAHDAD KOT DISTRICT,SHAHDAD KOT TALUKA,55,334,485,819
KAMBAR SHAHDAD KOT DISTRICT,SHAHDAD KOT TALUKA,56,413,526,939
KAMBAR SHAHDAD KOT DISTRICT,SHAHDAD KOT TALUKA,57,456,617,1073
KAMBAR SHAHDAD KOT DISTRICT,SHAHDAD KOT TALUKA,58,258,405,663
KAMBAR SHAHDAD KOT DISTRICT,SHAHDAD KOT TALUKA,59,276,431,707
KAMBAR SHAHDAD KOT DISTRICT,SHAHDAD KOT TALUKA,60,280,370,650
KAMBAR SHAHDAD KOT DISTRICT,SHAHDAD KOT TALUKA,61,300,461,761
KAMBAR SHAHDAD KOT DISTRICT,SHAHDAD KOT TALUKA,62,379,513,892
KAMBAR SHAHDAD KOT DISTRICT,SHAHDAD KOT TALUKA,63,245,399,644
KAMBAR SHAHDAD KOT DISTRICT,SHAHDAD KOT TALUKA,64,204,367,571
KAMBAR SHAHDAD KOT DISTRICT,SHAHDAD KOT TALUKA,65,220,299,519
KAMBAR SHAHDAD KOT DISTRICT,SHAHDAD KOT TALUKA,66,225,334,559
KAMBAR SHAHDAD KOT DISTRICT,SHAHDAD KOT TALUKA,67,248,399,647
KAMBAR SHAHDAD KOT DISTRICT,SHAHDAD KOT TALUKA,68,171,260,431
KAMBAR SHAHDAD KOT DISTRICT,SHAHDAD KOT TALUKA,69,170,264,434
KAMBAR SHAHDAD KOT DISTRICT,SHAHDAD KOT TALUKA,70,128,186,314
KAMBAR SHAHDAD KOT DISTRICT,SHAHDAD KOT TALUKA,71,178,192,370
KAMBAR SHAHDAD KOT DISTRICT,SHAHDAD KOT TALUKA,72,153,203,356
KAMBAR SHAHDAD KOT DISTRICT,SHAHDAD KOT TALUKA,73,114,154,268
KAMBAR SHAHDAD KOT DISTRICT,SHAHDAD KOT TALUKA,74,109,138,247
KAMBAR SHAHDAD KOT DISTRICT,SHAHDAD KOT TALUKA,>=75,897,1180,2077
KAMBAR SHAHDAD KOT DISTRICT,SUJAWAL JUNEJO TALUKA,<1,3001,0,3001
KAMBAR SHAHDAD KOT DISTRICT,SUJAWAL JUNEJO TALUKA,1,3068,0,3068
KAMBAR SHAHDAD KOT DISTRICT,SUJAWAL JUNEJO TALUKA,2,4319,0,4319
KAMBAR SHAHDAD KOT DISTRICT,SUJAWAL JUNEJO TALUKA,3,4527,0,4527
KAMBAR SHAHDAD KOT DISTRICT,SUJAWAL JUNEJO TALUKA,4,4676,0,4676
KAMBAR SHAHDAD KOT DISTRICT,SUJAWAL JUNEJO TALUKA,5,4726,0,4726
KAMBAR SHAHDAD KOT DISTRICT,SUJAWAL JUNEJO TALUKA,6,4583,0,4583
KAMBAR SHAHDAD KOT DISTRICT,SUJAWAL JUNEJO TALUKA,7,4320,0,4320
KAMBAR SHAHDAD KOT DISTRICT,SUJAWAL JUNEJO TALUKA,8,4810,0,4810
KAMBAR SHAHDAD KOT DISTRICT,SUJAWAL JUNEJO TALUKA,9,3739,0,3739
KAMBAR SHAHDAD KOT DISTRICT,SUJAWAL JUNEJO TALUKA,10,4136,0,4136
KAMBAR SHAHDAD KOT DISTRICT,SUJAWAL JUNEJO TALUKA,11,2811,0,2811
KAMBAR SHAHDAD KOT DISTRICT,SUJAWAL JUNEJO TALUKA,12,3256,0,3256
KAMBAR SHAHDAD KOT DISTRICT,SUJAWAL JUNEJO TALUKA,13,2375,0,2375
KAMBAR SHAHDAD KOT DISTRICT,SUJAWAL JUNEJO TALUKA,14,2599,0,2599
KAMBAR SHAHDAD KOT DISTRICT,SUJAWAL JUNEJO TALUKA,15,2514,0,2514
KAMBAR SHAHDAD KOT DISTRICT,SUJAWAL JUNEJO TALUKA,16,2552,0,2552
KAMBAR SHAHDAD KOT DISTRICT,SUJAWAL JUNEJO TALUKA,17,2396,0,2396
KAMBAR SHAHDAD KOT DISTRICT,SUJAWAL JUNEJO TALUKA,18,2673,0,2673
KAMBAR SHAHDAD KOT DISTRICT,SUJAWAL JUNEJO TALUKA,19,2058,0,2058
KAMBAR SHAHDAD KOT DISTRICT,SUJAWAL JUNEJO TALUKA,20,2286,0,2286
KAMBAR SHAHDAD KOT DISTRICT,SUJAWAL JUNEJO TALUKA,21,1662,0,1662
KAMBAR SHAHDAD KOT DISTRICT,SUJAWAL JUNEJO TALUKA,22,1696,0,1696
KAMBAR SHAHDAD KOT DISTRICT,SUJAWAL JUNEJO TALUKA,23,1436,0,1436
KAMBAR SHAHDAD KOT DISTRICT,SUJAWAL JUNEJO TALUKA,24,1384,0,1384
KAMBAR SHAHDAD KOT DISTRICT,SUJAWAL JUNEJO TALUKA,25,1708,0,1708
KAMBAR SHAHDAD KOT DISTRICT,SUJAWAL JUNEJO TALUKA,26,1307,0,1307
KAMBAR SHAHDAD KOT DISTRICT,SUJAWAL JUNEJO TALUKA,27,1490,0,1490
KAMBAR SHAHDAD KOT DISTRICT,SUJAWAL JUNEJO TALUKA,28,1555,0,1555
KAMBAR SHAHDAD KOT DISTRICT,SUJAWAL JUNEJO TALUKA,29,1692,0,1692
KAMBAR SHAHDAD KOT DISTRICT,SUJAWAL JUNEJO TALUKA,30,1540,0,1540
KAMBAR SHAHDAD KOT DISTRICT,SUJAWAL JUNEJO TALUKA,31,1435,0,1435
KAMBAR SHAHDAD KOT DISTRICT,SUJAWAL JUNEJO TALUKA,32,1452,0,1452
KAMBAR SHAHDAD KOT DISTRICT,SUJAWAL JUNEJO TALUKA,33,1381,0,1381
KAMBAR SHAHDAD KOT DISTRICT,SUJAWAL JUNEJO TALUKA,34,1185,0,1185
KAMBAR SHAHDAD KOT DISTRICT,SUJAWAL JUNEJO TALUKA,35,1404,0,1404
KAMBAR SHAHDAD KOT DISTRICT,SUJAWAL JUNEJO TALUKA,36,1135,0,1135
KAMBAR SHAHDAD KOT DISTRICT,SUJAWAL JUNEJO TALUKA,37,1439,0,1439
KAMBAR SHAHDAD KOT DISTRICT,SUJAWAL JUNEJO TALUKA,38,1057,0,1057
KAMBAR SHAHDAD KOT DISTRICT,SUJAWAL JUNEJO TALUKA,39,1216,0,1216
KAMBAR SHAHDAD KOT DISTRICT,SUJAWAL JUNEJO TALUKA,40,1079,0,1079
KAMBAR SHAHDAD KOT DISTRICT,SUJAWAL JUNEJO TALUKA,41,877,0,877
KAMBAR SHAHDAD KOT DISTRICT,SUJAWAL JUNEJO TALUKA,42,1044,0,1044
KAMBAR SHAHDAD KOT DISTRICT,SUJAWAL JUNEJO TALUKA,43,794,0,794
KAMBAR SHAHDAD KOT DISTRICT,SUJAWAL JUNEJO TALUKA,44,752,0,752
KAMBAR SHAHDAD KOT DISTRICT,SUJAWAL JUNEJO TALUKA,45,791,0,791
KAMBAR SHAHDAD KOT DISTRICT,SUJAWAL JUNEJO TALUKA,46,661,0,661
KAMBAR SHAHDAD KOT DISTRICT,SUJAWAL JUNEJO TALUKA,47,861,0,861
KAMBAR SHAHDAD KOT DISTRICT,SUJAWAL JUNEJO TALUKA,48,659,0,659
KAMBAR SHAHDAD KOT DISTRICT,SUJAWAL JUNEJO TALUKA,49,691,0,691
KAMBAR SHAHDAD KOT DISTRICT,SUJAWAL JUNEJO TALUKA,50,671,0,671
KAMBAR SHAHDAD KOT DISTRICT,SUJAWAL JUNEJO TALUKA,51,636,0,636
KAMBAR SHAHDAD KOT DISTRICT,SUJAWAL JUNEJO TALUKA,52,631,0,631
KAMBAR SHAHDAD KOT DISTRICT,SUJAWAL JUNEJO TALUKA,53,508,0,508
KAMBAR SHAHDAD KOT DISTRICT,SUJAWAL JUNEJO TALUKA,54,416,0,416
KAMBAR SHAHDAD KOT DISTRICT,SUJAWAL JUNEJO TALUKA,55,473,0,473
KAMBAR SHAHDAD KOT DISTRICT,SUJAWAL JUNEJO TALUKA,56,420,0,420
KAMBAR SHAHDAD KOT DISTRICT,SUJAWAL JUNEJO TALUKA,57,611,0,611
KAMBAR SHAHDAD KOT DISTRICT,SUJAWAL JUNEJO TALUKA,58,347,0,347
KAMBAR SHAHDAD KOT DISTRICT,SUJAWAL JUNEJO TALUKA,59,393,0,393
KAMBAR SHAHDAD KOT DISTRICT,SUJAWAL JUNEJO TALUKA,60,443,0,443
KAMBAR SHAHDAD KOT DISTRICT,SUJAWAL JUNEJO TALUKA,61,393,0,393
KAMBAR SHAHDAD KOT DISTRICT,SUJAWAL JUNEJO TALUKA,62,460,0,460
KAMBAR SHAHDAD KOT DISTRICT,SUJAWAL JUNEJO TALUKA,63,337,0,337
KAMBAR SHAHDAD KOT DISTRICT,SUJAWAL JUNEJO TALUKA,64,368,0,368
KAMBAR SHAHDAD KOT DISTRICT,SUJAWAL JUNEJO TALUKA,65,352,0,352
KAMBAR SHAHDAD KOT DISTRICT,SUJAWAL JUNEJO TALUKA,66,307,0,307
KAMBAR SHAHDAD KOT DISTRICT,SUJAWAL JUNEJO TALUKA,67,281,0,281
KAMBAR SHAHDAD KOT DISTRICT,SUJAWAL JUNEJO TALUKA,68,240,0,240
KAMBAR SHAHDAD KOT DISTRICT,SUJAWAL JUNEJO TALUKA,69,233,0,233
KAMBAR SHAHDAD KOT DISTRICT,SUJAWAL JUNEJO TALUKA,70,242,0,242
KAMBAR SHAHDAD KOT DISTRICT,SUJAWAL JUNEJO TALUKA,71,207,0,207
KAMBAR SHAHDAD KOT DISTRICT,SUJAWAL JUNEJO TALUKA,72,199,0,199
KAMBAR SHAHDAD KOT DISTRICT,SUJAWAL JUNEJO TALUKA,73,143,0,143
KAMBAR SHAHDAD KOT DISTRICT,SUJAWAL JUNEJO TALUKA,74,162,0,162
KAMBAR SHAHDAD KOT DISTRICT,SUJAWAL JUNEJO TALUKA,>=75,1186,0,1186
KAMBAR SHAHDAD KOT DISTRICT,WARAH TALUKA,<1,3774,1566,5340
KAMBAR SHAHDAD KOT DISTRICT,WARAH TALUKA,1,4300,1726,6026
KAMBAR SHAHDAD KOT DISTRICT,WARAH TALUKA,2,5721,2236,7957
KAMBAR SHAHDAD KOT DISTRICT,WARAH TALUKA,3,6376,2510,8886
KAMBAR SHAHDAD KOT DISTRICT,WARAH TALUKA,4,6479,2624,9103
KAMBAR SHAHDAD KOT DISTRICT,WARAH TALUKA,5,6511,2557,9068
KAMBAR SHAHDAD KOT DISTRICT,WARAH TALUKA,6,6465,2585,9050
KAMBAR SHAHDAD KOT DISTRICT,WARAH TALUKA,7,5474,2226,7700
KAMBAR SHAHDAD KOT DISTRICT,WARAH TALUKA,8,6501,2610,9111
KAMBAR SHAHDAD KOT DISTRICT,WARAH TALUKA,9,4904,1957,6861
KAMBAR SHAHDAD KOT DISTRICT,WARAH TALUKA,10,5585,2324,7909
KAMBAR SHAHDAD KOT DISTRICT,WARAH TALUKA,11,3699,1554,5253
KAMBAR SHAHDAD KOT DISTRICT,WARAH TALUKA,12,4217,1760,5977
KAMBAR SHAHDAD KOT DISTRICT,WARAH TALUKA,13,3447,1501,4948
KAMBAR SHAHDAD KOT DISTRICT,WARAH TALUKA,14,3470,1484,4954
KAMBAR SHAHDAD KOT DISTRICT,WARAH TALUKA,15,3510,1623,5133
KAMBAR SHAHDAD KOT DISTRICT,WARAH TALUKA,16,3292,1486,4778
KAMBAR SHAHDAD KOT DISTRICT,WARAH TALUKA,17,2884,1372,4256
KAMBAR SHAHDAD KOT DISTRICT,WARAH TALUKA,18,3526,1464,4990
KAMBAR SHAHDAD KOT DISTRICT,WARAH TALUKA,19,2653,1137,3790
KAMBAR SHAHDAD KOT DISTRICT,WARAH TALUKA,20,3126,1280,4406
KAMBAR SHAHDAD KOT DISTRICT,WARAH TALUKA,21,2303,1048,3351
KAMBAR SHAHDAD KOT DISTRICT,WARAH TALUKA,22,2442,1016,3458
KAMBAR SHAHDAD KOT DISTRICT,WARAH TALUKA,23,2136,959,3095
KAMBAR SHAHDAD KOT DISTRICT,WARAH TALUKA,24,1934,903,2837
KAMBAR SHAHDAD KOT DISTRICT,WARAH TALUKA,25,2331,1116,3447
KAMBAR SHAHDAD KOT DISTRICT,WARAH TALUKA,26,2014,884,2898
KAMBAR SHAHDAD KOT DISTRICT,WARAH TALUKA,27,2194,1015,3209
KAMBAR SHAHDAD KOT DISTRICT,WARAH TALUKA,28,2194,954,3148
KAMBAR SHAHDAD KOT DISTRICT,WARAH TALUKA,29,2173,1120,3293
KAMBAR SHAHDAD KOT DISTRICT,WARAH TALUKA,30,1958,846,2804
KAMBAR SHAHDAD KOT DISTRICT,WARAH TALUKA,31,2115,890,3005
KAMBAR SHAHDAD KOT DISTRICT,WARAH TALUKA,32,2021,952,2973
KAMBAR SHAHDAD KOT DISTRICT,WARAH TALUKA,33,1762,860,2622
KAMBAR SHAHDAD KOT DISTRICT,WARAH TALUKA,34,1650,716,2366
KAMBAR SHAHDAD KOT DISTRICT,WARAH TALUKA,35,1641,798,2439
KAMBAR SHAHDAD KOT DISTRICT,WARAH TALUKA,36,1693,687,2380
KAMBAR SHAHDAD KOT DISTRICT,WARAH TALUKA,37,2021,1079,3100
KAMBAR SHAHDAD KOT DISTRICT,WARAH TALUKA,38,1540,664,2204
KAMBAR SHAHDAD KOT DISTRICT,WARAH TALUKA,39,1648,778,2426
KAMBAR SHAHDAD KOT DISTRICT,WARAH TALUKA,40,1314,630,1944
KAMBAR SHAHDAD KOT DISTRICT,WARAH TALUKA,41,1338,572,1910
KAMBAR SHAHDAD KOT DISTRICT,WARAH TALUKA,42,1373,652,2025
KAMBAR SHAHDAD KOT DISTRICT,WARAH TALUKA,43,1123,489,1612
KAMBAR SHAHDAD KOT DISTRICT,WARAH TALUKA,44,1022,489,1511
KAMBAR SHAHDAD KOT DISTRICT,WARAH TALUKA,45,991,466,1457
KAMBAR SHAHDAD KOT DISTRICT,WARAH TALUKA,46,1086,371,1457
KAMBAR SHAHDAD KOT DISTRICT,WARAH TALUKA,47,1304,634,1938
KAMBAR SHAHDAD KOT DISTRICT,WARAH TALUKA,48,1046,385,1431
KAMBAR SHAHDAD KOT DISTRICT,WARAH TALUKA,49,984,527,1511
KAMBAR SHAHDAD KOT DISTRICT,WARAH TALUKA,50,848,394,1242
KAMBAR SHAHDAD KOT DISTRICT,WARAH TALUKA,51,901,436,1337
KAMBAR SHAHDAD KOT DISTRICT,WARAH TALUKA,52,904,461,1365
KAMBAR SHAHDAD KOT DISTRICT,WARAH TALUKA,53,673,334,1007
KAMBAR SHAHDAD KOT DISTRICT,WARAH TALUKA,54,602,313,915
KAMBAR SHAHDAD KOT DISTRICT,WARAH TALUKA,55,623,324,947
KAMBAR SHAHDAD KOT DISTRICT,WARAH TALUKA,56,626,292,918
KAMBAR SHAHDAD KOT DISTRICT,WARAH TALUKA,57,824,409,1233
KAMBAR SHAHDAD KOT DISTRICT,WARAH TALUKA,58,553,268,821
KAMBAR SHAHDAD KOT DISTRICT,WARAH TALUKA,59,573,268,841
KAMBAR SHAHDAD KOT DISTRICT,WARAH TALUKA,60,489,252,741
KAMBAR SHAHDAD KOT DISTRICT,WARAH TALUKA,61,592,247,839
KAMBAR SHAHDAD KOT DISTRICT,WARAH TALUKA,62,709,335,1044
KAMBAR SHAHDAD KOT DISTRICT,WARAH TALUKA,63,522,217,739
KAMBAR SHAHDAD KOT DISTRICT,WARAH TALUKA,64,545,210,755
KAMBAR SHAHDAD KOT DISTRICT,WARAH TALUKA,65,431,205,636
KAMBAR SHAHDAD KOT DISTRICT,WARAH TALUKA,66,457,176,633
KAMBAR SHAHDAD KOT DISTRICT,WARAH TALUKA,67,503,247,750
KAMBAR SHAHDAD KOT DISTRICT,WARAH TALUKA,68,339,145,484
KAMBAR SHAHDAD KOT DISTRICT,WARAH TALUKA,69,299,159,458
KAMBAR SHAHDAD KOT DISTRICT,WARAH TALUKA,70,275,119,394
KAMBAR SHAHDAD KOT DISTRICT,WARAH TALUKA,71,276,146,422
KAMBAR SHAHDAD KOT DISTRICT,WARAH TALUKA,72,314,159,473
KAMBAR SHAHDAD KOT DISTRICT,WARAH TALUKA,73,229,99,328
KAMBAR SHAHDAD KOT DISTRICT,WARAH TALUKA,74,199,104,303
KAMBAR SHAHDAD KOT DISTRICT,WARAH TALUKA,>=75,1804,743,2547
KARACHI CENTRAL DISTRICT,GULBERG SUB-DIVISION,<1,0,8925,8925
KARACHI CENTRAL DISTRICT,GULBERG SUB-DIVISION,1,0,9249,9249
KARACHI CENTRAL DISTRICT,GULBERG SUB-DIVISION,2,0,8747,8747
KARACHI CENTRAL DISTRICT,GULBERG SUB-DIVISION,3,0,9817,9817
KARACHI CENTRAL DISTRICT,GULBERG SUB-DIVISION,4,0,9197,9197
KARACHI CENTRAL DISTRICT,GULBERG SUB-DIVISION,5,0,9499,9499
KARACHI CENTRAL DISTRICT,GULBERG SUB-DIVISION,6,0,9616,9616
KARACHI CENTRAL DISTRICT,GULBERG SUB-DIVISION,7,0,10142,10142
KARACHI CENTRAL DISTRICT,GULBERG SUB-DIVISION,8,0,9036,9036
KARACHI CENTRAL DISTRICT,GULBERG SUB-DIVISION,9,0,10553,10553
KARACHI CENTRAL DISTRICT,GULBERG SUB-DIVISION,10,0,8681,8681
KARACHI CENTRAL DISTRICT,GULBERG SUB-DIVISION,11,0,10880,10880
KARACHI CENTRAL DISTRICT,GULBERG SUB-DIVISION,12,0,8504,8504
KARACHI CENTRAL DISTRICT,GULBERG SUB-DIVISION,13,0,9563,9563
KARACHI CENTRAL DISTRICT,GULBERG SUB-DIVISION,14,0,8523,8523
KARACHI CENTRAL DISTRICT,GULBERG SUB-DIVISION,15,0,8891,8891
KARACHI CENTRAL DISTRICT,GULBERG SUB-DIVISION,16,0,9460,9460
KARACHI CENTRAL DISTRICT,GULBERG SUB-DIVISION,17,0,10405,10405
KARACHI CENTRAL DISTRICT,GULBERG SUB-DIVISION,18,0,8120,8120
KARACHI CENTRAL DISTRICT,GULBERG SUB-DIVISION,19,0,10262,10262
KARACHI CENTRAL DISTRICT,GULBERG SUB-DIVISION,20,0,8307,8307
KARACHI CENTRAL DISTRICT,GULBERG SUB-DIVISION,21,0,10797,10797
KARACHI CENTRAL DISTRICT,GULBERG SUB-DIVISION,22,0,8814,8814
KARACHI CENTRAL DISTRICT,GULBERG SUB-DIVISION,23,0,9328,9328
KARACHI CENTRAL DISTRICT,GULBERG SUB-DIVISION,24,0,9284,9284
KARACHI CENTRAL DISTRICT,GULBERG SUB-DIVISION,25,0,6969,6969
KARACHI CENTRAL DISTRICT,GULBERG SUB-DIVISION,26,0,9233,9233
KARACHI CENTRAL DISTRICT,GULBERG SUB-DIVISION,27,0,8696,8696
KARACHI CENTRAL DISTRICT,GULBERG SUB-DIVISION,28,0,7909,7909
KARACHI CENTRAL DISTRICT,GULBERG SUB-DIVISION,29,0,8501,8501
KARACHI CENTRAL DISTRICT,GULBERG SUB-DIVISION,30,0,6993,6993
KARACHI CENTRAL DISTRICT,GULBERG SUB-DIVISION,31,0,8772,8772
KARACHI CENTRAL DISTRICT,GULBERG SUB-DIVISION,32,0,8264,8264
KARACHI CENTRAL DISTRICT,GULBERG SUB-DIVISION,33,0,8045,8045
KARACHI CENTRAL DISTRICT,GULBERG SUB-DIVISION,34,0,7983,7983
KARACHI CENTRAL DISTRICT,GULBERG SUB-DIVISION,35,0,5872,5872
KARACHI CENTRAL DISTRICT,GULBERG SUB-DIVISION,36,0,7633,7633
KARACHI CENTRAL DISTRICT,GULBERG SUB-DIVISION,37,0,6866,6866
KARACHI CENTRAL DISTRICT,GULBERG SUB-DIVISION,38,0,7393,7393
KARACHI CENTRAL DISTRICT,GULBERG SUB-DIVISION,39,0,7331,7331
KARACHI CENTRAL DISTRICT,GULBERG SUB-DIVISION,40,0,5920,5920
KARACHI CENTRAL DISTRICT,GULBERG SUB-DIVISION,41,0,6954,6954
KARACHI CENTRAL DISTRICT,GULBERG SUB-DIVISION,42,0,6512,6512
KARACHI CENTRAL DISTRICT,GULBERG SUB-DIVISION,43,0,6576,6576
KARACHI CENTRAL DISTRICT,GULBERG SUB-DIVISION,44,0,6271,6271
KARACHI CENTRAL DISTRICT,GULBERG SUB-DIVISION,45,0,4523,4523
KARACHI CENTRAL DISTRICT,GULBERG SUB-DIVISION,46,0,5744,5744
KARACHI CENTRAL DISTRICT,GULBERG SUB-DIVISION,47,0,4881,4881
KARACHI CENTRAL DISTRICT,GULBERG SUB-DIVISION,48,0,5697,5697
KARACHI CENTRAL DISTRICT,GULBERG SUB-DIVISION,49,0,5470,5470
KARACHI CENTRAL DISTRICT,GULBERG SUB-DIVISION,50,0,4400,4400
KARACHI CENTRAL DISTRICT,GULBERG SUB-DIVISION,51,0,5628,5628
KARACHI CENTRAL DISTRICT,GULBERG SUB-DIVISION,52,0,5396,5396
KARACHI CENTRAL DISTRICT,GULBERG SUB-DIVISION,53,0,5208,5208
KARACHI CENTRAL DISTRICT,GULBERG SUB-DIVISION,54,0,5043,5043
KARACHI CENTRAL DISTRICT,GULBERG SUB-DIVISION,55,0,3611,3611
KARACHI CENTRAL DISTRICT,GULBERG SUB-DIVISION,56,0,4413,4413
KARACHI CENTRAL DISTRICT,GULBERG SUB-DIVISION,57,0,3729,3729
KARACHI CENTRAL DISTRICT,GULBERG SUB-DIVISION,58,0,4064,4064
KARACHI CENTRAL DISTRICT,GULBERG SUB-DIVISION,59,0,3686,3686
KARACHI CENTRAL DISTRICT,GULBERG SUB-DIVISION,60,0,2656,2656
KARACHI CENTRAL DISTRICT,GULBERG SUB-DIVISION,61,0,3414,3414
KARACHI CENTRAL DISTRICT,GULBERG SUB-DIVISION,62,0,3632,3632
KARACHI CENTRAL DISTRICT,GULBERG SUB-DIVISION,63,0,3330,3330
KARACHI CENTRAL DISTRICT,GULBERG SUB-DIVISION,64,0,2942,2942
KARACHI CENTRAL DISTRICT,GULBERG SUB-DIVISION,65,0,2114,2114
KARACHI CENTRAL DISTRICT,GULBERG SUB-DIVISION,66,0,2202,2202
KARACHI CENTRAL DISTRICT,GULBERG SUB-DIVISION,67,0,1954,1954
KARACHI CENTRAL DISTRICT,GULBERG SUB-DIVISION,68,0,2019,2019
KARACHI CENTRAL DISTRICT,GULBERG SUB-DIVISION,69,0,1920,1920
KARACHI CENTRAL DISTRICT,GULBERG SUB-DIVISION,70,0,1337,1337
KARACHI CENTRAL DISTRICT,GULBERG SUB-DIVISION,71,0,1656,1656
KARACHI CENTRAL DISTRICT,GULBERG SUB-DIVISION,72,0,1568,1568
KARACHI CENTRAL DISTRICT,GULBERG SUB-DIVISION,73,0,1447,1447
KARACHI CENTRAL DISTRICT,GULBERG SUB-DIVISION,74,0,1273,1273
KARACHI CENTRAL DISTRICT,GULBERG SUB-DIVISION,>=75,0,7844,7844
KARACHI CENTRAL DISTRICT,LIAQUATABAD SUB-DIVISION,<1,0,8802,8802
KARACHI CENTRAL DISTRICT,LIAQUATABAD SUB-DIVISION,1,0,8893,8893
KARACHI CENTRAL DISTRICT,LIAQUATABAD SUB-DIVISION,2,0,9059,9059
KARACHI CENTRAL DISTRICT,LIAQUATABAD SUB-DIVISION,3,0,9910,9910
KARACHI CENTRAL DISTRICT,LIAQUATABAD SUB-DIVISION,4,0,9217,9217
KARACHI CENTRAL DISTRICT,LIAQUATABAD SUB-DIVISION,5,0,9520,9520
KARACHI CENTRAL DISTRICT,LIAQUATABAD SUB-DIVISION,6,0,9309,9309
KARACHI CENTRAL DISTRICT,LIAQUATABAD SUB-DIVISION,7,0,9900,9900
KARACHI CENTRAL DISTRICT,LIAQUATABAD SUB-DIVISION,8,0,8352,8352
KARACHI CENTRAL DISTRICT,LIAQUATABAD SUB-DIVISION,9,0,10010,10010
KARACHI CENTRAL DISTRICT,LIAQUATABAD SUB-DIVISION,10,0,7997,7997
KARACHI CENTRAL DISTRICT,LIAQUATABAD SUB-DIVISION,11,0,10152,10152
KARACHI CENTRAL DISTRICT,LIAQUATABAD SUB-DIVISION,12,0,8192,8192
KARACHI CENTRAL DISTRICT,LIAQUATABAD SUB-DIVISION,13,0,8977,8977
KARACHI CENTRAL DISTRICT,LIAQUATABAD SUB-DIVISION,14,0,8177,8177
KARACHI CENTRAL DISTRICT,LIAQUATABAD SUB-DIVISION,15,0,8533,8533
KARACHI CENTRAL DISTRICT,LIAQUATABAD SUB-DIVISION,16,0,9052,9052
KARACHI CENTRAL DISTRICT,LIAQUATABAD SUB-DIVISION,17,0,9895,9895
KARACHI CENTRAL DISTRICT,LIAQUATABAD SUB-DIVISION,18,0,8188,8188
KARACHI CENTRAL DISTRICT,LIAQUATABAD SUB-DIVISION,19,0,9488,9488
KARACHI CENTRAL DISTRICT,LIAQUATABAD SUB-DIVISION,20,0,8078,8078
KARACHI CENTRAL DISTRICT,LIAQUATABAD SUB-DIVISION,21,0,9844,9844
KARACHI CENTRAL DISTRICT,LIAQUATABAD SUB-DIVISION,22,0,8768,8768
KARACHI CENTRAL DISTRICT,LIAQUATABAD SUB-DIVISION,23,0,8988,8988
KARACHI CENTRAL DISTRICT,LIAQUATABAD SUB-DIVISION,24,0,8985,8985
KARACHI CENTRAL DISTRICT,LIAQUATABAD SUB-DIVISION,25,0,7437,7437
KARACHI CENTRAL DISTRICT,LIAQUATABAD SUB-DIVISION,26,0,8780,8780
KARACHI CENTRAL DISTRICT,LIAQUATABAD SUB-DIVISION,27,0,8355,8355
KARACHI CENTRAL DISTRICT,LIAQUATABAD SUB-DIVISION,28,0,8298,8298
KARACHI CENTRAL DISTRICT,LIAQUATABAD SUB-DIVISION,29,0,8267,8267
KARACHI CENTRAL DISTRICT,LIAQUATABAD SUB-DIVISION,30,0,7462,7462
KARACHI CENTRAL DISTRICT,LIAQUATABAD SUB-DIVISION,31,0,8525,8525
KARACHI CENTRAL DISTRICT,LIAQUATABAD SUB-DIVISION,32,0,8020,8020
KARACHI CENTRAL DISTRICT,LIAQUATABAD SUB-DIVISION,33,0,7728,7728
KARACHI CENTRAL DISTRICT,LIAQUATABAD SUB-DIVISION,34,0,7378,7378
KARACHI CENTRAL DISTRICT,LIAQUATABAD SUB-DIVISION,35,0,6114,6114
KARACHI CENTRAL DISTRICT,LIAQUATABAD SUB-DIVISION,36,0,6825,6825
KARACHI CENTRAL DISTRICT,LIAQUATABAD SUB-DIVISION,37,0,6285,6285
KARACHI CENTRAL DISTRICT,LIAQUATABAD SUB-DIVISION,38,0,7201,7201
KARACHI CENTRAL DISTRICT,LIAQUATABAD SUB-DIVISION,39,0,6538,6538
KARACHI CENTRAL DISTRICT,LIAQUATABAD SUB-DIVISION,40,0,5632,5632
KARACHI CENTRAL DISTRICT,LIAQUATABAD SUB-DIVISION,41,0,5973,5973
KARACHI CENTRAL DISTRICT,LIAQUATABAD SUB-DIVISION,42,0,5478,5478
KARACHI CENTRAL DISTRICT,LIAQUATABAD SUB-DIVISION,43,0,5367,5367
KARACHI CENTRAL DISTRICT,LIAQUATABAD SUB-DIVISION,44,0,5042,5042
KARACHI CENTRAL DISTRICT,LIAQUATABAD SUB-DIVISION,45,0,4247,4247
KARACHI CENTRAL DISTRICT,LIAQUATABAD SUB-DIVISION,46,0,4443,4443
KARACHI CENTRAL DISTRICT,LIAQUATABAD SUB-DIVISION,47,0,4051,4051
KARACHI CENTRAL DISTRICT,LIAQUATABAD SUB-DIVISION,48,0,4533,4533
KARACHI CENTRAL DISTRICT,LIAQUATABAD SUB-DIVISION,49,0,4646,4646
KARACHI CENTRAL DISTRICT,LIAQUATABAD SUB-DIVISION,50,0,3944,3944
KARACHI CENTRAL DISTRICT,LIAQUATABAD SUB-DIVISION,51,0,4546,4546
KARACHI CENTRAL DISTRICT,LIAQUATABAD SUB-DIVISION,52,0,4154,4154
KARACHI CENTRAL DISTRICT,LIAQUATABAD SUB-DIVISION,53,0,4191,4191
KARACHI CENTRAL DISTRICT,LIAQUATABAD SUB-DIVISION,54,0,3729,3729
KARACHI CENTRAL DISTRICT,LIAQUATABAD SUB-DIVISION,55,0,2872,2872
KARACHI CENTRAL DISTRICT,LIAQUATABAD SUB-DIVISION,56,0,3051,3051
KARACHI CENTRAL DISTRICT,LIAQUATABAD SUB-DIVISION,57,0,2808,2808
KARACHI CENTRAL DISTRICT,LIAQUATABAD SUB-DIVISION,58,0,2740,2740
KARACHI CENTRAL DISTRICT,LIAQUATABAD SUB-DIVISION,59,0,2629,2629
KARACHI CENTRAL DISTRICT,LIAQUATABAD SUB-DIVISION,60,0,1898,1898
KARACHI CENTRAL DISTRICT,LIAQUATABAD SUB-DIVISION,61,0,2518,2518
KARACHI CENTRAL DISTRICT,LIAQUATABAD SUB-DIVISION,62,0,2392,2392
KARACHI CENTRAL DISTRICT,LIAQUATABAD SUB-DIVISION,63,0,2202,2202
KARACHI CENTRAL DISTRICT,LIAQUATABAD SUB-DIVISION,64,0,1856,1856
KARACHI CENTRAL DISTRICT,LIAQUATABAD SUB-DIVISION,65,0,1348,1348
KARACHI CENTRAL DISTRICT,LIAQUATABAD SUB-DIVISION,66,0,1388,1388
KARACHI CENTRAL DISTRICT,LIAQUATABAD SUB-DIVISION,67,0,1148,1148
KARACHI CENTRAL DISTRICT,LIAQUATABAD SUB-DIVISION,68,0,1269,1269
KARACHI CENTRAL DISTRICT,LIAQUATABAD SUB-DIVISION,69,0,1227,1227
KARACHI CENTRAL DISTRICT,LIAQUATABAD SUB-DIVISION,70,0,824,824
KARACHI CENTRAL DISTRICT,LIAQUATABAD SUB-DIVISION,71,0,979,979
KARACHI CENTRAL DISTRICT,LIAQUATABAD SUB-DIVISION,72,0,854,854
KARACHI CENTRAL DISTRICT,LIAQUATABAD SUB-DIVISION,73,0,876,876
KARACHI CENTRAL DISTRICT,LIAQUATABAD SUB-DIVISION,74,0,685,685
KARACHI CENTRAL DISTRICT,LIAQUATABAD SUB-DIVISION,>=75,0,4059,4059
KARACHI CENTRAL DISTRICT,NAZIMABAD SUB-DIVISION,<1,0,8803,8803
KARACHI CENTRAL DISTRICT,NAZIMABAD SUB-DIVISION,1,0,8286,8286
KARACHI CENTRAL DISTRICT,NAZIMABAD SUB-DIVISION,2,0,9246,9246
KARACHI CENTRAL DISTRICT,NAZIMABAD SUB-DIVISION,3,0,10054,10054
KARACHI CENTRAL DISTRICT,NAZIMABAD SUB-DIVISION,4,0,9129,9129
KARACHI CENTRAL DISTRICT,NAZIMABAD SUB-DIVISION,5,0,9344,9344
KARACHI CENTRAL DISTRICT,NAZIMABAD SUB-DIVISION,6,0,9042,9042
KARACHI CENTRAL DISTRICT,NAZIMABAD SUB-DIVISION,7,0,9862,9862
KARACHI CENTRAL DISTRICT,NAZIMABAD SUB-DIVISION,8,0,8562,8562
KARACHI CENTRAL DISTRICT,NAZIMABAD SUB-DIVISION,9,0,9665,9665
KARACHI CENTRAL DISTRICT,NAZIMABAD SUB-DIVISION,10,0,8130,8130
KARACHI CENTRAL DISTRICT,NAZIMABAD SUB-DIVISION,11,0,10010,10010
KARACHI CENTRAL DISTRICT,NAZIMABAD SUB-DIVISION,12,0,8191,8191
KARACHI CENTRAL DISTRICT,NAZIMABAD SUB-DIVISION,13,0,8855,8855
KARACHI CENTRAL DISTRICT,NAZIMABAD SUB-DIVISION,14,0,8153,8153
KARACHI CENTRAL DISTRICT,NAZIMABAD SUB-DIVISION,15,0,8547,8547
KARACHI CENTRAL DISTRICT,NAZIMABAD SUB-DIVISION,16,0,8773,8773
KARACHI CENTRAL DISTRICT,NAZIMABAD SUB-DIVISION,17,0,9499,9499
KARACHI CENTRAL DISTRICT,NAZIMABAD SUB-DIVISION,18,0,7874,7874
KARACHI CENTRAL DISTRICT,NAZIMABAD SUB-DIVISION,19,0,9080,9080
KARACHI CENTRAL DISTRICT,NAZIMABAD SUB-DIVISION,20,0,7922,7922
KARACHI CENTRAL DISTRICT,NAZIMABAD SUB-DIVISION,21,0,9649,9649
KARACHI CENTRAL DISTRICT,NAZIMABAD SUB-DIVISION,22,0,8413,8413
KARACHI CENTRAL DISTRICT,NAZIMABAD SUB-DIVISION,23,0,8835,8835
KARACHI CENTRAL DISTRICT,NAZIMABAD SUB-DIVISION,24,0,8790,8790
KARACHI CENTRAL DISTRICT,NAZIMABAD SUB-DIVISION,25,0,7234,7234
KARACHI CENTRAL DISTRICT,NAZIMABAD SUB-DIVISION,26,0,8631,8631
KARACHI CENTRAL DISTRICT,NAZIMABAD SUB-DIVISION,27,0,8224,8224
KARACHI CENTRAL DISTRICT,NAZIMABAD SUB-DIVISION,28,0,7950,7950
KARACHI CENTRAL DISTRICT,NAZIMABAD SUB-DIVISION,29,0,7956,7956
KARACHI CENTRAL DISTRICT,NAZIMABAD SUB-DIVISION,30,0,7203,7203
KARACHI CENTRAL DISTRICT,NAZIMABAD SUB-DIVISION,31,0,7778,7778
KARACHI CENTRAL DISTRICT,NAZIMABAD SUB-DIVISION,32,0,7861,7861
KARACHI CENTRAL DISTRICT,NAZIMABAD SUB-DIVISION,33,0,7283,7283
KARACHI CENTRAL DISTRICT,NAZIMABAD SUB-DIVISION,34,0,7086,7086
KARACHI CENTRAL DISTRICT,NAZIMABAD SUB-DIVISION,35,0,6092,6092
KARACHI CENTRAL DISTRICT,NAZIMABAD SUB-DIVISION,36,0,6724,6724
KARACHI CENTRAL DISTRICT,NAZIMABAD SUB-DIVISION,37,0,6107,6107
KARACHI CENTRAL DISTRICT,NAZIMABAD SUB-DIVISION,38,0,6658,6658
KARACHI CENTRAL DISTRICT,NAZIMABAD SUB-DIVISION,39,0,6191,6191
KARACHI CENTRAL DISTRICT,NAZIMABAD SUB-DIVISION,40,0,5663,5663
KARACHI CENTRAL DISTRICT,NAZIMABAD SUB-DIVISION,41,0,5512,5512
KARACHI CENTRAL DISTRICT,NAZIMABAD SUB-DIVISION,42,0,5632,5632
KARACHI CENTRAL DISTRICT,NAZIMABAD SUB-DIVISION,43,0,5320,5320
KARACHI CENTRAL DISTRICT,NAZIMABAD SUB-DIVISION,44,0,4939,4939
KARACHI CENTRAL DISTRICT,NAZIMABAD SUB-DIVISION,45,0,4387,4387
KARACHI CENTRAL DISTRICT,NAZIMABAD SUB-DIVISION,46,0,4512,4512
KARACHI CENTRAL DISTRICT,NAZIMABAD SUB-DIVISION,47,0,3992,3992
KARACHI CENTRAL DISTRICT,NAZIMABAD SUB-DIVISION,48,0,4619,4619
KARACHI CENTRAL DISTRICT,NAZIMABAD SUB-DIVISION,49,0,4566,4566
KARACHI CENTRAL DISTRICT,NAZIMABAD SUB-DIVISION,50,0,4037,4037
KARACHI CENTRAL DISTRICT,NAZIMABAD SUB-DIVISION,51,0,4258,4258
KARACHI CENTRAL DISTRICT,NAZIMABAD SUB-DIVISION,52,0,4161,4161
KARACHI CENTRAL DISTRICT,NAZIMABAD SUB-DIVISION,53,0,4199,4199
KARACHI CENTRAL DISTRICT,NAZIMABAD SUB-DIVISION,54,0,3812,3812
KARACHI CENTRAL DISTRICT,NAZIMABAD SUB-DIVISION,55,0,3143,3143
KARACHI CENTRAL DISTRICT,NAZIMABAD SUB-DIVISION,56,0,3138,3138
KARACHI CENTRAL DISTRICT,NAZIMABAD SUB-DIVISION,57,0,2967,2967
KARACHI CENTRAL DISTRICT,NAZIMABAD SUB-DIVISION,58,0,2940,2940
KARACHI CENTRAL DISTRICT,NAZIMABAD SUB-DIVISION,59,0,2841,2841
KARACHI CENTRAL DISTRICT,NAZIMABAD SUB-DIVISION,60,0,2309,2309
KARACHI CENTRAL DISTRICT,NAZIMABAD SUB-DIVISION,61,0,2641,2641
KARACHI CENTRAL DISTRICT,NAZIMABAD SUB-DIVISION,62,0,2560,2560
KARACHI CENTRAL DISTRICT,NAZIMABAD SUB-DIVISION,63,0,2564,2564
KARACHI CENTRAL DISTRICT,NAZIMABAD SUB-DIVISION,64,0,2055,2055
KARACHI CENTRAL DISTRICT,NAZIMABAD SUB-DIVISION,65,0,1714,1714
KARACHI CENTRAL DISTRICT,NAZIMABAD SUB-DIVISION,66,0,1525,1525
KARACHI CENTRAL DISTRICT,NAZIMABAD SUB-DIVISION,67,0,1269,1269
KARACHI CENTRAL DISTRICT,NAZIMABAD SUB-DIVISION,68,0,1538,1538
KARACHI CENTRAL DISTRICT,NAZIMABAD SUB-DIVISION,69,0,1365,1365
KARACHI CENTRAL DISTRICT,NAZIMABAD SUB-DIVISION,70,0,1058,1058
KARACHI CENTRAL DISTRICT,NAZIMABAD SUB-DIVISION,71,0,1065,1065
KARACHI CENTRAL DISTRICT,NAZIMABAD SUB-DIVISION,72,0,1036,1036
KARACHI CENTRAL DISTRICT,NAZIMABAD SUB-DIVISION,73,0,1023,1023
KARACHI CENTRAL DISTRICT,NAZIMABAD SUB-DIVISION,74,0,863,863
KARACHI CENTRAL DISTRICT,NAZIMABAD SUB-DIVISION,>=75,0,5432,5432
KARACHI CENTRAL DISTRICT,NEW KARACHI SUB-DIVISION,<1,0,19887,19887
KARACHI CENTRAL DISTRICT,NEW KARACHI SUB-DIVISION,1,0,18975,18975
KARACHI CENTRAL DISTRICT,NEW KARACHI SUB-DIVISION,2,0,20255,20255
KARACHI CENTRAL DISTRICT,NEW KARACHI SUB-DIVISION,3,0,21665,21665
KARACHI CENTRAL DISTRICT,NEW KARACHI SUB-DIVISION,4,0,19816,19816
KARACHI CENTRAL DISTRICT,NEW KARACHI SUB-DIVISION,5,0,20260,20260
KARACHI CENTRAL DISTRICT,NEW KARACHI SUB-DIVISION,6,0,19699,19699
KARACHI CENTRAL DISTRICT,NEW KARACHI SUB-DIVISION,7,0,20305,20305
KARACHI CENTRAL DISTRICT,NEW KARACHI SUB-DIVISION,8,0,17814,17814
KARACHI CENTRAL DISTRICT,NEW KARACHI SUB-DIVISION,9,0,20486,20486
KARACHI CENTRAL DISTRICT,NEW KARACHI SUB-DIVISION,10,0,16693,16693
KARACHI CENTRAL DISTRICT,NEW KARACHI SUB-DIVISION,11,0,20007,20007
KARACHI CENTRAL DISTRICT,NEW KARACHI SUB-DIVISION,12,0,16067,16067
KARACHI CENTRAL DISTRICT,NEW KARACHI SUB-DIVISION,13,0,17817,17817
KARACHI CENTRAL DISTRICT,NEW KARACHI SUB-DIVISION,14,0,15901,15901
KARACHI CENTRAL DISTRICT,NEW KARACHI SUB-DIVISION,15,0,17217,17217
KARACHI CENTRAL DISTRICT,NEW KARACHI SUB-DIVISION,16,0,17471,17471
KARACHI CENTRAL DISTRICT,NEW KARACHI SUB-DIVISION,17,0,18706,18706
KARACHI CENTRAL DISTRICT,NEW KARACHI SUB-DIVISION,18,0,16156,16156
KARACHI CENTRAL DISTRICT,NEW KARACHI SUB-DIVISION,19,0,18621,18621
KARACHI CENTRAL DISTRICT,NEW KARACHI SUB-DIVISION,20,0,15784,15784
KARACHI CENTRAL DISTRICT,NEW KARACHI SUB-DIVISION,21,0,18570,18570
KARACHI CENTRAL DISTRICT,NEW KARACHI SUB-DIVISION,22,0,16931,16931
KARACHI CENTRAL DISTRICT,NEW KARACHI SUB-DIVISION,23,0,17280,17280
KARACHI CENTRAL DISTRICT,NEW KARACHI SUB-DIVISION,24,0,17465,17465
KARACHI CENTRAL DISTRICT,NEW KARACHI SUB-DIVISION,25,0,14143,14143
KARACHI CENTRAL DISTRICT,NEW KARACHI SUB-DIVISION,26,0,16896,16896
KARACHI CENTRAL DISTRICT,NEW KARACHI SUB-DIVISION,27,0,16017,16017
KARACHI CENTRAL DISTRICT,NEW KARACHI SUB-DIVISION,28,0,15529,15529
KARACHI CENTRAL DISTRICT,NEW KARACHI SUB-DIVISION,29,0,16100,16100
KARACHI CENTRAL DISTRICT,NEW KARACHI SUB-DIVISION,30,0,14102,14102
KARACHI CENTRAL DISTRICT,NEW KARACHI SUB-DIVISION,31,0,15884,15884
KARACHI CENTRAL DISTRICT,NEW KARACHI SUB-DIVISION,32,0,14599,14599
KARACHI CENTRAL DISTRICT,NEW KARACHI SUB-DIVISION,33,0,14885,14885
KARACHI CENTRAL DISTRICT,NEW KARACHI SUB-DIVISION,34,0,14423,14423
KARACHI CENTRAL DISTRICT,NEW KARACHI SUB-DIVISION,35,0,11630,11630
KARACHI CENTRAL DISTRICT,NEW KARACHI SUB-DIVISION,36,0,13205,13205
KARACHI CENTRAL DISTRICT,NEW KARACHI SUB-DIVISION,37,0,11941,11941
KARACHI CENTRAL DISTRICT,NEW KARACHI SUB-DIVISION,38,0,12678,12678
KARACHI CENTRAL DISTRICT,NEW KARACHI SUB-DIVISION,39,0,12504,12504
KARACHI CENTRAL DISTRICT,NEW KARACHI SUB-DIVISION,40,0,10218,10218
KARACHI CENTRAL DISTRICT,NEW KARACHI SUB-DIVISION,41,0,10948,10948
KARACHI CENTRAL DISTRICT,NEW KARACHI SUB-DIVISION,42,0,9467,9467
KARACHI CENTRAL DISTRICT,NEW KARACHI SUB-DIVISION,43,0,9877,9877
KARACHI CENTRAL DISTRICT,NEW KARACHI SUB-DIVISION,44,0,9290,9290
KARACHI CENTRAL DISTRICT,NEW KARACHI SUB-DIVISION,45,0,7190,7190
KARACHI CENTRAL DISTRICT,NEW KARACHI SUB-DIVISION,46,0,8296,8296
KARACHI CENTRAL DISTRICT,NEW KARACHI SUB-DIVISION,47,0,7467,7467
KARACHI CENTRAL DISTRICT,NEW KARACHI SUB-DIVISION,48,0,7881,7881
KARACHI CENTRAL DISTRICT,NEW KARACHI SUB-DIVISION,49,0,7982,7982
KARACHI CENTRAL DISTRICT,NEW KARACHI SUB-DIVISION,50,0,6606,6606
KARACHI CENTRAL DISTRICT,NEW KARACHI SUB-DIVISION,51,0,7806,7806
KARACHI CENTRAL DISTRICT,NEW KARACHI SUB-DIVISION,52,0,6917,6917
KARACHI CENTRAL DISTRICT,NEW KARACHI SUB-DIVISION,53,0,7254,7254
KARACHI CENTRAL DISTRICT,NEW KARACHI SUB-DIVISION,54,0,6351,6351
KARACHI CENTRAL DISTRICT,NEW KARACHI SUB-DIVISION,55,0,4798,4798
KARACHI CENTRAL DISTRICT,NEW KARACHI SUB-DIVISION,56,0,5484,5484
KARACHI CENTRAL DISTRICT,NEW KARACHI SUB-DIVISION,57,0,5006,5006
KARACHI CENTRAL DISTRICT,NEW KARACHI SUB-DIVISION,58,0,4727,4727
KARACHI CENTRAL DISTRICT,NEW KARACHI SUB-DIVISION,59,0,4652,4652
KARACHI CENTRAL DISTRICT,NEW KARACHI SUB-DIVISION,60,0,3390,3390
KARACHI CENTRAL DISTRICT,NEW KARACHI SUB-DIVISION,61,0,4848,4848
KARACHI CENTRAL DISTRICT,NEW KARACHI SUB-DIVISION,62,0,4510,4510
KARACHI CENTRAL DISTRICT,NEW KARACHI SUB-DIVISION,63,0,4158,4158
KARACHI CENTRAL DISTRICT,NEW KARACHI SUB-DIVISION,64,0,3582,3582
KARACHI CENTRAL DISTRICT,NEW KARACHI SUB-DIVISION,65,0,2550,2550
KARACHI CENTRAL DISTRICT,NEW KARACHI SUB-DIVISION,66,0,2544,2544
KARACHI CENTRAL DISTRICT,NEW KARACHI SUB-DIVISION,67,0,2341,2341
KARACHI CENTRAL DISTRICT,NEW KARACHI SUB-DIVISION,68,0,2540,2540
KARACHI CENTRAL DISTRICT,NEW KARACHI SUB-DIVISION,69,0,2207,2207
KARACHI CENTRAL DISTRICT,NEW KARACHI SUB-DIVISION,70,0,1586,1586
KARACHI CENTRAL DISTRICT,NEW KARACHI SUB-DIVISION,71,0,1854,1854
KARACHI CENTRAL DISTRICT,NEW KARACHI SUB-DIVISION,72,0,1694,1694
KARACHI CENTRAL DISTRICT,NEW KARACHI SUB-DIVISION,73,0,1592,1592
KARACHI CENTRAL DISTRICT,NEW KARACHI SUB-DIVISION,74,0,1250,1250
KARACHI CENTRAL DISTRICT,NEW KARACHI SUB-DIVISION,>=75,0,7998,7998
KARACHI CENTRAL DISTRICT,NORTH NAZIMABAD SUB-DIVISION,<1,0,13592,13592
KARACHI CENTRAL DISTRICT,NORTH NAZIMABAD SUB-DIVISION,1,0,13992,13992
KARACHI CENTRAL DISTRICT,NORTH NAZIMABAD SUB-DIVISION,2,0,14394,14394
KARACHI CENTRAL DISTRICT,NORTH NAZIMABAD SUB-DIVISION,3,0,15687,15687
KARACHI CENTRAL DISTRICT,NORTH NAZIMABAD SUB-DIVISION,4,0,14781,14781
KARACHI CENTRAL DISTRICT,NORTH NAZIMABAD SUB-DIVISION,5,0,14959,14959
KARACHI CENTRAL DISTRICT,NORTH NAZIMABAD SUB-DIVISION,6,0,15065,15065
KARACHI CENTRAL DISTRICT,NORTH NAZIMABAD SUB-DIVISION,7,0,15860,15860
KARACHI CENTRAL DISTRICT,NORTH NAZIMABAD SUB-DIVISION,8,0,14195,14195
KARACHI CENTRAL DISTRICT,NORTH NAZIMABAD SUB-DIVISION,9,0,16494,16494
KARACHI CENTRAL DISTRICT,NORTH NAZIMABAD SUB-DIVISION,10,0,13476,13476
KARACHI CENTRAL DISTRICT,NORTH NAZIMABAD SUB-DIVISION,11,0,16215,16215
KARACHI CENTRAL DISTRICT,NORTH NAZIMABAD SUB-DIVISION,12,0,13182,13182
KARACHI CENTRAL DISTRICT,NORTH NAZIMABAD SUB-DIVISION,13,0,14316,14316
KARACHI CENTRAL DISTRICT,NORTH NAZIMABAD SUB-DIVISION,14,0,13060,13060
KARACHI CENTRAL DISTRICT,NORTH NAZIMABAD SUB-DIVISION,15,0,13506,13506
KARACHI CENTRAL DISTRICT,NORTH NAZIMABAD SUB-DIVISION,16,0,14050,14050
KARACHI CENTRAL DISTRICT,NORTH NAZIMABAD SUB-DIVISION,17,0,14661,14661
KARACHI CENTRAL DISTRICT,NORTH NAZIMABAD SUB-DIVISION,18,0,12338,12338
KARACHI CENTRAL DISTRICT,NORTH NAZIMABAD SUB-DIVISION,19,0,14607,14607
KARACHI CENTRAL DISTRICT,NORTH NAZIMABAD SUB-DIVISION,20,0,12225,12225
KARACHI CENTRAL DISTRICT,NORTH NAZIMABAD SUB-DIVISION,21,0,15414,15414
KARACHI CENTRAL DISTRICT,NORTH NAZIMABAD SUB-DIVISION,22,0,12715,12715
KARACHI CENTRAL DISTRICT,NORTH NAZIMABAD SUB-DIVISION,23,0,13094,13094
KARACHI CENTRAL DISTRICT,NORTH NAZIMABAD SUB-DIVISION,24,0,13205,13205
KARACHI CENTRAL DISTRICT,NORTH NAZIMABAD SUB-DIVISION,25,0,10562,10562
KARACHI CENTRAL DISTRICT,NORTH NAZIMABAD SUB-DIVISION,26,0,12984,12984
KARACHI CENTRAL DISTRICT,NORTH NAZIMABAD SUB-DIVISION,27,0,12336,12336
KARACHI CENTRAL DISTRICT,NORTH NAZIMABAD SUB-DIVISION,28,0,11748,11748
KARACHI CENTRAL DISTRICT,NORTH NAZIMABAD SUB-DIVISION,29,0,12320,12320
KARACHI CENTRAL DISTRICT,NORTH NAZIMABAD SUB-DIVISION,30,0,10263,10263
KARACHI CENTRAL DISTRICT,NORTH NAZIMABAD SUB-DIVISION,31,0,12448,12448
KARACHI CENTRAL DISTRICT,NORTH NAZIMABAD SUB-DIVISION,32,0,11365,11365
KARACHI CENTRAL DISTRICT,NORTH NAZIMABAD SUB-DIVISION,33,0,11291,11291
KARACHI CENTRAL DISTRICT,NORTH NAZIMABAD SUB-DIVISION,34,0,11091,11091
KARACHI CENTRAL DISTRICT,NORTH NAZIMABAD SUB-DIVISION,35,0,8576,8576
KARACHI CENTRAL DISTRICT,NORTH NAZIMABAD SUB-DIVISION,36,0,10293,10293
KARACHI CENTRAL DISTRICT,NORTH NAZIMABAD SUB-DIVISION,37,0,9503,9503
KARACHI CENTRAL DISTRICT,NORTH NAZIMABAD SUB-DIVISION,38,0,10085,10085
KARACHI CENTRAL DISTRICT,NORTH NAZIMABAD SUB-DIVISION,39,0,9520,9520
KARACHI CENTRAL DISTRICT,NORTH NAZIMABAD SUB-DIVISION,40,0,8072,8072
KARACHI CENTRAL DISTRICT,NORTH NAZIMABAD SUB-DIVISION,41,0,9190,9190
KARACHI CENTRAL DISTRICT,NORTH NAZIMABAD SUB-DIVISION,42,0,8542,8542
KARACHI CENTRAL DISTRICT,NORTH NAZIMABAD SUB-DIVISION,43,0,8478,8478
KARACHI CENTRAL DISTRICT,NORTH NAZIMABAD SUB-DIVISION,44,0,8152,8152
KARACHI CENTRAL DISTRICT,NORTH NAZIMABAD SUB-DIVISION,45,0,6242,6242
KARACHI CENTRAL DISTRICT,NORTH NAZIMABAD SUB-DIVISION,46,0,7364,7364
KARACHI CENTRAL DISTRICT,NORTH NAZIMABAD SUB-DIVISION,47,0,6524,6524
KARACHI CENTRAL DISTRICT,NORTH NAZIMABAD SUB-DIVISION,48,0,7238,7238
KARACHI CENTRAL DISTRICT,NORTH NAZIMABAD SUB-DIVISION,49,0,7100,7100
KARACHI CENTRAL DISTRICT,NORTH NAZIMABAD SUB-DIVISION,50,0,5839,5839
KARACHI CENTRAL DISTRICT,NORTH NAZIMABAD SUB-DIVISION,51,0,7056,7056
KARACHI CENTRAL DISTRICT,NORTH NAZIMABAD SUB-DIVISION,52,0,6779,6779
KARACHI CENTRAL DISTRICT,NORTH NAZIMABAD SUB-DIVISION,53,0,6620,6620
KARACHI CENTRAL DISTRICT,NORTH NAZIMABAD SUB-DIVISION,54,0,6472,6472
KARACHI CENTRAL DISTRICT,NORTH NAZIMABAD SUB-DIVISION,55,0,4622,4622
KARACHI CENTRAL DISTRICT,NORTH NAZIMABAD SUB-DIVISION,56,0,5682,5682
KARACHI CENTRAL DISTRICT,NORTH NAZIMABAD SUB-DIVISION,57,0,4868,4868
KARACHI CENTRAL DISTRICT,NORTH NAZIMABAD SUB-DIVISION,58,0,5116,5116
KARACHI CENTRAL DISTRICT,NORTH NAZIMABAD SUB-DIVISION,59,0,4879,4879
KARACHI CENTRAL DISTRICT,NORTH NAZIMABAD SUB-DIVISION,60,0,3520,3520
KARACHI CENTRAL DISTRICT,NORTH NAZIMABAD SUB-DIVISION,61,0,4782,4782
KARACHI CENTRAL DISTRICT,NORTH NAZIMABAD SUB-DIVISION,62,0,4565,4565
KARACHI CENTRAL DISTRICT,NORTH NAZIMABAD SUB-DIVISION,63,0,4417,4417
KARACHI CENTRAL DISTRICT,NORTH NAZIMABAD SUB-DIVISION,64,0,3959,3959
KARACHI CENTRAL DISTRICT,NORTH NAZIMABAD SUB-DIVISION,65,0,2732,2732
KARACHI CENTRAL DISTRICT,NORTH NAZIMABAD SUB-DIVISION,66,0,2900,2900
KARACHI CENTRAL DISTRICT,NORTH NAZIMABAD SUB-DIVISION,67,0,2631,2631
KARACHI CENTRAL DISTRICT,NORTH NAZIMABAD SUB-DIVISION,68,0,2822,2822
KARACHI CENTRAL DISTRICT,NORTH NAZIMABAD SUB-DIVISION,69,0,2572,2572
KARACHI CENTRAL DISTRICT,NORTH NAZIMABAD SUB-DIVISION,70,0,1757,1757
KARACHI CENTRAL DISTRICT,NORTH NAZIMABAD SUB-DIVISION,71,0,2133,2133
KARACHI CENTRAL DISTRICT,NORTH NAZIMABAD SUB-DIVISION,72,0,1991,1991
KARACHI CENTRAL DISTRICT,NORTH NAZIMABAD SUB-DIVISION,73,0,1873,1873
KARACHI CENTRAL DISTRICT,NORTH NAZIMABAD SUB-DIVISION,74,0,1659,1659
KARACHI CENTRAL DISTRICT,NORTH NAZIMABAD SUB-DIVISION,>=75,0,9982,9982
KARACHI EAST DISTRICT,FEROZABAD SUB-DIVISION,<1,0,15910,15910
KARACHI EAST DISTRICT,FEROZABAD SUB-DIVISION,1,0,16006,16006
KARACHI EAST DISTRICT,FEROZABAD SUB-DIVISION,2,0,15699,15699
KARACHI EAST DISTRICT,FEROZABAD SUB-DIVISION,3,0,17246,17246
KARACHI EAST DISTRICT,FEROZABAD SUB-DIVISION,4,0,15481,15481
KARACHI EAST DISTRICT,FEROZABAD SUB-DIVISION,5,0,16448,16448
KARACHI EAST DISTRICT,FEROZABAD SUB-DIVISION,6,0,15944,15944
KARACHI EAST DISTRICT,FEROZABAD SUB-DIVISION,7,0,17203,17203
KARACHI EAST DISTRICT,FEROZABAD SUB-DIVISION,8,0,14903,14903
KARACHI EAST DISTRICT,FEROZABAD SUB-DIVISION,9,0,17219,17219
KARACHI EAST DISTRICT,FEROZABAD SUB-DIVISION,10,0,14185,14185
KARACHI EAST DISTRICT,FEROZABAD SUB-DIVISION,11,0,17289,17289
KARACHI EAST DISTRICT,FEROZABAD SUB-DIVISION,12,0,14106,14106
KARACHI EAST DISTRICT,FEROZABAD SUB-DIVISION,13,0,15465,15465
KARACHI EAST DISTRICT,FEROZABAD SUB-DIVISION,14,0,13724,13724
KARACHI EAST DISTRICT,FEROZABAD SUB-DIVISION,15,0,14411,14411
KARACHI EAST DISTRICT,FEROZABAD SUB-DIVISION,16,0,14627,14627
KARACHI EAST DISTRICT,FEROZABAD SUB-DIVISION,17,0,16356,16356
KARACHI EAST DISTRICT,FEROZABAD SUB-DIVISION,18,0,13640,13640
KARACHI EAST DISTRICT,FEROZABAD SUB-DIVISION,19,0,16021,16021
KARACHI EAST DISTRICT,FEROZABAD SUB-DIVISION,20,0,13529,13529
KARACHI EAST DISTRICT,FEROZABAD SUB-DIVISION,21,0,16542,16542
KARACHI EAST DISTRICT,FEROZABAD SUB-DIVISION,22,0,14644,14644
KARACHI EAST DISTRICT,FEROZABAD SUB-DIVISION,23,0,15338,15338
KARACHI EAST DISTRICT,FEROZABAD SUB-DIVISION,24,0,15275,15275
KARACHI EAST DISTRICT,FEROZABAD SUB-DIVISION,25,0,12853,12853
KARACHI EAST DISTRICT,FEROZABAD SUB-DIVISION,26,0,15025,15025
KARACHI EAST DISTRICT,FEROZABAD SUB-DIVISION,27,0,14523,14523
KARACHI EAST DISTRICT,FEROZABAD SUB-DIVISION,28,0,13612,13612
KARACHI EAST DISTRICT,FEROZABAD SUB-DIVISION,29,0,14040,14040
KARACHI EAST DISTRICT,FEROZABAD SUB-DIVISION,30,0,12521,12521
KARACHI EAST DISTRICT,FEROZABAD SUB-DIVISION,31,0,13649,13649
KARACHI EAST DISTRICT,FEROZABAD SUB-DIVISION,32,0,13166,13166
KARACHI EAST DISTRICT,FEROZABAD SUB-DIVISION,33,0,12686,12686
KARACHI EAST DISTRICT,FEROZABAD SUB-DIVISION,34,0,12430,12430
KARACHI EAST DISTRICT,FEROZABAD SUB-DIVISION,35,0,10122,10122
KARACHI EAST DISTRICT,FEROZABAD SUB-DIVISION,36,0,11294,11294
KARACHI EAST DISTRICT,FEROZABAD SUB-DIVISION,37,0,10487,10487
KARACHI EAST DISTRICT,FEROZABAD SUB-DIVISION,38,0,11162,11162
KARACHI EAST DISTRICT,FEROZABAD SUB-DIVISION,39,0,10567,10567
KARACHI EAST DISTRICT,FEROZABAD SUB-DIVISION,40,0,9370,9370
KARACHI EAST DISTRICT,FEROZABAD SUB-DIVISION,41,0,9476,9476
KARACHI EAST DISTRICT,FEROZABAD SUB-DIVISION,42,0,8816,8816
KARACHI EAST DISTRICT,FEROZABAD SUB-DIVISION,43,0,8842,8842
KARACHI EAST DISTRICT,FEROZABAD SUB-DIVISION,44,0,8104,8104
KARACHI EAST DISTRICT,FEROZABAD SUB-DIVISION,45,0,6488,6488
KARACHI EAST DISTRICT,FEROZABAD SUB-DIVISION,46,0,7255,7255
KARACHI EAST DISTRICT,FEROZABAD SUB-DIVISION,47,0,6620,6620
KARACHI EAST DISTRICT,FEROZABAD SUB-DIVISION,48,0,7102,7102
KARACHI EAST DISTRICT,FEROZABAD SUB-DIVISION,49,0,7239,7239
KARACHI EAST DISTRICT,FEROZABAD SUB-DIVISION,50,0,6461,6461
KARACHI EAST DISTRICT,FEROZABAD SUB-DIVISION,51,0,6767,6767
KARACHI EAST DISTRICT,FEROZABAD SUB-DIVISION,52,0,6576,6576
KARACHI EAST DISTRICT,FEROZABAD SUB-DIVISION,53,0,6591,6591
KARACHI EAST DISTRICT,FEROZABAD SUB-DIVISION,54,0,5873,5873
KARACHI EAST DISTRICT,FEROZABAD SUB-DIVISION,55,0,5031,5031
KARACHI EAST DISTRICT,FEROZABAD SUB-DIVISION,56,0,5184,5184
KARACHI EAST DISTRICT,FEROZABAD SUB-DIVISION,57,0,4522,4522
KARACHI EAST DISTRICT,FEROZABAD SUB-DIVISION,58,0,4823,4823
KARACHI EAST DISTRICT,FEROZABAD SUB-DIVISION,59,0,4444,4444
KARACHI EAST DISTRICT,FEROZABAD SUB-DIVISION,60,0,3548,3548
KARACHI EAST DISTRICT,FEROZABAD SUB-DIVISION,61,0,4156,4156
KARACHI EAST DISTRICT,FEROZABAD SUB-DIVISION,62,0,4242,4242
KARACHI EAST DISTRICT,FEROZABAD SUB-DIVISION,63,0,4210,4210
KARACHI EAST DISTRICT,FEROZABAD SUB-DIVISION,64,0,3575,3575
KARACHI EAST DISTRICT,FEROZABAD SUB-DIVISION,65,0,2730,2730
KARACHI EAST DISTRICT,FEROZABAD SUB-DIVISION,66,0,2591,2591
KARACHI EAST DISTRICT,FEROZABAD SUB-DIVISION,67,0,2319,2319
KARACHI EAST DISTRICT,FEROZABAD SUB-DIVISION,68,0,2544,2544
KARACHI EAST DISTRICT,FEROZABAD SUB-DIVISION,69,0,2405,2405
KARACHI EAST DISTRICT,FEROZABAD SUB-DIVISION,70,0,1758,1758
KARACHI EAST DISTRICT,FEROZABAD SUB-DIVISION,71,0,1885,1885
KARACHI EAST DISTRICT,FEROZABAD SUB-DIVISION,72,0,1798,1798
KARACHI EAST DISTRICT,FEROZABAD SUB-DIVISION,73,0,1730,1730
KARACHI EAST DISTRICT,FEROZABAD SUB-DIVISION,74,0,1439,1439
KARACHI EAST DISTRICT,FEROZABAD SUB-DIVISION,>=75,0,9769,9769
KARACHI EAST DISTRICT,GULSHAN-E-IQBAL SUB-DIVISION,<1,0,15728,15728
KARACHI EAST DISTRICT,GULSHAN-E-IQBAL SUB-DIVISION,1,0,16295,16295
KARACHI EAST DISTRICT,GULSHAN-E-IQBAL SUB-DIVISION,2,0,17108,17108
KARACHI EAST DISTRICT,GULSHAN-E-IQBAL SUB-DIVISION,3,0,18538,18538
KARACHI EAST DISTRICT,GULSHAN-E-IQBAL SUB-DIVISION,4,0,16849,16849
KARACHI EAST DISTRICT,GULSHAN-E-IQBAL SUB-DIVISION,5,0,17859,17859
KARACHI EAST DISTRICT,GULSHAN-E-IQBAL SUB-DIVISION,6,0,17140,17140
KARACHI EAST DISTRICT,GULSHAN-E-IQBAL SUB-DIVISION,7,0,18676,18676
KARACHI EAST DISTRICT,GULSHAN-E-IQBAL SUB-DIVISION,8,0,16483,16483
KARACHI EAST DISTRICT,GULSHAN-E-IQBAL SUB-DIVISION,9,0,18715,18715
KARACHI EAST DISTRICT,GULSHAN-E-IQBAL SUB-DIVISION,10,0,15279,15279
KARACHI EAST DISTRICT,GULSHAN-E-IQBAL SUB-DIVISION,11,0,18070,18070
KARACHI EAST DISTRICT,GULSHAN-E-IQBAL SUB-DIVISION,12,0,14917,14917
KARACHI EAST DISTRICT,GULSHAN-E-IQBAL SUB-DIVISION,13,0,16084,16084
KARACHI EAST DISTRICT,GULSHAN-E-IQBAL SUB-DIVISION,14,0,14549,14549
KARACHI EAST DISTRICT,GULSHAN-E-IQBAL SUB-DIVISION,15,0,15352,15352
KARACHI EAST DISTRICT,GULSHAN-E-IQBAL SUB-DIVISION,16,0,15367,15367
KARACHI EAST DISTRICT,GULSHAN-E-IQBAL SUB-DIVISION,17,0,16611,16611
KARACHI EAST DISTRICT,GULSHAN-E-IQBAL SUB-DIVISION,18,0,14598,14598
KARACHI EAST DISTRICT,GULSHAN-E-IQBAL SUB-DIVISION,19,0,17128,17128
KARACHI EAST DISTRICT,GULSHAN-E-IQBAL SUB-DIVISION,20,0,14673,14673
KARACHI EAST DISTRICT,GULSHAN-E-IQBAL SUB-DIVISION,21,0,17943,17943
KARACHI EAST DISTRICT,GULSHAN-E-IQBAL SUB-DIVISION,22,0,15840,15840
KARACHI EAST DISTRICT,GULSHAN-E-IQBAL SUB-DIVISION,23,0,16496,16496
KARACHI EAST DISTRICT,GULSHAN-E-IQBAL SUB-DIVISION,24,0,16358,16358
KARACHI EAST DISTRICT,GULSHAN-E-IQBAL SUB-DIVISION,25,0,13379,13379
KARACHI EAST DISTRICT,GULSHAN-E-IQBAL SUB-DIVISION,26,0,15947,15947
KARACHI EAST DISTRICT,GULSHAN-E-IQBAL SUB-DIVISION,27,0,15381,15381
KARACHI EAST DISTRICT,GULSHAN-E-IQBAL SUB-DIVISION,28,0,14353,14353
KARACHI EAST DISTRICT,GULSHAN-E-IQBAL SUB-DIVISION,29,0,15155,15155
KARACHI EAST DISTRICT,GULSHAN-E-IQBAL SUB-DIVISION,30,0,12737,12737
KARACHI EAST DISTRICT,GULSHAN-E-IQBAL SUB-DIVISION,31,0,14565,14565
KARACHI EAST DISTRICT,GULSHAN-E-IQBAL SUB-DIVISION,32,0,13889,13889
KARACHI EAST DISTRICT,GULSHAN-E-IQBAL SUB-DIVISION,33,0,13571,13571
KARACHI EAST DISTRICT,GULSHAN-E-IQBAL SUB-DIVISION,34,0,12742,12742
KARACHI EAST DISTRICT,GULSHAN-E-IQBAL SUB-DIVISION,35,0,10409,10409
KARACHI EAST DISTRICT,GULSHAN-E-IQBAL SUB-DIVISION,36,0,12056,12056
KARACHI EAST DISTRICT,GULSHAN-E-IQBAL SUB-DIVISION,37,0,11095,11095
KARACHI EAST DISTRICT,GULSHAN-E-IQBAL SUB-DIVISION,38,0,11968,11968
KARACHI EAST DISTRICT,GULSHAN-E-IQBAL SUB-DIVISION,39,0,11369,11369
KARACHI EAST DISTRICT,GULSHAN-E-IQBAL SUB-DIVISION,40,0,9834,9834
KARACHI EAST DISTRICT,GULSHAN-E-IQBAL SUB-DIVISION,41,0,10292,10292
KARACHI EAST DISTRICT,GULSHAN-E-IQBAL SUB-DIVISION,42,0,9988,9988
KARACHI EAST DISTRICT,GULSHAN-E-IQBAL SUB-DIVISION,43,0,10035,10035
KARACHI EAST DISTRICT,GULSHAN-E-IQBAL SUB-DIVISION,44,0,9034,9034
KARACHI EAST DISTRICT,GULSHAN-E-IQBAL SUB-DIVISION,45,0,7336,7336
KARACHI EAST DISTRICT,GULSHAN-E-IQBAL SUB-DIVISION,46,0,8199,8199
KARACHI EAST DISTRICT,GULSHAN-E-IQBAL SUB-DIVISION,47,0,7480,7480
KARACHI EAST DISTRICT,GULSHAN-E-IQBAL SUB-DIVISION,48,0,8566,8566
KARACHI EAST DISTRICT,GULSHAN-E-IQBAL SUB-DIVISION,49,0,8206,8206
KARACHI EAST DISTRICT,GULSHAN-E-IQBAL SUB-DIVISION,50,0,7354,7354
KARACHI EAST DISTRICT,GULSHAN-E-IQBAL SUB-DIVISION,51,0,7865,7865
KARACHI EAST DISTRICT,GULSHAN-E-IQBAL SUB-DIVISION,52,0,8489,8489
KARACHI EAST DISTRICT,GULSHAN-E-IQBAL SUB-DIVISION,53,0,7891,7891
KARACHI EAST DISTRICT,GULSHAN-E-IQBAL SUB-DIVISION,54,0,7579,7579
KARACHI EAST DISTRICT,GULSHAN-E-IQBAL SUB-DIVISION,55,0,6011,6011
KARACHI EAST DISTRICT,GULSHAN-E-IQBAL SUB-DIVISION,56,0,6771,6771
KARACHI EAST DISTRICT,GULSHAN-E-IQBAL SUB-DIVISION,57,0,5979,5979
KARACHI EAST DISTRICT,GULSHAN-E-IQBAL SUB-DIVISION,58,0,6564,6564
KARACHI EAST DISTRICT,GULSHAN-E-IQBAL SUB-DIVISION,59,0,6253,6253
KARACHI EAST DISTRICT,GULSHAN-E-IQBAL SUB-DIVISION,60,0,4713,4713
KARACHI EAST DISTRICT,GULSHAN-E-IQBAL SUB-DIVISION,61,0,5608,5608
KARACHI EAST DISTRICT,GULSHAN-E-IQBAL SUB-DIVISION,62,0,5964,5964
KARACHI EAST DISTRICT,GULSHAN-E-IQBAL SUB-DIVISION,63,0,5801,5801
KARACHI EAST DISTRICT,GULSHAN-E-IQBAL SUB-DIVISION,64,0,5129,5129
KARACHI EAST DISTRICT,GULSHAN-E-IQBAL SUB-DIVISION,65,0,3711,3711
KARACHI EAST DISTRICT,GULSHAN-E-IQBAL SUB-DIVISION,66,0,3836,3836
KARACHI EAST DISTRICT,GULSHAN-E-IQBAL SUB-DIVISION,67,0,3425,3425
KARACHI EAST DISTRICT,GULSHAN-E-IQBAL SUB-DIVISION,68,0,3612,3612
KARACHI EAST DISTRICT,GULSHAN-E-IQBAL SUB-DIVISION,69,0,3288,3288
KARACHI EAST DISTRICT,GULSHAN-E-IQBAL SUB-DIVISION,70,0,2282,2282
KARACHI EAST DISTRICT,GULSHAN-E-IQBAL SUB-DIVISION,71,0,2692,2692
KARACHI EAST DISTRICT,GULSHAN-E-IQBAL SUB-DIVISION,72,0,2615,2615
KARACHI EAST DISTRICT,GULSHAN-E-IQBAL SUB-DIVISION,73,0,2401,2401
KARACHI EAST DISTRICT,GULSHAN-E-IQBAL SUB-DIVISION,74,0,2166,2166
KARACHI EAST DISTRICT,GULSHAN-E-IQBAL SUB-DIVISION,>=75,0,13559,13559
KARACHI EAST DISTRICT,GULZAR-E-HIJRI SUB-DIVISION,<1,0,19886,19886
KARACHI EAST DISTRICT,GULZAR-E-HIJRI SUB-DIVISION,1,0,21049,21049
KARACHI EAST DISTRICT,GULZAR-E-HIJRI SUB-DIVISION,2,0,22698,22698
KARACHI EAST DISTRICT,GULZAR-E-HIJRI SUB-DIVISION,3,0,25211,25211
KARACHI EAST DISTRICT,GULZAR-E-HIJRI SUB-DIVISION,4,0,23054,23054
KARACHI EAST DISTRICT,GULZAR-E-HIJRI SUB-DIVISION,5,0,23605,23605
KARACHI EAST DISTRICT,GULZAR-E-HIJRI SUB-DIVISION,6,0,22070,22070
KARACHI EAST DISTRICT,GULZAR-E-HIJRI SUB-DIVISION,7,0,23889,23889
KARACHI EAST DISTRICT,GULZAR-E-HIJRI SUB-DIVISION,8,0,21727,21727
KARACHI EAST DISTRICT,GULZAR-E-HIJRI SUB-DIVISION,9,0,22864,22864
KARACHI EAST DISTRICT,GULZAR-E-HIJRI SUB-DIVISION,10,0,19463,19463
KARACHI EAST DISTRICT,GULZAR-E-HIJRI SUB-DIVISION,11,0,20015,20015
KARACHI EAST DISTRICT,GULZAR-E-HIJRI SUB-DIVISION,12,0,17947,17947
KARACHI EAST DISTRICT,GULZAR-E-HIJRI SUB-DIVISION,13,0,17524,17524
KARACHI EAST DISTRICT,GULZAR-E-HIJRI SUB-DIVISION,14,0,16051,16051
KARACHI EAST DISTRICT,GULZAR-E-HIJRI SUB-DIVISION,15,0,16599,16599
KARACHI EAST DISTRICT,GULZAR-E-HIJRI SUB-DIVISION,16,0,16151,16151
KARACHI EAST DISTRICT,GULZAR-E-HIJRI SUB-DIVISION,17,0,16643,16643
KARACHI EAST DISTRICT,GULZAR-E-HIJRI SUB-DIVISION,18,0,16853,16853
KARACHI EAST DISTRICT,GULZAR-E-HIJRI SUB-DIVISION,19,0,16288,16288
KARACHI EAST DISTRICT,GULZAR-E-HIJRI SUB-DIVISION,20,0,16224,16224
KARACHI EAST DISTRICT,GULZAR-E-HIJRI SUB-DIVISION,21,0,15752,15752
KARACHI EAST DISTRICT,GULZAR-E-HIJRI SUB-DIVISION,22,0,15093,15093
KARACHI EAST DISTRICT,GULZAR-E-HIJRI SUB-DIVISION,23,0,13954,13954
KARACHI EAST DISTRICT,GULZAR-E-HIJRI SUB-DIVISION,24,0,13497,13497
KARACHI EAST DISTRICT,GULZAR-E-HIJRI SUB-DIVISION,25,0,14752,14752
KARACHI EAST DISTRICT,GULZAR-E-HIJRI SUB-DIVISION,26,0,13307,13307
KARACHI EAST DISTRICT,GULZAR-E-HIJRI SUB-DIVISION,27,0,13615,13615
KARACHI EAST DISTRICT,GULZAR-E-HIJRI SUB-DIVISION,28,0,13258,13258
KARACHI EAST DISTRICT,GULZAR-E-HIJRI SUB-DIVISION,29,0,12585,12585
KARACHI EAST DISTRICT,GULZAR-E-HIJRI SUB-DIVISION,30,0,13682,13682
KARACHI EAST DISTRICT,GULZAR-E-HIJRI SUB-DIVISION,31,0,11868,11868
KARACHI EAST DISTRICT,GULZAR-E-HIJRI SUB-DIVISION,32,0,11284,11284
KARACHI EAST DISTRICT,GULZAR-E-HIJRI SUB-DIVISION,33,0,11046,11046
KARACHI EAST DISTRICT,GULZAR-E-HIJRI SUB-DIVISION,34,0,10073,10073
KARACHI EAST DISTRICT,GULZAR-E-HIJRI SUB-DIVISION,35,0,10889,10889
KARACHI EAST DISTRICT,GULZAR-E-HIJRI SUB-DIVISION,36,0,9500,9500
KARACHI EAST DISTRICT,GULZAR-E-HIJRI SUB-DIVISION,37,0,9056,9056
KARACHI EAST DISTRICT,GULZAR-E-HIJRI SUB-DIVISION,38,0,9647,9647
KARACHI EAST DISTRICT,GULZAR-E-HIJRI SUB-DIVISION,39,0,8996,8996
KARACHI EAST DISTRICT,GULZAR-E-HIJRI SUB-DIVISION,40,0,9858,9858
KARACHI EAST DISTRICT,GULZAR-E-HIJRI SUB-DIVISION,41,0,7816,7816
KARACHI EAST DISTRICT,GULZAR-E-HIJRI SUB-DIVISION,42,0,7018,7018
KARACHI EAST DISTRICT,GULZAR-E-HIJRI SUB-DIVISION,43,0,7304,7304
KARACHI EAST DISTRICT,GULZAR-E-HIJRI SUB-DIVISION,44,0,6143,6143
KARACHI EAST DISTRICT,GULZAR-E-HIJRI SUB-DIVISION,45,0,6544,6544
KARACHI EAST DISTRICT,GULZAR-E-HIJRI SUB-DIVISION,46,0,5411,5411
KARACHI EAST DISTRICT,GULZAR-E-HIJRI SUB-DIVISION,47,0,5174,5174
KARACHI EAST DISTRICT,GULZAR-E-HIJRI SUB-DIVISION,48,0,5328,5328
KARACHI EAST DISTRICT,GULZAR-E-HIJRI SUB-DIVISION,49,0,5472,5472
KARACHI EAST DISTRICT,GULZAR-E-HIJRI SUB-DIVISION,50,0,5987,5987
KARACHI EAST DISTRICT,GULZAR-E-HIJRI SUB-DIVISION,51,0,4828,4828
KARACHI EAST DISTRICT,GULZAR-E-HIJRI SUB-DIVISION,52,0,4488,4488
KARACHI EAST DISTRICT,GULZAR-E-HIJRI SUB-DIVISION,53,0,4672,4672
KARACHI EAST DISTRICT,GULZAR-E-HIJRI SUB-DIVISION,54,0,4332,4332
KARACHI EAST DISTRICT,GULZAR-E-HIJRI SUB-DIVISION,55,0,4265,4265
KARACHI EAST DISTRICT,GULZAR-E-HIJRI SUB-DIVISION,56,0,3639,3639
KARACHI EAST DISTRICT,GULZAR-E-HIJRI SUB-DIVISION,57,0,3238,3238
KARACHI EAST DISTRICT,GULZAR-E-HIJRI SUB-DIVISION,58,0,3217,3217
KARACHI EAST DISTRICT,GULZAR-E-HIJRI SUB-DIVISION,59,0,3119,3119
KARACHI EAST DISTRICT,GULZAR-E-HIJRI SUB-DIVISION,60,0,3492,3492
KARACHI EAST DISTRICT,GULZAR-E-HIJRI SUB-DIVISION,61,0,3011,3011
KARACHI EAST DISTRICT,GULZAR-E-HIJRI SUB-DIVISION,62,0,2969,2969
KARACHI EAST DISTRICT,GULZAR-E-HIJRI SUB-DIVISION,63,0,2976,2976
KARACHI EAST DISTRICT,GULZAR-E-HIJRI SUB-DIVISION,64,0,2520,2520
KARACHI EAST DISTRICT,GULZAR-E-HIJRI SUB-DIVISION,65,0,2288,2288
KARACHI EAST DISTRICT,GULZAR-E-HIJRI SUB-DIVISION,66,0,1870,1870
KARACHI EAST DISTRICT,GULZAR-E-HIJRI SUB-DIVISION,67,0,1627,1627
KARACHI EAST DISTRICT,GULZAR-E-HIJRI SUB-DIVISION,68,0,1721,1721
KARACHI EAST DISTRICT,GULZAR-E-HIJRI SUB-DIVISION,69,0,1533,1533
KARACHI EAST DISTRICT,GULZAR-E-HIJRI SUB-DIVISION,70,0,1471,1471
KARACHI EAST DISTRICT,GULZAR-E-HIJRI SUB-DIVISION,71,0,1243,1243
KARACHI EAST DISTRICT,GULZAR-E-HIJRI SUB-DIVISION,72,0,1190,1190
KARACHI EAST DISTRICT,GULZAR-E-HIJRI SUB-DIVISION,73,0,1108,1108
KARACHI EAST DISTRICT,GULZAR-E-HIJRI SUB-DIVISION,74,0,944,944
KARACHI EAST DISTRICT,GULZAR-E-HIJRI SUB-DIVISION,>=75,0,6970,6970
KARACHI EAST DISTRICT,JAMSHED QUARTERS SUB-DIVISION,<1,0,8853,8853
KARACHI EAST DISTRICT,JAMSHED QUARTERS SUB-DIVISION,1,0,8984,8984
KARACHI EAST DISTRICT,JAMSHED QUARTERS SUB-DIVISION,2,0,9241,9241
KARACHI EAST DISTRICT,JAMSHED QUARTERS SUB-DIVISION,3,0,10057,10057
KARACHI EAST DISTRICT,JAMSHED QUARTERS SUB-DIVISION,4,0,9192,9192
KARACHI EAST DISTRICT,JAMSHED QUARTERS SUB-DIVISION,5,0,9699,9699
KARACHI EAST DISTRICT,JAMSHED QUARTERS SUB-DIVISION,6,0,9510,9510
KARACHI EAST DISTRICT,JAMSHED QUARTERS SUB-DIVISION,7,0,10441,10441
KARACHI EAST DISTRICT,JAMSHED QUARTERS SUB-DIVISION,8,0,9008,9008
KARACHI EAST DISTRICT,JAMSHED QUARTERS SUB-DIVISION,9,0,10614,10614
KARACHI EAST DISTRICT,JAMSHED QUARTERS SUB-DIVISION,10,0,8567,8567
KARACHI EAST DISTRICT,JAMSHED QUARTERS SUB-DIVISION,11,0,10743,10743
KARACHI EAST DISTRICT,JAMSHED QUARTERS SUB-DIVISION,12,0,8539,8539
KARACHI EAST DISTRICT,JAMSHED QUARTERS SUB-DIVISION,13,0,9647,9647
KARACHI EAST DISTRICT,JAMSHED QUARTERS SUB-DIVISION,14,0,8562,8562
KARACHI EAST DISTRICT,JAMSHED QUARTERS SUB-DIVISION,15,0,9125,9125
KARACHI EAST DISTRICT,JAMSHED QUARTERS SUB-DIVISION,16,0,9451,9451
KARACHI EAST DISTRICT,JAMSHED QUARTERS SUB-DIVISION,17,0,10161,10161
KARACHI EAST DISTRICT,JAMSHED QUARTERS SUB-DIVISION,18,0,8689,8689
KARACHI EAST DISTRICT,JAMSHED QUARTERS SUB-DIVISION,19,0,10183,10183
KARACHI EAST DISTRICT,JAMSHED QUARTERS SUB-DIVISION,20,0,8403,8403
KARACHI EAST DISTRICT,JAMSHED QUARTERS SUB-DIVISION,21,0,10530,10530
KARACHI EAST DISTRICT,JAMSHED QUARTERS SUB-DIVISION,22,0,9080,9080
KARACHI EAST DISTRICT,JAMSHED QUARTERS SUB-DIVISION,23,0,9532,9532
KARACHI EAST DISTRICT,JAMSHED QUARTERS SUB-DIVISION,24,0,9497,9497
KARACHI EAST DISTRICT,JAMSHED QUARTERS SUB-DIVISION,25,0,7566,7566
KARACHI EAST DISTRICT,JAMSHED QUARTERS SUB-DIVISION,26,0,9267,9267
KARACHI EAST DISTRICT,JAMSHED QUARTERS SUB-DIVISION,27,0,8794,8794
KARACHI EAST DISTRICT,JAMSHED QUARTERS SUB-DIVISION,28,0,8177,8177
KARACHI EAST DISTRICT,JAMSHED QUARTERS SUB-DIVISION,29,0,8576,8576
KARACHI EAST DISTRICT,JAMSHED QUARTERS SUB-DIVISION,30,0,7229,7229
KARACHI EAST DISTRICT,JAMSHED QUARTERS SUB-DIVISION,31,0,8360,8360
KARACHI EAST DISTRICT,JAMSHED QUARTERS SUB-DIVISION,32,0,7832,7832
KARACHI EAST DISTRICT,JAMSHED QUARTERS SUB-DIVISION,33,0,7676,7676
KARACHI EAST DISTRICT,JAMSHED QUARTERS SUB-DIVISION,34,0,7567,7567
KARACHI EAST DISTRICT,JAMSHED QUARTERS SUB-DIVISION,35,0,6078,6078
KARACHI EAST DISTRICT,JAMSHED QUARTERS SUB-DIVISION,36,0,6853,6853
KARACHI EAST DISTRICT,JAMSHED QUARTERS SUB-DIVISION,37,0,6272,6272
KARACHI EAST DISTRICT,JAMSHED QUARTERS SUB-DIVISION,38,0,7020,7020
KARACHI EAST DISTRICT,JAMSHED QUARTERS SUB-DIVISION,39,0,6554,6554
KARACHI EAST DISTRICT,JAMSHED QUARTERS SUB-DIVISION,40,0,5801,5801
KARACHI EAST DISTRICT,JAMSHED QUARTERS SUB-DIVISION,41,0,6011,6011
KARACHI EAST DISTRICT,JAMSHED QUARTERS SUB-DIVISION,42,0,5774,5774
KARACHI EAST DISTRICT,JAMSHED QUARTERS SUB-DIVISION,43,0,5984,5984
KARACHI EAST DISTRICT,JAMSHED QUARTERS SUB-DIVISION,44,0,5273,5273
KARACHI EAST DISTRICT,JAMSHED QUARTERS SUB-DIVISION,45,0,4173,4173
KARACHI EAST DISTRICT,JAMSHED QUARTERS SUB-DIVISION,46,0,4829,4829
KARACHI EAST DISTRICT,JAMSHED QUARTERS SUB-DIVISION,47,0,4334,4334
KARACHI EAST DISTRICT,JAMSHED QUARTERS SUB-DIVISION,48,0,4842,4842
KARACHI EAST DISTRICT,JAMSHED QUARTERS SUB-DIVISION,49,0,4809,4809
KARACHI EAST DISTRICT,JAMSHED QUARTERS SUB-DIVISION,50,0,4238,4238
KARACHI EAST DISTRICT,JAMSHED QUARTERS SUB-DIVISION,51,0,4656,4656
KARACHI EAST DISTRICT,JAMSHED QUARTERS SUB-DIVISION,52,0,4597,4597
KARACHI EAST DISTRICT,JAMSHED QUARTERS SUB-DIVISION,53,0,4543,4543
KARACHI EAST DISTRICT,JAMSHED QUARTERS SUB-DIVISION,54,0,4198,4198
KARACHI EAST DISTRICT,JAMSHED QUARTERS SUB-DIVISION,55,0,3322,3322
KARACHI EAST DISTRICT,JAMSHED QUARTERS SUB-DIVISION,56,0,3650,3650
KARACHI EAST DISTRICT,JAMSHED QUARTERS SUB-DIVISION,57,0,3344,3344
KARACHI EAST DISTRICT,JAMSHED QUARTERS SUB-DIVISION,58,0,3615,3615
KARACHI EAST DISTRICT,JAMSHED QUARTERS SUB-DIVISION,59,0,3390,3390
KARACHI EAST DISTRICT,JAMSHED QUARTERS SUB-DIVISION,60,0,2441,2441
KARACHI EAST DISTRICT,JAMSHED QUARTERS SUB-DIVISION,61,0,3173,3173
KARACHI EAST DISTRICT,JAMSHED QUARTERS SUB-DIVISION,62,0,3199,3199
KARACHI EAST DISTRICT,JAMSHED QUARTERS SUB-DIVISION,63,0,3114,3114
KARACHI EAST DISTRICT,JAMSHED QUARTERS SUB-DIVISION,64,0,2749,2749
KARACHI EAST DISTRICT,JAMSHED QUARTERS SUB-DIVISION,65,0,2038,2038
KARACHI EAST DISTRICT,JAMSHED QUARTERS SUB-DIVISION,66,0,1989,1989
KARACHI EAST DISTRICT,JAMSHED QUARTERS SUB-DIVISION,67,0,1852,1852
KARACHI EAST DISTRICT,JAMSHED QUARTERS SUB-DIVISION,68,0,2012,2012
KARACHI EAST DISTRICT,JAMSHED QUARTERS SUB-DIVISION,69,0,1756,1756
KARACHI EAST DISTRICT,JAMSHED QUARTERS SUB-DIVISION,70,0,1267,1267
KARACHI EAST DISTRICT,JAMSHED QUARTERS SUB-DIVISION,71,0,1430,1430
KARACHI EAST DISTRICT,JAMSHED QUARTERS SUB-DIVISION,72,0,1326,1326
KARACHI EAST DISTRICT,JAMSHED QUARTERS SUB-DIVISION,73,0,1386,1386
KARACHI EAST DISTRICT,JAMSHED QUARTERS SUB-DIVISION,74,0,1132,1132
KARACHI EAST DISTRICT,JAMSHED QUARTERS SUB-DIVISION,>=75,0,7057,7057
KARACHI SOUTH DISTRICT,ARAM BAGH SUB-DIVISION,<1,0,2222,2222
KARACHI SOUTH DISTRICT,ARAM BAGH SUB-DIVISION,1,0,2102,2102
KARACHI SOUTH DISTRICT,ARAM BAGH SUB-DIVISION,2,0,2358,2358
KARACHI SOUTH DISTRICT,ARAM BAGH SUB-DIVISION,3,0,2576,2576
KARACHI SOUTH DISTRICT,ARAM BAGH SUB-DIVISION,4,0,2386,2386
KARACHI SOUTH DISTRICT,ARAM BAGH SUB-DIVISION,5,0,2523,2523
KARACHI SOUTH DISTRICT,ARAM BAGH SUB-DIVISION,6,0,2375,2375
KARACHI SOUTH DISTRICT,ARAM BAGH SUB-DIVISION,7,0,2618,2618
KARACHI SOUTH DISTRICT,ARAM BAGH SUB-DIVISION,8,0,2223,2223
KARACHI SOUTH DISTRICT,ARAM BAGH SUB-DIVISION,9,0,2735,2735
KARACHI SOUTH DISTRICT,ARAM BAGH SUB-DIVISION,10,0,2227,2227
KARACHI SOUTH DISTRICT,ARAM BAGH SUB-DIVISION,11,0,2848,2848
KARACHI SOUTH DISTRICT,ARAM BAGH SUB-DIVISION,12,0,2313,2313
KARACHI SOUTH DISTRICT,ARAM BAGH SUB-DIVISION,13,0,2525,2525
KARACHI SOUTH DISTRICT,ARAM BAGH SUB-DIVISION,14,0,2305,2305
KARACHI SOUTH DISTRICT,ARAM BAGH SUB-DIVISION,15,0,2455,2455
KARACHI SOUTH DISTRICT,ARAM BAGH SUB-DIVISION,16,0,2478,2478
KARACHI SOUTH DISTRICT,ARAM BAGH SUB-DIVISION,17,0,2869,2869
KARACHI SOUTH DISTRICT,ARAM BAGH SUB-DIVISION,18,0,2308,2308
KARACHI SOUTH DISTRICT,ARAM BAGH SUB-DIVISION,19,0,2789,2789
KARACHI SOUTH DISTRICT,ARAM BAGH SUB-DIVISION,20,0,2215,2215
KARACHI SOUTH DISTRICT,ARAM BAGH SUB-DIVISION,21,0,2792,2792
KARACHI SOUTH DISTRICT,ARAM BAGH SUB-DIVISION,22,0,2496,2496
KARACHI SOUTH DISTRICT,ARAM BAGH SUB-DIVISION,23,0,2418,2418
KARACHI SOUTH DISTRICT,ARAM BAGH SUB-DIVISION,24,0,2423,2423
KARACHI SOUTH DISTRICT,ARAM BAGH SUB-DIVISION,25,0,2075,2075
KARACHI SOUTH DISTRICT,ARAM BAGH SUB-DIVISION,26,0,2374,2374
KARACHI SOUTH DISTRICT,ARAM BAGH SUB-DIVISION,27,0,2306,2306
KARACHI SOUTH DISTRICT,ARAM BAGH SUB-DIVISION,28,0,2152,2152
KARACHI SOUTH DISTRICT,ARAM BAGH SUB-DIVISION,29,0,2243,2243
KARACHI SOUTH DISTRICT,ARAM BAGH SUB-DIVISION,30,0,2061,2061
KARACHI SOUTH DISTRICT,ARAM BAGH SUB-DIVISION,31,0,2125,2125
KARACHI SOUTH DISTRICT,ARAM BAGH SUB-DIVISION,32,0,2092,2092
KARACHI SOUTH DISTRICT,ARAM BAGH SUB-DIVISION,33,0,2094,2094
KARACHI SOUTH DISTRICT,ARAM BAGH SUB-DIVISION,34,0,1872,1872
KARACHI SOUTH DISTRICT,ARAM BAGH SUB-DIVISION,35,0,1666,1666
KARACHI SOUTH DISTRICT,ARAM BAGH SUB-DIVISION,36,0,1805,1805
KARACHI SOUTH DISTRICT,ARAM BAGH SUB-DIVISION,37,0,1713,1713
KARACHI SOUTH DISTRICT,ARAM BAGH SUB-DIVISION,38,0,1947,1947
KARACHI SOUTH DISTRICT,ARAM BAGH SUB-DIVISION,39,0,1865,1865
KARACHI SOUTH DISTRICT,ARAM BAGH SUB-DIVISION,40,0,1819,1819
KARACHI SOUTH DISTRICT,ARAM BAGH SUB-DIVISION,41,0,1605,1605
KARACHI SOUTH DISTRICT,ARAM BAGH SUB-DIVISION,42,0,1613,1613
KARACHI SOUTH DISTRICT,ARAM BAGH SUB-DIVISION,43,0,1595,1595
KARACHI SOUTH DISTRICT,ARAM BAGH SUB-DIVISION,44,0,1507,1507
KARACHI SOUTH DISTRICT,ARAM BAGH SUB-DIVISION,45,0,1279,1279
KARACHI SOUTH DISTRICT,ARAM BAGH SUB-DIVISION,46,0,1384,1384
KARACHI SOUTH DISTRICT,ARAM BAGH SUB-DIVISION,47,0,1209,1209
KARACHI SOUTH DISTRICT,ARAM BAGH SUB-DIVISION,48,0,1407,1407
KARACHI SOUTH DISTRICT,ARAM BAGH SUB-DIVISION,49,0,1378,1378
KARACHI SOUTH DISTRICT,ARAM BAGH SUB-DIVISION,50,0,1374,1374
KARACHI SOUTH DISTRICT,ARAM BAGH SUB-DIVISION,51,0,1287,1287
KARACHI SOUTH DISTRICT,ARAM BAGH SUB-DIVISION,52,0,1341,1341
KARACHI SOUTH DISTRICT,ARAM BAGH SUB-DIVISION,53,0,1306,1306
KARACHI SOUTH DISTRICT,ARAM BAGH SUB-DIVISION,54,0,1166,1166
KARACHI SOUTH DISTRICT,ARAM BAGH SUB-DIVISION,55,0,1069,1069
KARACHI SOUTH DISTRICT,ARAM BAGH SUB-DIVISION,56,0,956,956
KARACHI SOUTH DISTRICT,ARAM BAGH SUB-DIVISION,57,0,946,946
KARACHI SOUTH DISTRICT,ARAM BAGH SUB-DIVISION,58,0,976,976
KARACHI SOUTH DISTRICT,ARAM BAGH SUB-DIVISION,59,0,953,953
KARACHI SOUTH DISTRICT,ARAM BAGH SUB-DIVISION,60,0,817,817
KARACHI SOUTH DISTRICT,ARAM BAGH SUB-DIVISION,61,0,867,867
KARACHI SOUTH DISTRICT,ARAM BAGH SUB-DIVISION,62,0,924,924
KARACHI SOUTH DISTRICT,ARAM BAGH SUB-DIVISION,63,0,900,900
KARACHI SOUTH DISTRICT,ARAM BAGH SUB-DIVISION,64,0,734,734
KARACHI SOUTH DISTRICT,ARAM BAGH SUB-DIVISION,65,0,564,564
KARACHI SOUTH DISTRICT,ARAM BAGH SUB-DIVISION,66,0,502,502
KARACHI SOUTH DISTRICT,ARAM BAGH SUB-DIVISION,67,0,453,453
KARACHI SOUTH DISTRICT,ARAM BAGH SUB-DIVISION,68,0,509,509
KARACHI SOUTH DISTRICT,ARAM BAGH SUB-DIVISION,69,0,474,474
KARACHI SOUTH DISTRICT,ARAM BAGH SUB-DIVISION,70,0,370,370
KARACHI SOUTH DISTRICT,ARAM BAGH SUB-DIVISION,71,0,369,369
KARACHI SOUTH DISTRICT,ARAM BAGH SUB-DIVISION,72,0,329,329
KARACHI SOUTH DISTRICT,ARAM BAGH SUB-DIVISION,73,0,333,333
KARACHI SOUTH DISTRICT,ARAM BAGH SUB-DIVISION,74,0,270,270
KARACHI SOUTH DISTRICT,ARAM BAGH SUB-DIVISION,>=75,0,1759,1759
KARACHI SOUTH DISTRICT,CIVIL LINES SUB-DIVISION,<1,0,8028,8028
KARACHI SOUTH DISTRICT,CIVIL LINES SUB-DIVISION,1,0,8286,8286
KARACHI SOUTH DISTRICT,CIVIL LINES SUB-DIVISION,2,0,8893,8893
KARACHI SOUTH DISTRICT,CIVIL LINES SUB-DIVISION,3,0,9516,9516
KARACHI SOUTH DISTRICT,CIVIL LINES SUB-DIVISION,4,0,8698,8698
KARACHI SOUTH DISTRICT,CIVIL LINES SUB-DIVISION,5,0,9148,9148
KARACHI SOUTH DISTRICT,CIVIL LINES SUB-DIVISION,6,0,8787,8787
KARACHI SOUTH DISTRICT,CIVIL LINES SUB-DIVISION,7,0,9546,9546
KARACHI SOUTH DISTRICT,CIVIL LINES SUB-DIVISION,8,0,8486,8486
KARACHI SOUTH DISTRICT,CIVIL LINES SUB-DIVISION,9,0,9777,9777
KARACHI SOUTH DISTRICT,CIVIL LINES SUB-DIVISION,10,0,8169,8169
KARACHI SOUTH DISTRICT,CIVIL LINES SUB-DIVISION,11,0,9900,9900
KARACHI SOUTH DISTRICT,CIVIL LINES SUB-DIVISION,12,0,8324,8324
KARACHI SOUTH DISTRICT,CIVIL LINES SUB-DIVISION,13,0,8743,8743
KARACHI SOUTH DISTRICT,CIVIL LINES SUB-DIVISION,14,0,8041,8041
KARACHI SOUTH DISTRICT,CIVIL LINES SUB-DIVISION,15,0,8625,8625
KARACHI SOUTH DISTRICT,CIVIL LINES SUB-DIVISION,16,0,8626,8626
KARACHI SOUTH DISTRICT,CIVIL LINES SUB-DIVISION,17,0,9964,9964
KARACHI SOUTH DISTRICT,CIVIL LINES SUB-DIVISION,18,0,8678,8678
KARACHI SOUTH DISTRICT,CIVIL LINES SUB-DIVISION,19,0,10098,10098
KARACHI SOUTH DISTRICT,CIVIL LINES SUB-DIVISION,20,0,8656,8656
KARACHI SOUTH DISTRICT,CIVIL LINES SUB-DIVISION,21,0,10311,10311
KARACHI SOUTH DISTRICT,CIVIL LINES SUB-DIVISION,22,0,9345,9345
KARACHI SOUTH DISTRICT,CIVIL LINES SUB-DIVISION,23,0,9509,9509
KARACHI SOUTH DISTRICT,CIVIL LINES SUB-DIVISION,24,0,9381,9381
KARACHI SOUTH DISTRICT,CIVIL LINES SUB-DIVISION,25,0,8268,8268
KARACHI SOUTH DISTRICT,CIVIL LINES SUB-DIVISION,26,0,9090,9090
KARACHI SOUTH DISTRICT,CIVIL LINES SUB-DIVISION,27,0,9016,9016
KARACHI SOUTH DISTRICT,CIVIL LINES SUB-DIVISION,28,0,8508,8508
KARACHI SOUTH DISTRICT,CIVIL LINES SUB-DIVISION,29,0,8551,8551
KARACHI SOUTH DISTRICT,CIVIL LINES SUB-DIVISION,30,0,8035,8035
KARACHI SOUTH DISTRICT,CIVIL LINES SUB-DIVISION,31,0,8223,8223
KARACHI SOUTH DISTRICT,CIVIL LINES SUB-DIVISION,32,0,8410,8410
KARACHI SOUTH DISTRICT,CIVIL LINES SUB-DIVISION,33,0,7810,7810
KARACHI SOUTH DISTRICT,CIVIL LINES SUB-DIVISION,34,0,7303,7303
KARACHI SOUTH DISTRICT,CIVIL LINES SUB-DIVISION,35,0,6710,6710
KARACHI SOUTH DISTRICT,CIVIL LINES SUB-DIVISION,36,0,6869,6869
KARACHI SOUTH DISTRICT,CIVIL LINES SUB-DIVISION,37,0,6318,6318
KARACHI SOUTH DISTRICT,CIVIL LINES SUB-DIVISION,38,0,7133,7133
KARACHI SOUTH DISTRICT,CIVIL LINES SUB-DIVISION,39,0,6651,6651
KARACHI SOUTH DISTRICT,CIVIL LINES SUB-DIVISION,40,0,6414,6414
KARACHI SOUTH DISTRICT,CIVIL LINES SUB-DIVISION,41,0,5864,5864
KARACHI SOUTH DISTRICT,CIVIL LINES SUB-DIVISION,42,0,5764,5764
KARACHI SOUTH DISTRICT,CIVIL LINES SUB-DIVISION,43,0,5826,5826
KARACHI SOUTH DISTRICT,CIVIL LINES SUB-DIVISION,44,0,5135,5135
KARACHI SOUTH DISTRICT,CIVIL LINES SUB-DIVISION,45,0,4699,4699
KARACHI SOUTH DISTRICT,CIVIL LINES SUB-DIVISION,46,0,4523,4523
KARACHI SOUTH DISTRICT,CIVIL LINES SUB-DIVISION,47,0,4319,4319
KARACHI SOUTH DISTRICT,CIVIL LINES SUB-DIVISION,48,0,4833,4833
KARACHI SOUTH DISTRICT,CIVIL LINES SUB-DIVISION,49,0,4590,4590
KARACHI SOUTH DISTRICT,CIVIL LINES SUB-DIVISION,50,0,4600,4600
KARACHI SOUTH DISTRICT,CIVIL LINES SUB-DIVISION,51,0,4192,4192
KARACHI SOUTH DISTRICT,CIVIL LINES SUB-DIVISION,52,0,4572,4572
KARACHI SOUTH DISTRICT,CIVIL LINES SUB-DIVISION,53,0,4381,4381
KARACHI SOUTH DISTRICT,CIVIL LINES SUB-DIVISION,54,0,3945,3945
KARACHI SOUTH DISTRICT,CIVIL LINES SUB-DIVISION,55,0,3457,3457
KARACHI SOUTH DISTRICT,CIVIL LINES SUB-DIVISION,56,0,3409,3409
KARACHI SOUTH DISTRICT,CIVIL LINES SUB-DIVISION,57,0,2982,2982
KARACHI SOUTH DISTRICT,CIVIL LINES SUB-DIVISION,58,0,3575,3575
KARACHI SOUTH DISTRICT,CIVIL LINES SUB-DIVISION,59,0,3079,3079
KARACHI SOUTH DISTRICT,CIVIL LINES SUB-DIVISION,60,0,2869,2869
KARACHI SOUTH DISTRICT,CIVIL LINES SUB-DIVISION,61,0,2889,2889
KARACHI SOUTH DISTRICT,CIVIL LINES SUB-DIVISION,62,0,3134,3134
KARACHI SOUTH DISTRICT,CIVIL LINES SUB-DIVISION,63,0,3042,3042
KARACHI SOUTH DISTRICT,CIVIL LINES SUB-DIVISION,64,0,2656,2656
KARACHI SOUTH DISTRICT,CIVIL LINES SUB-DIVISION,65,0,2298,2298
KARACHI SOUTH DISTRICT,CIVIL LINES SUB-DIVISION,66,0,2002,2002
KARACHI SOUTH DISTRICT,CIVIL LINES SUB-DIVISION,67,0,1760,1760
KARACHI SOUTH DISTRICT,CIVIL LINES SUB-DIVISION,68,0,1975,1975
KARACHI SOUTH DISTRICT,CIVIL LINES SUB-DIVISION,69,0,1860,1860
KARACHI SOUTH DISTRICT,CIVIL LINES SUB-DIVISION,70,0,1484,1484
KARACHI SOUTH DISTRICT,CIVIL LINES SUB-DIVISION,71,0,1464,1464
KARACHI SOUTH DISTRICT,CIVIL LINES SUB-DIVISION,72,0,1517,1517
KARACHI SOUTH DISTRICT,CIVIL LINES SUB-DIVISION,73,0,1433,1433
KARACHI SOUTH DISTRICT,CIVIL LINES SUB-DIVISION,74,0,1215,1215
KARACHI SOUTH DISTRICT,CIVIL LINES SUB-DIVISION,>=75,0,8932,8932
KARACHI SOUTH DISTRICT,GARDEN SUB-DIVISION,<1,0,6681,6681
KARACHI SOUTH DISTRICT,GARDEN SUB-DIVISION,1,0,6300,6300
KARACHI SOUTH DISTRICT,GARDEN SUB-DIVISION,2,0,7097,7097
KARACHI SOUTH DISTRICT,GARDEN SUB-DIVISION,3,0,7531,7531
KARACHI SOUTH DISTRICT,GARDEN SUB-DIVISION,4,0,6920,6920
KARACHI SOUTH DISTRICT,GARDEN SUB-DIVISION,5,0,7132,7132
KARACHI SOUTH DISTRICT,GARDEN SUB-DIVISION,6,0,7080,7080
KARACHI SOUTH DISTRICT,GARDEN SUB-DIVISION,7,0,7599,7599
KARACHI SOUTH DISTRICT,GARDEN SUB-DIVISION,8,0,6470,6470
KARACHI SOUTH DISTRICT,GARDEN SUB-DIVISION,9,0,7880,7880
KARACHI SOUTH DISTRICT,GARDEN SUB-DIVISION,10,0,6268,6268
KARACHI SOUTH DISTRICT,GARDEN SUB-DIVISION,11,0,7980,7980
KARACHI SOUTH DISTRICT,GARDEN SUB-DIVISION,12,0,6314,6314
KARACHI SOUTH DISTRICT,GARDEN SUB-DIVISION,13,0,7058,7058
KARACHI SOUTH DISTRICT,GARDEN SUB-DIVISION,14,0,6491,6491
KARACHI SOUTH DISTRICT,GARDEN SUB-DIVISION,15,0,6841,6841
KARACHI SOUTH DISTRICT,GARDEN SUB-DIVISION,16,0,7170,7170
KARACHI SOUTH DISTRICT,GARDEN SUB-DIVISION,17,0,7787,7787
KARACHI SOUTH DISTRICT,GARDEN SUB-DIVISION,18,0,6655,6655
KARACHI SOUTH DISTRICT,GARDEN SUB-DIVISION,19,0,7518,7518
KARACHI SOUTH DISTRICT,GARDEN SUB-DIVISION,20,0,6335,6335
KARACHI SOUTH DISTRICT,GARDEN SUB-DIVISION,21,0,7829,7829
KARACHI SOUTH DISTRICT,GARDEN SUB-DIVISION,22,0,6740,6740
KARACHI SOUTH DISTRICT,GARDEN SUB-DIVISION,23,0,7003,7003
KARACHI SOUTH DISTRICT,GARDEN SUB-DIVISION,24,0,7115,7115
KARACHI SOUTH DISTRICT,GARDEN SUB-DIVISION,25,0,5783,5783
KARACHI SOUTH DISTRICT,GARDEN SUB-DIVISION,26,0,6812,6812
KARACHI SOUTH DISTRICT,GARDEN SUB-DIVISION,27,0,6619,6619
KARACHI SOUTH DISTRICT,GARDEN SUB-DIVISION,28,0,6414,6414
KARACHI SOUTH DISTRICT,GARDEN SUB-DIVISION,29,0,6613,6613
KARACHI SOUTH DISTRICT,GARDEN SUB-DIVISION,30,0,5888,5888
KARACHI SOUTH DISTRICT,GARDEN SUB-DIVISION,31,0,6377,6377
KARACHI SOUTH DISTRICT,GARDEN SUB-DIVISION,32,0,6169,6169
KARACHI SOUTH DISTRICT,GARDEN SUB-DIVISION,33,0,6002,6002
KARACHI SOUTH DISTRICT,GARDEN SUB-DIVISION,34,0,5782,5782
KARACHI SOUTH DISTRICT,GARDEN SUB-DIVISION,35,0,4890,4890
KARACHI SOUTH DISTRICT,GARDEN SUB-DIVISION,36,0,5494,5494
KARACHI SOUTH DISTRICT,GARDEN SUB-DIVISION,37,0,5029,5029
KARACHI SOUTH DISTRICT,GARDEN SUB-DIVISION,38,0,5623,5623
KARACHI SOUTH DISTRICT,GARDEN SUB-DIVISION,39,0,5179,5179
KARACHI SOUTH DISTRICT,GARDEN SUB-DIVISION,40,0,4849,4849
KARACHI SOUTH DISTRICT,GARDEN SUB-DIVISION,41,0,4714,4714
KARACHI SOUTH DISTRICT,GARDEN SUB-DIVISION,42,0,4303,4303
KARACHI SOUTH DISTRICT,GARDEN SUB-DIVISION,43,0,4569,4569
KARACHI SOUTH DISTRICT,GARDEN SUB-DIVISION,44,0,4229,4229
KARACHI SOUTH DISTRICT,GARDEN SUB-DIVISION,45,0,3551,3551
KARACHI SOUTH DISTRICT,GARDEN SUB-DIVISION,46,0,3886,3886
KARACHI SOUTH DISTRICT,GARDEN SUB-DIVISION,47,0,3480,3480
KARACHI SOUTH DISTRICT,GARDEN SUB-DIVISION,48,0,4004,4004
KARACHI SOUTH DISTRICT,GARDEN SUB-DIVISION,49,0,3953,3953
KARACHI SOUTH DISTRICT,GARDEN SUB-DIVISION,50,0,3479,3479
KARACHI SOUTH DISTRICT,GARDEN SUB-DIVISION,51,0,3992,3992
KARACHI SOUTH DISTRICT,GARDEN SUB-DIVISION,52,0,3636,3636
KARACHI SOUTH DISTRICT,GARDEN SUB-DIVISION,53,0,3662,3662
KARACHI SOUTH DISTRICT,GARDEN SUB-DIVISION,54,0,3423,3423
KARACHI SOUTH DISTRICT,GARDEN SUB-DIVISION,55,0,2744,2744
KARACHI SOUTH DISTRICT,GARDEN SUB-DIVISION,56,0,2765,2765
KARACHI SOUTH DISTRICT,GARDEN SUB-DIVISION,57,0,2536,2536
KARACHI SOUTH DISTRICT,GARDEN SUB-DIVISION,58,0,2517,2517
KARACHI SOUTH DISTRICT,GARDEN SUB-DIVISION,59,0,2474,2474
KARACHI SOUTH DISTRICT,GARDEN SUB-DIVISION,60,0,1850,1850
KARACHI SOUTH DISTRICT,GARDEN SUB-DIVISION,61,0,2618,2618
KARACHI SOUTH DISTRICT,GARDEN SUB-DIVISION,62,0,2444,2444
KARACHI SOUTH DISTRICT,GARDEN SUB-DIVISION,63,0,2419,2419
KARACHI SOUTH DISTRICT,GARDEN SUB-DIVISION,64,0,2058,2058
KARACHI SOUTH DISTRICT,GARDEN SUB-DIVISION,65,0,1519,1519
KARACHI SOUTH DISTRICT,GARDEN SUB-DIVISION,66,0,1394,1394
KARACHI SOUTH DISTRICT,GARDEN SUB-DIVISION,67,0,1213,1213
KARACHI SOUTH DISTRICT,GARDEN SUB-DIVISION,68,0,1381,1381
KARACHI SOUTH DISTRICT,GARDEN SUB-DIVISION,69,0,1314,1314
KARACHI SOUTH DISTRICT,GARDEN SUB-DIVISION,70,0,840,840
KARACHI SOUTH DISTRICT,GARDEN SUB-DIVISION,71,0,926,926
KARACHI SOUTH DISTRICT,GARDEN SUB-DIVISION,72,0,844,844
KARACHI SOUTH DISTRICT,GARDEN SUB-DIVISION,73,0,886,886
KARACHI SOUTH DISTRICT,GARDEN SUB-DIVISION,74,0,720,720
KARACHI SOUTH DISTRICT,GARDEN SUB-DIVISION,>=75,0,4307,4307
KARACHI SOUTH DISTRICT,LYARI SUB-DIVISION,<1,0,14275,14275
KARACHI SOUTH DISTRICT,LYARI SUB-DIVISION,1,0,13153,13153
KARACHI SOUTH DISTRICT,LYARI SUB-DIVISION,2,0,14599,14599
KARACHI SOUTH DISTRICT,LYARI SUB-DIVISION,3,0,15542,15542
KARACHI SOUTH DISTRICT,LYARI SUB-DIVISION,4,0,14474,14474
KARACHI SOUTH DISTRICT,LYARI SUB-DIVISION,5,0,15146,15146
KARACHI SOUTH DISTRICT,LYARI SUB-DIVISION,6,0,14691,14691
KARACHI SOUTH DISTRICT,LYARI SUB-DIVISION,7,0,15975,15975
KARACHI SOUTH DISTRICT,LYARI SUB-DIVISION,8,0,13783,13783
KARACHI SOUTH DISTRICT,LYARI SUB-DIVISION,9,0,15863,15863
KARACHI SOUTH DISTRICT,LYARI SUB-DIVISION,10,0,12680,12680
KARACHI SOUTH DISTRICT,LYARI SUB-DIVISION,11,0,15337,15337
KARACHI SOUTH DISTRICT,LYARI SUB-DIVISION,12,0,12800,12800
KARACHI SOUTH DISTRICT,LYARI SUB-DIVISION,13,0,13773,13773
KARACHI SOUTH DISTRICT,LYARI SUB-DIVISION,14,0,12255,12255
KARACHI SOUTH DISTRICT,LYARI SUB-DIVISION,15,0,13092,13092
KARACHI SOUTH DISTRICT,LYARI SUB-DIVISION,16,0,13138,13138
KARACHI SOUTH DISTRICT,LYARI SUB-DIVISION,17,0,14754,14754
KARACHI SOUTH DISTRICT,LYARI SUB-DIVISION,18,0,12315,12315
KARACHI SOUTH DISTRICT,LYARI SUB-DIVISION,19,0,13899,13899
KARACHI SOUTH DISTRICT,LYARI SUB-DIVISION,20,0,11603,11603
KARACHI SOUTH DISTRICT,LYARI SUB-DIVISION,21,0,13735,13735
KARACHI SOUTH DISTRICT,LYARI SUB-DIVISION,22,0,12455,12455
KARACHI SOUTH DISTRICT,LYARI SUB-DIVISION,23,0,12345,12345
KARACHI SOUTH DISTRICT,LYARI SUB-DIVISION,24,0,11997,11997
KARACHI SOUTH DISTRICT,LYARI SUB-DIVISION,25,0,10884,10884
KARACHI SOUTH DISTRICT,LYARI SUB-DIVISION,26,0,12035,12035
KARACHI SOUTH DISTRICT,LYARI SUB-DIVISION,27,0,11949,11949
KARACHI SOUTH DISTRICT,LYARI SUB-DIVISION,28,0,11632,11632
KARACHI SOUTH DISTRICT,LYARI SUB-DIVISION,29,0,11733,11733
KARACHI SOUTH DISTRICT,LYARI SUB-DIVISION,30,0,11125,11125
KARACHI SOUTH DISTRICT,LYARI SUB-DIVISION,31,0,11739,11739
KARACHI SOUTH DISTRICT,LYARI SUB-DIVISION,32,0,10801,10801
KARACHI SOUTH DISTRICT,LYARI SUB-DIVISION,33,0,11135,11135
KARACHI SOUTH DISTRICT,LYARI SUB-DIVISION,34,0,10622,10622
KARACHI SOUTH DISTRICT,LYARI SUB-DIVISION,35,0,9667,9667
KARACHI SOUTH DISTRICT,LYARI SUB-DIVISION,36,0,9661,9661
KARACHI SOUTH DISTRICT,LYARI SUB-DIVISION,37,0,9150,9150
KARACHI SOUTH DISTRICT,LYARI SUB-DIVISION,38,0,9563,9563
KARACHI SOUTH DISTRICT,LYARI SUB-DIVISION,39,0,9248,9248
KARACHI SOUTH DISTRICT,LYARI SUB-DIVISION,40,0,8559,8559
KARACHI SOUTH DISTRICT,LYARI SUB-DIVISION,41,0,8302,8302
KARACHI SOUTH DISTRICT,LYARI SUB-DIVISION,42,0,7213,7213
KARACHI SOUTH DISTRICT,LYARI SUB-DIVISION,43,0,7512,7512
KARACHI SOUTH DISTRICT,LYARI SUB-DIVISION,44,0,6672,6672
KARACHI SOUTH DISTRICT,LYARI SUB-DIVISION,45,0,5853,5853
KARACHI SOUTH DISTRICT,LYARI SUB-DIVISION,46,0,6415,6415
KARACHI SOUTH DISTRICT,LYARI SUB-DIVISION,47,0,5790,5790
KARACHI SOUTH DISTRICT,LYARI SUB-DIVISION,48,0,6231,6231
KARACHI SOUTH DISTRICT,LYARI SUB-DIVISION,49,0,6234,6234
KARACHI SOUTH DISTRICT,LYARI SUB-DIVISION,50,0,5587,5587
KARACHI SOUTH DISTRICT,LYARI SUB-DIVISION,51,0,5846,5846
KARACHI SOUTH DISTRICT,LYARI SUB-DIVISION,52,0,5444,5444
KARACHI SOUTH DISTRICT,LYARI SUB-DIVISION,53,0,5427,5427
KARACHI SOUTH DISTRICT,LYARI SUB-DIVISION,54,0,4922,4922
KARACHI SOUTH DISTRICT,LYARI SUB-DIVISION,55,0,4181,4181
KARACHI SOUTH DISTRICT,LYARI SUB-DIVISION,56,0,3872,3872
KARACHI SOUTH DISTRICT,LYARI SUB-DIVISION,57,0,3548,3548
KARACHI SOUTH DISTRICT,LYARI SUB-DIVISION,58,0,3703,3703
KARACHI SOUTH DISTRICT,LYARI SUB-DIVISION,59,0,3776,3776
KARACHI SOUTH DISTRICT,LYARI SUB-DIVISION,60,0,3188,3188
KARACHI SOUTH DISTRICT,LYARI SUB-DIVISION,61,0,3921,3921
KARACHI SOUTH DISTRICT,LYARI SUB-DIVISION,62,0,3992,3992
KARACHI SOUTH DISTRICT,LYARI SUB-DIVISION,63,0,3898,3898
KARACHI SOUTH DISTRICT,LYARI SUB-DIVISION,64,0,3079,3079
KARACHI SOUTH DISTRICT,LYARI SUB-DIVISION,65,0,2395,2395
KARACHI SOUTH DISTRICT,LYARI SUB-DIVISION,66,0,2277,2277
KARACHI SOUTH DISTRICT,LYARI SUB-DIVISION,67,0,1901,1901
KARACHI SOUTH DISTRICT,LYARI SUB-DIVISION,68,0,2395,2395
KARACHI SOUTH DISTRICT,LYARI SUB-DIVISION,69,0,2074,2074
KARACHI SOUTH DISTRICT,LYARI SUB-DIVISION,70,0,1373,1373
KARACHI SOUTH DISTRICT,LYARI SUB-DIVISION,71,0,1441,1441
KARACHI SOUTH DISTRICT,LYARI SUB-DIVISION,72,0,1211,1211
KARACHI SOUTH DISTRICT,LYARI SUB-DIVISION,73,0,1419,1419
KARACHI SOUTH DISTRICT,LYARI SUB-DIVISION,74,0,1080,1080
KARACHI SOUTH DISTRICT,LYARI SUB-DIVISION,>=75,0,6572,6572
KARACHI SOUTH DISTRICT,SADDAR SUB-DIVISION,<1,0,2258,2258
KARACHI SOUTH DISTRICT,SADDAR SUB-DIVISION,1,0,2705,2705
KARACHI SOUTH DISTRICT,SADDAR SUB-DIVISION,2,0,2645,2645
KARACHI SOUTH DISTRICT,SADDAR SUB-DIVISION,3,0,2947,2947
KARACHI SOUTH DISTRICT,SADDAR SUB-DIVISION,4,0,2680,2680
KARACHI SOUTH DISTRICT,SADDAR SUB-DIVISION,5,0,2810,2810
KARACHI SOUTH DISTRICT,SADDAR SUB-DIVISION,6,0,2665,2665
KARACHI SOUTH DISTRICT,SADDAR SUB-DIVISION,7,0,2934,2934
KARACHI SOUTH DISTRICT,SADDAR SUB-DIVISION,8,0,2562,2562
KARACHI SOUTH DISTRICT,SADDAR SUB-DIVISION,9,0,2992,2992
KARACHI SOUTH DISTRICT,SADDAR SUB-DIVISION,10,0,2414,2414
KARACHI SOUTH DISTRICT,SADDAR SUB-DIVISION,11,0,2972,2972
KARACHI SOUTH DISTRICT,SADDAR SUB-DIVISION,12,0,2492,2492
KARACHI SOUTH DISTRICT,SADDAR SUB-DIVISION,13,0,2838,2838
KARACHI SOUTH DISTRICT,SADDAR SUB-DIVISION,14,0,2355,2355
KARACHI SOUTH DISTRICT,SADDAR SUB-DIVISION,15,0,2560,2560
KARACHI SOUTH DISTRICT,SADDAR SUB-DIVISION,16,0,2624,2624
KARACHI SOUTH DISTRICT,SADDAR SUB-DIVISION,17,0,3021,3021
KARACHI SOUTH DISTRICT,SADDAR SUB-DIVISION,18,0,2491,2491
KARACHI SOUTH DISTRICT,SADDAR SUB-DIVISION,19,0,2921,2921
KARACHI SOUTH DISTRICT,SADDAR SUB-DIVISION,20,0,2472,2472
KARACHI SOUTH DISTRICT,SADDAR SUB-DIVISION,21,0,3036,3036
KARACHI SOUTH DISTRICT,SADDAR SUB-DIVISION,22,0,2686,2686
KARACHI SOUTH DISTRICT,SADDAR SUB-DIVISION,23,0,2702,2702
KARACHI SOUTH DISTRICT,SADDAR SUB-DIVISION,24,0,2872,2872
KARACHI SOUTH DISTRICT,SADDAR SUB-DIVISION,25,0,2306,2306
KARACHI SOUTH DISTRICT,SADDAR SUB-DIVISION,26,0,2715,2715
KARACHI SOUTH DISTRICT,SADDAR SUB-DIVISION,27,0,2720,2720
KARACHI SOUTH DISTRICT,SADDAR SUB-DIVISION,28,0,2525,2525
KARACHI SOUTH DISTRICT,SADDAR SUB-DIVISION,29,0,2537,2537
KARACHI SOUTH DISTRICT,SADDAR SUB-DIVISION,30,0,2388,2388
KARACHI SOUTH DISTRICT,SADDAR SUB-DIVISION,31,0,2530,2530
KARACHI SOUTH DISTRICT,SADDAR SUB-DIVISION,32,0,2597,2597
KARACHI SOUTH DISTRICT,SADDAR SUB-DIVISION,33,0,2419,2419
KARACHI SOUTH DISTRICT,SADDAR SUB-DIVISION,34,0,2285,2285
KARACHI SOUTH DISTRICT,SADDAR SUB-DIVISION,35,0,1951,1951
KARACHI SOUTH DISTRICT,SADDAR SUB-DIVISION,36,0,2080,2080
KARACHI SOUTH DISTRICT,SADDAR SUB-DIVISION,37,0,1940,1940
KARACHI SOUTH DISTRICT,SADDAR SUB-DIVISION,38,0,2245,2245
KARACHI SOUTH DISTRICT,SADDAR SUB-DIVISION,39,0,1886,1886
KARACHI SOUTH DISTRICT,SADDAR SUB-DIVISION,40,0,2030,2030
KARACHI SOUTH DISTRICT,SADDAR SUB-DIVISION,41,0,1778,1778
KARACHI SOUTH DISTRICT,SADDAR SUB-DIVISION,42,0,1827,1827
KARACHI SOUTH DISTRICT,SADDAR SUB-DIVISION,43,0,1702,1702
KARACHI SOUTH DISTRICT,SADDAR SUB-DIVISION,44,0,1631,1631
KARACHI SOUTH DISTRICT,SADDAR SUB-DIVISION,45,0,1378,1378
KARACHI SOUTH DISTRICT,SADDAR SUB-DIVISION,46,0,1486,1486
KARACHI SOUTH DISTRICT,SADDAR SUB-DIVISION,47,0,1260,1260
KARACHI SOUTH DISTRICT,SADDAR SUB-DIVISION,48,0,1520,1520
KARACHI SOUTH DISTRICT,SADDAR SUB-DIVISION,49,0,1334,1334
KARACHI SOUTH DISTRICT,SADDAR SUB-DIVISION,50,0,1404,1404
KARACHI SOUTH DISTRICT,SADDAR SUB-DIVISION,51,0,1292,1292
KARACHI SOUTH DISTRICT,SADDAR SUB-DIVISION,52,0,1360,1360
KARACHI SOUTH DISTRICT,SADDAR SUB-DIVISION,53,0,1298,1298
KARACHI SOUTH DISTRICT,SADDAR SUB-DIVISION,54,0,1308,1308
KARACHI SOUTH DISTRICT,SADDAR SUB-DIVISION,55,0,1058,1058
KARACHI SOUTH DISTRICT,SADDAR SUB-DIVISION,56,0,1018,1018
KARACHI SOUTH DISTRICT,SADDAR SUB-DIVISION,57,0,897,897
KARACHI SOUTH DISTRICT,SADDAR SUB-DIVISION,58,0,1073,1073
KARACHI SOUTH DISTRICT,SADDAR SUB-DIVISION,59,0,874,874
KARACHI SOUTH DISTRICT,SADDAR SUB-DIVISION,60,0,845,845
KARACHI SOUTH DISTRICT,SADDAR SUB-DIVISION,61,0,791,791
KARACHI SOUTH DISTRICT,SADDAR SUB-DIVISION,62,0,864,864
KARACHI SOUTH DISTRICT,SADDAR SUB-DIVISION,63,0,902,902
KARACHI SOUTH DISTRICT,SADDAR SUB-DIVISION,64,0,748,748
KARACHI SOUTH DISTRICT,SADDAR SUB-DIVISION,65,0,633,633
KARACHI SOUTH DISTRICT,SADDAR SUB-DIVISION,66,0,568,568
KARACHI SOUTH DISTRICT,SADDAR SUB-DIVISION,67,0,496,496
KARACHI SOUTH DISTRICT,SADDAR SUB-DIVISION,68,0,601,601
KARACHI SOUTH DISTRICT,SADDAR SUB-DIVISION,69,0,496,496
KARACHI SOUTH DISTRICT,SADDAR SUB-DIVISION,70,0,406,406
KARACHI SOUTH DISTRICT,SADDAR SUB-DIVISION,71,0,412,412
KARACHI SOUTH DISTRICT,SADDAR SUB-DIVISION,72,0,424,424
KARACHI SOUTH DISTRICT,SADDAR SUB-DIVISION,73,0,418,418
KARACHI SOUTH DISTRICT,SADDAR SUB-DIVISION,74,0,335,335
KARACHI SOUTH DISTRICT,SADDAR SUB-DIVISION,>=75,0,2660,2660
KARACHI WEST DISTRICT,BALDIA SUB-DIVISION,<1,0,21766,21766
KARACHI WEST DISTRICT,BALDIA SUB-DIVISION,1,0,20781,20781
KARACHI WEST DISTRICT,BALDIA SUB-DIVISION,2,0,22055,22055
KARACHI WEST DISTRICT,BALDIA SUB-DIVISION,3,0,23665,23665
KARACHI WEST DISTRICT,BALDIA SUB-DIVISION,4,0,21836,21836
KARACHI WEST DISTRICT,BALDIA SUB-DIVISION,5,0,22573,22573
KARACHI WEST DISTRICT,BALDIA SUB-DIVISION,6,0,21447,21447
KARACHI WEST DISTRICT,BALDIA SUB-DIVISION,7,0,23513,23513
KARACHI WEST DISTRICT,BALDIA SUB-DIVISION,8,0,20400,20400
KARACHI WEST DISTRICT,BALDIA SUB-DIVISION,9,0,22994,22994
KARACHI WEST DISTRICT,BALDIA SUB-DIVISION,10,0,19002,19002
KARACHI WEST DISTRICT,BALDIA SUB-DIVISION,11,0,21739,21739
KARACHI WEST DISTRICT,BALDIA SUB-DIVISION,12,0,18374,18374
KARACHI WEST DISTRICT,BALDIA SUB-DIVISION,13,0,19363,19363
KARACHI WEST DISTRICT,BALDIA SUB-DIVISION,14,0,17471,17471
KARACHI WEST DISTRICT,BALDIA SUB-DIVISION,15,0,17996,17996
KARACHI WEST DISTRICT,BALDIA SUB-DIVISION,16,0,17461,17461
KARACHI WEST DISTRICT,BALDIA SUB-DIVISION,17,0,19389,19389
KARACHI WEST DISTRICT,BALDIA SUB-DIVISION,18,0,16672,16672
KARACHI WEST DISTRICT,BALDIA SUB-DIVISION,19,0,18247,18247
KARACHI WEST DISTRICT,BALDIA SUB-DIVISION,20,0,15369,15369
KARACHI WEST DISTRICT,BALDIA SUB-DIVISION,21,0,17484,17484
KARACHI WEST DISTRICT,BALDIA SUB-DIVISION,22,0,15666,15666
KARACHI WEST DISTRICT,BALDIA SUB-DIVISION,23,0,15793,15793
KARACHI WEST DISTRICT,BALDIA SUB-DIVISION,24,0,14968,14968
KARACHI WEST DISTRICT,BALDIA SUB-DIVISION,25,0,13829,13829
KARACHI WEST DISTRICT,BALDIA SUB-DIVISION,26,0,14827,14827
KARACHI WEST DISTRICT,BALDIA SUB-DIVISION,27,0,15206,15206
KARACHI WEST DISTRICT,BALDIA SUB-DIVISION,28,0,13718,13718
KARACHI WEST DISTRICT,BALDIA SUB-DIVISION,29,0,14287,14287
KARACHI WEST DISTRICT,BALDIA SUB-DIVISION,30,0,12716,12716
KARACHI WEST DISTRICT,BALDIA SUB-DIVISION,31,0,13394,13394
KARACHI WEST DISTRICT,BALDIA SUB-DIVISION,32,0,12506,12506
KARACHI WEST DISTRICT,BALDIA SUB-DIVISION,33,0,12571,12571
KARACHI WEST DISTRICT,BALDIA SUB-DIVISION,34,0,11783,11783
KARACHI WEST DISTRICT,BALDIA SUB-DIVISION,35,0,10914,10914
KARACHI WEST DISTRICT,BALDIA SUB-DIVISION,36,0,10316,10316
KARACHI WEST DISTRICT,BALDIA SUB-DIVISION,37,0,10910,10910
KARACHI WEST DISTRICT,BALDIA SUB-DIVISION,38,0,10329,10329
KARACHI WEST DISTRICT,BALDIA SUB-DIVISION,39,0,10625,10625
KARACHI WEST DISTRICT,BALDIA SUB-DIVISION,40,0,8877,8877
KARACHI WEST DISTRICT,BALDIA SUB-DIVISION,41,0,9179,9179
KARACHI WEST DISTRICT,BALDIA SUB-DIVISION,42,0,7824,7824
KARACHI WEST DISTRICT,BALDIA SUB-DIVISION,43,0,7923,7923
KARACHI WEST DISTRICT,BALDIA SUB-DIVISION,44,0,7066,7066
KARACHI WEST DISTRICT,BALDIA SUB-DIVISION,45,0,6485,6485
KARACHI WEST DISTRICT,BALDIA SUB-DIVISION,46,0,6369,6369
KARACHI WEST DISTRICT,BALDIA SUB-DIVISION,47,0,6349,6349
KARACHI WEST DISTRICT,BALDIA SUB-DIVISION,48,0,6133,6133
KARACHI WEST DISTRICT,BALDIA SUB-DIVISION,49,0,6611,6611
KARACHI WEST DISTRICT,BALDIA SUB-DIVISION,50,0,5480,5480
KARACHI WEST DISTRICT,BALDIA SUB-DIVISION,51,0,6134,6134
KARACHI WEST DISTRICT,BALDIA SUB-DIVISION,52,0,5429,5429
KARACHI WEST DISTRICT,BALDIA SUB-DIVISION,53,0,5378,5378
KARACHI WEST DISTRICT,BALDIA SUB-DIVISION,54,0,4631,4631
KARACHI WEST DISTRICT,BALDIA SUB-DIVISION,55,0,4069,4069
KARACHI WEST DISTRICT,BALDIA SUB-DIVISION,56,0,3621,3621
KARACHI WEST DISTRICT,BALDIA SUB-DIVISION,57,0,4098,4098
KARACHI WEST DISTRICT,BALDIA SUB-DIVISION,58,0,3485,3485
KARACHI WEST DISTRICT,BALDIA SUB-DIVISION,59,0,3881,3881
KARACHI WEST DISTRICT,BALDIA SUB-DIVISION,60,0,3069,3069
KARACHI WEST DISTRICT,BALDIA SUB-DIVISION,61,0,3759,3759
KARACHI WEST DISTRICT,BALDIA SUB-DIVISION,62,0,3304,3304
KARACHI WEST DISTRICT,BALDIA SUB-DIVISION,63,0,3549,3549
KARACHI WEST DISTRICT,BALDIA SUB-DIVISION,64,0,2706,2706
KARACHI WEST DISTRICT,BALDIA SUB-DIVISION,65,0,2216,2216
KARACHI WEST DISTRICT,BALDIA SUB-DIVISION,66,0,1936,1936
KARACHI WEST DISTRICT,BALDIA SUB-DIVISION,67,0,1869,1869
KARACHI WEST DISTRICT,BALDIA SUB-DIVISION,68,0,2049,2049
KARACHI WEST DISTRICT,BALDIA SUB-DIVISION,69,0,1941,1941
KARACHI WEST DISTRICT,BALDIA SUB-DIVISION,70,0,1295,1295
KARACHI WEST DISTRICT,BALDIA SUB-DIVISION,71,0,1468,1468
KARACHI WEST DISTRICT,BALDIA SUB-DIVISION,72,0,1155,1155
KARACHI WEST DISTRICT,BALDIA SUB-DIVISION,73,0,1370,1370
KARACHI WEST DISTRICT,BALDIA SUB-DIVISION,74,0,967,967
KARACHI WEST DISTRICT,BALDIA SUB-DIVISION,>=75,0,6953,6953
KARACHI WEST DISTRICT,HARBOUR SUB-DIVISION,<1,0,9685,9685
KARACHI WEST DISTRICT,HARBOUR SUB-DIVISION,1,0,10017,10017
KARACHI WEST DISTRICT,HARBOUR SUB-DIVISION,2,0,10736,10736
KARACHI WEST DISTRICT,HARBOUR SUB-DIVISION,3,0,11633,11633
KARACHI WEST DISTRICT,HARBOUR SUB-DIVISION,4,0,10531,10531
KARACHI WEST DISTRICT,HARBOUR SUB-DIVISION,5,0,10859,10859
KARACHI WEST DISTRICT,HARBOUR SUB-DIVISION,6,0,10554,10554
KARACHI WEST DISTRICT,HARBOUR SUB-DIVISION,7,0,11225,11225
KARACHI WEST DISTRICT,HARBOUR SUB-DIVISION,8,0,9764,9764
KARACHI WEST DISTRICT,HARBOUR SUB-DIVISION,9,0,11109,11109
KARACHI WEST DISTRICT,HARBOUR SUB-DIVISION,10,0,9076,9076
KARACHI WEST DISTRICT,HARBOUR SUB-DIVISION,11,0,10597,10597
KARACHI WEST DISTRICT,HARBOUR SUB-DIVISION,12,0,8557,8557
KARACHI WEST DISTRICT,HARBOUR SUB-DIVISION,13,0,9237,9237
KARACHI WEST DISTRICT,HARBOUR SUB-DIVISION,14,0,8115,8115
KARACHI WEST DISTRICT,HARBOUR SUB-DIVISION,15,0,8495,8495
KARACHI WEST DISTRICT,HARBOUR SUB-DIVISION,16,0,8599,8599
KARACHI WEST DISTRICT,HARBOUR SUB-DIVISION,17,0,9167,9167
KARACHI WEST DISTRICT,HARBOUR SUB-DIVISION,18,0,7981,7981
KARACHI WEST DISTRICT,HARBOUR SUB-DIVISION,19,0,9306,9306
KARACHI WEST DISTRICT,HARBOUR SUB-DIVISION,20,0,7638,7638
KARACHI WEST DISTRICT,HARBOUR SUB-DIVISION,21,0,9094,9094
KARACHI WEST DISTRICT,HARBOUR SUB-DIVISION,22,0,7702,7702
KARACHI WEST DISTRICT,HARBOUR SUB-DIVISION,23,0,7641,7641
KARACHI WEST DISTRICT,HARBOUR SUB-DIVISION,24,0,7356,7356
KARACHI WEST DISTRICT,HARBOUR SUB-DIVISION,25,0,6475,6475
KARACHI WEST DISTRICT,HARBOUR SUB-DIVISION,26,0,7276,7276
KARACHI WEST DISTRICT,HARBOUR SUB-DIVISION,27,0,7214,7214
KARACHI WEST DISTRICT,HARBOUR SUB-DIVISION,28,0,6296,6296
KARACHI WEST DISTRICT,HARBOUR SUB-DIVISION,29,0,6914,6914
KARACHI WEST DISTRICT,HARBOUR SUB-DIVISION,30,0,5888,5888
KARACHI WEST DISTRICT,HARBOUR SUB-DIVISION,31,0,6773,6773
KARACHI WEST DISTRICT,HARBOUR SUB-DIVISION,32,0,6000,6000
KARACHI WEST DISTRICT,HARBOUR SUB-DIVISION,33,0,6028,6028
KARACHI WEST DISTRICT,HARBOUR SUB-DIVISION,34,0,5938,5938
KARACHI WEST DISTRICT,HARBOUR SUB-DIVISION,35,0,4991,4991
KARACHI WEST DISTRICT,HARBOUR SUB-DIVISION,36,0,5401,5401
KARACHI WEST DISTRICT,HARBOUR SUB-DIVISION,37,0,5337,5337
KARACHI WEST DISTRICT,HARBOUR SUB-DIVISION,38,0,5017,5017
KARACHI WEST DISTRICT,HARBOUR SUB-DIVISION,39,0,5064,5064
KARACHI WEST DISTRICT,HARBOUR SUB-DIVISION,40,0,4076,4076
KARACHI WEST DISTRICT,HARBOUR SUB-DIVISION,41,0,4529,4529
KARACHI WEST DISTRICT,HARBOUR SUB-DIVISION,42,0,3952,3952
KARACHI WEST DISTRICT,HARBOUR SUB-DIVISION,43,0,4055,4055
KARACHI WEST DISTRICT,HARBOUR SUB-DIVISION,44,0,3587,3587
KARACHI WEST DISTRICT,HARBOUR SUB-DIVISION,45,0,2929,2929
KARACHI WEST DISTRICT,HARBOUR SUB-DIVISION,46,0,3341,3341
KARACHI WEST DISTRICT,HARBOUR SUB-DIVISION,47,0,3249,3249
KARACHI WEST DISTRICT,HARBOUR SUB-DIVISION,48,0,3098,3098
KARACHI WEST DISTRICT,HARBOUR SUB-DIVISION,49,0,3089,3089
KARACHI WEST DISTRICT,HARBOUR SUB-DIVISION,50,0,2653,2653
KARACHI WEST DISTRICT,HARBOUR SUB-DIVISION,51,0,3066,3066
KARACHI WEST DISTRICT,HARBOUR SUB-DIVISION,52,0,2579,2579
KARACHI WEST DISTRICT,HARBOUR SUB-DIVISION,53,0,2595,2595
KARACHI WEST DISTRICT,HARBOUR SUB-DIVISION,54,0,2217,2217
KARACHI WEST DISTRICT,HARBOUR SUB-DIVISION,55,0,1752,1752
KARACHI WEST DISTRICT,HARBOUR SUB-DIVISION,56,0,1899,1899
KARACHI WEST DISTRICT,HARBOUR SUB-DIVISION,57,0,1940,1940
KARACHI WEST DISTRICT,HARBOUR SUB-DIVISION,58,0,1694,1694
KARACHI WEST DISTRICT,HARBOUR SUB-DIVISION,59,0,1820,1820
KARACHI WEST DISTRICT,HARBOUR SUB-DIVISION,60,0,1294,1294
KARACHI WEST DISTRICT,HARBOUR SUB-DIVISION,61,0,1668,1668
KARACHI WEST DISTRICT,HARBOUR SUB-DIVISION,62,0,1652,1652
KARACHI WEST DISTRICT,HARBOUR SUB-DIVISION,63,0,1542,1542
KARACHI WEST DISTRICT,HARBOUR SUB-DIVISION,64,0,1303,1303
KARACHI WEST DISTRICT,HARBOUR SUB-DIVISION,65,0,913,913
KARACHI WEST DISTRICT,HARBOUR SUB-DIVISION,66,0,924,924
KARACHI WEST DISTRICT,HARBOUR SUB-DIVISION,67,0,919,919
KARACHI WEST DISTRICT,HARBOUR SUB-DIVISION,68,0,1014,1014
KARACHI WEST DISTRICT,HARBOUR SUB-DIVISION,69,0,850,850
KARACHI WEST DISTRICT,HARBOUR SUB-DIVISION,70,0,478,478
KARACHI WEST DISTRICT,HARBOUR SUB-DIVISION,71,0,597,597
KARACHI WEST DISTRICT,HARBOUR SUB-DIVISION,72,0,524,524
KARACHI WEST DISTRICT,HARBOUR SUB-DIVISION,73,0,590,590
KARACHI WEST DISTRICT,HARBOUR SUB-DIVISION,74,0,465,465
KARACHI WEST DISTRICT,HARBOUR SUB-DIVISION,>=75,0,2976,2976
KARACHI WEST DISTRICT,MANGHOPIR SUB-DIVISION,<1,4675,13946,18621
KARACHI WEST DISTRICT,MANGHOPIR SUB-DIVISION,1,4171,12478,16649
KARACHI WEST DISTRICT,MANGHOPIR SUB-DIVISION,2,4968,15129,20097
KARACHI WEST DISTRICT,MANGHOPIR SUB-DIVISION,3,5475,16218,21693
KARACHI WEST DISTRICT,MANGHOPIR SUB-DIVISION,4,4911,14550,19461
KARACHI WEST DISTRICT,MANGHOPIR SUB-DIVISION,5,5067,14661,19728
KARACHI WEST DISTRICT,MANGHOPIR SUB-DIVISION,6,4682,13698,18380
KARACHI WEST DISTRICT,MANGHOPIR SUB-DIVISION,7,5405,15019,20424
KARACHI WEST DISTRICT,MANGHOPIR SUB-DIVISION,8,4663,13347,18010
KARACHI WEST DISTRICT,MANGHOPIR SUB-DIVISION,9,4954,14514,19468
KARACHI WEST DISTRICT,MANGHOPIR SUB-DIVISION,10,4310,12137,16447
KARACHI WEST DISTRICT,MANGHOPIR SUB-DIVISION,11,4366,13521,17887
KARACHI WEST DISTRICT,MANGHOPIR SUB-DIVISION,12,3965,11782,15747
KARACHI WEST DISTRICT,MANGHOPIR SUB-DIVISION,13,3933,12016,15949
KARACHI WEST DISTRICT,MANGHOPIR SUB-DIVISION,14,3470,10622,14092
KARACHI WEST DISTRICT,MANGHOPIR SUB-DIVISION,15,3646,11285,14931
KARACHI WEST DISTRICT,MANGHOPIR SUB-DIVISION,16,3351,11240,14591
KARACHI WEST DISTRICT,MANGHOPIR SUB-DIVISION,17,3387,12067,15454
KARACHI WEST DISTRICT,MANGHOPIR SUB-DIVISION,18,3336,11044,14380
KARACHI WEST DISTRICT,MANGHOPIR SUB-DIVISION,19,3509,11419,14928
KARACHI WEST DISTRICT,MANGHOPIR SUB-DIVISION,20,3256,10386,13642
KARACHI WEST DISTRICT,MANGHOPIR SUB-DIVISION,21,3343,11434,14777
KARACHI WEST DISTRICT,MANGHOPIR SUB-DIVISION,22,3013,10450,13463
KARACHI WEST DISTRICT,MANGHOPIR SUB-DIVISION,23,2819,10246,13065
KARACHI WEST DISTRICT,MANGHOPIR SUB-DIVISION,24,2563,10196,12759
KARACHI WEST DISTRICT,MANGHOPIR SUB-DIVISION,25,2855,9532,12387
KARACHI WEST DISTRICT,MANGHOPIR SUB-DIVISION,26,2630,10167,12797
KARACHI WEST DISTRICT,MANGHOPIR SUB-DIVISION,27,2642,9708,12350
KARACHI WEST DISTRICT,MANGHOPIR SUB-DIVISION,28,2451,9398,11849
KARACHI WEST DISTRICT,MANGHOPIR SUB-DIVISION,29,2499,9142,11641
KARACHI WEST DISTRICT,MANGHOPIR SUB-DIVISION,30,2427,9437,11864
KARACHI WEST DISTRICT,MANGHOPIR SUB-DIVISION,31,2357,8909,11266
KARACHI WEST DISTRICT,MANGHOPIR SUB-DIVISION,32,2047,8656,10703
KARACHI WEST DISTRICT,MANGHOPIR SUB-DIVISION,33,2056,8264,10320
KARACHI WEST DISTRICT,MANGHOPIR SUB-DIVISION,34,1941,7728,9669
KARACHI WEST DISTRICT,MANGHOPIR SUB-DIVISION,35,2060,7616,9676
KARACHI WEST DISTRICT,MANGHOPIR SUB-DIVISION,36,1734,7307,9041
KARACHI WEST DISTRICT,MANGHOPIR SUB-DIVISION,37,1916,6735,8651
KARACHI WEST DISTRICT,MANGHOPIR SUB-DIVISION,38,1668,7319,8987
KARACHI WEST DISTRICT,MANGHOPIR SUB-DIVISION,39,1731,6800,8531
KARACHI WEST DISTRICT,MANGHOPIR SUB-DIVISION,40,1678,6738,8416
KARACHI WEST DISTRICT,MANGHOPIR SUB-DIVISION,41,1458,6093,7551
KARACHI WEST DISTRICT,MANGHOPIR SUB-DIVISION,42,1272,5580,6852
KARACHI WEST DISTRICT,MANGHOPIR SUB-DIVISION,43,1292,5294,6586
KARACHI WEST DISTRICT,MANGHOPIR SUB-DIVISION,44,1170,4784,5954
KARACHI WEST DISTRICT,MANGHOPIR SUB-DIVISION,45,1175,4639,5814
KARACHI WEST DISTRICT,MANGHOPIR SUB-DIVISION,46,1085,4533,5618
KARACHI WEST DISTRICT,MANGHOPIR SUB-DIVISION,47,1148,3997,5145
KARACHI WEST DISTRICT,MANGHOPIR SUB-DIVISION,48,1053,4435,5488
KARACHI WEST DISTRICT,MANGHOPIR SUB-DIVISION,49,1120,4294,5414
KARACHI WEST DISTRICT,MANGHOPIR SUB-DIVISION,50,993,4264,5257
KARACHI WEST DISTRICT,MANGHOPIR SUB-DIVISION,51,964,4127,5091
KARACHI WEST DISTRICT,MANGHOPIR SUB-DIVISION,52,837,3697,4534
KARACHI WEST DISTRICT,MANGHOPIR SUB-DIVISION,53,796,3650,4446
KARACHI WEST DISTRICT,MANGHOPIR SUB-DIVISION,54,718,3117,3835
KARACHI WEST DISTRICT,MANGHOPIR SUB-DIVISION,55,687,3028,3715
KARACHI WEST DISTRICT,MANGHOPIR SUB-DIVISION,56,571,2919,3490
KARACHI WEST DISTRICT,MANGHOPIR SUB-DIVISION,57,649,2601,3250
KARACHI WEST DISTRICT,MANGHOPIR SUB-DIVISION,58,554,2603,3157
KARACHI WEST DISTRICT,MANGHOPIR SUB-DIVISION,59,581,2395,2976
KARACHI WEST DISTRICT,MANGHOPIR SUB-DIVISION,60,587,2423,3010
KARACHI WEST DISTRICT,MANGHOPIR SUB-DIVISION,61,592,2491,3083
KARACHI WEST DISTRICT,MANGHOPIR SUB-DIVISION,62,542,2297,2839
KARACHI WEST DISTRICT,MANGHOPIR SUB-DIVISION,63,553,2183,2736
KARACHI WEST DISTRICT,MANGHOPIR SUB-DIVISION,64,432,1901,2333
KARACHI WEST DISTRICT,MANGHOPIR SUB-DIVISION,65,369,1629,1998
KARACHI WEST DISTRICT,MANGHOPIR SUB-DIVISION,66,364,1402,1766
KARACHI WEST DISTRICT,MANGHOPIR SUB-DIVISION,67,332,1232,1564
KARACHI WEST DISTRICT,MANGHOPIR SUB-DIVISION,68,372,1357,1729
KARACHI WEST DISTRICT,MANGHOPIR SUB-DIVISION,69,309,1141,1450
KARACHI WEST DISTRICT,MANGHOPIR SUB-DIVISION,70,252,1059,1311
KARACHI WEST DISTRICT,MANGHOPIR SUB-DIVISION,71,232,970,1202
KARACHI WEST DISTRICT,MANGHOPIR SUB-DIVISION,72,217,884,1101
KARACHI WEST DISTRICT,MANGHOPIR SUB-DIVISION,73,203,850,1053
KARACHI WEST DISTRICT,MANGHOPIR SUB-DIVISION,74,151,630,781
KARACHI WEST DISTRICT,MANGHOPIR SUB-DIVISION,>=75,1344,4972,6316
KARACHI WEST DISTRICT,MAURIPUR SUB-DIVISION,<1,3041,1582,4623
KARACHI WEST DISTRICT,MAURIPUR SUB-DIVISION,1,3171,1681,4852
KARACHI WEST DISTRICT,MAURIPUR SUB-DIVISION,2,3452,1672,5124
KARACHI WEST DISTRICT,MAURIPUR SUB-DIVISION,3,3680,1842,5522
KARACHI WEST DISTRICT,MAURIPUR SUB-DIVISION,4,3449,1719,5168
KARACHI WEST DISTRICT,MAURIPUR SUB-DIVISION,5,3541,1846,5387
KARACHI WEST DISTRICT,MAURIPUR SUB-DIVISION,6,3473,1697,5170
KARACHI WEST DISTRICT,MAURIPUR SUB-DIVISION,7,3771,1891,5662
KARACHI WEST DISTRICT,MAURIPUR SUB-DIVISION,8,3401,1608,5009
KARACHI WEST DISTRICT,MAURIPUR SUB-DIVISION,9,3501,1831,5332
KARACHI WEST DISTRICT,MAURIPUR SUB-DIVISION,10,3005,1520,4525
KARACHI WEST DISTRICT,MAURIPUR SUB-DIVISION,11,2896,1762,4658
KARACHI WEST DISTRICT,MAURIPUR SUB-DIVISION,12,2763,1387,4150
KARACHI WEST DISTRICT,MAURIPUR SUB-DIVISION,13,2715,1511,4226
KARACHI WEST DISTRICT,MAURIPUR SUB-DIVISION,14,2433,1359,3792
KARACHI WEST DISTRICT,MAURIPUR SUB-DIVISION,15,2616,1349,3965
KARACHI WEST DISTRICT,MAURIPUR SUB-DIVISION,16,2464,1329,3793
KARACHI WEST DISTRICT,MAURIPUR SUB-DIVISION,17,2530,1411,3941
KARACHI WEST DISTRICT,MAURIPUR SUB-DIVISION,18,2643,1257,3900
KARACHI WEST DISTRICT,MAURIPUR SUB-DIVISION,19,2704,1617,4321
KARACHI WEST DISTRICT,MAURIPUR SUB-DIVISION,20,2384,1341,3725
KARACHI WEST DISTRICT,MAURIPUR SUB-DIVISION,21,2437,1498,3935
KARACHI WEST DISTRICT,MAURIPUR SUB-DIVISION,22,2248,1358,3606
KARACHI WEST DISTRICT,MAURIPUR SUB-DIVISION,23,2138,1453,3591
KARACHI WEST DISTRICT,MAURIPUR SUB-DIVISION,24,2087,1296,3383
KARACHI WEST DISTRICT,MAURIPUR SUB-DIVISION,25,2081,1140,3221
KARACHI WEST DISTRICT,MAURIPUR SUB-DIVISION,26,2146,1396,3542
KARACHI WEST DISTRICT,MAURIPUR SUB-DIVISION,27,2196,1411,3607
KARACHI WEST DISTRICT,MAURIPUR SUB-DIVISION,28,2040,1226,3266
KARACHI WEST DISTRICT,MAURIPUR SUB-DIVISION,29,2010,1418,3428
KARACHI WEST DISTRICT,MAURIPUR SUB-DIVISION,30,1980,1200,3180
KARACHI WEST DISTRICT,MAURIPUR SUB-DIVISION,31,1991,1346,3337
KARACHI WEST DISTRICT,MAURIPUR SUB-DIVISION,32,1707,1199,2906
KARACHI WEST DISTRICT,MAURIPUR SUB-DIVISION,33,1750,1184,2934
KARACHI WEST DISTRICT,MAURIPUR SUB-DIVISION,34,1753,1197,2950
KARACHI WEST DISTRICT,MAURIPUR SUB-DIVISION,35,1669,1001,2670
KARACHI WEST DISTRICT,MAURIPUR SUB-DIVISION,36,1630,1066,2696
KARACHI WEST DISTRICT,MAURIPUR SUB-DIVISION,37,1494,1061,2555
KARACHI WEST DISTRICT,MAURIPUR SUB-DIVISION,38,1381,983,2364
KARACHI WEST DISTRICT,MAURIPUR SUB-DIVISION,39,1385,1037,2422
KARACHI WEST DISTRICT,MAURIPUR SUB-DIVISION,40,1298,806,2104
KARACHI WEST DISTRICT,MAURIPUR SUB-DIVISION,41,1304,858,2162
KARACHI WEST DISTRICT,MAURIPUR SUB-DIVISION,42,1109,709,1818
KARACHI WEST DISTRICT,MAURIPUR SUB-DIVISION,43,1114,748,1862
KARACHI WEST DISTRICT,MAURIPUR SUB-DIVISION,44,991,660,1651
KARACHI WEST DISTRICT,MAURIPUR SUB-DIVISION,45,881,501,1382
KARACHI WEST DISTRICT,MAURIPUR SUB-DIVISION,46,1049,543,1592
KARACHI WEST DISTRICT,MAURIPUR SUB-DIVISION,47,893,544,1437
KARACHI WEST DISTRICT,MAURIPUR SUB-DIVISION,48,847,551,1398
KARACHI WEST DISTRICT,MAURIPUR SUB-DIVISION,49,858,572,1430
KARACHI WEST DISTRICT,MAURIPUR SUB-DIVISION,50,759,476,1235
KARACHI WEST DISTRICT,MAURIPUR SUB-DIVISION,51,874,475,1349
KARACHI WEST DISTRICT,MAURIPUR SUB-DIVISION,52,701,438,1139
KARACHI WEST DISTRICT,MAURIPUR SUB-DIVISION,53,714,482,1196
KARACHI WEST DISTRICT,MAURIPUR SUB-DIVISION,54,560,389,949
KARACHI WEST DISTRICT,MAURIPUR SUB-DIVISION,55,537,331,868
KARACHI WEST DISTRICT,MAURIPUR SUB-DIVISION,56,541,341,882
KARACHI WEST DISTRICT,MAURIPUR SUB-DIVISION,57,508,348,856
KARACHI WEST DISTRICT,MAURIPUR SUB-DIVISION,58,499,338,837
KARACHI WEST DISTRICT,MAURIPUR SUB-DIVISION,59,505,366,871
KARACHI WEST DISTRICT,MAURIPUR SUB-DIVISION,60,463,258,721
KARACHI WEST DISTRICT,MAURIPUR SUB-DIVISION,61,478,288,766
KARACHI WEST DISTRICT,MAURIPUR SUB-DIVISION,62,450,348,798
KARACHI WEST DISTRICT,MAURIPUR SUB-DIVISION,63,506,289,795
KARACHI WEST DISTRICT,MAURIPUR SUB-DIVISION,64,392,232,624
KARACHI WEST DISTRICT,MAURIPUR SUB-DIVISION,65,308,192,500
KARACHI WEST DISTRICT,MAURIPUR SUB-DIVISION,66,297,180,477
KARACHI WEST DISTRICT,MAURIPUR SUB-DIVISION,67,219,143,362
KARACHI WEST DISTRICT,MAURIPUR SUB-DIVISION,68,320,181,501
KARACHI WEST DISTRICT,MAURIPUR SUB-DIVISION,69,270,163,433
KARACHI WEST DISTRICT,MAURIPUR SUB-DIVISION,70,181,100,281
KARACHI WEST DISTRICT,MAURIPUR SUB-DIVISION,71,209,133,342
KARACHI WEST DISTRICT,MAURIPUR SUB-DIVISION,72,177,106,283
KARACHI WEST DISTRICT,MAURIPUR SUB-DIVISION,73,182,139,321
KARACHI WEST DISTRICT,MAURIPUR SUB-DIVISION,74,140,95,235
KARACHI WEST DISTRICT,MAURIPUR SUB-DIVISION,>=75,1064,606,1670
KARACHI WEST DISTRICT,MOMINABAD SUB-DIVISION,<1,0,20017,20017
KARACHI WEST DISTRICT,MOMINABAD SUB-DIVISION,1,0,19214,19214
KARACHI WEST DISTRICT,MOMINABAD SUB-DIVISION,2,0,20608,20608
KARACHI WEST DISTRICT,MOMINABAD SUB-DIVISION,3,0,22087,22087
KARACHI WEST DISTRICT,MOMINABAD SUB-DIVISION,4,0,19713,19713
KARACHI WEST DISTRICT,MOMINABAD SUB-DIVISION,5,0,20541,20541
KARACHI WEST DISTRICT,MOMINABAD SUB-DIVISION,6,0,19605,19605
KARACHI WEST DISTRICT,MOMINABAD SUB-DIVISION,7,0,20992,20992
KARACHI WEST DISTRICT,MOMINABAD SUB-DIVISION,8,0,18265,18265
KARACHI WEST DISTRICT,MOMINABAD SUB-DIVISION,9,0,21386,21386
KARACHI WEST DISTRICT,MOMINABAD SUB-DIVISION,10,0,16941,16941
KARACHI WEST DISTRICT,MOMINABAD SUB-DIVISION,11,0,20958,20958
KARACHI WEST DISTRICT,MOMINABAD SUB-DIVISION,12,0,16569,16569
KARACHI WEST DISTRICT,MOMINABAD SUB-DIVISION,13,0,18580,18580
KARACHI WEST DISTRICT,MOMINABAD SUB-DIVISION,14,0,16852,16852
KARACHI WEST DISTRICT,MOMINABAD SUB-DIVISION,15,0,17533,17533
KARACHI WEST DISTRICT,MOMINABAD SUB-DIVISION,16,0,17848,17848
KARACHI WEST DISTRICT,MOMINABAD SUB-DIVISION,17,0,19674,19674
KARACHI WEST DISTRICT,MOMINABAD SUB-DIVISION,18,0,16318,16318
KARACHI WEST DISTRICT,MOMINABAD SUB-DIVISION,19,0,19557,19557
KARACHI WEST DISTRICT,MOMINABAD SUB-DIVISION,20,0,15968,15968
KARACHI WEST DISTRICT,MOMINABAD SUB-DIVISION,21,0,19450,19450
KARACHI WEST DISTRICT,MOMINABAD SUB-DIVISION,22,0,16689,16689
KARACHI WEST DISTRICT,MOMINABAD SUB-DIVISION,23,0,17627,17627
KARACHI WEST DISTRICT,MOMINABAD SUB-DIVISION,24,0,17172,17172
KARACHI WEST DISTRICT,MOMINABAD SUB-DIVISION,25,0,14213,14213
KARACHI WEST DISTRICT,MOMINABAD SUB-DIVISION,26,0,16897,16897
KARACHI WEST DISTRICT,MOMINABAD SUB-DIVISION,27,0,16227,16227
KARACHI WEST DISTRICT,MOMINABAD SUB-DIVISION,28,0,14455,14455
KARACHI WEST DISTRICT,MOMINABAD SUB-DIVISION,29,0,15592,15592
KARACHI WEST DISTRICT,MOMINABAD SUB-DIVISION,30,0,12754,12754
KARACHI WEST DISTRICT,MOMINABAD SUB-DIVISION,31,0,14257,14257
KARACHI WEST DISTRICT,MOMINABAD SUB-DIVISION,32,0,13327,13327
KARACHI WEST DISTRICT,MOMINABAD SUB-DIVISION,33,0,13541,13541
KARACHI WEST DISTRICT,MOMINABAD SUB-DIVISION,34,0,13196,13196
KARACHI WEST DISTRICT,MOMINABAD SUB-DIVISION,35,0,10825,10825
KARACHI WEST DISTRICT,MOMINABAD SUB-DIVISION,36,0,11729,11729
KARACHI WEST DISTRICT,MOMINABAD SUB-DIVISION,37,0,11743,11743
KARACHI WEST DISTRICT,MOMINABAD SUB-DIVISION,38,0,11404,11404
KARACHI WEST DISTRICT,MOMINABAD SUB-DIVISION,39,0,11717,11717
KARACHI WEST DISTRICT,MOMINABAD SUB-DIVISION,40,0,9248,9248
KARACHI WEST DISTRICT,MOMINABAD SUB-DIVISION,41,0,10106,10106
KARACHI WEST DISTRICT,MOMINABAD SUB-DIVISION,42,0,8581,8581
KARACHI WEST DISTRICT,MOMINABAD SUB-DIVISION,43,0,8996,8996
KARACHI WEST DISTRICT,MOMINABAD SUB-DIVISION,44,0,8302,8302
KARACHI WEST DISTRICT,MOMINABAD SUB-DIVISION,45,0,6672,6672
KARACHI WEST DISTRICT,MOMINABAD SUB-DIVISION,46,0,7621,7621
KARACHI WEST DISTRICT,MOMINABAD SUB-DIVISION,47,0,7302,7302
KARACHI WEST DISTRICT,MOMINABAD SUB-DIVISION,48,0,7214,7214
KARACHI WEST DISTRICT,MOMINABAD SUB-DIVISION,49,0,7530,7530
KARACHI WEST DISTRICT,MOMINABAD SUB-DIVISION,50,0,5775,5775
KARACHI WEST DISTRICT,MOMINABAD SUB-DIVISION,51,0,7103,7103
KARACHI WEST DISTRICT,MOMINABAD SUB-DIVISION,52,0,5961,5961
KARACHI WEST DISTRICT,MOMINABAD SUB-DIVISION,53,0,5943,5943
KARACHI WEST DISTRICT,MOMINABAD SUB-DIVISION,54,0,5330,5330
KARACHI WEST DISTRICT,MOMINABAD SUB-DIVISION,55,0,4009,4009
KARACHI WEST DISTRICT,MOMINABAD SUB-DIVISION,56,0,4215,4215
KARACHI WEST DISTRICT,MOMINABAD SUB-DIVISION,57,0,4394,4394
KARACHI WEST DISTRICT,MOMINABAD SUB-DIVISION,58,0,3802,3802
KARACHI WEST DISTRICT,MOMINABAD SUB-DIVISION,59,0,3923,3923
KARACHI WEST DISTRICT,MOMINABAD SUB-DIVISION,60,0,2967,2967
KARACHI WEST DISTRICT,MOMINABAD SUB-DIVISION,61,0,4049,4049
KARACHI WEST DISTRICT,MOMINABAD SUB-DIVISION,62,0,3601,3601
KARACHI WEST DISTRICT,MOMINABAD SUB-DIVISION,63,0,3660,3660
KARACHI WEST DISTRICT,MOMINABAD SUB-DIVISION,64,0,3054,3054
KARACHI WEST DISTRICT,MOMINABAD SUB-DIVISION,65,0,2143,2143
KARACHI WEST DISTRICT,MOMINABAD SUB-DIVISION,66,0,2154,2154
KARACHI WEST DISTRICT,MOMINABAD SUB-DIVISION,67,0,2288,2288
KARACHI WEST DISTRICT,MOMINABAD SUB-DIVISION,68,0,2239,2239
KARACHI WEST DISTRICT,MOMINABAD SUB-DIVISION,69,0,2039,2039
KARACHI WEST DISTRICT,MOMINABAD SUB-DIVISION,70,0,1273,1273
KARACHI WEST DISTRICT,MOMINABAD SUB-DIVISION,71,0,1482,1482
KARACHI WEST DISTRICT,MOMINABAD SUB-DIVISION,72,0,1349,1349
KARACHI WEST DISTRICT,MOMINABAD SUB-DIVISION,73,0,1393,1393
KARACHI WEST DISTRICT,MOMINABAD SUB-DIVISION,74,0,1095,1095
KARACHI WEST DISTRICT,MOMINABAD SUB-DIVISION,>=75,0,6943,6943
KARACHI WEST DISTRICT,ORANGI SUB-DIVISION,<1,0,13474,13474
KARACHI WEST DISTRICT,ORANGI SUB-DIVISION,1,0,13072,13072
KARACHI WEST DISTRICT,ORANGI SUB-DIVISION,2,0,14145,14145
KARACHI WEST DISTRICT,ORANGI SUB-DIVISION,3,0,15306,15306
KARACHI WEST DISTRICT,ORANGI SUB-DIVISION,4,0,14091,14091
KARACHI WEST DISTRICT,ORANGI SUB-DIVISION,5,0,14367,14367
KARACHI WEST DISTRICT,ORANGI SUB-DIVISION,6,0,14118,14118
KARACHI WEST DISTRICT,ORANGI SUB-DIVISION,7,0,14828,14828
KARACHI WEST DISTRICT,ORANGI SUB-DIVISION,8,0,13356,13356
KARACHI WEST DISTRICT,ORANGI SUB-DIVISION,9,0,14860,14860
KARACHI WEST DISTRICT,ORANGI SUB-DIVISION,10,0,12202,12202
KARACHI WEST DISTRICT,ORANGI SUB-DIVISION,11,0,13937,13937
KARACHI WEST DISTRICT,ORANGI SUB-DIVISION,12,0,11746,11746
KARACHI WEST DISTRICT,ORANGI SUB-DIVISION,13,0,12536,12536
KARACHI WEST DISTRICT,ORANGI SUB-DIVISION,14,0,10998,10998
KARACHI WEST DISTRICT,ORANGI SUB-DIVISION,15,0,11393,11393
KARACHI WEST DISTRICT,ORANGI SUB-DIVISION,16,0,11304,11304
KARACHI WEST DISTRICT,ORANGI SUB-DIVISION,17,0,12088,12088
KARACHI WEST DISTRICT,ORANGI SUB-DIVISION,18,0,10539,10539
KARACHI WEST DISTRICT,ORANGI SUB-DIVISION,19,0,11608,11608
KARACHI WEST DISTRICT,ORANGI SUB-DIVISION,20,0,10055,10055
KARACHI WEST DISTRICT,ORANGI SUB-DIVISION,21,0,10871,10871
KARACHI WEST DISTRICT,ORANGI SUB-DIVISION,22,0,9746,9746
KARACHI WEST DISTRICT,ORANGI SUB-DIVISION,23,0,9529,9529
KARACHI WEST DISTRICT,ORANGI SUB-DIVISION,24,0,9520,9520
KARACHI WEST DISTRICT,ORANGI SUB-DIVISION,25,0,8592,8592
KARACHI WEST DISTRICT,ORANGI SUB-DIVISION,26,0,9315,9315
KARACHI WEST DISTRICT,ORANGI SUB-DIVISION,27,0,9386,9386
KARACHI WEST DISTRICT,ORANGI SUB-DIVISION,28,0,8474,8474
KARACHI WEST DISTRICT,ORANGI SUB-DIVISION,29,0,8839,8839
KARACHI WEST DISTRICT,ORANGI SUB-DIVISION,30,0,7648,7648
KARACHI WEST DISTRICT,ORANGI SUB-DIVISION,31,0,8172,8172
KARACHI WEST DISTRICT,ORANGI SUB-DIVISION,32,0,7434,7434
KARACHI WEST DISTRICT,ORANGI SUB-DIVISION,33,0,7515,7515
KARACHI WEST DISTRICT,ORANGI SUB-DIVISION,34,0,7772,7772
KARACHI WEST DISTRICT,ORANGI SUB-DIVISION,35,0,6517,6517
KARACHI WEST DISTRICT,ORANGI SUB-DIVISION,36,0,6906,6906
KARACHI WEST DISTRICT,ORANGI SUB-DIVISION,37,0,6573,6573
KARACHI WEST DISTRICT,ORANGI SUB-DIVISION,38,0,6143,6143
KARACHI WEST DISTRICT,ORANGI SUB-DIVISION,39,0,6392,6392
KARACHI WEST DISTRICT,ORANGI SUB-DIVISION,40,0,5248,5248
KARACHI WEST DISTRICT,ORANGI SUB-DIVISION,41,0,5742,5742
KARACHI WEST DISTRICT,ORANGI SUB-DIVISION,42,0,4769,4769
KARACHI WEST DISTRICT,ORANGI SUB-DIVISION,43,0,4841,4841
KARACHI WEST DISTRICT,ORANGI SUB-DIVISION,44,0,4335,4335
KARACHI WEST DISTRICT,ORANGI SUB-DIVISION,45,0,3730,3730
KARACHI WEST DISTRICT,ORANGI SUB-DIVISION,46,0,4231,4231
KARACHI WEST DISTRICT,ORANGI SUB-DIVISION,47,0,3919,3919
KARACHI WEST DISTRICT,ORANGI SUB-DIVISION,48,0,3632,3632
KARACHI WEST DISTRICT,ORANGI SUB-DIVISION,49,0,3888,3888
KARACHI WEST DISTRICT,ORANGI SUB-DIVISION,50,0,3150,3150
KARACHI WEST DISTRICT,ORANGI SUB-DIVISION,51,0,3721,3721
KARACHI WEST DISTRICT,ORANGI SUB-DIVISION,52,0,3070,3070
KARACHI WEST DISTRICT,ORANGI SUB-DIVISION,53,0,3115,3115
KARACHI WEST DISTRICT,ORANGI SUB-DIVISION,54,0,2696,2696
KARACHI WEST DISTRICT,ORANGI SUB-DIVISION,55,0,2165,2165
KARACHI WEST DISTRICT,ORANGI SUB-DIVISION,56,0,2287,2287
KARACHI WEST DISTRICT,ORANGI SUB-DIVISION,57,0,2374,2374
KARACHI WEST DISTRICT,ORANGI SUB-DIVISION,58,0,1995,1995
KARACHI WEST DISTRICT,ORANGI SUB-DIVISION,59,0,2060,2060
KARACHI WEST DISTRICT,ORANGI SUB-DIVISION,60,0,1653,1653
KARACHI WEST DISTRICT,ORANGI SUB-DIVISION,61,0,2199,2199
KARACHI WEST DISTRICT,ORANGI SUB-DIVISION,62,0,1962,1962
KARACHI WEST DISTRICT,ORANGI SUB-DIVISION,63,0,2061,2061
KARACHI WEST DISTRICT,ORANGI SUB-DIVISION,64,0,1623,1623
KARACHI WEST DISTRICT,ORANGI SUB-DIVISION,65,0,1176,1176
KARACHI WEST DISTRICT,ORANGI SUB-DIVISION,66,0,1218,1218
KARACHI WEST DISTRICT,ORANGI SUB-DIVISION,67,0,1304,1304
KARACHI WEST DISTRICT,ORANGI SUB-DIVISION,68,0,1366,1366
KARACHI WEST DISTRICT,ORANGI SUB-DIVISION,69,0,1157,1157
KARACHI WEST DISTRICT,ORANGI SUB-DIVISION,70,0,763,763
KARACHI WEST DISTRICT,ORANGI SUB-DIVISION,71,0,868,868
KARACHI WEST DISTRICT,ORANGI SUB-DIVISION,72,0,733,733
KARACHI WEST DISTRICT,ORANGI SUB-DIVISION,73,0,817,817
KARACHI WEST DISTRICT,ORANGI SUB-DIVISION,74,0,662,662
KARACHI WEST DISTRICT,ORANGI SUB-DIVISION,>=75,0,4298,4298
KARACHI WEST DISTRICT,SITE SUB-DIVISION,<1,0,8719,8719
KARACHI WEST DISTRICT,SITE SUB-DIVISION,1,0,9121,9121
KARACHI WEST DISTRICT,SITE SUB-DIVISION,2,0,9660,9660
KARACHI WEST DISTRICT,SITE SUB-DIVISION,3,0,10099,10099
KARACHI WEST DISTRICT,SITE SUB-DIVISION,4,0,9490,9490
KARACHI WEST DISTRICT,SITE SUB-DIVISION,5,0,9731,9731
KARACHI WEST DISTRICT,SITE SUB-DIVISION,6,0,9447,9447
KARACHI WEST DISTRICT,SITE SUB-DIVISION,7,0,9924,9924
KARACHI WEST DISTRICT,SITE SUB-DIVISION,8,0,8678,8678
KARACHI WEST DISTRICT,SITE SUB-DIVISION,9,0,10151,10151
KARACHI WEST DISTRICT,SITE SUB-DIVISION,10,0,8147,8147
KARACHI WEST DISTRICT,SITE SUB-DIVISION,11,0,9609,9609
KARACHI WEST DISTRICT,SITE SUB-DIVISION,12,0,7910,7910
KARACHI WEST DISTRICT,SITE SUB-DIVISION,13,0,8494,8494
KARACHI WEST DISTRICT,SITE SUB-DIVISION,14,0,7729,7729
KARACHI WEST DISTRICT,SITE SUB-DIVISION,15,0,8194,8194
KARACHI WEST DISTRICT,SITE SUB-DIVISION,16,0,8320,8320
KARACHI WEST DISTRICT,SITE SUB-DIVISION,17,0,9248,9248
KARACHI WEST DISTRICT,SITE SUB-DIVISION,18,0,7983,7983
KARACHI WEST DISTRICT,SITE SUB-DIVISION,19,0,9404,9404
KARACHI WEST DISTRICT,SITE SUB-DIVISION,20,0,8008,8008
KARACHI WEST DISTRICT,SITE SUB-DIVISION,21,0,9688,9688
KARACHI WEST DISTRICT,SITE SUB-DIVISION,22,0,8459,8459
KARACHI WEST DISTRICT,SITE SUB-DIVISION,23,0,8502,8502
KARACHI WEST DISTRICT,SITE SUB-DIVISION,24,0,8508,8508
KARACHI WEST DISTRICT,SITE SUB-DIVISION,25,0,7179,7179
KARACHI WEST DISTRICT,SITE SUB-DIVISION,26,0,8104,8104
KARACHI WEST DISTRICT,SITE SUB-DIVISION,27,0,8243,8243
KARACHI WEST DISTRICT,SITE SUB-DIVISION,28,0,7504,7504
KARACHI WEST DISTRICT,SITE SUB-DIVISION,29,0,7710,7710
KARACHI WEST DISTRICT,SITE SUB-DIVISION,30,0,6238,6238
KARACHI WEST DISTRICT,SITE SUB-DIVISION,31,0,7451,7451
KARACHI WEST DISTRICT,SITE SUB-DIVISION,32,0,6607,6607
KARACHI WEST DISTRICT,SITE SUB-DIVISION,33,0,6600,6600
KARACHI WEST DISTRICT,SITE SUB-DIVISION,34,0,6764,6764
KARACHI WEST DISTRICT,SITE SUB-DIVISION,35,0,5283,5283
KARACHI WEST DISTRICT,SITE SUB-DIVISION,36,0,5854,5854
KARACHI WEST DISTRICT,SITE SUB-DIVISION,37,0,5755,5755
KARACHI WEST DISTRICT,SITE SUB-DIVISION,38,0,5511,5511
KARACHI WEST DISTRICT,SITE SUB-DIVISION,39,0,5632,5632
KARACHI WEST DISTRICT,SITE SUB-DIVISION,40,0,4381,4381
KARACHI WEST DISTRICT,SITE SUB-DIVISION,41,0,4824,4824
KARACHI WEST DISTRICT,SITE SUB-DIVISION,42,0,4102,4102
KARACHI WEST DISTRICT,SITE SUB-DIVISION,43,0,4069,4069
KARACHI WEST DISTRICT,SITE SUB-DIVISION,44,0,3901,3901
KARACHI WEST DISTRICT,SITE SUB-DIVISION,45,0,2986,2986
KARACHI WEST DISTRICT,SITE SUB-DIVISION,46,0,3528,3528
KARACHI WEST DISTRICT,SITE SUB-DIVISION,47,0,3244,3244
KARACHI WEST DISTRICT,SITE SUB-DIVISION,48,0,3104,3104
KARACHI WEST DISTRICT,SITE SUB-DIVISION,49,0,3165,3165
KARACHI WEST DISTRICT,SITE SUB-DIVISION,50,0,2512,2512
KARACHI WEST DISTRICT,SITE SUB-DIVISION,51,0,3342,3342
KARACHI WEST DISTRICT,SITE SUB-DIVISION,52,0,2692,2692
KARACHI WEST DISTRICT,SITE SUB-DIVISION,53,0,2645,2645
KARACHI WEST DISTRICT,SITE SUB-DIVISION,54,0,2351,2351
KARACHI WEST DISTRICT,SITE SUB-DIVISION,55,0,1777,1777
KARACHI WEST DISTRICT,SITE SUB-DIVISION,56,0,1912,1912
KARACHI WEST DISTRICT,SITE SUB-DIVISION,57,0,2097,2097
KARACHI WEST DISTRICT,SITE SUB-DIVISION,58,0,1846,1846
KARACHI WEST DISTRICT,SITE SUB-DIVISION,59,0,1854,1854
KARACHI WEST DISTRICT,SITE SUB-DIVISION,60,0,1393,1393
KARACHI WEST DISTRICT,SITE SUB-DIVISION,61,0,1982,1982
KARACHI WEST DISTRICT,SITE SUB-DIVISION,62,0,1703,1703
KARACHI WEST DISTRICT,SITE SUB-DIVISION,63,0,1708,1708
KARACHI WEST DISTRICT,SITE SUB-DIVISION,64,0,1390,1390
KARACHI WEST DISTRICT,SITE SUB-DIVISION,65,0,1026,1026
KARACHI WEST DISTRICT,SITE SUB-DIVISION,66,0,1007,1007
KARACHI WEST DISTRICT,SITE SUB-DIVISION,67,0,1025,1025
KARACHI WEST DISTRICT,SITE SUB-DIVISION,68,0,1064,1064
KARACHI WEST DISTRICT,SITE SUB-DIVISION,69,0,947,947
KARACHI WEST DISTRICT,SITE SUB-DIVISION,70,0,603,603
KARACHI WEST DISTRICT,SITE SUB-DIVISION,71,0,688,688
KARACHI WEST DISTRICT,SITE SUB-DIVISION,72,0,580,580
KARACHI WEST DISTRICT,SITE SUB-DIVISION,73,0,658,658
KARACHI WEST DISTRICT,SITE SUB-DIVISION,74,0,438,438
KARACHI WEST DISTRICT,SITE SUB-DIVISION,>=75,0,3372,3372
KARAK DISTRICT,BANDA DAUD SHAH TEHSIL,<1,4196,0,4196
KARAK DISTRICT,BANDA DAUD SHAH TEHSIL,1,4728,0,4728
KARAK DISTRICT,BANDA DAUD SHAH TEHSIL,2,4910,0,4910
KARAK DISTRICT,BANDA DAUD SHAH TEHSIL,3,5185,0,5185
KARAK DISTRICT,BANDA DAUD SHAH TEHSIL,4,4814,0,4814
KARAK DISTRICT,BANDA DAUD SHAH TEHSIL,5,5057,0,5057
KARAK DISTRICT,BANDA DAUD SHAH TEHSIL,6,4379,0,4379
KARAK DISTRICT,BANDA DAUD SHAH TEHSIL,7,4890,0,4890
KARAK DISTRICT,BANDA DAUD SHAH TEHSIL,8,4456,0,4456
KARAK DISTRICT,BANDA DAUD SHAH TEHSIL,9,4713,0,4713
KARAK DISTRICT,BANDA DAUD SHAH TEHSIL,10,4113,0,4113
KARAK DISTRICT,BANDA DAUD SHAH TEHSIL,11,4308,0,4308
KARAK DISTRICT,BANDA DAUD SHAH TEHSIL,12,3641,0,3641
KARAK DISTRICT,BANDA DAUD SHAH TEHSIL,13,3967,0,3967
KARAK DISTRICT,BANDA DAUD SHAH TEHSIL,14,3579,0,3579
KARAK DISTRICT,BANDA DAUD SHAH TEHSIL,15,3786,0,3786
KARAK DISTRICT,BANDA DAUD SHAH TEHSIL,16,3562,0,3562
KARAK DISTRICT,BANDA DAUD SHAH TEHSIL,17,3918,0,3918
KARAK DISTRICT,BANDA DAUD SHAH TEHSIL,18,3305,0,3305
KARAK DISTRICT,BANDA DAUD SHAH TEHSIL,19,3323,0,3323
KARAK DISTRICT,BANDA DAUD SHAH TEHSIL,20,2866,0,2866
KARAK DISTRICT,BANDA DAUD SHAH TEHSIL,21,3057,0,3057
KARAK DISTRICT,BANDA DAUD SHAH TEHSIL,22,2635,0,2635
KARAK DISTRICT,BANDA DAUD SHAH TEHSIL,23,2806,0,2806
KARAK DISTRICT,BANDA DAUD SHAH TEHSIL,24,2680,0,2680
KARAK DISTRICT,BANDA DAUD SHAH TEHSIL,25,2518,0,2518
KARAK DISTRICT,BANDA DAUD SHAH TEHSIL,26,2354,0,2354
KARAK DISTRICT,BANDA DAUD SHAH TEHSIL,27,2327,0,2327
KARAK DISTRICT,BANDA DAUD SHAH TEHSIL,28,2282,0,2282
KARAK DISTRICT,BANDA DAUD SHAH TEHSIL,29,2106,0,2106
KARAK DISTRICT,BANDA DAUD SHAH TEHSIL,30,2048,0,2048
KARAK DISTRICT,BANDA DAUD SHAH TEHSIL,31,1983,0,1983
KARAK DISTRICT,BANDA DAUD SHAH TEHSIL,32,1712,0,1712
KARAK DISTRICT,BANDA DAUD SHAH TEHSIL,33,1813,0,1813
KARAK DISTRICT,BANDA DAUD SHAH TEHSIL,34,1550,0,1550
KARAK DISTRICT,BANDA DAUD SHAH TEHSIL,35,1521,0,1521
KARAK DISTRICT,BANDA DAUD SHAH TEHSIL,36,1415,0,1415
KARAK DISTRICT,BANDA DAUD SHAH TEHSIL,37,1437,0,1437
KARAK DISTRICT,BANDA DAUD SHAH TEHSIL,38,1575,0,1575
KARAK DISTRICT,BANDA DAUD SHAH TEHSIL,39,1373,0,1373
KARAK DISTRICT,BANDA DAUD SHAH TEHSIL,40,1534,0,1534
KARAK DISTRICT,BANDA DAUD SHAH TEHSIL,41,1255,0,1255
KARAK DISTRICT,BANDA DAUD SHAH TEHSIL,42,1135,0,1135
KARAK DISTRICT,BANDA DAUD SHAH TEHSIL,43,1245,0,1245
KARAK DISTRICT,BANDA DAUD SHAH TEHSIL,44,1046,0,1046
KARAK DISTRICT,BANDA DAUD SHAH TEHSIL,45,1146,0,1146
KARAK DISTRICT,BANDA DAUD SHAH TEHSIL,46,916,0,916
KARAK DISTRICT,BANDA DAUD SHAH TEHSIL,47,883,0,883
KARAK DISTRICT,BANDA DAUD SHAH TEHSIL,48,1153,0,1153
KARAK DISTRICT,BANDA DAUD SHAH TEHSIL,49,983,0,983
KARAK DISTRICT,BANDA DAUD SHAH TEHSIL,50,1186,0,1186
KARAK DISTRICT,BANDA DAUD SHAH TEHSIL,51,850,0,850
KARAK DISTRICT,BANDA DAUD SHAH TEHSIL,52,931,0,931
KARAK DISTRICT,BANDA DAUD SHAH TEHSIL,53,849,0,849
KARAK DISTRICT,BANDA DAUD SHAH TEHSIL,54,784,0,784
KARAK DISTRICT,BANDA DAUD SHAH TEHSIL,55,807,0,807
KARAK DISTRICT,BANDA DAUD SHAH TEHSIL,56,629,0,629
KARAK DISTRICT,BANDA DAUD SHAH TEHSIL,57,633,0,633
KARAK DISTRICT,BANDA DAUD SHAH TEHSIL,58,778,0,778
KARAK DISTRICT,BANDA DAUD SHAH TEHSIL,59,644,0,644
KARAK DISTRICT,BANDA DAUD SHAH TEHSIL,60,691,0,691
KARAK DISTRICT,BANDA DAUD SHAH TEHSIL,61,631,0,631
KARAK DISTRICT,BANDA DAUD SHAH TEHSIL,62,632,0,632
KARAK DISTRICT,BANDA DAUD SHAH TEHSIL,63,650,0,650
KARAK DISTRICT,BANDA DAUD SHAH TEHSIL,64,546,0,546
KARAK DISTRICT,BANDA DAUD SHAH TEHSIL,65,533,0,533
KARAK DISTRICT,BANDA DAUD SHAH TEHSIL,66,440,0,440
KARAK DISTRICT,BANDA DAUD SHAH TEHSIL,67,452,0,452
KARAK DISTRICT,BANDA DAUD SHAH TEHSIL,68,451,0,451
KARAK DISTRICT,BANDA DAUD SHAH TEHSIL,69,395,0,395
KARAK DISTRICT,BANDA DAUD SHAH TEHSIL,70,431,0,431
KARAK DISTRICT,BANDA DAUD SHAH TEHSIL,71,341,0,341
KARAK DISTRICT,BANDA DAUD SHAH TEHSIL,72,349,0,349
KARAK DISTRICT,BANDA DAUD SHAH TEHSIL,73,320,0,320
KARAK DISTRICT,BANDA DAUD SHAH TEHSIL,74,236,0,236
KARAK DISTRICT,BANDA DAUD SHAH TEHSIL,>=75,2109,0,2109
KARAK DISTRICT,KARAK TEHSIL,<1,6958,1346,8304
KARAK DISTRICT,KARAK TEHSIL,1,7358,1428,8786
KARAK DISTRICT,KARAK TEHSIL,2,7944,1486,9430
KARAK DISTRICT,KARAK TEHSIL,3,8464,1682,10146
KARAK DISTRICT,KARAK TEHSIL,4,7904,1691,9595
KARAK DISTRICT,KARAK TEHSIL,5,7946,1639,9585
KARAK DISTRICT,KARAK TEHSIL,6,6874,1407,8281
KARAK DISTRICT,KARAK TEHSIL,7,7296,1543,8839
KARAK DISTRICT,KARAK TEHSIL,8,6804,1360,8164
KARAK DISTRICT,KARAK TEHSIL,9,7180,1355,8535
KARAK DISTRICT,KARAK TEHSIL,10,6192,1207,7399
KARAK DISTRICT,KARAK TEHSIL,11,6816,1440,8256
KARAK DISTRICT,KARAK TEHSIL,12,5716,1183,6899
KARAK DISTRICT,KARAK TEHSIL,13,6257,1292,7549
KARAK DISTRICT,KARAK TEHSIL,14,5662,1148,6810
KARAK DISTRICT,KARAK TEHSIL,15,5648,1188,6836
KARAK DISTRICT,KARAK TEHSIL,16,5713,1160,6873
KARAK DISTRICT,KARAK TEHSIL,17,5948,1225,7173
KARAK DISTRICT,KARAK TEHSIL,18,5242,1023,6265
KARAK DISTRICT,KARAK TEHSIL,19,5516,1077,6593
KARAK DISTRICT,KARAK TEHSIL,20,4468,984,5452
KARAK DISTRICT,KARAK TEHSIL,21,4700,1020,5720
KARAK DISTRICT,KARAK TEHSIL,22,4239,996,5235
KARAK DISTRICT,KARAK TEHSIL,23,4574,950,5524
KARAK DISTRICT,KARAK TEHSIL,24,3982,929,4911
KARAK DISTRICT,KARAK TEHSIL,25,3908,906,4814
KARAK DISTRICT,KARAK TEHSIL,26,3776,851,4627
KARAK DISTRICT,KARAK TEHSIL,27,3478,802,4280
KARAK DISTRICT,KARAK TEHSIL,28,3612,838,4450
KARAK DISTRICT,KARAK TEHSIL,29,3051,769,3820
KARAK DISTRICT,KARAK TEHSIL,30,3204,785,3989
KARAK DISTRICT,KARAK TEHSIL,31,2778,706,3484
KARAK DISTRICT,KARAK TEHSIL,32,2720,677,3397
KARAK DISTRICT,KARAK TEHSIL,33,2586,662,3248
KARAK DISTRICT,KARAK TEHSIL,34,2234,621,2855
KARAK DISTRICT,KARAK TEHSIL,35,2449,595,3044
KARAK DISTRICT,KARAK TEHSIL,36,2037,482,2519
KARAK DISTRICT,KARAK TEHSIL,37,1850,432,2282
KARAK DISTRICT,KARAK TEHSIL,38,2418,618,3036
KARAK DISTRICT,KARAK TEHSIL,39,1931,487,2418
KARAK DISTRICT,KARAK TEHSIL,40,2560,590,3150
KARAK DISTRICT,KARAK TEHSIL,41,1798,406,2204
KARAK DISTRICT,KARAK TEHSIL,42,1691,407,2098
KARAK DISTRICT,KARAK TEHSIL,43,1907,428,2335
KARAK DISTRICT,KARAK TEHSIL,44,1632,384,2016
KARAK DISTRICT,KARAK TEHSIL,45,1965,423,2388
KARAK DISTRICT,KARAK TEHSIL,46,1427,323,1750
KARAK DISTRICT,KARAK TEHSIL,47,1402,284,1686
KARAK DISTRICT,KARAK TEHSIL,48,1867,372,2239
KARAK DISTRICT,KARAK TEHSIL,49,1429,307,1736
KARAK DISTRICT,KARAK TEHSIL,50,1845,388,2233
KARAK DISTRICT,KARAK TEHSIL,51,1350,309,1659
KARAK DISTRICT,KARAK TEHSIL,52,1415,265,1680
KARAK DISTRICT,KARAK TEHSIL,53,1477,292,1769
KARAK DISTRICT,KARAK TEHSIL,54,1360,281,1641
KARAK DISTRICT,KARAK TEHSIL,55,1504,352,1856
KARAK DISTRICT,KARAK TEHSIL,56,1085,219,1304
KARAK DISTRICT,KARAK TEHSIL,57,914,198,1112
KARAK DISTRICT,KARAK TEHSIL,58,1311,246,1557
KARAK DISTRICT,KARAK TEHSIL,59,917,200,1117
KARAK DISTRICT,KARAK TEHSIL,60,1118,212,1330
KARAK DISTRICT,KARAK TEHSIL,61,792,186,978
KARAK DISTRICT,KARAK TEHSIL,62,960,183,1143
KARAK DISTRICT,KARAK TEHSIL,63,952,169,1121
KARAK DISTRICT,KARAK TEHSIL,64,771,124,895
KARAK DISTRICT,KARAK TEHSIL,65,790,153,943
KARAK DISTRICT,KARAK TEHSIL,66,583,102,685
KARAK DISTRICT,KARAK TEHSIL,67,566,95,661
KARAK DISTRICT,KARAK TEHSIL,68,661,110,771
KARAK DISTRICT,KARAK TEHSIL,69,502,97,599
KARAK DISTRICT,KARAK TEHSIL,70,687,120,807
KARAK DISTRICT,KARAK TEHSIL,71,443,75,518
KARAK DISTRICT,KARAK TEHSIL,72,513,84,597
KARAK DISTRICT,KARAK TEHSIL,73,404,90,494
KARAK DISTRICT,KARAK TEHSIL,74,408,72,480
KARAK DISTRICT,KARAK TEHSIL,>=75,3304,550,3854
KARAK DISTRICT,TAKHT-E-NASRATI TEHSIL,<1,6568,0,6568
KARAK DISTRICT,TAKHT-E-NASRATI TEHSIL,1,7951,0,7951
KARAK DISTRICT,TAKHT-E-NASRATI TEHSIL,2,8561,0,8561
KARAK DISTRICT,TAKHT-E-NASRATI TEHSIL,3,9356,0,9356
KARAK DISTRICT,TAKHT-E-NASRATI TEHSIL,4,8867,0,8867
KARAK DISTRICT,TAKHT-E-NASRATI TEHSIL,5,8702,0,8702
KARAK DISTRICT,TAKHT-E-NASRATI TEHSIL,6,7339,0,7339
KARAK DISTRICT,TAKHT-E-NASRATI TEHSIL,7,8044,0,8044
KARAK DISTRICT,TAKHT-E-NASRATI TEHSIL,8,7189,0,7189
KARAK DISTRICT,TAKHT-E-NASRATI TEHSIL,9,7847,0,7847
KARAK DISTRICT,TAKHT-E-NASRATI TEHSIL,10,6401,0,6401
KARAK DISTRICT,TAKHT-E-NASRATI TEHSIL,11,7135,0,7135
KARAK DISTRICT,TAKHT-E-NASRATI TEHSIL,12,6101,0,6101
KARAK DISTRICT,TAKHT-E-NASRATI TEHSIL,13,6446,0,6446
KARAK DISTRICT,TAKHT-E-NASRATI TEHSIL,14,6069,0,6069
KARAK DISTRICT,TAKHT-E-NASRATI TEHSIL,15,6078,0,6078
KARAK DISTRICT,TAKHT-E-NASRATI TEHSIL,16,6141,0,6141
KARAK DISTRICT,TAKHT-E-NASRATI TEHSIL,17,6266,0,6266
KARAK DISTRICT,TAKHT-E-NASRATI TEHSIL,18,5160,0,5160
KARAK DISTRICT,TAKHT-E-NASRATI TEHSIL,19,5590,0,5590
KARAK DISTRICT,TAKHT-E-NASRATI TEHSIL,20,4781,0,4781
KARAK DISTRICT,TAKHT-E-NASRATI TEHSIL,21,4937,0,4937
KARAK DISTRICT,TAKHT-E-NASRATI TEHSIL,22,4581,0,4581
KARAK DISTRICT,TAKHT-E-NASRATI TEHSIL,23,4868,0,4868
KARAK DISTRICT,TAKHT-E-NASRATI TEHSIL,24,4346,0,4346
KARAK DISTRICT,TAKHT-E-NASRATI TEHSIL,25,4331,0,4331
KARAK DISTRICT,TAKHT-E-NASRATI TEHSIL,26,4322,0,4322
KARAK DISTRICT,TAKHT-E-NASRATI TEHSIL,27,3907,0,3907
KARAK DISTRICT,TAKHT-E-NASRATI TEHSIL,28,4025,0,4025
KARAK DISTRICT,TAKHT-E-NASRATI TEHSIL,29,3404,0,3404
KARAK DISTRICT,TAKHT-E-NASRATI TEHSIL,30,3528,0,3528
KARAK DISTRICT,TAKHT-E-NASRATI TEHSIL,31,3061,0,3061
KARAK DISTRICT,TAKHT-E-NASRATI TEHSIL,32,2944,0,2944
KARAK DISTRICT,TAKHT-E-NASRATI TEHSIL,33,2975,0,2975
KARAK DISTRICT,TAKHT-E-NASRATI TEHSIL,34,2590,0,2590
KARAK DISTRICT,TAKHT-E-NASRATI TEHSIL,35,2568,0,2568
KARAK DISTRICT,TAKHT-E-NASRATI TEHSIL,36,2212,0,2212
KARAK DISTRICT,TAKHT-E-NASRATI TEHSIL,37,2086,0,2086
KARAK DISTRICT,TAKHT-E-NASRATI TEHSIL,38,2679,0,2679
KARAK DISTRICT,TAKHT-E-NASRATI TEHSIL,39,2200,0,2200
KARAK DISTRICT,TAKHT-E-NASRATI TEHSIL,40,2571,0,2571
KARAK DISTRICT,TAKHT-E-NASRATI TEHSIL,41,1863,0,1863
KARAK DISTRICT,TAKHT-E-NASRATI TEHSIL,42,1883,0,1883
KARAK DISTRICT,TAKHT-E-NASRATI TEHSIL,43,1929,0,1929
KARAK DISTRICT,TAKHT-E-NASRATI TEHSIL,44,1676,0,1676
KARAK DISTRICT,TAKHT-E-NASRATI TEHSIL,45,1881,0,1881
KARAK DISTRICT,TAKHT-E-NASRATI TEHSIL,46,1373,0,1373
KARAK DISTRICT,TAKHT-E-NASRATI TEHSIL,47,1378,0,1378
KARAK DISTRICT,TAKHT-E-NASRATI TEHSIL,48,1861,0,1861
KARAK DISTRICT,TAKHT-E-NASRATI TEHSIL,49,1521,0,1521
KARAK DISTRICT,TAKHT-E-NASRATI TEHSIL,50,1909,0,1909
KARAK DISTRICT,TAKHT-E-NASRATI TEHSIL,51,1300,0,1300
KARAK DISTRICT,TAKHT-E-NASRATI TEHSIL,52,1352,0,1352
KARAK DISTRICT,TAKHT-E-NASRATI TEHSIL,53,1409,0,1409
KARAK DISTRICT,TAKHT-E-NASRATI TEHSIL,54,1246,0,1246
KARAK DISTRICT,TAKHT-E-NASRATI TEHSIL,55,1444,0,1444
KARAK DISTRICT,TAKHT-E-NASRATI TEHSIL,56,1075,0,1075
KARAK DISTRICT,TAKHT-E-NASRATI TEHSIL,57,991,0,991
KARAK DISTRICT,TAKHT-E-NASRATI TEHSIL,58,1340,0,1340
KARAK DISTRICT,TAKHT-E-NASRATI TEHSIL,59,1090,0,1090
KARAK DISTRICT,TAKHT-E-NASRATI TEHSIL,60,1301,0,1301
KARAK DISTRICT,TAKHT-E-NASRATI TEHSIL,61,977,0,977
KARAK DISTRICT,TAKHT-E-NASRATI TEHSIL,62,1025,0,1025
KARAK DISTRICT,TAKHT-E-NASRATI TEHSIL,63,1011,0,1011
KARAK DISTRICT,TAKHT-E-NASRATI TEHSIL,64,814,0,814
KARAK DISTRICT,TAKHT-E-NASRATI TEHSIL,65,819,0,819
KARAK DISTRICT,TAKHT-E-NASRATI TEHSIL,66,574,0,574
KARAK DISTRICT,TAKHT-E-NASRATI TEHSIL,67,589,0,589
KARAK DISTRICT,TAKHT-E-NASRATI TEHSIL,68,625,0,625
KARAK DISTRICT,TAKHT-E-NASRATI TEHSIL,69,507,0,507
KARAK DISTRICT,TAKHT-E-NASRATI TEHSIL,70,700,0,700
KARAK DISTRICT,TAKHT-E-NASRATI TEHSIL,71,426,0,426
KARAK DISTRICT,TAKHT-E-NASRATI TEHSIL,72,486,0,486
KARAK DISTRICT,TAKHT-E-NASRATI TEHSIL,73,435,0,435
KARAK DISTRICT,TAKHT-E-NASRATI TEHSIL,74,353,0,353
KARAK DISTRICT,TAKHT-E-NASRATI TEHSIL,>=75,3161,0,3161
KASHMORE DISTRICT,KANDHKOT TALUKA,<1,6354,3556,9910
KASHMORE DISTRICT,KANDHKOT TALUKA,1,7886,3811,11697
KASHMORE DISTRICT,KANDHKOT TALUKA,2,10222,4826,15048
KASHMORE DISTRICT,KANDHKOT TALUKA,3,10108,5283,15391
KASHMORE DISTRICT,KANDHKOT TALUKA,4,10527,5014,15541
KASHMORE DISTRICT,KANDHKOT TALUKA,5,9743,4727,14470
KASHMORE DISTRICT,KANDHKOT TALUKA,6,9879,4684,14563
KASHMORE DISTRICT,KANDHKOT TALUKA,7,8825,4803,13628
KASHMORE DISTRICT,KANDHKOT TALUKA,8,9803,4981,14784
KASHMORE DISTRICT,KANDHKOT TALUKA,9,7644,4194,11838
KASHMORE DISTRICT,KANDHKOT TALUKA,10,8502,4225,12727
KASHMORE DISTRICT,KANDHKOT TALUKA,11,5381,3254,8635
KASHMORE DISTRICT,KANDHKOT TALUKA,12,5931,3465,9396
KASHMORE DISTRICT,KANDHKOT TALUKA,13,4211,3034,7245
KASHMORE DISTRICT,KANDHKOT TALUKA,14,4285,2972,7257
KASHMORE DISTRICT,KANDHKOT TALUKA,15,3804,2886,6690
KASHMORE DISTRICT,KANDHKOT TALUKA,16,3759,2825,6584
KASHMORE DISTRICT,KANDHKOT TALUKA,17,3253,3024,6277
KASHMORE DISTRICT,KANDHKOT TALUKA,18,4350,2964,7314
KASHMORE DISTRICT,KANDHKOT TALUKA,19,3536,2663,6199
KASHMORE DISTRICT,KANDHKOT TALUKA,20,4146,2491,6637
KASHMORE DISTRICT,KANDHKOT TALUKA,21,3216,2198,5414
KASHMORE DISTRICT,KANDHKOT TALUKA,22,3034,2135,5169
KASHMORE DISTRICT,KANDHKOT TALUKA,23,2928,1967,4895
KASHMORE DISTRICT,KANDHKOT TALUKA,24,2818,1981,4799
KASHMORE DISTRICT,KANDHKOT TALUKA,25,3427,1975,5402
KASHMORE DISTRICT,KANDHKOT TALUKA,26,2693,2011,4704
KASHMORE DISTRICT,KANDHKOT TALUKA,27,3236,2068,5304
KASHMORE DISTRICT,KANDHKOT TALUKA,28,3086,2047,5133
KASHMORE DISTRICT,KANDHKOT TALUKA,29,3349,2106,5455
KASHMORE DISTRICT,KANDHKOT TALUKA,30,3379,1841,5220
KASHMORE DISTRICT,KANDHKOT TALUKA,31,2776,1761,4537
KASHMORE DISTRICT,KANDHKOT TALUKA,32,2596,1726,4322
KASHMORE DISTRICT,KANDHKOT TALUKA,33,2568,1710,4278
KASHMORE DISTRICT,KANDHKOT TALUKA,34,1986,1395,3381
KASHMORE DISTRICT,KANDHKOT TALUKA,35,2592,1352,3944
KASHMORE DISTRICT,KANDHKOT TALUKA,36,2397,1478,3875
KASHMORE DISTRICT,KANDHKOT TALUKA,37,2876,1756,4632
KASHMORE DISTRICT,KANDHKOT TALUKA,38,2258,1376,3634
KASHMORE DISTRICT,KANDHKOT TALUKA,39,2325,1385,3710
KASHMORE DISTRICT,KANDHKOT TALUKA,40,2314,1188,3502
KASHMORE DISTRICT,KANDHKOT TALUKA,41,1725,1031,2756
KASHMORE DISTRICT,KANDHKOT TALUKA,42,1722,1166,2888
KASHMORE DISTRICT,KANDHKOT TALUKA,43,1430,1018,2448
KASHMORE DISTRICT,KANDHKOT TALUKA,44,1251,971,2222
KASHMORE DISTRICT,KANDHKOT TALUKA,45,1418,889,2307
KASHMORE DISTRICT,KANDHKOT TALUKA,46,1421,861,2282
KASHMORE DISTRICT,KANDHKOT TALUKA,47,1857,1259,3116
KASHMORE DISTRICT,KANDHKOT TALUKA,48,1242,946,2188
KASHMORE DISTRICT,KANDHKOT TALUKA,49,1307,982,2289
KASHMORE DISTRICT,KANDHKOT TALUKA,50,1268,745,2013
KASHMORE DISTRICT,KANDHKOT TALUKA,51,1116,766,1882
KASHMORE DISTRICT,KANDHKOT TALUKA,52,1144,775,1919
KASHMORE DISTRICT,KANDHKOT TALUKA,53,776,605,1381
KASHMORE DISTRICT,KANDHKOT TALUKA,54,816,570,1386
KASHMORE DISTRICT,KANDHKOT TALUKA,55,913,497,1410
KASHMORE DISTRICT,KANDHKOT TALUKA,56,886,529,1415
KASHMORE DISTRICT,KANDHKOT TALUKA,57,1173,724,1897
KASHMORE DISTRICT,KANDHKOT TALUKA,58,584,473,1057
KASHMORE DISTRICT,KANDHKOT TALUKA,59,723,436,1159
KASHMORE DISTRICT,KANDHKOT TALUKA,60,784,444,1228
KASHMORE DISTRICT,KANDHKOT TALUKA,61,663,454,1117
KASHMORE DISTRICT,KANDHKOT TALUKA,62,830,516,1346
KASHMORE DISTRICT,KANDHKOT TALUKA,63,554,424,978
KASHMORE DISTRICT,KANDHKOT TALUKA,64,528,371,899
KASHMORE DISTRICT,KANDHKOT TALUKA,65,495,324,819
KASHMORE DISTRICT,KANDHKOT TALUKA,66,540,273,813
KASHMORE DISTRICT,KANDHKOT TALUKA,67,687,399,1086
KASHMORE DISTRICT,KANDHKOT TALUKA,68,351,240,591
KASHMORE DISTRICT,KANDHKOT TALUKA,69,366,226,592
KASHMORE DISTRICT,KANDHKOT TALUKA,70,350,223,573
KASHMORE DISTRICT,KANDHKOT TALUKA,71,337,208,545
KASHMORE DISTRICT,KANDHKOT TALUKA,72,327,223,550
KASHMORE DISTRICT,KANDHKOT TALUKA,73,208,160,368
KASHMORE DISTRICT,KANDHKOT TALUKA,74,211,129,340
KASHMORE DISTRICT,KANDHKOT TALUKA,>=75,1936,1174,3110
KASHMORE DISTRICT,KASHMORE TALUKA,<1,9049,2000,11049
KASHMORE DISTRICT,KASHMORE TALUKA,1,10983,2675,13658
KASHMORE DISTRICT,KASHMORE TALUKA,2,14219,2985,17204
KASHMORE DISTRICT,KASHMORE TALUKA,3,14419,3483,17902
KASHMORE DISTRICT,KASHMORE TALUKA,4,14891,3252,18143
KASHMORE DISTRICT,KASHMORE TALUKA,5,14203,3164,17367
KASHMORE DISTRICT,KASHMORE TALUKA,6,14338,2966,17304
KASHMORE DISTRICT,KASHMORE TALUKA,7,14093,3308,17401
KASHMORE DISTRICT,KASHMORE TALUKA,8,15005,3073,18078
KASHMORE DISTRICT,KASHMORE TALUKA,9,11731,2778,14509
KASHMORE DISTRICT,KASHMORE TALUKA,10,12602,2542,15144
KASHMORE DISTRICT,KASHMORE TALUKA,11,8033,2184,10217
KASHMORE DISTRICT,KASHMORE TALUKA,12,9029,2239,11268
KASHMORE DISTRICT,KASHMORE TALUKA,13,6551,2013,8564
KASHMORE DISTRICT,KASHMORE TALUKA,14,6499,1897,8396
KASHMORE DISTRICT,KASHMORE TALUKA,15,5735,1920,7655
KASHMORE DISTRICT,KASHMORE TALUKA,16,6081,1878,7959
KASHMORE DISTRICT,KASHMORE TALUKA,17,5909,1999,7908
KASHMORE DISTRICT,KASHMORE TALUKA,18,6978,2065,9043
KASHMORE DISTRICT,KASHMORE TALUKA,19,5405,1924,7329
KASHMORE DISTRICT,KASHMORE TALUKA,20,6238,1759,7997
KASHMORE DISTRICT,KASHMORE TALUKA,21,4535,1648,6183
KASHMORE DISTRICT,KASHMORE TALUKA,22,4519,1526,6045
KASHMORE DISTRICT,KASHMORE TALUKA,23,4033,1441,5474
KASHMORE DISTRICT,KASHMORE TALUKA,24,3804,1302,5106
KASHMORE DISTRICT,KASHMORE TALUKA,25,4805,1366,6171
KASHMORE DISTRICT,KASHMORE TALUKA,26,4084,1257,5341
KASHMORE DISTRICT,KASHMORE TALUKA,27,4531,1381,5912
KASHMORE DISTRICT,KASHMORE TALUKA,28,4308,1338,5646
KASHMORE DISTRICT,KASHMORE TALUKA,29,4879,1313,6192
KASHMORE DISTRICT,KASHMORE TALUKA,30,4382,1285,5667
KASHMORE DISTRICT,KASHMORE TALUKA,31,4288,1184,5472
KASHMORE DISTRICT,KASHMORE TALUKA,32,3964,1163,5127
KASHMORE DISTRICT,KASHMORE TALUKA,33,3682,1121,4803
KASHMORE DISTRICT,KASHMORE TALUKA,34,3330,1039,4369
KASHMORE DISTRICT,KASHMORE TALUKA,35,3641,1051,4692
KASHMORE DISTRICT,KASHMORE TALUKA,36,3979,989,4968
KASHMORE DISTRICT,KASHMORE TALUKA,37,4357,1087,5444
KASHMORE DISTRICT,KASHMORE TALUKA,38,3333,970,4303
KASHMORE DISTRICT,KASHMORE TALUKA,39,3660,1039,4699
KASHMORE DISTRICT,KASHMORE TALUKA,40,3090,867,3957
KASHMORE DISTRICT,KASHMORE TALUKA,41,2808,776,3584
KASHMORE DISTRICT,KASHMORE TALUKA,42,2572,706,3278
KASHMORE DISTRICT,KASHMORE TALUKA,43,1969,664,2633
KASHMORE DISTRICT,KASHMORE TALUKA,44,1982,669,2651
KASHMORE DISTRICT,KASHMORE TALUKA,45,2143,682,2825
KASHMORE DISTRICT,KASHMORE TALUKA,46,2422,618,3040
KASHMORE DISTRICT,KASHMORE TALUKA,47,2719,682,3401
KASHMORE DISTRICT,KASHMORE TALUKA,48,1760,648,2408
KASHMORE DISTRICT,KASHMORE TALUKA,49,1966,635,2601
KASHMORE DISTRICT,KASHMORE TALUKA,50,1894,609,2503
KASHMORE DISTRICT,KASHMORE TALUKA,51,1870,570,2440
KASHMORE DISTRICT,KASHMORE TALUKA,52,1704,544,2248
KASHMORE DISTRICT,KASHMORE TALUKA,53,1302,481,1783
KASHMORE DISTRICT,KASHMORE TALUKA,54,1259,452,1711
KASHMORE DISTRICT,KASHMORE TALUKA,55,1360,445,1805
KASHMORE DISTRICT,KASHMORE TALUKA,56,1513,438,1951
KASHMORE DISTRICT,KASHMORE TALUKA,57,1887,449,2336
KASHMORE DISTRICT,KASHMORE TALUKA,58,887,384,1271
KASHMORE DISTRICT,KASHMORE TALUKA,59,1055,385,1440
KASHMORE DISTRICT,KASHMORE TALUKA,60,1150,328,1478
KASHMORE DISTRICT,KASHMORE TALUKA,61,1110,287,1397
KASHMORE DISTRICT,KASHMORE TALUKA,62,1183,291,1474
KASHMORE DISTRICT,KASHMORE TALUKA,63,865,259,1124
KASHMORE DISTRICT,KASHMORE TALUKA,64,799,258,1057
KASHMORE DISTRICT,KASHMORE TALUKA,65,876,223,1099
KASHMORE DISTRICT,KASHMORE TALUKA,66,964,218,1182
KASHMORE DISTRICT,KASHMORE TALUKA,67,1171,208,1379
KASHMORE DISTRICT,KASHMORE TALUKA,68,632,157,789
KASHMORE DISTRICT,KASHMORE TALUKA,69,644,166,810
KASHMORE DISTRICT,KASHMORE TALUKA,70,597,138,735
KASHMORE DISTRICT,KASHMORE TALUKA,71,668,133,801
KASHMORE DISTRICT,KASHMORE TALUKA,72,527,136,663
KASHMORE DISTRICT,KASHMORE TALUKA,73,391,92,483
KASHMORE DISTRICT,KASHMORE TALUKA,74,342,74,416
KASHMORE DISTRICT,KASHMORE TALUKA,>=75,3800,704,4504
KASHMORE DISTRICT,TANGWANI TALUKA,<1,6191,859,7050
KASHMORE DISTRICT,TANGWANI TALUKA,1,10550,863,11413
KASHMORE DISTRICT,TANGWANI TALUKA,2,10721,1044,11765
KASHMORE DISTRICT,TANGWANI TALUKA,3,11211,1068,12279
KASHMORE DISTRICT,TANGWANI TALUKA,4,11539,1073,12612
KASHMORE DISTRICT,TANGWANI TALUKA,5,10696,958,11654
KASHMORE DISTRICT,TANGWANI TALUKA,6,11299,1020,12319
KASHMORE DISTRICT,TANGWANI TALUKA,7,9908,888,10796
KASHMORE DISTRICT,TANGWANI TALUKA,8,11430,1168,12598
KASHMORE DISTRICT,TANGWANI TALUKA,9,9263,797,10060
KASHMORE DISTRICT,TANGWANI TALUKA,10,9581,975,10556
KASHMORE DISTRICT,TANGWANI TALUKA,11,6630,648,7278
KASHMORE DISTRICT,TANGWANI TALUKA,12,6847,643,7490
KASHMORE DISTRICT,TANGWANI TALUKA,13,4955,551,5506
KASHMORE DISTRICT,TANGWANI TALUKA,14,5327,520,5847
KASHMORE DISTRICT,TANGWANI TALUKA,15,4723,574,5297
KASHMORE DISTRICT,TANGWANI TALUKA,16,4961,546,5507
KASHMORE DISTRICT,TANGWANI TALUKA,17,4956,646,5602
KASHMORE DISTRICT,TANGWANI TALUKA,18,4701,502,5203
KASHMORE DISTRICT,TANGWANI TALUKA,19,3830,528,4358
KASHMORE DISTRICT,TANGWANI TALUKA,20,4658,494,5152
KASHMORE DISTRICT,TANGWANI TALUKA,21,3319,366,3685
KASHMORE DISTRICT,TANGWANI TALUKA,22,3143,331,3474
KASHMORE DISTRICT,TANGWANI TALUKA,23,2772,315,3087
KASHMORE DISTRICT,TANGWANI TALUKA,24,2602,283,2885
KASHMORE DISTRICT,TANGWANI TALUKA,25,3711,389,4100
KASHMORE DISTRICT,TANGWANI TALUKA,26,2587,306,2893
KASHMORE DISTRICT,TANGWANI TALUKA,27,3219,416,3635
KASHMORE DISTRICT,TANGWANI TALUKA,28,3456,372,3828
KASHMORE DISTRICT,TANGWANI TALUKA,29,3668,411,4079
KASHMORE DISTRICT,TANGWANI TALUKA,30,3745,378,4123
KASHMORE DISTRICT,TANGWANI TALUKA,31,3229,316,3545
KASHMORE DISTRICT,TANGWANI TALUKA,32,2847,364,3211
KASHMORE DISTRICT,TANGWANI TALUKA,33,3101,305,3406
KASHMORE DISTRICT,TANGWANI TALUKA,34,2244,265,2509
KASHMORE DISTRICT,TANGWANI TALUKA,35,2834,295,3129
KASHMORE DISTRICT,TANGWANI TALUKA,36,2656,214,2870
KASHMORE DISTRICT,TANGWANI TALUKA,37,3141,355,3496
KASHMORE DISTRICT,TANGWANI TALUKA,38,2574,209,2783
KASHMORE DISTRICT,TANGWANI TALUKA,39,2739,305,3044
KASHMORE DISTRICT,TANGWANI TALUKA,40,2639,170,2809
KASHMORE DISTRICT,TANGWANI TALUKA,41,1967,174,2141
KASHMORE DISTRICT,TANGWANI TALUKA,42,2109,192,2301
KASHMORE DISTRICT,TANGWANI TALUKA,43,1608,120,1728
KASHMORE DISTRICT,TANGWANI TALUKA,44,1513,146,1659
KASHMORE DISTRICT,TANGWANI TALUKA,45,1671,175,1846
KASHMORE DISTRICT,TANGWANI TALUKA,46,1645,138,1783
KASHMORE DISTRICT,TANGWANI TALUKA,47,2238,270,2508
KASHMORE DISTRICT,TANGWANI TALUKA,48,1602,180,1782
KASHMORE DISTRICT,TANGWANI TALUKA,49,1702,200,1902
KASHMORE DISTRICT,TANGWANI TALUKA,50,1719,136,1855
KASHMORE DISTRICT,TANGWANI TALUKA,51,1263,161,1424
KASHMORE DISTRICT,TANGWANI TALUKA,52,1377,187,1564
KASHMORE DISTRICT,TANGWANI TALUKA,53,1029,98,1127
KASHMORE DISTRICT,TANGWANI TALUKA,54,904,102,1006
KASHMORE DISTRICT,TANGWANI TALUKA,55,1139,96,1235
KASHMORE DISTRICT,TANGWANI TALUKA,56,947,75,1022
KASHMORE DISTRICT,TANGWANI TALUKA,57,1384,166,1550
KASHMORE DISTRICT,TANGWANI TALUKA,58,711,65,776
KASHMORE DISTRICT,TANGWANI TALUKA,59,843,81,924
KASHMORE DISTRICT,TANGWANI TALUKA,60,979,89,1068
KASHMORE DISTRICT,TANGWANI TALUKA,61,728,70,798
KASHMORE DISTRICT,TANGWANI TALUKA,62,977,111,1088
KASHMORE DISTRICT,TANGWANI TALUKA,63,606,60,666
KASHMORE DISTRICT,TANGWANI TALUKA,64,640,48,688
KASHMORE DISTRICT,TANGWANI TALUKA,65,659,60,719
KASHMORE DISTRICT,TANGWANI TALUKA,66,570,62,632
KASHMORE DISTRICT,TANGWANI TALUKA,67,802,94,896
KASHMORE DISTRICT,TANGWANI TALUKA,68,426,45,471
KASHMORE DISTRICT,TANGWANI TALUKA,69,503,45,548
KASHMORE DISTRICT,TANGWANI TALUKA,70,471,40,511
KASHMORE DISTRICT,TANGWANI TALUKA,71,359,30,389
KASHMORE DISTRICT,TANGWANI TALUKA,72,435,36,471
KASHMORE DISTRICT,TANGWANI TALUKA,73,292,21,313
KASHMORE DISTRICT,TANGWANI TALUKA,74,234,18,252
KASHMORE DISTRICT,TANGWANI TALUKA,>=75,2494,189,2683
KASUR DISTRICT,CHUNIAN TEHSIL,<1,16242,3842,20084
KASUR DISTRICT,CHUNIAN TEHSIL,1,18084,4274,22358
KASUR DISTRICT,CHUNIAN TEHSIL,2,18585,4223,22808
KASUR DISTRICT,CHUNIAN TEHSIL,3,19913,4523,24436
KASUR DISTRICT,CHUNIAN TEHSIL,4,19894,4445,24339
KASUR DISTRICT,CHUNIAN TEHSIL,5,19173,4420,23593
KASUR DISTRICT,CHUNIAN TEHSIL,6,18707,4210,22917
KASUR DISTRICT,CHUNIAN TEHSIL,7,20053,4686,24739
KASUR DISTRICT,CHUNIAN TEHSIL,8,19437,4178,23615
KASUR DISTRICT,CHUNIAN TEHSIL,9,18466,4362,22828
KASUR DISTRICT,CHUNIAN TEHSIL,10,18134,3969,22103
KASUR DISTRICT,CHUNIAN TEHSIL,11,16577,4217,20794
KASUR DISTRICT,CHUNIAN TEHSIL,12,16540,3730,20270
KASUR DISTRICT,CHUNIAN TEHSIL,13,15182,3829,19011
KASUR DISTRICT,CHUNIAN TEHSIL,14,15231,3501,18732
KASUR DISTRICT,CHUNIAN TEHSIL,15,14592,3572,18164
KASUR DISTRICT,CHUNIAN TEHSIL,16,14567,3486,18053
KASUR DISTRICT,CHUNIAN TEHSIL,17,13601,3433,17034
KASUR DISTRICT,CHUNIAN TEHSIL,18,13719,3291,17010
KASUR DISTRICT,CHUNIAN TEHSIL,19,13042,3312,16354
KASUR DISTRICT,CHUNIAN TEHSIL,20,13630,3123,16753
KASUR DISTRICT,CHUNIAN TEHSIL,21,12052,3272,15324
KASUR DISTRICT,CHUNIAN TEHSIL,22,12518,3249,15767
KASUR DISTRICT,CHUNIAN TEHSIL,23,11076,3021,14097
KASUR DISTRICT,CHUNIAN TEHSIL,24,10458,2850,13308
KASUR DISTRICT,CHUNIAN TEHSIL,25,11631,2740,14371
KASUR DISTRICT,CHUNIAN TEHSIL,26,9572,2852,12424
KASUR DISTRICT,CHUNIAN TEHSIL,27,9199,2692,11891
KASUR DISTRICT,CHUNIAN TEHSIL,28,10035,2800,12835
KASUR DISTRICT,CHUNIAN TEHSIL,29,8913,2525,11438
KASUR DISTRICT,CHUNIAN TEHSIL,30,10832,2504,13336
KASUR DISTRICT,CHUNIAN TEHSIL,31,8580,2467,11047
KASUR DISTRICT,CHUNIAN TEHSIL,32,8648,2533,11181
KASUR DISTRICT,CHUNIAN TEHSIL,33,8033,2284,10317
KASUR DISTRICT,CHUNIAN TEHSIL,34,7407,2228,9635
KASUR DISTRICT,CHUNIAN TEHSIL,35,8861,2135,10996
KASUR DISTRICT,CHUNIAN TEHSIL,36,6771,1919,8690
KASUR DISTRICT,CHUNIAN TEHSIL,37,7103,1991,9094
KASUR DISTRICT,CHUNIAN TEHSIL,38,7515,2050,9565
KASUR DISTRICT,CHUNIAN TEHSIL,39,7082,1921,9003
KASUR DISTRICT,CHUNIAN TEHSIL,40,7715,1887,9602
KASUR DISTRICT,CHUNIAN TEHSIL,41,6026,1676,7702
KASUR DISTRICT,CHUNIAN TEHSIL,42,5615,1593,7208
KASUR DISTRICT,CHUNIAN TEHSIL,43,5380,1404,6784
KASUR DISTRICT,CHUNIAN TEHSIL,44,4932,1399,6331
KASUR DISTRICT,CHUNIAN TEHSIL,45,5678,1376,7054
KASUR DISTRICT,CHUNIAN TEHSIL,46,4188,1102,5290
KASUR DISTRICT,CHUNIAN TEHSIL,47,4777,1310,6087
KASUR DISTRICT,CHUNIAN TEHSIL,48,4874,1292,6166
KASUR DISTRICT,CHUNIAN TEHSIL,49,4998,1227,6225
KASUR DISTRICT,CHUNIAN TEHSIL,50,5703,1276,6979
KASUR DISTRICT,CHUNIAN TEHSIL,51,4244,1123,5367
KASUR DISTRICT,CHUNIAN TEHSIL,52,4532,1098,5630
KASUR DISTRICT,CHUNIAN TEHSIL,53,3974,1018,4992
KASUR DISTRICT,CHUNIAN TEHSIL,54,3713,985,4698
KASUR DISTRICT,CHUNIAN TEHSIL,55,4031,903,4934
KASUR DISTRICT,CHUNIAN TEHSIL,56,3016,711,3727
KASUR DISTRICT,CHUNIAN TEHSIL,57,2954,727,3681
KASUR DISTRICT,CHUNIAN TEHSIL,58,2842,658,3500
KASUR DISTRICT,CHUNIAN TEHSIL,59,2788,648,3436
KASUR DISTRICT,CHUNIAN TEHSIL,60,3518,723,4241
KASUR DISTRICT,CHUNIAN TEHSIL,61,2538,613,3151
KASUR DISTRICT,CHUNIAN TEHSIL,62,2480,558,3038
KASUR DISTRICT,CHUNIAN TEHSIL,63,2403,529,2932
KASUR DISTRICT,CHUNIAN TEHSIL,64,2394,492,2886
KASUR DISTRICT,CHUNIAN TEHSIL,65,2769,550,3319
KASUR DISTRICT,CHUNIAN TEHSIL,66,1578,349,1927
KASUR DISTRICT,CHUNIAN TEHSIL,67,1618,355,1973
KASUR DISTRICT,CHUNIAN TEHSIL,68,1808,401,2209
KASUR DISTRICT,CHUNIAN TEHSIL,69,1919,370,2289
KASUR DISTRICT,CHUNIAN TEHSIL,70,2447,444,2891
KASUR DISTRICT,CHUNIAN TEHSIL,71,1516,343,1859
KASUR DISTRICT,CHUNIAN TEHSIL,72,1583,328,1911
KASUR DISTRICT,CHUNIAN TEHSIL,73,1549,303,1852
KASUR DISTRICT,CHUNIAN TEHSIL,74,1415,282,1697
KASUR DISTRICT,CHUNIAN TEHSIL,>=75,10445,1996,12441
KASUR DISTRICT,KASUR TEHSIL,<1,21680,10770,32450
KASUR DISTRICT,KASUR TEHSIL,1,22778,11841,34619
KASUR DISTRICT,KASUR TEHSIL,2,23659,11927,35586
KASUR DISTRICT,KASUR TEHSIL,3,24604,12581,37185
KASUR DISTRICT,KASUR TEHSIL,4,23631,11705,35336
KASUR DISTRICT,KASUR TEHSIL,5,23535,11988,35523
KASUR DISTRICT,KASUR TEHSIL,6,22984,11665,34649
KASUR DISTRICT,KASUR TEHSIL,7,24291,12681,36972
KASUR DISTRICT,KASUR TEHSIL,8,23238,11241,34479
KASUR DISTRICT,KASUR TEHSIL,9,22724,11890,34614
KASUR DISTRICT,KASUR TEHSIL,10,22272,10535,32807
KASUR DISTRICT,KASUR TEHSIL,11,21534,11667,33201
KASUR DISTRICT,KASUR TEHSIL,12,20479,10526,31005
KASUR DISTRICT,KASUR TEHSIL,13,19932,10769,30701
KASUR DISTRICT,KASUR TEHSIL,14,19344,10097,29441
KASUR DISTRICT,KASUR TEHSIL,15,18961,10071,29032
KASUR DISTRICT,KASUR TEHSIL,16,19082,10345,29427
KASUR DISTRICT,KASUR TEHSIL,17,18167,10675,28842
KASUR DISTRICT,KASUR TEHSIL,18,17847,9837,27684
KASUR DISTRICT,KASUR TEHSIL,19,17507,10257,27764
KASUR DISTRICT,KASUR TEHSIL,20,18274,9795,28069
KASUR DISTRICT,KASUR TEHSIL,21,16910,10530,27440
KASUR DISTRICT,KASUR TEHSIL,22,17024,10290,27314
KASUR DISTRICT,KASUR TEHSIL,23,15350,9709,25059
KASUR DISTRICT,KASUR TEHSIL,24,14231,9383,23614
KASUR DISTRICT,KASUR TEHSIL,25,14626,9021,23647
KASUR DISTRICT,KASUR TEHSIL,26,13013,8770,21783
KASUR DISTRICT,KASUR TEHSIL,27,12401,8492,20893
KASUR DISTRICT,KASUR TEHSIL,28,12761,8454,21215
KASUR DISTRICT,KASUR TEHSIL,29,11747,7628,19375
KASUR DISTRICT,KASUR TEHSIL,30,13312,8469,21781
KASUR DISTRICT,KASUR TEHSIL,31,11110,7274,18384
KASUR DISTRICT,KASUR TEHSIL,32,11747,7931,19678
KASUR DISTRICT,KASUR TEHSIL,33,10324,7129,17453
KASUR DISTRICT,KASUR TEHSIL,34,9426,6366,15792
KASUR DISTRICT,KASUR TEHSIL,35,10707,7125,17832
KASUR DISTRICT,KASUR TEHSIL,36,8910,5834,14744
KASUR DISTRICT,KASUR TEHSIL,37,9027,5719,14746
KASUR DISTRICT,KASUR TEHSIL,38,9157,6338,15495
KASUR DISTRICT,KASUR TEHSIL,39,8983,5750,14733
KASUR DISTRICT,KASUR TEHSIL,40,9167,6538,15705
KASUR DISTRICT,KASUR TEHSIL,41,7697,5030,12727
KASUR DISTRICT,KASUR TEHSIL,42,7647,5405,13052
KASUR DISTRICT,KASUR TEHSIL,43,6809,4674,11483
KASUR DISTRICT,KASUR TEHSIL,44,6234,4260,10494
KASUR DISTRICT,KASUR TEHSIL,45,7080,4787,11867
KASUR DISTRICT,KASUR TEHSIL,46,5551,3634,9185
KASUR DISTRICT,KASUR TEHSIL,47,6096,3862,9958
KASUR DISTRICT,KASUR TEHSIL,48,6063,4022,10085
KASUR DISTRICT,KASUR TEHSIL,49,6186,3849,10035
KASUR DISTRICT,KASUR TEHSIL,50,6863,4428,11291
KASUR DISTRICT,KASUR TEHSIL,51,5730,3388,9118
KASUR DISTRICT,KASUR TEHSIL,52,5782,3852,9634
KASUR DISTRICT,KASUR TEHSIL,53,5284,3437,8721
KASUR DISTRICT,KASUR TEHSIL,54,4864,3211,8075
KASUR DISTRICT,KASUR TEHSIL,55,5064,3504,8568
KASUR DISTRICT,KASUR TEHSIL,56,3747,2391,6138
KASUR DISTRICT,KASUR TEHSIL,57,3709,2158,5867
KASUR DISTRICT,KASUR TEHSIL,58,3682,2292,5974
KASUR DISTRICT,KASUR TEHSIL,59,3595,2146,5741
KASUR DISTRICT,KASUR TEHSIL,60,4205,2571,6776
KASUR DISTRICT,KASUR TEHSIL,61,3280,2017,5297
KASUR DISTRICT,KASUR TEHSIL,62,3379,2133,5512
KASUR DISTRICT,KASUR TEHSIL,63,3137,1935,5072
KASUR DISTRICT,KASUR TEHSIL,64,2940,1671,4611
KASUR DISTRICT,KASUR TEHSIL,65,3322,1957,5279
KASUR DISTRICT,KASUR TEHSIL,66,1869,1047,2916
KASUR DISTRICT,KASUR TEHSIL,67,2036,1118,3154
KASUR DISTRICT,KASUR TEHSIL,68,2299,1196,3495
KASUR DISTRICT,KASUR TEHSIL,69,2291,1069,3360
KASUR DISTRICT,KASUR TEHSIL,70,2662,1527,4189
KASUR DISTRICT,KASUR TEHSIL,71,1828,959,2787
KASUR DISTRICT,KASUR TEHSIL,72,1856,1067,2923
KASUR DISTRICT,KASUR TEHSIL,73,1901,993,2894
KASUR DISTRICT,KASUR TEHSIL,74,1737,851,2588
KASUR DISTRICT,KASUR TEHSIL,>=75,12123,6525,18648
KASUR DISTRICT,KOT RADHA KISHAN TEHSIL,<1,7540,1273,8813
KASUR DISTRICT,KOT RADHA KISHAN TEHSIL,1,8463,1371,9834
KASUR DISTRICT,KOT RADHA KISHAN TEHSIL,2,8648,1468,10116
KASUR DISTRICT,KOT RADHA KISHAN TEHSIL,3,9286,1518,10804
KASUR DISTRICT,KOT RADHA KISHAN TEHSIL,4,9045,1483,10528
KASUR DISTRICT,KOT RADHA KISHAN TEHSIL,5,8891,1500,10391
KASUR DISTRICT,KOT RADHA KISHAN TEHSIL,6,8781,1416,10197
KASUR DISTRICT,KOT RADHA KISHAN TEHSIL,7,8933,1520,10453
KASUR DISTRICT,KOT RADHA KISHAN TEHSIL,8,8683,1398,10081
KASUR DISTRICT,KOT RADHA KISHAN TEHSIL,9,8572,1478,10050
KASUR DISTRICT,KOT RADHA KISHAN TEHSIL,10,8429,1305,9734
KASUR DISTRICT,KOT RADHA KISHAN TEHSIL,11,8146,1436,9582
KASUR DISTRICT,KOT RADHA KISHAN TEHSIL,12,7798,1245,9043
KASUR DISTRICT,KOT RADHA KISHAN TEHSIL,13,7421,1361,8782
KASUR DISTRICT,KOT RADHA KISHAN TEHSIL,14,7311,1255,8566
KASUR DISTRICT,KOT RADHA KISHAN TEHSIL,15,6997,1288,8285
KASUR DISTRICT,KOT RADHA KISHAN TEHSIL,16,7132,1284,8416
KASUR DISTRICT,KOT RADHA KISHAN TEHSIL,17,6621,1326,7947
KASUR DISTRICT,KOT RADHA KISHAN TEHSIL,18,6775,1152,7927
KASUR DISTRICT,KOT RADHA KISHAN TEHSIL,19,6419,1331,7750
KASUR DISTRICT,KOT RADHA KISHAN TEHSIL,20,6798,1180,7978
KASUR DISTRICT,KOT RADHA KISHAN TEHSIL,21,5920,1329,7249
KASUR DISTRICT,KOT RADHA KISHAN TEHSIL,22,6243,1311,7554
KASUR DISTRICT,KOT RADHA KISHAN TEHSIL,23,5367,1187,6554
KASUR DISTRICT,KOT RADHA KISHAN TEHSIL,24,5171,1184,6355
KASUR DISTRICT,KOT RADHA KISHAN TEHSIL,25,5073,1037,6110
KASUR DISTRICT,KOT RADHA KISHAN TEHSIL,26,4656,1090,5746
KASUR DISTRICT,KOT RADHA KISHAN TEHSIL,27,3930,983,4913
KASUR DISTRICT,KOT RADHA KISHAN TEHSIL,28,4666,1053,5719
KASUR DISTRICT,KOT RADHA KISHAN TEHSIL,29,3730,926,4656
KASUR DISTRICT,KOT RADHA KISHAN TEHSIL,30,5070,963,6033
KASUR DISTRICT,KOT RADHA KISHAN TEHSIL,31,3592,849,4441
KASUR DISTRICT,KOT RADHA KISHAN TEHSIL,32,3831,910,4741
KASUR DISTRICT,KOT RADHA KISHAN TEHSIL,33,3486,814,4300
KASUR DISTRICT,KOT RADHA KISHAN TEHSIL,34,2992,733,3725
KASUR DISTRICT,KOT RADHA KISHAN TEHSIL,35,3786,825,4611
KASUR DISTRICT,KOT RADHA KISHAN TEHSIL,36,2858,687,3545
KASUR DISTRICT,KOT RADHA KISHAN TEHSIL,37,2581,582,3163
KASUR DISTRICT,KOT RADHA KISHAN TEHSIL,38,3378,715,4093
KASUR DISTRICT,KOT RADHA KISHAN TEHSIL,39,2941,688,3629
KASUR DISTRICT,KOT RADHA KISHAN TEHSIL,40,3629,693,4322
KASUR DISTRICT,KOT RADHA KISHAN TEHSIL,41,2602,608,3210
KASUR DISTRICT,KOT RADHA KISHAN TEHSIL,42,2433,650,3083
KASUR DISTRICT,KOT RADHA KISHAN TEHSIL,43,2428,543,2971
KASUR DISTRICT,KOT RADHA KISHAN TEHSIL,44,2119,506,2625
KASUR DISTRICT,KOT RADHA KISHAN TEHSIL,45,2628,546,3174
KASUR DISTRICT,KOT RADHA KISHAN TEHSIL,46,1815,440,2255
KASUR DISTRICT,KOT RADHA KISHAN TEHSIL,47,1749,420,2169
KASUR DISTRICT,KOT RADHA KISHAN TEHSIL,48,2228,479,2707
KASUR DISTRICT,KOT RADHA KISHAN TEHSIL,49,1963,524,2487
KASUR DISTRICT,KOT RADHA KISHAN TEHSIL,50,2659,548,3207
KASUR DISTRICT,KOT RADHA KISHAN TEHSIL,51,1803,431,2234
KASUR DISTRICT,KOT RADHA KISHAN TEHSIL,52,1797,444,2241
KASUR DISTRICT,KOT RADHA KISHAN TEHSIL,53,1809,441,2250
KASUR DISTRICT,KOT RADHA KISHAN TEHSIL,54,1626,373,1999
KASUR DISTRICT,KOT RADHA KISHAN TEHSIL,55,1952,395,2347
KASUR DISTRICT,KOT RADHA KISHAN TEHSIL,56,1294,296,1590
KASUR DISTRICT,KOT RADHA KISHAN TEHSIL,57,1017,241,1258
KASUR DISTRICT,KOT RADHA KISHAN TEHSIL,58,1340,300,1640
KASUR DISTRICT,KOT RADHA KISHAN TEHSIL,59,1148,307,1455
KASUR DISTRICT,KOT RADHA KISHAN TEHSIL,60,1592,291,1883
KASUR DISTRICT,KOT RADHA KISHAN TEHSIL,61,1009,269,1278
KASUR DISTRICT,KOT RADHA KISHAN TEHSIL,62,993,234,1227
KASUR DISTRICT,KOT RADHA KISHAN TEHSIL,63,951,253,1204
KASUR DISTRICT,KOT RADHA KISHAN TEHSIL,64,908,182,1090
KASUR DISTRICT,KOT RADHA KISHAN TEHSIL,65,1108,209,1317
KASUR DISTRICT,KOT RADHA KISHAN TEHSIL,66,559,143,702
KASUR DISTRICT,KOT RADHA KISHAN TEHSIL,67,462,131,593
KASUR DISTRICT,KOT RADHA KISHAN TEHSIL,68,638,132,770
KASUR DISTRICT,KOT RADHA KISHAN TEHSIL,69,609,119,728
KASUR DISTRICT,KOT RADHA KISHAN TEHSIL,70,935,158,1093
KASUR DISTRICT,KOT RADHA KISHAN TEHSIL,71,509,109,618
KASUR DISTRICT,KOT RADHA KISHAN TEHSIL,72,532,136,668
KASUR DISTRICT,KOT RADHA KISHAN TEHSIL,73,524,109,633
KASUR DISTRICT,KOT RADHA KISHAN TEHSIL,74,491,90,581
KASUR DISTRICT,KOT RADHA KISHAN TEHSIL,>=75,3810,690,4500
KASUR DISTRICT,PATTOKI TEHSIL,<1,18323,4189,22512
KASUR DISTRICT,PATTOKI TEHSIL,1,20128,4422,24550
KASUR DISTRICT,PATTOKI TEHSIL,2,20487,4569,25056
KASUR DISTRICT,PATTOKI TEHSIL,3,21988,4903,26891
KASUR DISTRICT,PATTOKI TEHSIL,4,22177,4572,26749
KASUR DISTRICT,PATTOKI TEHSIL,5,21180,4708,25888
KASUR DISTRICT,PATTOKI TEHSIL,6,21254,4521,25775
KASUR DISTRICT,PATTOKI TEHSIL,7,21882,4727,26609
KASUR DISTRICT,PATTOKI TEHSIL,8,20990,4491,25481
KASUR DISTRICT,PATTOKI TEHSIL,9,20462,4560,25022
KASUR DISTRICT,PATTOKI TEHSIL,10,20033,4121,24154
KASUR DISTRICT,PATTOKI TEHSIL,11,19063,4512,23575
KASUR DISTRICT,PATTOKI TEHSIL,12,18267,3973,22240
KASUR DISTRICT,PATTOKI TEHSIL,13,17551,4169,21720
KASUR DISTRICT,PATTOKI TEHSIL,14,16985,3710,20695
KASUR DISTRICT,PATTOKI TEHSIL,15,16792,3733,20525
KASUR DISTRICT,PATTOKI TEHSIL,16,16559,3765,20324
KASUR DISTRICT,PATTOKI TEHSIL,17,16541,3954,20495
KASUR DISTRICT,PATTOKI TEHSIL,18,15233,3569,18802
KASUR DISTRICT,PATTOKI TEHSIL,19,15848,3896,19744
KASUR DISTRICT,PATTOKI TEHSIL,20,16182,3720,19902
KASUR DISTRICT,PATTOKI TEHSIL,21,14971,4079,19050
KASUR DISTRICT,PATTOKI TEHSIL,22,14767,3644,18411
KASUR DISTRICT,PATTOKI TEHSIL,23,13275,3594,16869
KASUR DISTRICT,PATTOKI TEHSIL,24,12449,3324,15773
KASUR DISTRICT,PATTOKI TEHSIL,25,12870,3114,15984
KASUR DISTRICT,PATTOKI TEHSIL,26,11837,3033,14870
KASUR DISTRICT,PATTOKI TEHSIL,27,10968,3049,14017
KASUR DISTRICT,PATTOKI TEHSIL,28,11576,3157,14733
KASUR DISTRICT,PATTOKI TEHSIL,29,10806,2954,13760
KASUR DISTRICT,PATTOKI TEHSIL,30,11989,3114,15103
KASUR DISTRICT,PATTOKI TEHSIL,31,10377,2705,13082
KASUR DISTRICT,PATTOKI TEHSIL,32,10373,2823,13196
KASUR DISTRICT,PATTOKI TEHSIL,33,9728,2652,12380
KASUR DISTRICT,PATTOKI TEHSIL,34,9012,2345,11357
KASUR DISTRICT,PATTOKI TEHSIL,35,9856,2503,12359
KASUR DISTRICT,PATTOKI TEHSIL,36,8203,2178,10381
KASUR DISTRICT,PATTOKI TEHSIL,37,8805,2091,10896
KASUR DISTRICT,PATTOKI TEHSIL,38,8251,2251,10502
KASUR DISTRICT,PATTOKI TEHSIL,39,8563,2165,10728
KASUR DISTRICT,PATTOKI TEHSIL,40,8165,2221,10386
KASUR DISTRICT,PATTOKI TEHSIL,41,7340,1904,9244
KASUR DISTRICT,PATTOKI TEHSIL,42,7090,1741,8831
KASUR DISTRICT,PATTOKI TEHSIL,43,6078,1603,7681
KASUR DISTRICT,PATTOKI TEHSIL,44,5687,1440,7127
KASUR DISTRICT,PATTOKI TEHSIL,45,6113,1684,7797
KASUR DISTRICT,PATTOKI TEHSIL,46,5120,1337,6457
KASUR DISTRICT,PATTOKI TEHSIL,47,5856,1333,7189
KASUR DISTRICT,PATTOKI TEHSIL,48,5423,1386,6809
KASUR DISTRICT,PATTOKI TEHSIL,49,5696,1518,7214
KASUR DISTRICT,PATTOKI TEHSIL,50,5626,1508,7134
KASUR DISTRICT,PATTOKI TEHSIL,51,5055,1343,6398
KASUR DISTRICT,PATTOKI TEHSIL,52,5218,1309,6527
KASUR DISTRICT,PATTOKI TEHSIL,53,4584,1211,5795
KASUR DISTRICT,PATTOKI TEHSIL,54,4271,1102,5373
KASUR DISTRICT,PATTOKI TEHSIL,55,4325,1126,5451
KASUR DISTRICT,PATTOKI TEHSIL,56,3307,939,4246
KASUR DISTRICT,PATTOKI TEHSIL,57,3570,774,4344
KASUR DISTRICT,PATTOKI TEHSIL,58,3253,810,4063
KASUR DISTRICT,PATTOKI TEHSIL,59,3207,807,4014
KASUR DISTRICT,PATTOKI TEHSIL,60,3476,945,4421
KASUR DISTRICT,PATTOKI TEHSIL,61,2847,733,3580
KASUR DISTRICT,PATTOKI TEHSIL,62,2710,701,3411
KASUR DISTRICT,PATTOKI TEHSIL,63,2665,739,3404
KASUR DISTRICT,PATTOKI TEHSIL,64,2603,648,3251
KASUR DISTRICT,PATTOKI TEHSIL,65,2669,680,3349
KASUR DISTRICT,PATTOKI TEHSIL,66,1740,441,2181
KASUR DISTRICT,PATTOKI TEHSIL,67,1778,408,2186
KASUR DISTRICT,PATTOKI TEHSIL,68,1812,428,2240
KASUR DISTRICT,PATTOKI TEHSIL,69,1961,410,2371
KASUR DISTRICT,PATTOKI TEHSIL,70,2109,499,2608
KASUR DISTRICT,PATTOKI TEHSIL,71,1580,332,1912
KASUR DISTRICT,PATTOKI TEHSIL,72,1477,356,1833
KASUR DISTRICT,PATTOKI TEHSIL,73,1472,322,1794
KASUR DISTRICT,PATTOKI TEHSIL,74,1420,283,1703
KASUR DISTRICT,PATTOKI TEHSIL,>=75,9949,2019,11968
KECH DISTRICT,BALNIGORE SUB-TEHSIL,<1,1014,0,1014
KECH DISTRICT,BALNIGORE SUB-TEHSIL,1,932,0,932
KECH DISTRICT,BALNIGORE SUB-TEHSIL,2,1322,0,1322
KECH DISTRICT,BALNIGORE SUB-TEHSIL,3,1053,0,1053
KECH DISTRICT,BALNIGORE SUB-TEHSIL,4,1468,0,1468
KECH DISTRICT,BALNIGORE SUB-TEHSIL,5,1314,0,1314
KECH DISTRICT,BALNIGORE SUB-TEHSIL,6,1460,0,1460
KECH DISTRICT,BALNIGORE SUB-TEHSIL,7,1108,0,1108
KECH DISTRICT,BALNIGORE SUB-TEHSIL,8,1873,0,1873
KECH DISTRICT,BALNIGORE SUB-TEHSIL,9,1264,0,1264
KECH DISTRICT,BALNIGORE SUB-TEHSIL,10,2023,0,2023
KECH DISTRICT,BALNIGORE SUB-TEHSIL,11,1222,0,1222
KECH DISTRICT,BALNIGORE SUB-TEHSIL,12,1341,0,1341
KECH DISTRICT,BALNIGORE SUB-TEHSIL,13,1158,0,1158
KECH DISTRICT,BALNIGORE SUB-TEHSIL,14,1422,0,1422
KECH DISTRICT,BALNIGORE SUB-TEHSIL,15,1333,0,1333
KECH DISTRICT,BALNIGORE SUB-TEHSIL,16,1336,0,1336
KECH DISTRICT,BALNIGORE SUB-TEHSIL,17,1110,0,1110
KECH DISTRICT,BALNIGORE SUB-TEHSIL,18,1305,0,1305
KECH DISTRICT,BALNIGORE SUB-TEHSIL,19,748,0,748
KECH DISTRICT,BALNIGORE SUB-TEHSIL,20,1241,0,1241
KECH DISTRICT,BALNIGORE SUB-TEHSIL,21,747,0,747
KECH DISTRICT,BALNIGORE SUB-TEHSIL,22,503,0,503
KECH DISTRICT,BALNIGORE SUB-TEHSIL,23,543,0,543
KECH DISTRICT,BALNIGORE SUB-TEHSIL,24,554,0,554
KECH DISTRICT,BALNIGORE SUB-TEHSIL,25,787,0,787
KECH DISTRICT,BALNIGORE SUB-TEHSIL,26,541,0,541
KECH DISTRICT,BALNIGORE SUB-TEHSIL,27,484,0,484
KECH DISTRICT,BALNIGORE SUB-TEHSIL,28,647,0,647
KECH DISTRICT,BALNIGORE SUB-TEHSIL,29,508,0,508
KECH DISTRICT,BALNIGORE SUB-TEHSIL,30,906,0,906
KECH DISTRICT,BALNIGORE SUB-TEHSIL,31,520,0,520
KECH DISTRICT,BALNIGORE SUB-TEHSIL,32,348,0,348
KECH DISTRICT,BALNIGORE SUB-TEHSIL,33,445,0,445
KECH DISTRICT,BALNIGORE SUB-TEHSIL,34,357,0,357
KECH DISTRICT,BALNIGORE SUB-TEHSIL,35,530,0,530
KECH DISTRICT,BALNIGORE SUB-TEHSIL,36,352,0,352
KECH DISTRICT,BALNIGORE SUB-TEHSIL,37,259,0,259
KECH DISTRICT,BALNIGORE SUB-TEHSIL,38,511,0,511
KECH DISTRICT,BALNIGORE SUB-TEHSIL,39,437,0,437
KECH DISTRICT,BALNIGORE SUB-TEHSIL,40,756,0,756
KECH DISTRICT,BALNIGORE SUB-TEHSIL,41,364,0,364
KECH DISTRICT,BALNIGORE SUB-TEHSIL,42,194,0,194
KECH DISTRICT,BALNIGORE SUB-TEHSIL,43,382,0,382
KECH DISTRICT,BALNIGORE SUB-TEHSIL,44,272,0,272
KECH DISTRICT,BALNIGORE SUB-TEHSIL,45,329,0,329
KECH DISTRICT,BALNIGORE SUB-TEHSIL,46,195,0,195
KECH DISTRICT,BALNIGORE SUB-TEHSIL,47,212,0,212
KECH DISTRICT,BALNIGORE SUB-TEHSIL,48,295,0,295
KECH DISTRICT,BALNIGORE SUB-TEHSIL,49,316,0,316
KECH DISTRICT,BALNIGORE SUB-TEHSIL,50,425,0,425
KECH DISTRICT,BALNIGORE SUB-TEHSIL,51,211,0,211
KECH DISTRICT,BALNIGORE SUB-TEHSIL,52,141,0,141
KECH DISTRICT,BALNIGORE SUB-TEHSIL,53,233,0,233
KECH DISTRICT,BALNIGORE SUB-TEHSIL,54,229,0,229
KECH DISTRICT,BALNIGORE SUB-TEHSIL,55,215,0,215
KECH DISTRICT,BALNIGORE SUB-TEHSIL,56,154,0,154
KECH DISTRICT,BALNIGORE SUB-TEHSIL,57,100,0,100
KECH DISTRICT,BALNIGORE SUB-TEHSIL,58,149,0,149
KECH DISTRICT,BALNIGORE SUB-TEHSIL,59,138,0,138
KECH DISTRICT,BALNIGORE SUB-TEHSIL,60,235,0,235
KECH DISTRICT,BALNIGORE SUB-TEHSIL,61,138,0,138
KECH DISTRICT,BALNIGORE SUB-TEHSIL,62,102,0,102
KECH DISTRICT,BALNIGORE SUB-TEHSIL,63,155,0,155
KECH DISTRICT,BALNIGORE SUB-TEHSIL,64,131,0,131
KECH DISTRICT,BALNIGORE SUB-TEHSIL,65,120,0,120
KECH DISTRICT,BALNIGORE SUB-TEHSIL,66,72,0,72
KECH DISTRICT,BALNIGORE SUB-TEHSIL,67,52,0,52
KECH DISTRICT,BALNIGORE SUB-TEHSIL,68,129,0,129
KECH DISTRICT,BALNIGORE SUB-TEHSIL,69,94,0,94
KECH DISTRICT,BALNIGORE SUB-TEHSIL,70,152,0,152
KECH DISTRICT,BALNIGORE SUB-TEHSIL,71,71,0,71
KECH DISTRICT,BALNIGORE SUB-TEHSIL,72,63,0,63
KECH DISTRICT,BALNIGORE SUB-TEHSIL,73,138,0,138
KECH DISTRICT,BALNIGORE SUB-TEHSIL,74,68,0,68
KECH DISTRICT,BALNIGORE SUB-TEHSIL,>=75,539,0,539
KECH DISTRICT,BULAIDA SUB-TEHSIL,<1,852,564,1416
KECH DISTRICT,BULAIDA SUB-TEHSIL,1,660,954,1614
KECH DISTRICT,BULAIDA SUB-TEHSIL,2,966,851,1817
KECH DISTRICT,BULAIDA SUB-TEHSIL,3,791,802,1593
KECH DISTRICT,BULAIDA SUB-TEHSIL,4,1157,888,2045
KECH DISTRICT,BULAIDA SUB-TEHSIL,5,801,996,1797
KECH DISTRICT,BULAIDA SUB-TEHSIL,6,1279,1035,2314
KECH DISTRICT,BULAIDA SUB-TEHSIL,7,829,983,1812
KECH DISTRICT,BULAIDA SUB-TEHSIL,8,1348,1359,2707
KECH DISTRICT,BULAIDA SUB-TEHSIL,9,1108,1203,2311
KECH DISTRICT,BULAIDA SUB-TEHSIL,10,1669,1677,3346
KECH DISTRICT,BULAIDA SUB-TEHSIL,11,1067,1399,2466
KECH DISTRICT,BULAIDA SUB-TEHSIL,12,1160,1199,2359
KECH DISTRICT,BULAIDA SUB-TEHSIL,13,1023,1177,2200
KECH DISTRICT,BULAIDA SUB-TEHSIL,14,1167,1221,2388
KECH DISTRICT,BULAIDA SUB-TEHSIL,15,1023,1420,2443
KECH DISTRICT,BULAIDA SUB-TEHSIL,16,1182,1118,2300
KECH DISTRICT,BULAIDA SUB-TEHSIL,17,861,1034,1895
KECH DISTRICT,BULAIDA SUB-TEHSIL,18,1148,1113,2261
KECH DISTRICT,BULAIDA SUB-TEHSIL,19,855,950,1805
KECH DISTRICT,BULAIDA SUB-TEHSIL,20,997,1124,2121
KECH DISTRICT,BULAIDA SUB-TEHSIL,21,754,735,1489
KECH DISTRICT,BULAIDA SUB-TEHSIL,22,547,535,1082
KECH DISTRICT,BULAIDA SUB-TEHSIL,23,489,560,1049
KECH DISTRICT,BULAIDA SUB-TEHSIL,24,509,483,992
KECH DISTRICT,BULAIDA SUB-TEHSIL,25,645,641,1286
KECH DISTRICT,BULAIDA SUB-TEHSIL,26,559,535,1094
KECH DISTRICT,BULAIDA SUB-TEHSIL,27,482,428,910
KECH DISTRICT,BULAIDA SUB-TEHSIL,28,531,654,1185
KECH DISTRICT,BULAIDA SUB-TEHSIL,29,554,521,1075
KECH DISTRICT,BULAIDA SUB-TEHSIL,30,564,701,1265
KECH DISTRICT,BULAIDA SUB-TEHSIL,31,450,442,892
KECH DISTRICT,BULAIDA SUB-TEHSIL,32,374,389,763
KECH DISTRICT,BULAIDA SUB-TEHSIL,33,434,409,843
KECH DISTRICT,BULAIDA SUB-TEHSIL,34,277,382,659
KECH DISTRICT,BULAIDA SUB-TEHSIL,35,358,421,779
KECH DISTRICT,BULAIDA SUB-TEHSIL,36,320,442,762
KECH DISTRICT,BULAIDA SUB-TEHSIL,37,295,351,646
KECH DISTRICT,BULAIDA SUB-TEHSIL,38,403,749,1152
KECH DISTRICT,BULAIDA SUB-TEHSIL,39,395,454,849
KECH DISTRICT,BULAIDA SUB-TEHSIL,40,401,747,1148
KECH DISTRICT,BULAIDA SUB-TEHSIL,41,292,334,626
KECH DISTRICT,BULAIDA SUB-TEHSIL,42,263,323,586
KECH DISTRICT,BULAIDA SUB-TEHSIL,43,278,414,692
KECH DISTRICT,BULAIDA SUB-TEHSIL,44,234,330,564
KECH DISTRICT,BULAIDA SUB-TEHSIL,45,255,315,570
KECH DISTRICT,BULAIDA SUB-TEHSIL,46,221,284,505
KECH DISTRICT,BULAIDA SUB-TEHSIL,47,278,192,470
KECH DISTRICT,BULAIDA SUB-TEHSIL,48,328,414,742
KECH DISTRICT,BULAIDA SUB-TEHSIL,49,285,316,601
KECH DISTRICT,BULAIDA SUB-TEHSIL,50,269,358,627
KECH DISTRICT,BULAIDA SUB-TEHSIL,51,217,141,358
KECH DISTRICT,BULAIDA SUB-TEHSIL,52,206,128,334
KECH DISTRICT,BULAIDA SUB-TEHSIL,53,200,156,356
KECH DISTRICT,BULAIDA SUB-TEHSIL,54,194,198,392
KECH DISTRICT,BULAIDA SUB-TEHSIL,55,173,193,366
KECH DISTRICT,BULAIDA SUB-TEHSIL,56,145,131,276
KECH DISTRICT,BULAIDA SUB-TEHSIL,57,146,64,210
KECH DISTRICT,BULAIDA SUB-TEHSIL,58,158,181,339
KECH DISTRICT,BULAIDA SUB-TEHSIL,59,155,103,258
KECH DISTRICT,BULAIDA SUB-TEHSIL,60,151,250,401
KECH DISTRICT,BULAIDA SUB-TEHSIL,61,107,88,195
KECH DISTRICT,BULAIDA SUB-TEHSIL,62,100,65,165
KECH DISTRICT,BULAIDA SUB-TEHSIL,63,109,116,225
KECH DISTRICT,BULAIDA SUB-TEHSIL,64,123,114,237
KECH DISTRICT,BULAIDA SUB-TEHSIL,65,80,79,159
KECH DISTRICT,BULAIDA SUB-TEHSIL,66,76,72,148
KECH DISTRICT,BULAIDA SUB-TEHSIL,67,66,28,94
KECH DISTRICT,BULAIDA SUB-TEHSIL,68,79,122,201
KECH DISTRICT,BULAIDA SUB-TEHSIL,69,91,55,146
KECH DISTRICT,BULAIDA SUB-TEHSIL,70,69,90,159
KECH DISTRICT,BULAIDA SUB-TEHSIL,71,53,26,79
KECH DISTRICT,BULAIDA SUB-TEHSIL,72,52,46,98
KECH DISTRICT,BULAIDA SUB-TEHSIL,73,57,42,99
KECH DISTRICT,BULAIDA SUB-TEHSIL,74,49,59,108
KECH DISTRICT,BULAIDA SUB-TEHSIL,>=75,459,373,832
KECH DISTRICT,DASHT SUB-TEHSIL,<1,2476,0,2476
KECH DISTRICT,DASHT SUB-TEHSIL,1,1735,0,1735
KECH DISTRICT,DASHT SUB-TEHSIL,2,2462,0,2462
KECH DISTRICT,DASHT SUB-TEHSIL,3,2044,0,2044
KECH DISTRICT,DASHT SUB-TEHSIL,4,2959,0,2959
KECH DISTRICT,DASHT SUB-TEHSIL,5,2494,0,2494
KECH DISTRICT,DASHT SUB-TEHSIL,6,2706,0,2706
KECH DISTRICT,DASHT SUB-TEHSIL,7,2266,0,2266
KECH DISTRICT,DASHT SUB-TEHSIL,8,3119,0,3119
KECH DISTRICT,DASHT SUB-TEHSIL,9,2548,0,2548
KECH DISTRICT,DASHT SUB-TEHSIL,10,3456,0,3456
KECH DISTRICT,DASHT SUB-TEHSIL,11,2326,0,2326
KECH DISTRICT,DASHT SUB-TEHSIL,12,2401,0,2401
KECH DISTRICT,DASHT SUB-TEHSIL,13,2093,0,2093
KECH DISTRICT,DASHT SUB-TEHSIL,14,2093,0,2093
KECH DISTRICT,DASHT SUB-TEHSIL,15,2362,0,2362
KECH DISTRICT,DASHT SUB-TEHSIL,16,1985,0,1985
KECH DISTRICT,DASHT SUB-TEHSIL,17,1883,0,1883
KECH DISTRICT,DASHT SUB-TEHSIL,18,1789,0,1789
KECH DISTRICT,DASHT SUB-TEHSIL,19,1309,0,1309
KECH DISTRICT,DASHT SUB-TEHSIL,20,1842,0,1842
KECH DISTRICT,DASHT SUB-TEHSIL,21,1103,0,1103
KECH DISTRICT,DASHT SUB-TEHSIL,22,784,0,784
KECH DISTRICT,DASHT SUB-TEHSIL,23,814,0,814
KECH DISTRICT,DASHT SUB-TEHSIL,24,825,0,825
KECH DISTRICT,DASHT SUB-TEHSIL,25,1175,0,1175
KECH DISTRICT,DASHT SUB-TEHSIL,26,924,0,924
KECH DISTRICT,DASHT SUB-TEHSIL,27,856,0,856
KECH DISTRICT,DASHT SUB-TEHSIL,28,1074,0,1074
KECH DISTRICT,DASHT SUB-TEHSIL,29,1146,0,1146
KECH DISTRICT,DASHT SUB-TEHSIL,30,1352,0,1352
KECH DISTRICT,DASHT SUB-TEHSIL,31,930,0,930
KECH DISTRICT,DASHT SUB-TEHSIL,32,758,0,758
KECH DISTRICT,DASHT SUB-TEHSIL,33,869,0,869
KECH DISTRICT,DASHT SUB-TEHSIL,34,633,0,633
KECH DISTRICT,DASHT SUB-TEHSIL,35,855,0,855
KECH DISTRICT,DASHT SUB-TEHSIL,36,630,0,630
KECH DISTRICT,DASHT SUB-TEHSIL,37,610,0,610
KECH DISTRICT,DASHT SUB-TEHSIL,38,904,0,904
KECH DISTRICT,DASHT SUB-TEHSIL,39,802,0,802
KECH DISTRICT,DASHT SUB-TEHSIL,40,977,0,977
KECH DISTRICT,DASHT SUB-TEHSIL,41,609,0,609
KECH DISTRICT,DASHT SUB-TEHSIL,42,449,0,449
KECH DISTRICT,DASHT SUB-TEHSIL,43,571,0,571
KECH DISTRICT,DASHT SUB-TEHSIL,44,430,0,430
KECH DISTRICT,DASHT SUB-TEHSIL,45,448,0,448
KECH DISTRICT,DASHT SUB-TEHSIL,46,378,0,378
KECH DISTRICT,DASHT SUB-TEHSIL,47,360,0,360
KECH DISTRICT,DASHT SUB-TEHSIL,48,526,0,526
KECH DISTRICT,DASHT SUB-TEHSIL,49,519,0,519
KECH DISTRICT,DASHT SUB-TEHSIL,50,552,0,552
KECH DISTRICT,DASHT SUB-TEHSIL,51,353,0,353
KECH DISTRICT,DASHT SUB-TEHSIL,52,324,0,324
KECH DISTRICT,DASHT SUB-TEHSIL,53,376,0,376
KECH DISTRICT,DASHT SUB-TEHSIL,54,280,0,280
KECH DISTRICT,DASHT SUB-TEHSIL,55,293,0,293
KECH DISTRICT,DASHT SUB-TEHSIL,56,182,0,182
KECH DISTRICT,DASHT SUB-TEHSIL,57,195,0,195
KECH DISTRICT,DASHT SUB-TEHSIL,58,240,0,240
KECH DISTRICT,DASHT SUB-TEHSIL,59,242,0,242
KECH DISTRICT,DASHT SUB-TEHSIL,60,280,0,280
KECH DISTRICT,DASHT SUB-TEHSIL,61,207,0,207
KECH DISTRICT,DASHT SUB-TEHSIL,62,189,0,189
KECH DISTRICT,DASHT SUB-TEHSIL,63,222,0,222
KECH DISTRICT,DASHT SUB-TEHSIL,64,146,0,146
KECH DISTRICT,DASHT SUB-TEHSIL,65,142,0,142
KECH DISTRICT,DASHT SUB-TEHSIL,66,126,0,126
KECH DISTRICT,DASHT SUB-TEHSIL,67,103,0,103
KECH DISTRICT,DASHT SUB-TEHSIL,68,142,0,142
KECH DISTRICT,DASHT SUB-TEHSIL,69,151,0,151
KECH DISTRICT,DASHT SUB-TEHSIL,70,142,0,142
KECH DISTRICT,DASHT SUB-TEHSIL,71,82,0,82
KECH DISTRICT,DASHT SUB-TEHSIL,72,85,0,85
KECH DISTRICT,DASHT SUB-TEHSIL,73,92,0,92
KECH DISTRICT,DASHT SUB-TEHSIL,74,80,0,80
KECH DISTRICT,DASHT SUB-TEHSIL,>=75,585,0,585
KECH DISTRICT,HOSHAB SUB-TEHSIL,<1,772,0,772
KECH DISTRICT,HOSHAB SUB-TEHSIL,1,1204,0,1204
KECH DISTRICT,HOSHAB SUB-TEHSIL,2,1463,0,1463
KECH DISTRICT,HOSHAB SUB-TEHSIL,3,1251,0,1251
KECH DISTRICT,HOSHAB SUB-TEHSIL,4,1477,0,1477
KECH DISTRICT,HOSHAB SUB-TEHSIL,5,1711,0,1711
KECH DISTRICT,HOSHAB SUB-TEHSIL,6,1643,0,1643
KECH DISTRICT,HOSHAB SUB-TEHSIL,7,1471,0,1471
KECH DISTRICT,HOSHAB SUB-TEHSIL,8,2076,0,2076
KECH DISTRICT,HOSHAB SUB-TEHSIL,9,1835,0,1835
KECH DISTRICT,HOSHAB SUB-TEHSIL,10,2398,0,2398
KECH DISTRICT,HOSHAB SUB-TEHSIL,11,1667,0,1667
KECH DISTRICT,HOSHAB SUB-TEHSIL,12,1693,0,1693
KECH DISTRICT,HOSHAB SUB-TEHSIL,13,1474,0,1474
KECH DISTRICT,HOSHAB SUB-TEHSIL,14,1670,0,1670
KECH DISTRICT,HOSHAB SUB-TEHSIL,15,1571,0,1571
KECH DISTRICT,HOSHAB SUB-TEHSIL,16,1501,0,1501
KECH DISTRICT,HOSHAB SUB-TEHSIL,17,1116,0,1116
KECH DISTRICT,HOSHAB SUB-TEHSIL,18,1426,0,1426
KECH DISTRICT,HOSHAB SUB-TEHSIL,19,972,0,972
KECH DISTRICT,HOSHAB SUB-TEHSIL,20,1280,0,1280
KECH DISTRICT,HOSHAB SUB-TEHSIL,21,794,0,794
KECH DISTRICT,HOSHAB SUB-TEHSIL,22,733,0,733
KECH DISTRICT,HOSHAB SUB-TEHSIL,23,508,0,508
KECH DISTRICT,HOSHAB SUB-TEHSIL,24,645,0,645
KECH DISTRICT,HOSHAB SUB-TEHSIL,25,729,0,729
KECH DISTRICT,HOSHAB SUB-TEHSIL,26,618,0,618
KECH DISTRICT,HOSHAB SUB-TEHSIL,27,472,0,472
KECH DISTRICT,HOSHAB SUB-TEHSIL,28,826,0,826
KECH DISTRICT,HOSHAB SUB-TEHSIL,29,639,0,639
KECH DISTRICT,HOSHAB SUB-TEHSIL,30,1064,0,1064
KECH DISTRICT,HOSHAB SUB-TEHSIL,31,622,0,622
KECH DISTRICT,HOSHAB SUB-TEHSIL,32,617,0,617
KECH DISTRICT,HOSHAB SUB-TEHSIL,33,555,0,555
KECH DISTRICT,HOSHAB SUB-TEHSIL,34,578,0,578
KECH DISTRICT,HOSHAB SUB-TEHSIL,35,604,0,604
KECH DISTRICT,HOSHAB SUB-TEHSIL,36,481,0,481
KECH DISTRICT,HOSHAB SUB-TEHSIL,37,392,0,392
KECH DISTRICT,HOSHAB SUB-TEHSIL,38,638,0,638
KECH DISTRICT,HOSHAB SUB-TEHSIL,39,581,0,581
KECH DISTRICT,HOSHAB SUB-TEHSIL,40,880,0,880
KECH DISTRICT,HOSHAB SUB-TEHSIL,41,511,0,511
KECH DISTRICT,HOSHAB SUB-TEHSIL,42,362,0,362
KECH DISTRICT,HOSHAB SUB-TEHSIL,43,461,0,461
KECH DISTRICT,HOSHAB SUB-TEHSIL,44,376,0,376
KECH DISTRICT,HOSHAB SUB-TEHSIL,45,474,0,474
KECH DISTRICT,HOSHAB SUB-TEHSIL,46,289,0,289
KECH DISTRICT,HOSHAB SUB-TEHSIL,47,221,0,221
KECH DISTRICT,HOSHAB SUB-TEHSIL,48,373,0,373
KECH DISTRICT,HOSHAB SUB-TEHSIL,49,325,0,325
KECH DISTRICT,HOSHAB SUB-TEHSIL,50,477,0,477
KECH DISTRICT,HOSHAB SUB-TEHSIL,51,234,0,234
KECH DISTRICT,HOSHAB SUB-TEHSIL,52,223,0,223
KECH DISTRICT,HOSHAB SUB-TEHSIL,53,270,0,270
KECH DISTRICT,HOSHAB SUB-TEHSIL,54,326,0,326
KECH DISTRICT,HOSHAB SUB-TEHSIL,55,299,0,299
KECH DISTRICT,HOSHAB SUB-TEHSIL,56,182,0,182
KECH DISTRICT,HOSHAB SUB-TEHSIL,57,109,0,109
KECH DISTRICT,HOSHAB SUB-TEHSIL,58,193,0,193
KECH DISTRICT,HOSHAB SUB-TEHSIL,59,227,0,227
KECH DISTRICT,HOSHAB SUB-TEHSIL,60,301,0,301
KECH DISTRICT,HOSHAB SUB-TEHSIL,61,130,0,130
KECH DISTRICT,HOSHAB SUB-TEHSIL,62,110,0,110
KECH DISTRICT,HOSHAB SUB-TEHSIL,63,135,0,135
KECH DISTRICT,HOSHAB SUB-TEHSIL,64,184,0,184
KECH DISTRICT,HOSHAB SUB-TEHSIL,65,124,0,124
KECH DISTRICT,HOSHAB SUB-TEHSIL,66,104,0,104
KECH DISTRICT,HOSHAB SUB-TEHSIL,67,67,0,67
KECH DISTRICT,HOSHAB SUB-TEHSIL,68,122,0,122
KECH DISTRICT,HOSHAB SUB-TEHSIL,69,101,0,101
KECH DISTRICT,HOSHAB SUB-TEHSIL,70,76,0,76
KECH DISTRICT,HOSHAB SUB-TEHSIL,71,44,0,44
KECH DISTRICT,HOSHAB SUB-TEHSIL,72,42,0,42
KECH DISTRICT,HOSHAB SUB-TEHSIL,73,56,0,56
KECH DISTRICT,HOSHAB SUB-TEHSIL,74,60,0,60
KECH DISTRICT,HOSHAB SUB-TEHSIL,>=75,712,0,712
KECH DISTRICT,KECH (TURBAT) TEHSIL,<1,3756,4097,7853
KECH DISTRICT,KECH (TURBAT) TEHSIL,1,4820,6036,10856
KECH DISTRICT,KECH (TURBAT) TEHSIL,2,5153,6217,11370
KECH DISTRICT,KECH (TURBAT) TEHSIL,3,5136,6361,11497
KECH DISTRICT,KECH (TURBAT) TEHSIL,4,5941,6242,12183
KECH DISTRICT,KECH (TURBAT) TEHSIL,5,5995,6735,12730
KECH DISTRICT,KECH (TURBAT) TEHSIL,6,6213,6337,12550
KECH DISTRICT,KECH (TURBAT) TEHSIL,7,5966,6553,12519
KECH DISTRICT,KECH (TURBAT) TEHSIL,8,7325,7453,14778
KECH DISTRICT,KECH (TURBAT) TEHSIL,9,6568,6639,13207
KECH DISTRICT,KECH (TURBAT) TEHSIL,10,8223,8067,16290
KECH DISTRICT,KECH (TURBAT) TEHSIL,11,5796,6382,12178
KECH DISTRICT,KECH (TURBAT) TEHSIL,12,5835,5834,11669
KECH DISTRICT,KECH (TURBAT) TEHSIL,13,5468,5615,11083
KECH DISTRICT,KECH (TURBAT) TEHSIL,14,5841,5827,11668
KECH DISTRICT,KECH (TURBAT) TEHSIL,15,5295,5894,11189
KECH DISTRICT,KECH (TURBAT) TEHSIL,16,5476,5752,11228
KECH DISTRICT,KECH (TURBAT) TEHSIL,17,4560,5033,9593
KECH DISTRICT,KECH (TURBAT) TEHSIL,18,5198,5530,10728
KECH DISTRICT,KECH (TURBAT) TEHSIL,19,3876,4389,8265
KECH DISTRICT,KECH (TURBAT) TEHSIL,20,5371,5428,10799
KECH DISTRICT,KECH (TURBAT) TEHSIL,21,3469,3965,7434
KECH DISTRICT,KECH (TURBAT) TEHSIL,22,2867,3257,6124
KECH DISTRICT,KECH (TURBAT) TEHSIL,23,2536,3192,5728
KECH DISTRICT,KECH (TURBAT) TEHSIL,24,2890,2721,5611
KECH DISTRICT,KECH (TURBAT) TEHSIL,25,3090,3555,6645
KECH DISTRICT,KECH (TURBAT) TEHSIL,26,3008,2729,5737
KECH DISTRICT,KECH (TURBAT) TEHSIL,27,2348,2861,5209
KECH DISTRICT,KECH (TURBAT) TEHSIL,28,3353,3213,6566
KECH DISTRICT,KECH (TURBAT) TEHSIL,29,2827,3280,6107
KECH DISTRICT,KECH (TURBAT) TEHSIL,30,4023,3672,7695
KECH DISTRICT,KECH (TURBAT) TEHSIL,31,2595,2866,5461
KECH DISTRICT,KECH (TURBAT) TEHSIL,32,2308,2207,4515
KECH DISTRICT,KECH (TURBAT) TEHSIL,33,2485,2643,5128
KECH DISTRICT,KECH (TURBAT) TEHSIL,34,2092,1958,4050
KECH DISTRICT,KECH (TURBAT) TEHSIL,35,2480,2416,4896
KECH DISTRICT,KECH (TURBAT) TEHSIL,36,1853,1658,3511
KECH DISTRICT,KECH (TURBAT) TEHSIL,37,1795,1882,3677
KECH DISTRICT,KECH (TURBAT) TEHSIL,38,2734,2496,5230
KECH DISTRICT,KECH (TURBAT) TEHSIL,39,2536,2372,4908
KECH DISTRICT,KECH (TURBAT) TEHSIL,40,3256,2827,6083
KECH DISTRICT,KECH (TURBAT) TEHSIL,41,1811,1778,3589
KECH DISTRICT,KECH (TURBAT) TEHSIL,42,1354,1469,2823
KECH DISTRICT,KECH (TURBAT) TEHSIL,43,1682,1690,3372
KECH DISTRICT,KECH (TURBAT) TEHSIL,44,1417,1387,2804
KECH DISTRICT,KECH (TURBAT) TEHSIL,45,1426,1722,3148
KECH DISTRICT,KECH (TURBAT) TEHSIL,46,1042,1132,2174
KECH DISTRICT,KECH (TURBAT) TEHSIL,47,1082,1136,2218
KECH DISTRICT,KECH (TURBAT) TEHSIL,48,1650,1765,3415
KECH DISTRICT,KECH (TURBAT) TEHSIL,49,1526,1673,3199
KECH DISTRICT,KECH (TURBAT) TEHSIL,50,1807,1775,3582
KECH DISTRICT,KECH (TURBAT) TEHSIL,51,983,1077,2060
KECH DISTRICT,KECH (TURBAT) TEHSIL,52,942,986,1928
KECH DISTRICT,KECH (TURBAT) TEHSIL,53,962,1067,2029
KECH DISTRICT,KECH (TURBAT) TEHSIL,54,1147,978,2125
KECH DISTRICT,KECH (TURBAT) TEHSIL,55,838,949,1787
KECH DISTRICT,KECH (TURBAT) TEHSIL,56,773,672,1445
KECH DISTRICT,KECH (TURBAT) TEHSIL,57,545,651,1196
KECH DISTRICT,KECH (TURBAT) TEHSIL,58,675,761,1436
KECH DISTRICT,KECH (TURBAT) TEHSIL,59,701,749,1450
KECH DISTRICT,KECH (TURBAT) TEHSIL,60,888,867,1755
KECH DISTRICT,KECH (TURBAT) TEHSIL,61,536,632,1168
KECH DISTRICT,KECH (TURBAT) TEHSIL,62,431,501,932
KECH DISTRICT,KECH (TURBAT) TEHSIL,63,545,561,1106
KECH DISTRICT,KECH (TURBAT) TEHSIL,64,587,573,1160
KECH DISTRICT,KECH (TURBAT) TEHSIL,65,378,497,875
KECH DISTRICT,KECH (TURBAT) TEHSIL,66,294,350,644
KECH DISTRICT,KECH (TURBAT) TEHSIL,67,349,374,723
KECH DISTRICT,KECH (TURBAT) TEHSIL,68,384,394,778
KECH DISTRICT,KECH (TURBAT) TEHSIL,69,397,444,841
KECH DISTRICT,KECH (TURBAT) TEHSIL,70,425,287,712
KECH DISTRICT,KECH (TURBAT) TEHSIL,71,243,291,534
KECH DISTRICT,KECH (TURBAT) TEHSIL,72,193,229,422
KECH DISTRICT,KECH (TURBAT) TEHSIL,73,260,231,491
KECH DISTRICT,KECH (TURBAT) TEHSIL,74,276,211,487
KECH DISTRICT,KECH (TURBAT) TEHSIL,>=75,1871,1781,3652
KECH DISTRICT,MAND SUB-TEHSIL,<1,1177,0,1177
KECH DISTRICT,MAND SUB-TEHSIL,1,1673,0,1673
KECH DISTRICT,MAND SUB-TEHSIL,2,1689,0,1689
KECH DISTRICT,MAND SUB-TEHSIL,3,1539,0,1539
KECH DISTRICT,MAND SUB-TEHSIL,4,1671,0,1671
KECH DISTRICT,MAND SUB-TEHSIL,5,1495,0,1495
KECH DISTRICT,MAND SUB-TEHSIL,6,1515,0,1515
KECH DISTRICT,MAND SUB-TEHSIL,7,1671,0,1671
KECH DISTRICT,MAND SUB-TEHSIL,8,1645,0,1645
KECH DISTRICT,MAND SUB-TEHSIL,9,1500,0,1500
KECH DISTRICT,MAND SUB-TEHSIL,10,1703,0,1703
KECH DISTRICT,MAND SUB-TEHSIL,11,1312,0,1312
KECH DISTRICT,MAND SUB-TEHSIL,12,1330,0,1330
KECH DISTRICT,MAND SUB-TEHSIL,13,1299,0,1299
KECH DISTRICT,MAND SUB-TEHSIL,14,1284,0,1284
KECH DISTRICT,MAND SUB-TEHSIL,15,1409,0,1409
KECH DISTRICT,MAND SUB-TEHSIL,16,1153,0,1153
KECH DISTRICT,MAND SUB-TEHSIL,17,1154,0,1154
KECH DISTRICT,MAND SUB-TEHSIL,18,1388,0,1388
KECH DISTRICT,MAND SUB-TEHSIL,19,1107,0,1107
KECH DISTRICT,MAND SUB-TEHSIL,20,1315,0,1315
KECH DISTRICT,MAND SUB-TEHSIL,21,963,0,963
KECH DISTRICT,MAND SUB-TEHSIL,22,780,0,780
KECH DISTRICT,MAND SUB-TEHSIL,23,941,0,941
KECH DISTRICT,MAND SUB-TEHSIL,24,790,0,790
KECH DISTRICT,MAND SUB-TEHSIL,25,979,0,979
KECH DISTRICT,MAND SUB-TEHSIL,26,610,0,610
KECH DISTRICT,MAND SUB-TEHSIL,27,786,0,786
KECH DISTRICT,MAND SUB-TEHSIL,28,809,0,809
KECH DISTRICT,MAND SUB-TEHSIL,29,898,0,898
KECH DISTRICT,MAND SUB-TEHSIL,30,848,0,848
KECH DISTRICT,MAND SUB-TEHSIL,31,681,0,681
KECH DISTRICT,MAND SUB-TEHSIL,32,532,0,532
KECH DISTRICT,MAND SUB-TEHSIL,33,610,0,610
KECH DISTRICT,MAND SUB-TEHSIL,34,412,0,412
KECH DISTRICT,MAND SUB-TEHSIL,35,610,0,610
KECH DISTRICT,MAND SUB-TEHSIL,36,367,0,367
KECH DISTRICT,MAND SUB-TEHSIL,37,582,0,582
KECH DISTRICT,MAND SUB-TEHSIL,38,455,0,455
KECH DISTRICT,MAND SUB-TEHSIL,39,501,0,501
KECH DISTRICT,MAND SUB-TEHSIL,40,554,0,554
KECH DISTRICT,MAND SUB-TEHSIL,41,366,0,366
KECH DISTRICT,MAND SUB-TEHSIL,42,319,0,319
KECH DISTRICT,MAND SUB-TEHSIL,43,346,0,346
KECH DISTRICT,MAND SUB-TEHSIL,44,257,0,257
KECH DISTRICT,MAND SUB-TEHSIL,45,346,0,346
KECH DISTRICT,MAND SUB-TEHSIL,46,163,0,163
KECH DISTRICT,MAND SUB-TEHSIL,47,323,0,323
KECH DISTRICT,MAND SUB-TEHSIL,48,307,0,307
KECH DISTRICT,MAND SUB-TEHSIL,49,366,0,366
KECH DISTRICT,MAND SUB-TEHSIL,50,367,0,367
KECH DISTRICT,MAND SUB-TEHSIL,51,242,0,242
KECH DISTRICT,MAND SUB-TEHSIL,52,282,0,282
KECH DISTRICT,MAND SUB-TEHSIL,53,236,0,236
KECH DISTRICT,MAND SUB-TEHSIL,54,263,0,263
KECH DISTRICT,MAND SUB-TEHSIL,55,222,0,222
KECH DISTRICT,MAND SUB-TEHSIL,56,136,0,136
KECH DISTRICT,MAND SUB-TEHSIL,57,231,0,231
KECH DISTRICT,MAND SUB-TEHSIL,58,161,0,161
KECH DISTRICT,MAND SUB-TEHSIL,59,239,0,239
KECH DISTRICT,MAND SUB-TEHSIL,60,196,0,196
KECH DISTRICT,MAND SUB-TEHSIL,61,135,0,135
KECH DISTRICT,MAND SUB-TEHSIL,62,158,0,158
KECH DISTRICT,MAND SUB-TEHSIL,63,127,0,127
KECH DISTRICT,MAND SUB-TEHSIL,64,169,0,169
KECH DISTRICT,MAND SUB-TEHSIL,65,114,0,114
KECH DISTRICT,MAND SUB-TEHSIL,66,74,0,74
KECH DISTRICT,MAND SUB-TEHSIL,67,110,0,110
KECH DISTRICT,MAND SUB-TEHSIL,68,72,0,72
KECH DISTRICT,MAND SUB-TEHSIL,69,137,0,137
KECH DISTRICT,MAND SUB-TEHSIL,70,83,0,83
KECH DISTRICT,MAND SUB-TEHSIL,71,57,0,57
KECH DISTRICT,MAND SUB-TEHSIL,72,60,0,60
KECH DISTRICT,MAND SUB-TEHSIL,73,53,0,53
KECH DISTRICT,MAND SUB-TEHSIL,74,89,0,89
KECH DISTRICT,MAND SUB-TEHSIL,>=75,452,0,452
KECH DISTRICT,TUMP SUB-TEHSIL,<1,1765,963,2728
KECH DISTRICT,TUMP SUB-TEHSIL,1,1612,1132,2744
KECH DISTRICT,TUMP SUB-TEHSIL,2,2321,1357,3678
KECH DISTRICT,TUMP SUB-TEHSIL,3,1860,1076,2936
KECH DISTRICT,TUMP SUB-TEHSIL,4,2655,1444,4099
KECH DISTRICT,TUMP SUB-TEHSIL,5,2320,1206,3526
KECH DISTRICT,TUMP SUB-TEHSIL,6,2949,1615,4564
KECH DISTRICT,TUMP SUB-TEHSIL,7,2331,1507,3838
KECH DISTRICT,TUMP SUB-TEHSIL,8,3641,1860,5501
KECH DISTRICT,TUMP SUB-TEHSIL,9,3078,1784,4862
KECH DISTRICT,TUMP SUB-TEHSIL,10,4625,2052,6677
KECH DISTRICT,TUMP SUB-TEHSIL,11,3301,1381,4682
KECH DISTRICT,TUMP SUB-TEHSIL,12,3485,1635,5120
KECH DISTRICT,TUMP SUB-TEHSIL,13,3043,1305,4348
KECH DISTRICT,TUMP SUB-TEHSIL,14,3779,1617,5396
KECH DISTRICT,TUMP SUB-TEHSIL,15,3431,1285,4716
KECH DISTRICT,TUMP SUB-TEHSIL,16,3644,1454,5098
KECH DISTRICT,TUMP SUB-TEHSIL,17,2693,1196,3889
KECH DISTRICT,TUMP SUB-TEHSIL,18,3458,1478,4936
KECH DISTRICT,TUMP SUB-TEHSIL,19,2231,1079,3310
KECH DISTRICT,TUMP SUB-TEHSIL,20,3024,1317,4341
KECH DISTRICT,TUMP SUB-TEHSIL,21,1886,892,2778
KECH DISTRICT,TUMP SUB-TEHSIL,22,1620,718,2338
KECH DISTRICT,TUMP SUB-TEHSIL,23,1513,631,2144
KECH DISTRICT,TUMP SUB-TEHSIL,24,1365,569,1934
KECH DISTRICT,TUMP SUB-TEHSIL,25,1417,764,2181
KECH DISTRICT,TUMP SUB-TEHSIL,26,1249,452,1701
KECH DISTRICT,TUMP SUB-TEHSIL,27,885,525,1410
KECH DISTRICT,TUMP SUB-TEHSIL,28,1234,622,1856
KECH DISTRICT,TUMP SUB-TEHSIL,29,1053,599,1652
KECH DISTRICT,TUMP SUB-TEHSIL,30,1272,654,1926
KECH DISTRICT,TUMP SUB-TEHSIL,31,888,523,1411
KECH DISTRICT,TUMP SUB-TEHSIL,32,663,356,1019
KECH DISTRICT,TUMP SUB-TEHSIL,33,848,477,1325
KECH DISTRICT,TUMP SUB-TEHSIL,34,597,333,930
KECH DISTRICT,TUMP SUB-TEHSIL,35,871,422,1293
KECH DISTRICT,TUMP SUB-TEHSIL,36,707,322,1029
KECH DISTRICT,TUMP SUB-TEHSIL,37,631,349,980
KECH DISTRICT,TUMP SUB-TEHSIL,38,1189,517,1706
KECH DISTRICT,TUMP SUB-TEHSIL,39,1052,511,1563
KECH DISTRICT,TUMP SUB-TEHSIL,40,1327,569,1896
KECH DISTRICT,TUMP SUB-TEHSIL,41,705,351,1056
KECH DISTRICT,TUMP SUB-TEHSIL,42,547,282,829
KECH DISTRICT,TUMP SUB-TEHSIL,43,667,345,1012
KECH DISTRICT,TUMP SUB-TEHSIL,44,536,287,823
KECH DISTRICT,TUMP SUB-TEHSIL,45,774,379,1153
KECH DISTRICT,TUMP SUB-TEHSIL,46,549,205,754
KECH DISTRICT,TUMP SUB-TEHSIL,47,490,240,730
KECH DISTRICT,TUMP SUB-TEHSIL,48,964,417,1381
KECH DISTRICT,TUMP SUB-TEHSIL,49,859,335,1194
KECH DISTRICT,TUMP SUB-TEHSIL,50,1028,518,1546
KECH DISTRICT,TUMP SUB-TEHSIL,51,458,218,676
KECH DISTRICT,TUMP SUB-TEHSIL,52,405,216,621
KECH DISTRICT,TUMP SUB-TEHSIL,53,538,313,851
KECH DISTRICT,TUMP SUB-TEHSIL,54,497,230,727
KECH DISTRICT,TUMP SUB-TEHSIL,55,466,289,755
KECH DISTRICT,TUMP SUB-TEHSIL,56,352,150,502
KECH DISTRICT,TUMP SUB-TEHSIL,57,280,137,417
KECH DISTRICT,TUMP SUB-TEHSIL,58,419,198,617
KECH DISTRICT,TUMP SUB-TEHSIL,59,364,191,555
KECH DISTRICT,TUMP SUB-TEHSIL,60,475,314,789
KECH DISTRICT,TUMP SUB-TEHSIL,61,253,124,377
KECH DISTRICT,TUMP SUB-TEHSIL,62,179,144,323
KECH DISTRICT,TUMP SUB-TEHSIL,63,235,201,436
KECH DISTRICT,TUMP SUB-TEHSIL,64,234,170,404
KECH DISTRICT,TUMP SUB-TEHSIL,65,199,154,353
KECH DISTRICT,TUMP SUB-TEHSIL,66,130,124,254
KECH DISTRICT,TUMP SUB-TEHSIL,67,113,87,200
KECH DISTRICT,TUMP SUB-TEHSIL,68,167,159,326
KECH DISTRICT,TUMP SUB-TEHSIL,69,138,167,305
KECH DISTRICT,TUMP SUB-TEHSIL,70,144,115,259
KECH DISTRICT,TUMP SUB-TEHSIL,71,91,64,155
KECH DISTRICT,TUMP SUB-TEHSIL,72,81,61,142
KECH DISTRICT,TUMP SUB-TEHSIL,73,99,79,178
KECH DISTRICT,TUMP SUB-TEHSIL,74,80,77,157
KECH DISTRICT,TUMP SUB-TEHSIL,>=75,636,454,1090
KECH DISTRICT,ZAMORAN SUB-TEHSIL,<1,941,0,941
KECH DISTRICT,ZAMORAN SUB-TEHSIL,1,1115,0,1115
KECH DISTRICT,ZAMORAN SUB-TEHSIL,2,1198,0,1198
KECH DISTRICT,ZAMORAN SUB-TEHSIL,3,1408,0,1408
KECH DISTRICT,ZAMORAN SUB-TEHSIL,4,1315,0,1315
KECH DISTRICT,ZAMORAN SUB-TEHSIL,5,1754,0,1754
KECH DISTRICT,ZAMORAN SUB-TEHSIL,6,1410,0,1410
KECH DISTRICT,ZAMORAN SUB-TEHSIL,7,1776,0,1776
KECH DISTRICT,ZAMORAN SUB-TEHSIL,8,1569,0,1569
KECH DISTRICT,ZAMORAN SUB-TEHSIL,9,1639,0,1639
KECH DISTRICT,ZAMORAN SUB-TEHSIL,10,2146,0,2146
KECH DISTRICT,ZAMORAN SUB-TEHSIL,11,1583,0,1583
KECH DISTRICT,ZAMORAN SUB-TEHSIL,12,1515,0,1515
KECH DISTRICT,ZAMORAN SUB-TEHSIL,13,1386,0,1386
KECH DISTRICT,ZAMORAN SUB-TEHSIL,14,1366,0,1366
KECH DISTRICT,ZAMORAN SUB-TEHSIL,15,1361,0,1361
KECH DISTRICT,ZAMORAN SUB-TEHSIL,16,1198,0,1198
KECH DISTRICT,ZAMORAN SUB-TEHSIL,17,1009,0,1009
KECH DISTRICT,ZAMORAN SUB-TEHSIL,18,853,0,853
KECH DISTRICT,ZAMORAN SUB-TEHSIL,19,538,0,538
KECH DISTRICT,ZAMORAN SUB-TEHSIL,20,760,0,760
KECH DISTRICT,ZAMORAN SUB-TEHSIL,21,464,0,464
KECH DISTRICT,ZAMORAN SUB-TEHSIL,22,325,0,325
KECH DISTRICT,ZAMORAN SUB-TEHSIL,23,342,0,342
KECH DISTRICT,ZAMORAN SUB-TEHSIL,24,280,0,280
KECH DISTRICT,ZAMORAN SUB-TEHSIL,25,416,0,416
KECH DISTRICT,ZAMORAN SUB-TEHSIL,26,312,0,312
KECH DISTRICT,ZAMORAN SUB-TEHSIL,27,362,0,362
KECH DISTRICT,ZAMORAN SUB-TEHSIL,28,405,0,405
KECH DISTRICT,ZAMORAN SUB-TEHSIL,29,450,0,450
KECH DISTRICT,ZAMORAN SUB-TEHSIL,30,565,0,565
KECH DISTRICT,ZAMORAN SUB-TEHSIL,31,419,0,419
KECH DISTRICT,ZAMORAN SUB-TEHSIL,32,311,0,311
KECH DISTRICT,ZAMORAN SUB-TEHSIL,33,407,0,407
KECH DISTRICT,ZAMORAN SUB-TEHSIL,34,233,0,233
KECH DISTRICT,ZAMORAN SUB-TEHSIL,35,333,0,333
KECH DISTRICT,ZAMORAN SUB-TEHSIL,36,295,0,295
KECH DISTRICT,ZAMORAN SUB-TEHSIL,37,348,0,348
KECH DISTRICT,ZAMORAN SUB-TEHSIL,38,655,0,655
KECH DISTRICT,ZAMORAN SUB-TEHSIL,39,567,0,567
KECH DISTRICT,ZAMORAN SUB-TEHSIL,40,792,0,792
KECH DISTRICT,ZAMORAN SUB-TEHSIL,41,423,0,423
KECH DISTRICT,ZAMORAN SUB-TEHSIL,42,408,0,408
KECH DISTRICT,ZAMORAN SUB-TEHSIL,43,461,0,461
KECH DISTRICT,ZAMORAN SUB-TEHSIL,44,319,0,319
KECH DISTRICT,ZAMORAN SUB-TEHSIL,45,300,0,300
KECH DISTRICT,ZAMORAN SUB-TEHSIL,46,228,0,228
KECH DISTRICT,ZAMORAN SUB-TEHSIL,47,250,0,250
KECH DISTRICT,ZAMORAN SUB-TEHSIL,48,415,0,415
KECH DISTRICT,ZAMORAN SUB-TEHSIL,49,417,0,417
KECH DISTRICT,ZAMORAN SUB-TEHSIL,50,316,0,316
KECH DISTRICT,ZAMORAN SUB-TEHSIL,51,206,0,206
KECH DISTRICT,ZAMORAN SUB-TEHSIL,52,153,0,153
KECH DISTRICT,ZAMORAN SUB-TEHSIL,53,202,0,202
KECH DISTRICT,ZAMORAN SUB-TEHSIL,54,146,0,146
KECH DISTRICT,ZAMORAN SUB-TEHSIL,55,143,0,143
KECH DISTRICT,ZAMORAN SUB-TEHSIL,56,121,0,121
KECH DISTRICT,ZAMORAN SUB-TEHSIL,57,88,0,88
KECH DISTRICT,ZAMORAN SUB-TEHSIL,58,139,0,139
KECH DISTRICT,ZAMORAN SUB-TEHSIL,59,123,0,123
KECH DISTRICT,ZAMORAN SUB-TEHSIL,60,114,0,114
KECH DISTRICT,ZAMORAN SUB-TEHSIL,61,104,0,104
KECH DISTRICT,ZAMORAN SUB-TEHSIL,62,87,0,87
KECH DISTRICT,ZAMORAN SUB-TEHSIL,63,91,0,91
KECH DISTRICT,ZAMORAN SUB-TEHSIL,64,73,0,73
KECH DISTRICT,ZAMORAN SUB-TEHSIL,65,74,0,74
KECH DISTRICT,ZAMORAN SUB-TEHSIL,66,46,0,46
KECH DISTRICT,ZAMORAN SUB-TEHSIL,67,63,0,63
KECH DISTRICT,ZAMORAN SUB-TEHSIL,68,65,0,65
KECH DISTRICT,ZAMORAN SUB-TEHSIL,69,65,0,65
KECH DISTRICT,ZAMORAN SUB-TEHSIL,70,60,0,60
KECH DISTRICT,ZAMORAN SUB-TEHSIL,71,39,0,39
KECH DISTRICT,ZAMORAN SUB-TEHSIL,72,50,0,50
KECH DISTRICT,ZAMORAN SUB-TEHSIL,73,38,0,38
KECH DISTRICT,ZAMORAN SUB-TEHSIL,74,39,0,39
KECH DISTRICT,ZAMORAN SUB-TEHSIL,>=75,424,0,424
KHAIRPUR DISTRICT,FAIZ GANJ TALUKA,<1,4619,1084,5703
KHAIRPUR DISTRICT,FAIZ GANJ TALUKA,1,5215,1132,6347
KHAIRPUR DISTRICT,FAIZ GANJ TALUKA,2,6495,1339,7834
KHAIRPUR DISTRICT,FAIZ GANJ TALUKA,3,6884,1552,8436
KHAIRPUR DISTRICT,FAIZ GANJ TALUKA,4,7626,1516,9142
KHAIRPUR DISTRICT,FAIZ GANJ TALUKA,5,6936,1558,8494
KHAIRPUR DISTRICT,FAIZ GANJ TALUKA,6,6767,1337,8104
KHAIRPUR DISTRICT,FAIZ GANJ TALUKA,7,5841,1402,7243
KHAIRPUR DISTRICT,FAIZ GANJ TALUKA,8,6734,1358,8092
KHAIRPUR DISTRICT,FAIZ GANJ TALUKA,9,5288,1287,6575
KHAIRPUR DISTRICT,FAIZ GANJ TALUKA,10,5775,1182,6957
KHAIRPUR DISTRICT,FAIZ GANJ TALUKA,11,4078,1049,5127
KHAIRPUR DISTRICT,FAIZ GANJ TALUKA,12,4496,1022,5518
KHAIRPUR DISTRICT,FAIZ GANJ TALUKA,13,3723,957,4680
KHAIRPUR DISTRICT,FAIZ GANJ TALUKA,14,3860,951,4811
KHAIRPUR DISTRICT,FAIZ GANJ TALUKA,15,3965,1063,5028
KHAIRPUR DISTRICT,FAIZ GANJ TALUKA,16,3495,902,4397
KHAIRPUR DISTRICT,FAIZ GANJ TALUKA,17,3911,997,4908
KHAIRPUR DISTRICT,FAIZ GANJ TALUKA,18,3175,813,3988
KHAIRPUR DISTRICT,FAIZ GANJ TALUKA,19,2908,798,3706
KHAIRPUR DISTRICT,FAIZ GANJ TALUKA,20,3348,779,4127
KHAIRPUR DISTRICT,FAIZ GANJ TALUKA,21,2536,689,3225
KHAIRPUR DISTRICT,FAIZ GANJ TALUKA,22,2669,720,3389
KHAIRPUR DISTRICT,FAIZ GANJ TALUKA,23,2317,702,3019
KHAIRPUR DISTRICT,FAIZ GANJ TALUKA,24,2449,653,3102
KHAIRPUR DISTRICT,FAIZ GANJ TALUKA,25,2845,711,3556
KHAIRPUR DISTRICT,FAIZ GANJ TALUKA,26,2460,631,3091
KHAIRPUR DISTRICT,FAIZ GANJ TALUKA,27,2535,694,3229
KHAIRPUR DISTRICT,FAIZ GANJ TALUKA,28,2605,650,3255
KHAIRPUR DISTRICT,FAIZ GANJ TALUKA,29,2567,679,3246
KHAIRPUR DISTRICT,FAIZ GANJ TALUKA,30,2685,595,3280
KHAIRPUR DISTRICT,FAIZ GANJ TALUKA,31,2599,647,3246
KHAIRPUR DISTRICT,FAIZ GANJ TALUKA,32,2370,561,2931
KHAIRPUR DISTRICT,FAIZ GANJ TALUKA,33,2060,600,2660
KHAIRPUR DISTRICT,FAIZ GANJ TALUKA,34,1950,518,2468
KHAIRPUR DISTRICT,FAIZ GANJ TALUKA,35,2174,528,2702
KHAIRPUR DISTRICT,FAIZ GANJ TALUKA,36,1899,441,2340
KHAIRPUR DISTRICT,FAIZ GANJ TALUKA,37,2262,537,2799
KHAIRPUR DISTRICT,FAIZ GANJ TALUKA,38,1716,435,2151
KHAIRPUR DISTRICT,FAIZ GANJ TALUKA,39,1823,432,2255
KHAIRPUR DISTRICT,FAIZ GANJ TALUKA,40,1695,403,2098
KHAIRPUR DISTRICT,FAIZ GANJ TALUKA,41,1582,403,1985
KHAIRPUR DISTRICT,FAIZ GANJ TALUKA,42,1666,394,2060
KHAIRPUR DISTRICT,FAIZ GANJ TALUKA,43,1296,380,1676
KHAIRPUR DISTRICT,FAIZ GANJ TALUKA,44,1348,380,1728
KHAIRPUR DISTRICT,FAIZ GANJ TALUKA,45,1388,349,1737
KHAIRPUR DISTRICT,FAIZ GANJ TALUKA,46,1349,316,1665
KHAIRPUR DISTRICT,FAIZ GANJ TALUKA,47,1541,357,1898
KHAIRPUR DISTRICT,FAIZ GANJ TALUKA,48,1255,345,1600
KHAIRPUR DISTRICT,FAIZ GANJ TALUKA,49,1248,369,1617
KHAIRPUR DISTRICT,FAIZ GANJ TALUKA,50,1167,258,1425
KHAIRPUR DISTRICT,FAIZ GANJ TALUKA,51,1069,290,1359
KHAIRPUR DISTRICT,FAIZ GANJ TALUKA,52,1006,252,1258
KHAIRPUR DISTRICT,FAIZ GANJ TALUKA,53,766,205,971
KHAIRPUR DISTRICT,FAIZ GANJ TALUKA,54,724,187,911
KHAIRPUR DISTRICT,FAIZ GANJ TALUKA,55,742,181,923
KHAIRPUR DISTRICT,FAIZ GANJ TALUKA,56,624,130,754
KHAIRPUR DISTRICT,FAIZ GANJ TALUKA,57,730,213,943
KHAIRPUR DISTRICT,FAIZ GANJ TALUKA,58,602,142,744
KHAIRPUR DISTRICT,FAIZ GANJ TALUKA,59,634,158,792
KHAIRPUR DISTRICT,FAIZ GANJ TALUKA,60,707,165,872
KHAIRPUR DISTRICT,FAIZ GANJ TALUKA,61,635,152,787
KHAIRPUR DISTRICT,FAIZ GANJ TALUKA,62,661,144,805
KHAIRPUR DISTRICT,FAIZ GANJ TALUKA,63,563,185,748
KHAIRPUR DISTRICT,FAIZ GANJ TALUKA,64,547,134,681
KHAIRPUR DISTRICT,FAIZ GANJ TALUKA,65,531,130,661
KHAIRPUR DISTRICT,FAIZ GANJ TALUKA,66,488,128,616
KHAIRPUR DISTRICT,FAIZ GANJ TALUKA,67,547,119,666
KHAIRPUR DISTRICT,FAIZ GANJ TALUKA,68,367,95,462
KHAIRPUR DISTRICT,FAIZ GANJ TALUKA,69,362,95,457
KHAIRPUR DISTRICT,FAIZ GANJ TALUKA,70,357,76,433
KHAIRPUR DISTRICT,FAIZ GANJ TALUKA,71,333,81,414
KHAIRPUR DISTRICT,FAIZ GANJ TALUKA,72,351,79,430
KHAIRPUR DISTRICT,FAIZ GANJ TALUKA,73,238,70,308
KHAIRPUR DISTRICT,FAIZ GANJ TALUKA,74,205,54,259
KHAIRPUR DISTRICT,FAIZ GANJ TALUKA,>=75,1755,429,2184
KHAIRPUR DISTRICT,GAMBAT TALUKA,<1,3299,1864,5163
KHAIRPUR DISTRICT,GAMBAT TALUKA,1,4866,2493,7359
KHAIRPUR DISTRICT,GAMBAT TALUKA,2,5710,2763,8473
KHAIRPUR DISTRICT,GAMBAT TALUKA,3,6390,3144,9534
KHAIRPUR DISTRICT,GAMBAT TALUKA,4,6786,3144,9930
KHAIRPUR DISTRICT,GAMBAT TALUKA,5,6829,3320,10149
KHAIRPUR DISTRICT,GAMBAT TALUKA,6,6443,2982,9425
KHAIRPUR DISTRICT,GAMBAT TALUKA,7,5737,3028,8765
KHAIRPUR DISTRICT,GAMBAT TALUKA,8,6433,3031,9464
KHAIRPUR DISTRICT,GAMBAT TALUKA,9,5004,2591,7595
KHAIRPUR DISTRICT,GAMBAT TALUKA,10,5704,2700,8404
KHAIRPUR DISTRICT,GAMBAT TALUKA,11,3841,2184,6025
KHAIRPUR DISTRICT,GAMBAT TALUKA,12,4538,2350,6888
KHAIRPUR DISTRICT,GAMBAT TALUKA,13,3504,2058,5562
KHAIRPUR DISTRICT,GAMBAT TALUKA,14,3907,2110,6017
KHAIRPUR DISTRICT,GAMBAT TALUKA,15,4147,2315,6462
KHAIRPUR DISTRICT,GAMBAT TALUKA,16,3725,2140,5865
KHAIRPUR DISTRICT,GAMBAT TALUKA,17,3455,2111,5566
KHAIRPUR DISTRICT,GAMBAT TALUKA,18,4067,2172,6239
KHAIRPUR DISTRICT,GAMBAT TALUKA,19,3030,1907,4937
KHAIRPUR DISTRICT,GAMBAT TALUKA,20,3590,1908,5498
KHAIRPUR DISTRICT,GAMBAT TALUKA,21,2412,1605,4017
KHAIRPUR DISTRICT,GAMBAT TALUKA,22,2662,1597,4259
KHAIRPUR DISTRICT,GAMBAT TALUKA,23,2173,1429,3602
KHAIRPUR DISTRICT,GAMBAT TALUKA,24,2049,1382,3431
KHAIRPUR DISTRICT,GAMBAT TALUKA,25,2762,1568,4330
KHAIRPUR DISTRICT,GAMBAT TALUKA,26,2132,1303,3435
KHAIRPUR DISTRICT,GAMBAT TALUKA,27,2222,1360,3582
KHAIRPUR DISTRICT,GAMBAT TALUKA,28,2413,1475,3888
KHAIRPUR DISTRICT,GAMBAT TALUKA,29,2370,1355,3725
KHAIRPUR DISTRICT,GAMBAT TALUKA,30,2466,1472,3938
KHAIRPUR DISTRICT,GAMBAT TALUKA,31,2204,1366,3570
KHAIRPUR DISTRICT,GAMBAT TALUKA,32,2029,1206,3235
KHAIRPUR DISTRICT,GAMBAT TALUKA,33,2037,1202,3239
KHAIRPUR DISTRICT,GAMBAT TALUKA,34,1875,1097,2972
KHAIRPUR DISTRICT,GAMBAT TALUKA,35,2015,1171,3186
KHAIRPUR DISTRICT,GAMBAT TALUKA,36,1500,923,2423
KHAIRPUR DISTRICT,GAMBAT TALUKA,37,1746,1045,2791
KHAIRPUR DISTRICT,GAMBAT TALUKA,38,1583,1044,2627
KHAIRPUR DISTRICT,GAMBAT TALUKA,39,1586,960,2546
KHAIRPUR DISTRICT,GAMBAT TALUKA,40,1649,1036,2685
KHAIRPUR DISTRICT,GAMBAT TALUKA,41,1304,849,2153
KHAIRPUR DISTRICT,GAMBAT TALUKA,42,1347,740,2087
KHAIRPUR DISTRICT,GAMBAT TALUKA,43,1219,743,1962
KHAIRPUR DISTRICT,GAMBAT TALUKA,44,1199,686,1885
KHAIRPUR DISTRICT,GAMBAT TALUKA,45,1355,803,2158
KHAIRPUR DISTRICT,GAMBAT TALUKA,46,1010,735,1745
KHAIRPUR DISTRICT,GAMBAT TALUKA,47,1270,718,1988
KHAIRPUR DISTRICT,GAMBAT TALUKA,48,1269,743,2012
KHAIRPUR DISTRICT,GAMBAT TALUKA,49,1164,712,1876
KHAIRPUR DISTRICT,GAMBAT TALUKA,50,1178,689,1867
KHAIRPUR DISTRICT,GAMBAT TALUKA,51,963,668,1631
KHAIRPUR DISTRICT,GAMBAT TALUKA,52,931,565,1496
KHAIRPUR DISTRICT,GAMBAT TALUKA,53,736,559,1295
KHAIRPUR DISTRICT,GAMBAT TALUKA,54,674,452,1126
KHAIRPUR DISTRICT,GAMBAT TALUKA,55,758,490,1248
KHAIRPUR DISTRICT,GAMBAT TALUKA,56,561,372,933
KHAIRPUR DISTRICT,GAMBAT TALUKA,57,688,374,1062
KHAIRPUR DISTRICT,GAMBAT TALUKA,58,547,339,886
KHAIRPUR DISTRICT,GAMBAT TALUKA,59,519,305,824
KHAIRPUR DISTRICT,GAMBAT TALUKA,60,646,401,1047
KHAIRPUR DISTRICT,GAMBAT TALUKA,61,552,331,883
KHAIRPUR DISTRICT,GAMBAT TALUKA,62,608,358,966
KHAIRPUR DISTRICT,GAMBAT TALUKA,63,540,305,845
KHAIRPUR DISTRICT,GAMBAT TALUKA,64,483,295,778
KHAIRPUR DISTRICT,GAMBAT TALUKA,65,513,293,806
KHAIRPUR DISTRICT,GAMBAT TALUKA,66,402,214,616
KHAIRPUR DISTRICT,GAMBAT TALUKA,67,471,215,686
KHAIRPUR DISTRICT,GAMBAT TALUKA,68,360,248,608
KHAIRPUR DISTRICT,GAMBAT TALUKA,69,360,187,547
KHAIRPUR DISTRICT,GAMBAT TALUKA,70,354,205,559
KHAIRPUR DISTRICT,GAMBAT TALUKA,71,279,171,450
KHAIRPUR DISTRICT,GAMBAT TALUKA,72,245,153,398
KHAIRPUR DISTRICT,GAMBAT TALUKA,73,240,149,389
KHAIRPUR DISTRICT,GAMBAT TALUKA,74,170,102,272
KHAIRPUR DISTRICT,GAMBAT TALUKA,>=75,1529,804,2333
KHAIRPUR DISTRICT,KHAIRPUR TALUKA,<1,4480,4540,9020
KHAIRPUR DISTRICT,KHAIRPUR TALUKA,1,5958,6069,12027
KHAIRPUR DISTRICT,KHAIRPUR TALUKA,2,7493,6389,13882
KHAIRPUR DISTRICT,KHAIRPUR TALUKA,3,7892,7298,15190
KHAIRPUR DISTRICT,KHAIRPUR TALUKA,4,8227,6884,15111
KHAIRPUR DISTRICT,KHAIRPUR TALUKA,5,8099,7350,15449
KHAIRPUR DISTRICT,KHAIRPUR TALUKA,6,7669,6655,14324
KHAIRPUR DISTRICT,KHAIRPUR TALUKA,7,6964,7029,13993
KHAIRPUR DISTRICT,KHAIRPUR TALUKA,8,7928,6708,14636
KHAIRPUR DISTRICT,KHAIRPUR TALUKA,9,6137,6133,12270
KHAIRPUR DISTRICT,KHAIRPUR TALUKA,10,6842,6067,12909
KHAIRPUR DISTRICT,KHAIRPUR TALUKA,11,4706,5205,9911
KHAIRPUR DISTRICT,KHAIRPUR TALUKA,12,5485,5597,11082
KHAIRPUR DISTRICT,KHAIRPUR TALUKA,13,4391,5021,9412
KHAIRPUR DISTRICT,KHAIRPUR TALUKA,14,4471,4981,9452
KHAIRPUR DISTRICT,KHAIRPUR TALUKA,15,4964,5604,10568
KHAIRPUR DISTRICT,KHAIRPUR TALUKA,16,4493,5120,9613
KHAIRPUR DISTRICT,KHAIRPUR TALUKA,17,4267,5696,9963
KHAIRPUR DISTRICT,KHAIRPUR TALUKA,18,4916,5450,10366
KHAIRPUR DISTRICT,KHAIRPUR TALUKA,19,4046,5095,9141
KHAIRPUR DISTRICT,KHAIRPUR TALUKA,20,4350,4945,9295
KHAIRPUR DISTRICT,KHAIRPUR TALUKA,21,3399,4434,7833
KHAIRPUR DISTRICT,KHAIRPUR TALUKA,22,3548,4457,8005
KHAIRPUR DISTRICT,KHAIRPUR TALUKA,23,3138,4056,7194
KHAIRPUR DISTRICT,KHAIRPUR TALUKA,24,2695,3611,6306
KHAIRPUR DISTRICT,KHAIRPUR TALUKA,25,3468,4165,7633
KHAIRPUR DISTRICT,KHAIRPUR TALUKA,26,2696,3765,6461
KHAIRPUR DISTRICT,KHAIRPUR TALUKA,27,3014,3694,6708
KHAIRPUR DISTRICT,KHAIRPUR TALUKA,28,2847,3997,6844
KHAIRPUR DISTRICT,KHAIRPUR TALUKA,29,3008,3515,6523
KHAIRPUR DISTRICT,KHAIRPUR TALUKA,30,2988,3822,6810
KHAIRPUR DISTRICT,KHAIRPUR TALUKA,31,2600,3263,5863
KHAIRPUR DISTRICT,KHAIRPUR TALUKA,32,2625,3321,5946
KHAIRPUR DISTRICT,KHAIRPUR TALUKA,33,2431,3189,5620
KHAIRPUR DISTRICT,KHAIRPUR TALUKA,34,2085,2736,4821
KHAIRPUR DISTRICT,KHAIRPUR TALUKA,35,2581,3181,5762
KHAIRPUR DISTRICT,KHAIRPUR TALUKA,36,1791,2276,4067
KHAIRPUR DISTRICT,KHAIRPUR TALUKA,37,2232,2443,4675
KHAIRPUR DISTRICT,KHAIRPUR TALUKA,38,2046,2730,4776
KHAIRPUR DISTRICT,KHAIRPUR TALUKA,39,2053,2437,4490
KHAIRPUR DISTRICT,KHAIRPUR TALUKA,40,2105,2781,4886
KHAIRPUR DISTRICT,KHAIRPUR TALUKA,41,1697,2091,3788
KHAIRPUR DISTRICT,KHAIRPUR TALUKA,42,1714,2145,3859
KHAIRPUR DISTRICT,KHAIRPUR TALUKA,43,1471,2019,3490
KHAIRPUR DISTRICT,KHAIRPUR TALUKA,44,1409,1857,3266
KHAIRPUR DISTRICT,KHAIRPUR TALUKA,45,1694,2189,3883
KHAIRPUR DISTRICT,KHAIRPUR TALUKA,46,1170,1612,2782
KHAIRPUR DISTRICT,KHAIRPUR TALUKA,47,1406,1632,3038
KHAIRPUR DISTRICT,KHAIRPUR TALUKA,48,1263,1811,3074
KHAIRPUR DISTRICT,KHAIRPUR TALUKA,49,1242,1810,3052
KHAIRPUR DISTRICT,KHAIRPUR TALUKA,50,1459,1976,3435
KHAIRPUR DISTRICT,KHAIRPUR TALUKA,51,1126,1423,2549
KHAIRPUR DISTRICT,KHAIRPUR TALUKA,52,1076,1416,2492
KHAIRPUR DISTRICT,KHAIRPUR TALUKA,53,946,1337,2283
KHAIRPUR DISTRICT,KHAIRPUR TALUKA,54,808,1217,2025
KHAIRPUR DISTRICT,KHAIRPUR TALUKA,55,963,1398,2361
KHAIRPUR DISTRICT,KHAIRPUR TALUKA,56,591,951,1542
KHAIRPUR DISTRICT,KHAIRPUR TALUKA,57,754,872,1626
KHAIRPUR DISTRICT,KHAIRPUR TALUKA,58,658,938,1596
KHAIRPUR DISTRICT,KHAIRPUR TALUKA,59,716,866,1582
KHAIRPUR DISTRICT,KHAIRPUR TALUKA,60,852,986,1838
KHAIRPUR DISTRICT,KHAIRPUR TALUKA,61,657,798,1455
KHAIRPUR DISTRICT,KHAIRPUR TALUKA,62,791,891,1682
KHAIRPUR DISTRICT,KHAIRPUR TALUKA,63,664,842,1506
KHAIRPUR DISTRICT,KHAIRPUR TALUKA,64,591,676,1267
KHAIRPUR DISTRICT,KHAIRPUR TALUKA,65,595,732,1327
KHAIRPUR DISTRICT,KHAIRPUR TALUKA,66,414,497,911
KHAIRPUR DISTRICT,KHAIRPUR TALUKA,67,555,475,1030
KHAIRPUR DISTRICT,KHAIRPUR TALUKA,68,434,543,977
KHAIRPUR DISTRICT,KHAIRPUR TALUKA,69,395,420,815
KHAIRPUR DISTRICT,KHAIRPUR TALUKA,70,430,410,840
KHAIRPUR DISTRICT,KHAIRPUR TALUKA,71,363,337,700
KHAIRPUR DISTRICT,KHAIRPUR TALUKA,72,319,372,691
KHAIRPUR DISTRICT,KHAIRPUR TALUKA,73,260,381,641
KHAIRPUR DISTRICT,KHAIRPUR TALUKA,74,233,248,481
KHAIRPUR DISTRICT,KHAIRPUR TALUKA,>=75,1723,1968,3691
KHAIRPUR DISTRICT,KINGRI TALUKA,<1,5330,1783,7113
KHAIRPUR DISTRICT,KINGRI TALUKA,1,7357,2546,9903
KHAIRPUR DISTRICT,KINGRI TALUKA,2,8551,2756,11307
KHAIRPUR DISTRICT,KINGRI TALUKA,3,9665,3094,12759
KHAIRPUR DISTRICT,KINGRI TALUKA,4,10110,3252,13362
KHAIRPUR DISTRICT,KINGRI TALUKA,5,9778,3308,13086
KHAIRPUR DISTRICT,KINGRI TALUKA,6,8839,2868,11707
KHAIRPUR DISTRICT,KINGRI TALUKA,7,8185,3088,11273
KHAIRPUR DISTRICT,KINGRI TALUKA,8,8939,3160,12099
KHAIRPUR DISTRICT,KINGRI TALUKA,9,7002,2687,9689
KHAIRPUR DISTRICT,KINGRI TALUKA,10,7880,2676,10556
KHAIRPUR DISTRICT,KINGRI TALUKA,11,5687,2327,8014
KHAIRPUR DISTRICT,KINGRI TALUKA,12,6401,2365,8766
KHAIRPUR DISTRICT,KINGRI TALUKA,13,5241,2227,7468
KHAIRPUR DISTRICT,KINGRI TALUKA,14,5501,2340,7841
KHAIRPUR DISTRICT,KINGRI TALUKA,15,5983,2430,8413
KHAIRPUR DISTRICT,KINGRI TALUKA,16,5648,2294,7942
KHAIRPUR DISTRICT,KINGRI TALUKA,17,5295,2237,7532
KHAIRPUR DISTRICT,KINGRI TALUKA,18,5928,2267,8195
KHAIRPUR DISTRICT,KINGRI TALUKA,19,4466,1933,6399
KHAIRPUR DISTRICT,KINGRI TALUKA,20,5134,2053,7187
KHAIRPUR DISTRICT,KINGRI TALUKA,21,3720,1608,5328
KHAIRPUR DISTRICT,KINGRI TALUKA,22,3951,1607,5558
KHAIRPUR DISTRICT,KINGRI TALUKA,23,3338,1472,4810
KHAIRPUR DISTRICT,KINGRI TALUKA,24,3228,1279,4507
KHAIRPUR DISTRICT,KINGRI TALUKA,25,3952,1527,5479
KHAIRPUR DISTRICT,KINGRI TALUKA,26,3223,1391,4614
KHAIRPUR DISTRICT,KINGRI TALUKA,27,3238,1362,4600
KHAIRPUR DISTRICT,KINGRI TALUKA,28,3481,1459,4940
KHAIRPUR DISTRICT,KINGRI TALUKA,29,3240,1350,4590
KHAIRPUR DISTRICT,KINGRI TALUKA,30,3637,1563,5200
KHAIRPUR DISTRICT,KINGRI TALUKA,31,3022,1391,4413
KHAIRPUR DISTRICT,KINGRI TALUKA,32,2982,1259,4241
KHAIRPUR DISTRICT,KINGRI TALUKA,33,2925,1194,4119
KHAIRPUR DISTRICT,KINGRI TALUKA,34,2571,1072,3643
KHAIRPUR DISTRICT,KINGRI TALUKA,35,2975,1202,4177
KHAIRPUR DISTRICT,KINGRI TALUKA,36,2115,953,3068
KHAIRPUR DISTRICT,KINGRI TALUKA,37,2554,1062,3616
KHAIRPUR DISTRICT,KINGRI TALUKA,38,2333,1026,3359
KHAIRPUR DISTRICT,KINGRI TALUKA,39,2376,1004,3380
KHAIRPUR DISTRICT,KINGRI TALUKA,40,2438,1144,3582
KHAIRPUR DISTRICT,KINGRI TALUKA,41,1868,843,2711
KHAIRPUR DISTRICT,KINGRI TALUKA,42,1929,834,2763
KHAIRPUR DISTRICT,KINGRI TALUKA,43,1807,806,2613
KHAIRPUR DISTRICT,KINGRI TALUKA,44,1696,704,2400
KHAIRPUR DISTRICT,KINGRI TALUKA,45,1998,818,2816
KHAIRPUR DISTRICT,KINGRI TALUKA,46,1406,605,2011
KHAIRPUR DISTRICT,KINGRI TALUKA,47,1636,628,2264
KHAIRPUR DISTRICT,KINGRI TALUKA,48,1547,706,2253
KHAIRPUR DISTRICT,KINGRI TALUKA,49,1577,677,2254
KHAIRPUR DISTRICT,KINGRI TALUKA,50,1741,723,2464
KHAIRPUR DISTRICT,KINGRI TALUKA,51,1252,548,1800
KHAIRPUR DISTRICT,KINGRI TALUKA,52,1229,513,1742
KHAIRPUR DISTRICT,KINGRI TALUKA,53,1069,491,1560
KHAIRPUR DISTRICT,KINGRI TALUKA,54,1010,479,1489
KHAIRPUR DISTRICT,KINGRI TALUKA,55,1212,488,1700
KHAIRPUR DISTRICT,KINGRI TALUKA,56,753,355,1108
KHAIRPUR DISTRICT,KINGRI TALUKA,57,917,358,1275
KHAIRPUR DISTRICT,KINGRI TALUKA,58,849,352,1201
KHAIRPUR DISTRICT,KINGRI TALUKA,59,782,330,1112
KHAIRPUR DISTRICT,KINGRI TALUKA,60,984,362,1346
KHAIRPUR DISTRICT,KINGRI TALUKA,61,715,337,1052
KHAIRPUR DISTRICT,KINGRI TALUKA,62,859,381,1240
KHAIRPUR DISTRICT,KINGRI TALUKA,63,785,303,1088
KHAIRPUR DISTRICT,KINGRI TALUKA,64,725,295,1020
KHAIRPUR DISTRICT,KINGRI TALUKA,65,716,311,1027
KHAIRPUR DISTRICT,KINGRI TALUKA,66,475,196,671
KHAIRPUR DISTRICT,KINGRI TALUKA,67,590,267,857
KHAIRPUR DISTRICT,KINGRI TALUKA,68,471,194,665
KHAIRPUR DISTRICT,KINGRI TALUKA,69,486,170,656
KHAIRPUR DISTRICT,KINGRI TALUKA,70,516,202,718
KHAIRPUR DISTRICT,KINGRI TALUKA,71,321,125,446
KHAIRPUR DISTRICT,KINGRI TALUKA,72,366,157,523
KHAIRPUR DISTRICT,KINGRI TALUKA,73,301,106,407
KHAIRPUR DISTRICT,KINGRI TALUKA,74,270,105,375
KHAIRPUR DISTRICT,KINGRI TALUKA,>=75,2039,796,2835
KHAIRPUR DISTRICT,KOT DIJI TALUKA,<1,5682,1743,7425
KHAIRPUR DISTRICT,KOT DIJI TALUKA,1,7884,2591,10475
KHAIRPUR DISTRICT,KOT DIJI TALUKA,2,9276,2949,12225
KHAIRPUR DISTRICT,KOT DIJI TALUKA,3,10310,3321,13631
KHAIRPUR DISTRICT,KOT DIJI TALUKA,4,10315,3269,13584
KHAIRPUR DISTRICT,KOT DIJI TALUKA,5,10251,3314,13565
KHAIRPUR DISTRICT,KOT DIJI TALUKA,6,9325,3032,12357
KHAIRPUR DISTRICT,KOT DIJI TALUKA,7,8701,2895,11596
KHAIRPUR DISTRICT,KOT DIJI TALUKA,8,9807,3216,13023
KHAIRPUR DISTRICT,KOT DIJI TALUKA,9,7403,2404,9807
KHAIRPUR DISTRICT,KOT DIJI TALUKA,10,8001,2753,10754
KHAIRPUR DISTRICT,KOT DIJI TALUKA,11,5736,1906,7642
KHAIRPUR DISTRICT,KOT DIJI TALUKA,12,6642,2179,8821
KHAIRPUR DISTRICT,KOT DIJI TALUKA,13,5124,1690,6814
KHAIRPUR DISTRICT,KOT DIJI TALUKA,14,5579,1823,7402
KHAIRPUR DISTRICT,KOT DIJI TALUKA,15,5811,1825,7636
KHAIRPUR DISTRICT,KOT DIJI TALUKA,16,5773,1692,7465
KHAIRPUR DISTRICT,KOT DIJI TALUKA,17,5472,1703,7175
KHAIRPUR DISTRICT,KOT DIJI TALUKA,18,6259,2022,8281
KHAIRPUR DISTRICT,KOT DIJI TALUKA,19,5187,1747,6934
KHAIRPUR DISTRICT,KOT DIJI TALUKA,20,5627,1774,7401
KHAIRPUR DISTRICT,KOT DIJI TALUKA,21,4150,1356,5506
KHAIRPUR DISTRICT,KOT DIJI TALUKA,22,4226,1466,5692
KHAIRPUR DISTRICT,KOT DIJI TALUKA,23,3720,1199,4919
KHAIRPUR DISTRICT,KOT DIJI TALUKA,24,3283,1155,4438
KHAIRPUR DISTRICT,KOT DIJI TALUKA,25,4344,1521,5865
KHAIRPUR DISTRICT,KOT DIJI TALUKA,26,3377,1137,4514
KHAIRPUR DISTRICT,KOT DIJI TALUKA,27,3419,1097,4516
KHAIRPUR DISTRICT,KOT DIJI TALUKA,28,3809,1287,5096
KHAIRPUR DISTRICT,KOT DIJI TALUKA,29,3395,1105,4500
KHAIRPUR DISTRICT,KOT DIJI TALUKA,30,3908,1402,5310
KHAIRPUR DISTRICT,KOT DIJI TALUKA,31,3317,1192,4509
KHAIRPUR DISTRICT,KOT DIJI TALUKA,32,3314,1046,4360
KHAIRPUR DISTRICT,KOT DIJI TALUKA,33,3084,1010,4094
KHAIRPUR DISTRICT,KOT DIJI TALUKA,34,2847,901,3748
KHAIRPUR DISTRICT,KOT DIJI TALUKA,35,3373,1099,4472
KHAIRPUR DISTRICT,KOT DIJI TALUKA,36,2465,774,3239
KHAIRPUR DISTRICT,KOT DIJI TALUKA,37,3033,895,3928
KHAIRPUR DISTRICT,KOT DIJI TALUKA,38,2636,839,3475
KHAIRPUR DISTRICT,KOT DIJI TALUKA,39,2617,844,3461
KHAIRPUR DISTRICT,KOT DIJI TALUKA,40,2528,990,3518
KHAIRPUR DISTRICT,KOT DIJI TALUKA,41,2136,738,2874
KHAIRPUR DISTRICT,KOT DIJI TALUKA,42,2270,682,2952
KHAIRPUR DISTRICT,KOT DIJI TALUKA,43,1933,637,2570
KHAIRPUR DISTRICT,KOT DIJI TALUKA,44,1842,617,2459
KHAIRPUR DISTRICT,KOT DIJI TALUKA,45,2070,712,2782
KHAIRPUR DISTRICT,KOT DIJI TALUKA,46,1679,557,2236
KHAIRPUR DISTRICT,KOT DIJI TALUKA,47,1884,535,2419
KHAIRPUR DISTRICT,KOT DIJI TALUKA,48,1760,566,2326
KHAIRPUR DISTRICT,KOT DIJI TALUKA,49,1836,618,2454
KHAIRPUR DISTRICT,KOT DIJI TALUKA,50,1828,698,2526
KHAIRPUR DISTRICT,KOT DIJI TALUKA,51,1501,485,1986
KHAIRPUR DISTRICT,KOT DIJI TALUKA,52,1485,411,1896
KHAIRPUR DISTRICT,KOT DIJI TALUKA,53,1249,380,1629
KHAIRPUR DISTRICT,KOT DIJI TALUKA,54,1113,349,1462
KHAIRPUR DISTRICT,KOT DIJI TALUKA,55,1262,448,1710
KHAIRPUR DISTRICT,KOT DIJI TALUKA,56,882,268,1150
KHAIRPUR DISTRICT,KOT DIJI TALUKA,57,1009,303,1312
KHAIRPUR DISTRICT,KOT DIJI TALUKA,58,851,286,1137
KHAIRPUR DISTRICT,KOT DIJI TALUKA,59,859,258,1117
KHAIRPUR DISTRICT,KOT DIJI TALUKA,60,1032,381,1413
KHAIRPUR DISTRICT,KOT DIJI TALUKA,61,785,270,1055
KHAIRPUR DISTRICT,KOT DIJI TALUKA,62,917,289,1206
KHAIRPUR DISTRICT,KOT DIJI TALUKA,63,891,269,1160
KHAIRPUR DISTRICT,KOT DIJI TALUKA,64,743,235,978
KHAIRPUR DISTRICT,KOT DIJI TALUKA,65,885,280,1165
KHAIRPUR DISTRICT,KOT DIJI TALUKA,66,584,233,817
KHAIRPUR DISTRICT,KOT DIJI TALUKA,67,682,195,877
KHAIRPUR DISTRICT,KOT DIJI TALUKA,68,686,179,865
KHAIRPUR DISTRICT,KOT DIJI TALUKA,69,552,177,729
KHAIRPUR DISTRICT,KOT DIJI TALUKA,70,550,175,725
KHAIRPUR DISTRICT,KOT DIJI TALUKA,71,490,140,630
KHAIRPUR DISTRICT,KOT DIJI TALUKA,72,428,141,569
KHAIRPUR DISTRICT,KOT DIJI TALUKA,73,429,126,555
KHAIRPUR DISTRICT,KOT DIJI TALUKA,74,302,93,395
KHAIRPUR DISTRICT,KOT DIJI TALUKA,>=75,2511,762,3273
KHAIRPUR DISTRICT,MIRWAH TALUKA,<1,6667,2350,9017
KHAIRPUR DISTRICT,MIRWAH TALUKA,1,7665,2589,10254
KHAIRPUR DISTRICT,MIRWAH TALUKA,2,9549,3082,12631
KHAIRPUR DISTRICT,MIRWAH TALUKA,3,10186,3173,13359
KHAIRPUR DISTRICT,MIRWAH TALUKA,4,11305,3422,14727
KHAIRPUR DISTRICT,MIRWAH TALUKA,5,10195,3367,13562
KHAIRPUR DISTRICT,MIRWAH TALUKA,6,9760,3159,12919
KHAIRPUR DISTRICT,MIRWAH TALUKA,7,8547,2937,11484
KHAIRPUR DISTRICT,MIRWAH TALUKA,8,9939,3172,13111
KHAIRPUR DISTRICT,MIRWAH TALUKA,9,7519,2615,10134
KHAIRPUR DISTRICT,MIRWAH TALUKA,10,8158,2726,10884
KHAIRPUR DISTRICT,MIRWAH TALUKA,11,5890,2059,7949
KHAIRPUR DISTRICT,MIRWAH TALUKA,12,6593,2305,8898
KHAIRPUR DISTRICT,MIRWAH TALUKA,13,5464,2052,7516
KHAIRPUR DISTRICT,MIRWAH TALUKA,14,5776,2144,7920
KHAIRPUR DISTRICT,MIRWAH TALUKA,15,5475,2168,7643
KHAIRPUR DISTRICT,MIRWAH TALUKA,16,5390,2100,7490
KHAIRPUR DISTRICT,MIRWAH TALUKA,17,5177,2064,7241
KHAIRPUR DISTRICT,MIRWAH TALUKA,18,5712,2027,7739
KHAIRPUR DISTRICT,MIRWAH TALUKA,19,4637,1925,6562
KHAIRPUR DISTRICT,MIRWAH TALUKA,20,4976,1823,6799
KHAIRPUR DISTRICT,MIRWAH TALUKA,21,3863,1618,5481
KHAIRPUR DISTRICT,MIRWAH TALUKA,22,3944,1541,5485
KHAIRPUR DISTRICT,MIRWAH TALUKA,23,3405,1466,4871
KHAIRPUR DISTRICT,MIRWAH TALUKA,24,3187,1260,4447
KHAIRPUR DISTRICT,MIRWAH TALUKA,25,3940,1466,5406
KHAIRPUR DISTRICT,MIRWAH TALUKA,26,3290,1311,4601
KHAIRPUR DISTRICT,MIRWAH TALUKA,27,3494,1369,4863
KHAIRPUR DISTRICT,MIRWAH TALUKA,28,3458,1295,4753
KHAIRPUR DISTRICT,MIRWAH TALUKA,29,3304,1332,4636
KHAIRPUR DISTRICT,MIRWAH TALUKA,30,3470,1217,4687
KHAIRPUR DISTRICT,MIRWAH TALUKA,31,3473,1349,4822
KHAIRPUR DISTRICT,MIRWAH TALUKA,32,3364,1236,4600
KHAIRPUR DISTRICT,MIRWAH TALUKA,33,3035,1187,4222
KHAIRPUR DISTRICT,MIRWAH TALUKA,34,2756,1075,3831
KHAIRPUR DISTRICT,MIRWAH TALUKA,35,3058,1055,4113
KHAIRPUR DISTRICT,MIRWAH TALUKA,36,2498,949,3447
KHAIRPUR DISTRICT,MIRWAH TALUKA,37,3170,1232,4402
KHAIRPUR DISTRICT,MIRWAH TALUKA,38,2391,903,3294
KHAIRPUR DISTRICT,MIRWAH TALUKA,39,2464,911,3375
KHAIRPUR DISTRICT,MIRWAH TALUKA,40,2312,769,3081
KHAIRPUR DISTRICT,MIRWAH TALUKA,41,2022,872,2894
KHAIRPUR DISTRICT,MIRWAH TALUKA,42,2200,870,3070
KHAIRPUR DISTRICT,MIRWAH TALUKA,43,1795,720,2515
KHAIRPUR DISTRICT,MIRWAH TALUKA,44,1808,708,2516
KHAIRPUR DISTRICT,MIRWAH TALUKA,45,1899,634,2533
KHAIRPUR DISTRICT,MIRWAH TALUKA,46,1798,696,2494
KHAIRPUR DISTRICT,MIRWAH TALUKA,47,2201,885,3086
KHAIRPUR DISTRICT,MIRWAH TALUKA,48,1836,691,2527
KHAIRPUR DISTRICT,MIRWAH TALUKA,49,1761,779,2540
KHAIRPUR DISTRICT,MIRWAH TALUKA,50,1638,561,2199
KHAIRPUR DISTRICT,MIRWAH TALUKA,51,1482,632,2114
KHAIRPUR DISTRICT,MIRWAH TALUKA,52,1393,549,1942
KHAIRPUR DISTRICT,MIRWAH TALUKA,53,1135,450,1585
KHAIRPUR DISTRICT,MIRWAH TALUKA,54,1007,380,1387
KHAIRPUR DISTRICT,MIRWAH TALUKA,55,1031,397,1428
KHAIRPUR DISTRICT,MIRWAH TALUKA,56,852,363,1215
KHAIRPUR DISTRICT,MIRWAH TALUKA,57,963,444,1407
KHAIRPUR DISTRICT,MIRWAH TALUKA,58,775,341,1116
KHAIRPUR DISTRICT,MIRWAH TALUKA,59,784,347,1131
KHAIRPUR DISTRICT,MIRWAH TALUKA,60,838,302,1140
KHAIRPUR DISTRICT,MIRWAH TALUKA,61,848,356,1204
KHAIRPUR DISTRICT,MIRWAH TALUKA,62,922,355,1277
KHAIRPUR DISTRICT,MIRWAH TALUKA,63,869,324,1193
KHAIRPUR DISTRICT,MIRWAH TALUKA,64,753,299,1052
KHAIRPUR DISTRICT,MIRWAH TALUKA,65,692,275,967
KHAIRPUR DISTRICT,MIRWAH TALUKA,66,603,292,895
KHAIRPUR DISTRICT,MIRWAH TALUKA,67,734,285,1019
KHAIRPUR DISTRICT,MIRWAH TALUKA,68,643,244,887
KHAIRPUR DISTRICT,MIRWAH TALUKA,69,495,192,687
KHAIRPUR DISTRICT,MIRWAH TALUKA,70,497,197,694
KHAIRPUR DISTRICT,MIRWAH TALUKA,71,454,194,648
KHAIRPUR DISTRICT,MIRWAH TALUKA,72,451,176,627
KHAIRPUR DISTRICT,MIRWAH TALUKA,73,446,162,608
KHAIRPUR DISTRICT,MIRWAH TALUKA,74,289,119,408
KHAIRPUR DISTRICT,MIRWAH TALUKA,>=75,2529,974,3503
KHAIRPUR DISTRICT,NARA TALUKA,<1,3131,953,4084
KHAIRPUR DISTRICT,NARA TALUKA,1,4164,1076,5240
KHAIRPUR DISTRICT,NARA TALUKA,2,5168,1357,6525
KHAIRPUR DISTRICT,NARA TALUKA,3,4988,1635,6623
KHAIRPUR DISTRICT,NARA TALUKA,4,5813,1508,7321
KHAIRPUR DISTRICT,NARA TALUKA,5,4852,1658,6510
KHAIRPUR DISTRICT,NARA TALUKA,6,5497,1372,6869
KHAIRPUR DISTRICT,NARA TALUKA,7,3904,1303,5207
KHAIRPUR DISTRICT,NARA TALUKA,8,5370,1473,6843
KHAIRPUR DISTRICT,NARA TALUKA,9,3457,1103,4560
KHAIRPUR DISTRICT,NARA TALUKA,10,4416,1218,5634
KHAIRPUR DISTRICT,NARA TALUKA,11,2494,776,3270
KHAIRPUR DISTRICT,NARA TALUKA,12,3275,1009,4284
KHAIRPUR DISTRICT,NARA TALUKA,13,1916,790,2706
KHAIRPUR DISTRICT,NARA TALUKA,14,2435,820,3255
KHAIRPUR DISTRICT,NARA TALUKA,15,2073,965,3038
KHAIRPUR DISTRICT,NARA TALUKA,16,2150,748,2898
KHAIRPUR DISTRICT,NARA TALUKA,17,1437,682,2119
KHAIRPUR DISTRICT,NARA TALUKA,18,3232,996,4228
KHAIRPUR DISTRICT,NARA TALUKA,19,1965,732,2697
KHAIRPUR DISTRICT,NARA TALUKA,20,2660,903,3563
KHAIRPUR DISTRICT,NARA TALUKA,21,1490,597,2087
KHAIRPUR DISTRICT,NARA TALUKA,22,1914,658,2572
KHAIRPUR DISTRICT,NARA TALUKA,23,1384,554,1938
KHAIRPUR DISTRICT,NARA TALUKA,24,1557,599,2156
KHAIRPUR DISTRICT,NARA TALUKA,25,1930,699,2629
KHAIRPUR DISTRICT,NARA TALUKA,26,1249,528,1777
KHAIRPUR DISTRICT,NARA TALUKA,27,1408,442,1850
KHAIRPUR DISTRICT,NARA TALUKA,28,1733,599,2332
KHAIRPUR DISTRICT,NARA TALUKA,29,1406,442,1848
KHAIRPUR DISTRICT,NARA TALUKA,30,1952,608,2560
KHAIRPUR DISTRICT,NARA TALUKA,31,1377,459,1836
KHAIRPUR DISTRICT,NARA TALUKA,32,1247,481,1728
KHAIRPUR DISTRICT,NARA TALUKA,33,1296,452,1748
KHAIRPUR DISTRICT,NARA TALUKA,34,1290,445,1735
KHAIRPUR DISTRICT,NARA TALUKA,35,1564,482,2046
KHAIRPUR DISTRICT,NARA TALUKA,36,1231,390,1621
KHAIRPUR DISTRICT,NARA TALUKA,37,1347,320,1667
KHAIRPUR DISTRICT,NARA TALUKA,38,1291,422,1713
KHAIRPUR DISTRICT,NARA TALUKA,39,1183,351,1534
KHAIRPUR DISTRICT,NARA TALUKA,40,1378,440,1818
KHAIRPUR DISTRICT,NARA TALUKA,41,969,323,1292
KHAIRPUR DISTRICT,NARA TALUKA,42,946,271,1217
KHAIRPUR DISTRICT,NARA TALUKA,43,821,280,1101
KHAIRPUR DISTRICT,NARA TALUKA,44,787,251,1038
KHAIRPUR DISTRICT,NARA TALUKA,45,908,341,1249
KHAIRPUR DISTRICT,NARA TALUKA,46,748,257,1005
KHAIRPUR DISTRICT,NARA TALUKA,47,726,183,909
KHAIRPUR DISTRICT,NARA TALUKA,48,810,309,1119
KHAIRPUR DISTRICT,NARA TALUKA,49,683,232,915
KHAIRPUR DISTRICT,NARA TALUKA,50,833,302,1135
KHAIRPUR DISTRICT,NARA TALUKA,51,468,170,638
KHAIRPUR DISTRICT,NARA TALUKA,52,468,152,620
KHAIRPUR DISTRICT,NARA TALUKA,53,471,151,622
KHAIRPUR DISTRICT,NARA TALUKA,54,462,136,598
KHAIRPUR DISTRICT,NARA TALUKA,55,556,212,768
KHAIRPUR DISTRICT,NARA TALUKA,56,370,141,511
KHAIRPUR DISTRICT,NARA TALUKA,57,389,77,466
KHAIRPUR DISTRICT,NARA TALUKA,58,420,123,543
KHAIRPUR DISTRICT,NARA TALUKA,59,332,99,431
KHAIRPUR DISTRICT,NARA TALUKA,60,575,180,755
KHAIRPUR DISTRICT,NARA TALUKA,61,333,105,438
KHAIRPUR DISTRICT,NARA TALUKA,62,391,100,491
KHAIRPUR DISTRICT,NARA TALUKA,63,362,95,457
KHAIRPUR DISTRICT,NARA TALUKA,64,367,89,456
KHAIRPUR DISTRICT,NARA TALUKA,65,370,129,499
KHAIRPUR DISTRICT,NARA TALUKA,66,291,76,367
KHAIRPUR DISTRICT,NARA TALUKA,67,306,55,361
KHAIRPUR DISTRICT,NARA TALUKA,68,287,63,350
KHAIRPUR DISTRICT,NARA TALUKA,69,231,62,293
KHAIRPUR DISTRICT,NARA TALUKA,70,288,85,373
KHAIRPUR DISTRICT,NARA TALUKA,71,198,32,230
KHAIRPUR DISTRICT,NARA TALUKA,72,266,47,313
KHAIRPUR DISTRICT,NARA TALUKA,73,187,56,243
KHAIRPUR DISTRICT,NARA TALUKA,74,163,37,200
KHAIRPUR DISTRICT,NARA TALUKA,>=75,1617,354,1971
KHAIRPUR DISTRICT,SOBHO DERO TALUKA,<1,3777,1871,5648
KHAIRPUR DISTRICT,SOBHO DERO TALUKA,1,4751,2474,7225
KHAIRPUR DISTRICT,SOBHO DERO TALUKA,2,5987,2880,8867
KHAIRPUR DISTRICT,SOBHO DERO TALUKA,3,6342,3318,9660
KHAIRPUR DISTRICT,SOBHO DERO TALUKA,4,6944,3215,10159
KHAIRPUR DISTRICT,SOBHO DERO TALUKA,5,6906,3619,10525
KHAIRPUR DISTRICT,SOBHO DERO TALUKA,6,6682,3095,9777
KHAIRPUR DISTRICT,SOBHO DERO TALUKA,7,5611,3210,8821
KHAIRPUR DISTRICT,SOBHO DERO TALUKA,8,6637,3061,9698
KHAIRPUR DISTRICT,SOBHO DERO TALUKA,9,5063,2692,7755
KHAIRPUR DISTRICT,SOBHO DERO TALUKA,10,5950,2552,8502
KHAIRPUR DISTRICT,SOBHO DERO TALUKA,11,3926,2076,6002
KHAIRPUR DISTRICT,SOBHO DERO TALUKA,12,4645,2252,6897
KHAIRPUR DISTRICT,SOBHO DERO TALUKA,13,3720,2098,5818
KHAIRPUR DISTRICT,SOBHO DERO TALUKA,14,4264,2090,6354
KHAIRPUR DISTRICT,SOBHO DERO TALUKA,15,4382,2344,6726
KHAIRPUR DISTRICT,SOBHO DERO TALUKA,16,4139,2237,6376
KHAIRPUR DISTRICT,SOBHO DERO TALUKA,17,3392,2192,5584
KHAIRPUR DISTRICT,SOBHO DERO TALUKA,18,4407,2338,6745
KHAIRPUR DISTRICT,SOBHO DERO TALUKA,19,3444,1979,5423
KHAIRPUR DISTRICT,SOBHO DERO TALUKA,20,3963,1852,5815
KHAIRPUR DISTRICT,SOBHO DERO TALUKA,21,2835,1570,4405
KHAIRPUR DISTRICT,SOBHO DERO TALUKA,22,2925,1576,4501
KHAIRPUR DISTRICT,SOBHO DERO TALUKA,23,2347,1503,3850
KHAIRPUR DISTRICT,SOBHO DERO TALUKA,24,2352,1238,3590
KHAIRPUR DISTRICT,SOBHO DERO TALUKA,25,3322,1711,5033
KHAIRPUR DISTRICT,SOBHO DERO TALUKA,26,2262,1297,3559
KHAIRPUR DISTRICT,SOBHO DERO TALUKA,27,2271,1494,3765
KHAIRPUR DISTRICT,SOBHO DERO TALUKA,28,2704,1534,4238
KHAIRPUR DISTRICT,SOBHO DERO TALUKA,29,2340,1445,3785
KHAIRPUR DISTRICT,SOBHO DERO TALUKA,30,2920,1474,4394
KHAIRPUR DISTRICT,SOBHO DERO TALUKA,31,2182,1292,3474
KHAIRPUR DISTRICT,SOBHO DERO TALUKA,32,2174,1223,3397
KHAIRPUR DISTRICT,SOBHO DERO TALUKA,33,2184,1099,3283
KHAIRPUR DISTRICT,SOBHO DERO TALUKA,34,1822,1000,2822
KHAIRPUR DISTRICT,SOBHO DERO TALUKA,35,2210,1239,3449
KHAIRPUR DISTRICT,SOBHO DERO TALUKA,36,1560,862,2422
KHAIRPUR DISTRICT,SOBHO DERO TALUKA,37,1860,1047,2907
KHAIRPUR DISTRICT,SOBHO DERO TALUKA,38,1847,941,2788
KHAIRPUR DISTRICT,SOBHO DERO TALUKA,39,1661,963,2624
KHAIRPUR DISTRICT,SOBHO DERO TALUKA,40,2077,1075,3152
KHAIRPUR DISTRICT,SOBHO DERO TALUKA,41,1247,786,2033
KHAIRPUR DISTRICT,SOBHO DERO TALUKA,42,1488,805,2293
KHAIRPUR DISTRICT,SOBHO DERO TALUKA,43,1410,771,2181
KHAIRPUR DISTRICT,SOBHO DERO TALUKA,44,1362,741,2103
KHAIRPUR DISTRICT,SOBHO DERO TALUKA,45,1547,819,2366
KHAIRPUR DISTRICT,SOBHO DERO TALUKA,46,1062,598,1660
KHAIRPUR DISTRICT,SOBHO DERO TALUKA,47,1332,746,2078
KHAIRPUR DISTRICT,SOBHO DERO TALUKA,48,1406,621,2027
KHAIRPUR DISTRICT,SOBHO DERO TALUKA,49,1218,709,1927
KHAIRPUR DISTRICT,SOBHO DERO TALUKA,50,1476,768,2244
KHAIRPUR DISTRICT,SOBHO DERO TALUKA,51,1030,622,1652
KHAIRPUR DISTRICT,SOBHO DERO TALUKA,52,989,540,1529
KHAIRPUR DISTRICT,SOBHO DERO TALUKA,53,927,520,1447
KHAIRPUR DISTRICT,SOBHO DERO TALUKA,54,822,449,1271
KHAIRPUR DISTRICT,SOBHO DERO TALUKA,55,945,482,1427
KHAIRPUR DISTRICT,SOBHO DERO TALUKA,56,615,324,939
KHAIRPUR DISTRICT,SOBHO DERO TALUKA,57,639,382,1021
KHAIRPUR DISTRICT,SOBHO DERO TALUKA,58,665,336,1001
KHAIRPUR DISTRICT,SOBHO DERO TALUKA,59,538,332,870
KHAIRPUR DISTRICT,SOBHO DERO TALUKA,60,791,370,1161
KHAIRPUR DISTRICT,SOBHO DERO TALUKA,61,554,316,870
KHAIRPUR DISTRICT,SOBHO DERO TALUKA,62,656,345,1001
KHAIRPUR DISTRICT,SOBHO DERO TALUKA,63,589,334,923
KHAIRPUR DISTRICT,SOBHO DERO TALUKA,64,581,249,830
KHAIRPUR DISTRICT,SOBHO DERO TALUKA,65,643,291,934
KHAIRPUR DISTRICT,SOBHO DERO TALUKA,66,344,216,560
KHAIRPUR DISTRICT,SOBHO DERO TALUKA,67,454,228,682
KHAIRPUR DISTRICT,SOBHO DERO TALUKA,68,461,228,689
KHAIRPUR DISTRICT,SOBHO DERO TALUKA,69,366,167,533
KHAIRPUR DISTRICT,SOBHO DERO TALUKA,70,492,156,648
KHAIRPUR DISTRICT,SOBHO DERO TALUKA,71,311,140,451
KHAIRPUR DISTRICT,SOBHO DERO TALUKA,72,333,142,475
KHAIRPUR DISTRICT,SOBHO DERO TALUKA,73,326,142,468
KHAIRPUR DISTRICT,SOBHO DERO TALUKA,74,235,92,327
KHAIRPUR DISTRICT,SOBHO DERO TALUKA,>=75,1939,811,2750
KHANEWAL DISTRICT,JAHANIAN TEHSIL,<1,7122,972,8094
KHANEWAL DISTRICT,JAHANIAN TEHSIL,1,7994,994,8988
KHANEWAL DISTRICT,JAHANIAN TEHSIL,2,8094,994,9088
KHANEWAL DISTRICT,JAHANIAN TEHSIL,3,8739,1140,9879
KHANEWAL DISTRICT,JAHANIAN TEHSIL,4,9132,1096,10228
KHANEWAL DISTRICT,JAHANIAN TEHSIL,5,8022,1070,9092
KHANEWAL DISTRICT,JAHANIAN TEHSIL,6,8211,1084,9295
KHANEWAL DISTRICT,JAHANIAN TEHSIL,7,8593,1177,9770
KHANEWAL DISTRICT,JAHANIAN TEHSIL,8,8161,1096,9257
KHANEWAL DISTRICT,JAHANIAN TEHSIL,9,8582,1188,9770
KHANEWAL DISTRICT,JAHANIAN TEHSIL,10,7648,987,8635
KHANEWAL DISTRICT,JAHANIAN TEHSIL,11,7768,1243,9011
KHANEWAL DISTRICT,JAHANIAN TEHSIL,12,6820,983,7803
KHANEWAL DISTRICT,JAHANIAN TEHSIL,13,6777,1038,7815
KHANEWAL DISTRICT,JAHANIAN TEHSIL,14,6404,918,7322
KHANEWAL DISTRICT,JAHANIAN TEHSIL,15,6399,959,7358
KHANEWAL DISTRICT,JAHANIAN TEHSIL,16,6277,934,7211
KHANEWAL DISTRICT,JAHANIAN TEHSIL,17,6321,1010,7331
KHANEWAL DISTRICT,JAHANIAN TEHSIL,18,5691,838,6529
KHANEWAL DISTRICT,JAHANIAN TEHSIL,19,5943,940,6883
KHANEWAL DISTRICT,JAHANIAN TEHSIL,20,5728,832,6560
KHANEWAL DISTRICT,JAHANIAN TEHSIL,21,5709,914,6623
KHANEWAL DISTRICT,JAHANIAN TEHSIL,22,5509,796,6305
KHANEWAL DISTRICT,JAHANIAN TEHSIL,23,5078,794,5872
KHANEWAL DISTRICT,JAHANIAN TEHSIL,24,4636,775,5411
KHANEWAL DISTRICT,JAHANIAN TEHSIL,25,4528,701,5229
KHANEWAL DISTRICT,JAHANIAN TEHSIL,26,4656,725,5381
KHANEWAL DISTRICT,JAHANIAN TEHSIL,27,4743,736,5479
KHANEWAL DISTRICT,JAHANIAN TEHSIL,28,4458,684,5142
KHANEWAL DISTRICT,JAHANIAN TEHSIL,29,4695,695,5390
KHANEWAL DISTRICT,JAHANIAN TEHSIL,30,4265,630,4895
KHANEWAL DISTRICT,JAHANIAN TEHSIL,31,4145,618,4763
KHANEWAL DISTRICT,JAHANIAN TEHSIL,32,3845,610,4455
KHANEWAL DISTRICT,JAHANIAN TEHSIL,33,3631,589,4220
KHANEWAL DISTRICT,JAHANIAN TEHSIL,34,3847,536,4383
KHANEWAL DISTRICT,JAHANIAN TEHSIL,35,3561,548,4109
KHANEWAL DISTRICT,JAHANIAN TEHSIL,36,3850,580,4430
KHANEWAL DISTRICT,JAHANIAN TEHSIL,37,3880,545,4425
KHANEWAL DISTRICT,JAHANIAN TEHSIL,38,3467,525,3992
KHANEWAL DISTRICT,JAHANIAN TEHSIL,39,3789,554,4343
KHANEWAL DISTRICT,JAHANIAN TEHSIL,40,2897,489,3386
KHANEWAL DISTRICT,JAHANIAN TEHSIL,41,3114,532,3646
KHANEWAL DISTRICT,JAHANIAN TEHSIL,42,2839,444,3283
KHANEWAL DISTRICT,JAHANIAN TEHSIL,43,2403,407,2810
KHANEWAL DISTRICT,JAHANIAN TEHSIL,44,2360,385,2745
KHANEWAL DISTRICT,JAHANIAN TEHSIL,45,2093,403,2496
KHANEWAL DISTRICT,JAHANIAN TEHSIL,46,2221,412,2633
KHANEWAL DISTRICT,JAHANIAN TEHSIL,47,2463,386,2849
KHANEWAL DISTRICT,JAHANIAN TEHSIL,48,2419,390,2809
KHANEWAL DISTRICT,JAHANIAN TEHSIL,49,2501,397,2898
KHANEWAL DISTRICT,JAHANIAN TEHSIL,50,2075,365,2440
KHANEWAL DISTRICT,JAHANIAN TEHSIL,51,2498,404,2902
KHANEWAL DISTRICT,JAHANIAN TEHSIL,52,2346,370,2716
KHANEWAL DISTRICT,JAHANIAN TEHSIL,53,2161,340,2501
KHANEWAL DISTRICT,JAHANIAN TEHSIL,54,1851,282,2133
KHANEWAL DISTRICT,JAHANIAN TEHSIL,55,1553,288,1841
KHANEWAL DISTRICT,JAHANIAN TEHSIL,56,1553,234,1787
KHANEWAL DISTRICT,JAHANIAN TEHSIL,57,1672,202,1874
KHANEWAL DISTRICT,JAHANIAN TEHSIL,58,1465,228,1693
KHANEWAL DISTRICT,JAHANIAN TEHSIL,59,1566,236,1802
KHANEWAL DISTRICT,JAHANIAN TEHSIL,60,1365,201,1566
KHANEWAL DISTRICT,JAHANIAN TEHSIL,61,1475,191,1666
KHANEWAL DISTRICT,JAHANIAN TEHSIL,62,1387,194,1581
KHANEWAL DISTRICT,JAHANIAN TEHSIL,63,1382,182,1564
KHANEWAL DISTRICT,JAHANIAN TEHSIL,64,1194,142,1336
KHANEWAL DISTRICT,JAHANIAN TEHSIL,65,1034,136,1170
KHANEWAL DISTRICT,JAHANIAN TEHSIL,66,995,105,1100
KHANEWAL DISTRICT,JAHANIAN TEHSIL,67,1008,103,1111
KHANEWAL DISTRICT,JAHANIAN TEHSIL,68,820,120,940
KHANEWAL DISTRICT,JAHANIAN TEHSIL,69,845,113,958
KHANEWAL DISTRICT,JAHANIAN TEHSIL,70,772,79,851
KHANEWAL DISTRICT,JAHANIAN TEHSIL,71,789,97,886
KHANEWAL DISTRICT,JAHANIAN TEHSIL,72,647,89,736
KHANEWAL DISTRICT,JAHANIAN TEHSIL,73,625,84,709
KHANEWAL DISTRICT,JAHANIAN TEHSIL,74,599,62,661
KHANEWAL DISTRICT,JAHANIAN TEHSIL,>=75,4074,506,4580
KHANEWAL DISTRICT,KABIRWALA TEHSIL,<1,18615,3295,21910
KHANEWAL DISTRICT,KABIRWALA TEHSIL,1,21665,3705,25370
KHANEWAL DISTRICT,KABIRWALA TEHSIL,2,22812,3834,26646
KHANEWAL DISTRICT,KABIRWALA TEHSIL,3,25416,4152,29568
KHANEWAL DISTRICT,KABIRWALA TEHSIL,4,25625,3984,29609
KHANEWAL DISTRICT,KABIRWALA TEHSIL,5,25183,4107,29290
KHANEWAL DISTRICT,KABIRWALA TEHSIL,6,24191,3885,28076
KHANEWAL DISTRICT,KABIRWALA TEHSIL,7,25822,4425,30247
KHANEWAL DISTRICT,KABIRWALA TEHSIL,8,25397,3846,29243
KHANEWAL DISTRICT,KABIRWALA TEHSIL,9,23706,4181,27887
KHANEWAL DISTRICT,KABIRWALA TEHSIL,10,22432,3653,26085
KHANEWAL DISTRICT,KABIRWALA TEHSIL,11,19776,3813,23589
KHANEWAL DISTRICT,KABIRWALA TEHSIL,12,19407,3277,22684
KHANEWAL DISTRICT,KABIRWALA TEHSIL,13,16675,3342,20017
KHANEWAL DISTRICT,KABIRWALA TEHSIL,14,16816,3068,19884
KHANEWAL DISTRICT,KABIRWALA TEHSIL,15,16189,3200,19389
KHANEWAL DISTRICT,KABIRWALA TEHSIL,16,16120,3071,19191
KHANEWAL DISTRICT,KABIRWALA TEHSIL,17,14983,3313,18296
KHANEWAL DISTRICT,KABIRWALA TEHSIL,18,17134,2916,20050
KHANEWAL DISTRICT,KABIRWALA TEHSIL,19,14717,3046,17763
KHANEWAL DISTRICT,KABIRWALA TEHSIL,20,16115,2880,18995
KHANEWAL DISTRICT,KABIRWALA TEHSIL,21,13065,2926,15991
KHANEWAL DISTRICT,KABIRWALA TEHSIL,22,14874,2774,17648
KHANEWAL DISTRICT,KABIRWALA TEHSIL,23,12698,2698,15396
KHANEWAL DISTRICT,KABIRWALA TEHSIL,24,11604,2535,14139
KHANEWAL DISTRICT,KABIRWALA TEHSIL,25,14436,2641,17077
KHANEWAL DISTRICT,KABIRWALA TEHSIL,26,11236,2387,13623
KHANEWAL DISTRICT,KABIRWALA TEHSIL,27,10808,2496,13304
KHANEWAL DISTRICT,KABIRWALA TEHSIL,28,12023,2447,14470
KHANEWAL DISTRICT,KABIRWALA TEHSIL,29,11451,2417,13868
KHANEWAL DISTRICT,KABIRWALA TEHSIL,30,13219,2332,15551
KHANEWAL DISTRICT,KABIRWALA TEHSIL,31,10737,2180,12917
KHANEWAL DISTRICT,KABIRWALA TEHSIL,32,10119,2115,12234
KHANEWAL DISTRICT,KABIRWALA TEHSIL,33,9505,1945,11450
KHANEWAL DISTRICT,KABIRWALA TEHSIL,34,9261,1942,11203
KHANEWAL DISTRICT,KABIRWALA TEHSIL,35,11202,1990,13192
KHANEWAL DISTRICT,KABIRWALA TEHSIL,36,9954,1870,11824
KHANEWAL DISTRICT,KABIRWALA TEHSIL,37,9323,1817,11140
KHANEWAL DISTRICT,KABIRWALA TEHSIL,38,9207,1929,11136
KHANEWAL DISTRICT,KABIRWALA TEHSIL,39,9237,1842,11079
KHANEWAL DISTRICT,KABIRWALA TEHSIL,40,9402,1712,11114
KHANEWAL DISTRICT,KABIRWALA TEHSIL,41,8296,1655,9951
KHANEWAL DISTRICT,KABIRWALA TEHSIL,42,7405,1604,9009
KHANEWAL DISTRICT,KABIRWALA TEHSIL,43,6595,1366,7961
KHANEWAL DISTRICT,KABIRWALA TEHSIL,44,6011,1305,7316
KHANEWAL DISTRICT,KABIRWALA TEHSIL,45,7005,1360,8365
KHANEWAL DISTRICT,KABIRWALA TEHSIL,46,5589,1164,6753
KHANEWAL DISTRICT,KABIRWALA TEHSIL,47,5918,1206,7124
KHANEWAL DISTRICT,KABIRWALA TEHSIL,48,5620,1113,6733
KHANEWAL DISTRICT,KABIRWALA TEHSIL,49,5743,1151,6894
KHANEWAL DISTRICT,KABIRWALA TEHSIL,50,6559,1174,7733
KHANEWAL DISTRICT,KABIRWALA TEHSIL,51,5745,1128,6873
KHANEWAL DISTRICT,KABIRWALA TEHSIL,52,5564,1157,6721
KHANEWAL DISTRICT,KABIRWALA TEHSIL,53,4908,989,5897
KHANEWAL DISTRICT,KABIRWALA TEHSIL,54,4595,940,5535
KHANEWAL DISTRICT,KABIRWALA TEHSIL,55,5163,879,6042
KHANEWAL DISTRICT,KABIRWALA TEHSIL,56,4241,815,5056
KHANEWAL DISTRICT,KABIRWALA TEHSIL,57,4118,779,4897
KHANEWAL DISTRICT,KABIRWALA TEHSIL,58,3331,660,3991
KHANEWAL DISTRICT,KABIRWALA TEHSIL,59,3560,725,4285
KHANEWAL DISTRICT,KABIRWALA TEHSIL,60,4307,734,5041
KHANEWAL DISTRICT,KABIRWALA TEHSIL,61,3739,693,4432
KHANEWAL DISTRICT,KABIRWALA TEHSIL,62,3581,660,4241
KHANEWAL DISTRICT,KABIRWALA TEHSIL,63,3200,606,3806
KHANEWAL DISTRICT,KABIRWALA TEHSIL,64,3043,548,3591
KHANEWAL DISTRICT,KABIRWALA TEHSIL,65,3298,507,3805
KHANEWAL DISTRICT,KABIRWALA TEHSIL,66,2701,393,3094
KHANEWAL DISTRICT,KABIRWALA TEHSIL,67,2499,404,2903
KHANEWAL DISTRICT,KABIRWALA TEHSIL,68,2094,365,2459
KHANEWAL DISTRICT,KABIRWALA TEHSIL,69,2142,331,2473
KHANEWAL DISTRICT,KABIRWALA TEHSIL,70,2444,354,2798
KHANEWAL DISTRICT,KABIRWALA TEHSIL,71,1956,323,2279
KHANEWAL DISTRICT,KABIRWALA TEHSIL,72,1621,289,1910
KHANEWAL DISTRICT,KABIRWALA TEHSIL,73,1560,266,1826
KHANEWAL DISTRICT,KABIRWALA TEHSIL,74,1390,218,1608
KHANEWAL DISTRICT,KABIRWALA TEHSIL,>=75,11304,1745,13049
KHANEWAL DISTRICT,KHANEWAL TEHSIL,<1,13171,6070,19241
KHANEWAL DISTRICT,KHANEWAL TEHSIL,1,14936,6607,21543
KHANEWAL DISTRICT,KHANEWAL TEHSIL,2,15543,6647,22190
KHANEWAL DISTRICT,KHANEWAL TEHSIL,3,16891,7095,23986
KHANEWAL DISTRICT,KHANEWAL TEHSIL,4,16956,6854,23810
KHANEWAL DISTRICT,KHANEWAL TEHSIL,5,16793,6957,23750
KHANEWAL DISTRICT,KHANEWAL TEHSIL,6,16091,6705,22796
KHANEWAL DISTRICT,KHANEWAL TEHSIL,7,17229,7206,24435
KHANEWAL DISTRICT,KHANEWAL TEHSIL,8,16710,6603,23313
KHANEWAL DISTRICT,KHANEWAL TEHSIL,9,16215,7229,23444
KHANEWAL DISTRICT,KHANEWAL TEHSIL,10,15492,6009,21501
KHANEWAL DISTRICT,KHANEWAL TEHSIL,11,14649,6885,21534
KHANEWAL DISTRICT,KHANEWAL TEHSIL,12,13720,5827,19547
KHANEWAL DISTRICT,KHANEWAL TEHSIL,13,12937,5983,18920
KHANEWAL DISTRICT,KHANEWAL TEHSIL,14,12576,5730,18306
KHANEWAL DISTRICT,KHANEWAL TEHSIL,15,12626,5724,18350
KHANEWAL DISTRICT,KHANEWAL TEHSIL,16,12342,5613,17955
KHANEWAL DISTRICT,KHANEWAL TEHSIL,17,11952,5995,17947
KHANEWAL DISTRICT,KHANEWAL TEHSIL,18,12016,5348,17364
KHANEWAL DISTRICT,KHANEWAL TEHSIL,19,11655,5995,17650
KHANEWAL DISTRICT,KHANEWAL TEHSIL,20,11439,5059,16498
KHANEWAL DISTRICT,KHANEWAL TEHSIL,21,10702,5611,16313
KHANEWAL DISTRICT,KHANEWAL TEHSIL,22,10759,5401,16160
KHANEWAL DISTRICT,KHANEWAL TEHSIL,23,10199,5470,15669
KHANEWAL DISTRICT,KHANEWAL TEHSIL,24,9509,5302,14811
KHANEWAL DISTRICT,KHANEWAL TEHSIL,25,9869,4526,14395
KHANEWAL DISTRICT,KHANEWAL TEHSIL,26,8862,4853,13715
KHANEWAL DISTRICT,KHANEWAL TEHSIL,27,8738,4818,13556
KHANEWAL DISTRICT,KHANEWAL TEHSIL,28,8910,4595,13505
KHANEWAL DISTRICT,KHANEWAL TEHSIL,29,8748,4474,13222
KHANEWAL DISTRICT,KHANEWAL TEHSIL,30,8989,4234,13223
KHANEWAL DISTRICT,KHANEWAL TEHSIL,31,8227,4295,12522
KHANEWAL DISTRICT,KHANEWAL TEHSIL,32,7915,4024,11939
KHANEWAL DISTRICT,KHANEWAL TEHSIL,33,7383,3809,11192
KHANEWAL DISTRICT,KHANEWAL TEHSIL,34,6998,3597,10595
KHANEWAL DISTRICT,KHANEWAL TEHSIL,35,7601,3441,11042
KHANEWAL DISTRICT,KHANEWAL TEHSIL,36,7339,3503,10842
KHANEWAL DISTRICT,KHANEWAL TEHSIL,37,7205,3270,10475
KHANEWAL DISTRICT,KHANEWAL TEHSIL,38,6869,3472,10341
KHANEWAL DISTRICT,KHANEWAL TEHSIL,39,7117,3200,10317
KHANEWAL DISTRICT,KHANEWAL TEHSIL,40,6252,2896,9148
KHANEWAL DISTRICT,KHANEWAL TEHSIL,41,6186,2911,9097
KHANEWAL DISTRICT,KHANEWAL TEHSIL,42,5456,2779,8235
KHANEWAL DISTRICT,KHANEWAL TEHSIL,43,5011,2701,7712
KHANEWAL DISTRICT,KHANEWAL TEHSIL,44,4576,2349,6925
KHANEWAL DISTRICT,KHANEWAL TEHSIL,45,4757,2301,7058
KHANEWAL DISTRICT,KHANEWAL TEHSIL,46,4317,2158,6475
KHANEWAL DISTRICT,KHANEWAL TEHSIL,47,4756,2298,7054
KHANEWAL DISTRICT,KHANEWAL TEHSIL,48,4430,2365,6795
KHANEWAL DISTRICT,KHANEWAL TEHSIL,49,4674,2302,6976
KHANEWAL DISTRICT,KHANEWAL TEHSIL,50,4594,2053,6647
KHANEWAL DISTRICT,KHANEWAL TEHSIL,51,4452,2255,6707
KHANEWAL DISTRICT,KHANEWAL TEHSIL,52,4520,2057,6577
KHANEWAL DISTRICT,KHANEWAL TEHSIL,53,4049,2108,6157
KHANEWAL DISTRICT,KHANEWAL TEHSIL,54,3722,1938,5660
KHANEWAL DISTRICT,KHANEWAL TEHSIL,55,3394,1652,5046
KHANEWAL DISTRICT,KHANEWAL TEHSIL,56,3107,1479,4586
KHANEWAL DISTRICT,KHANEWAL TEHSIL,57,2929,1381,4310
KHANEWAL DISTRICT,KHANEWAL TEHSIL,58,2634,1305,3939
KHANEWAL DISTRICT,KHANEWAL TEHSIL,59,2714,1301,4015
KHANEWAL DISTRICT,KHANEWAL TEHSIL,60,2672,1177,3849
KHANEWAL DISTRICT,KHANEWAL TEHSIL,61,2709,1179,3888
KHANEWAL DISTRICT,KHANEWAL TEHSIL,62,2603,1211,3814
KHANEWAL DISTRICT,KHANEWAL TEHSIL,63,2510,1110,3620
KHANEWAL DISTRICT,KHANEWAL TEHSIL,64,2293,1033,3326
KHANEWAL DISTRICT,KHANEWAL TEHSIL,65,1994,832,2826
KHANEWAL DISTRICT,KHANEWAL TEHSIL,66,1836,681,2517
KHANEWAL DISTRICT,KHANEWAL TEHSIL,67,1698,669,2367
KHANEWAL DISTRICT,KHANEWAL TEHSIL,68,1481,654,2135
KHANEWAL DISTRICT,KHANEWAL TEHSIL,69,1579,612,2191
KHANEWAL DISTRICT,KHANEWAL TEHSIL,70,1433,572,2005
KHANEWAL DISTRICT,KHANEWAL TEHSIL,71,1445,577,2022
KHANEWAL DISTRICT,KHANEWAL TEHSIL,72,1087,503,1590
KHANEWAL DISTRICT,KHANEWAL TEHSIL,73,1126,440,1566
KHANEWAL DISTRICT,KHANEWAL TEHSIL,74,1008,369,1377
KHANEWAL DISTRICT,KHANEWAL TEHSIL,>=75,7278,2853,10131
KHANEWAL DISTRICT,MIAN CHANNU TEHSIL,<1,14649,2406,17055
KHANEWAL DISTRICT,MIAN CHANNU TEHSIL,1,16663,2876,19539
KHANEWAL DISTRICT,MIAN CHANNU TEHSIL,2,16843,2693,19536
KHANEWAL DISTRICT,MIAN CHANNU TEHSIL,3,18202,3003,21205
KHANEWAL DISTRICT,MIAN CHANNU TEHSIL,4,18125,2902,21027
KHANEWAL DISTRICT,MIAN CHANNU TEHSIL,5,18044,2815,20859
KHANEWAL DISTRICT,MIAN CHANNU TEHSIL,6,17010,2853,19863
KHANEWAL DISTRICT,MIAN CHANNU TEHSIL,7,19086,3080,22166
KHANEWAL DISTRICT,MIAN CHANNU TEHSIL,8,17193,2588,19781
KHANEWAL DISTRICT,MIAN CHANNU TEHSIL,9,17682,3058,20740
KHANEWAL DISTRICT,MIAN CHANNU TEHSIL,10,15662,2506,18168
KHANEWAL DISTRICT,MIAN CHANNU TEHSIL,11,15890,3024,18914
KHANEWAL DISTRICT,MIAN CHANNU TEHSIL,12,13800,2439,16239
KHANEWAL DISTRICT,MIAN CHANNU TEHSIL,13,14165,2733,16898
KHANEWAL DISTRICT,MIAN CHANNU TEHSIL,14,13110,2545,15655
KHANEWAL DISTRICT,MIAN CHANNU TEHSIL,15,13335,2563,15898
KHANEWAL DISTRICT,MIAN CHANNU TEHSIL,16,12816,2575,15391
KHANEWAL DISTRICT,MIAN CHANNU TEHSIL,17,13389,2720,16109
KHANEWAL DISTRICT,MIAN CHANNU TEHSIL,18,12225,2235,14460
KHANEWAL DISTRICT,MIAN CHANNU TEHSIL,19,12728,2754,15482
KHANEWAL DISTRICT,MIAN CHANNU TEHSIL,20,11477,2239,13716
KHANEWAL DISTRICT,MIAN CHANNU TEHSIL,21,11934,2767,14701
KHANEWAL DISTRICT,MIAN CHANNU TEHSIL,22,11330,2301,13631
KHANEWAL DISTRICT,MIAN CHANNU TEHSIL,23,10864,2323,13187
KHANEWAL DISTRICT,MIAN CHANNU TEHSIL,24,10367,2410,12777
KHANEWAL DISTRICT,MIAN CHANNU TEHSIL,25,10095,1899,11994
KHANEWAL DISTRICT,MIAN CHANNU TEHSIL,26,10122,2279,12401
KHANEWAL DISTRICT,MIAN CHANNU TEHSIL,27,10072,2250,12322
KHANEWAL DISTRICT,MIAN CHANNU TEHSIL,28,9482,2068,11550
KHANEWAL DISTRICT,MIAN CHANNU TEHSIL,29,10604,2202,12806
KHANEWAL DISTRICT,MIAN CHANNU TEHSIL,30,8708,1580,10288
KHANEWAL DISTRICT,MIAN CHANNU TEHSIL,31,9553,2073,11626
KHANEWAL DISTRICT,MIAN CHANNU TEHSIL,32,8320,1788,10108
KHANEWAL DISTRICT,MIAN CHANNU TEHSIL,33,7683,1726,9409
KHANEWAL DISTRICT,MIAN CHANNU TEHSIL,34,7828,1680,9508
KHANEWAL DISTRICT,MIAN CHANNU TEHSIL,35,7732,1401,9133
KHANEWAL DISTRICT,MIAN CHANNU TEHSIL,36,8427,1736,10163
KHANEWAL DISTRICT,MIAN CHANNU TEHSIL,37,8737,1578,10315
KHANEWAL DISTRICT,MIAN CHANNU TEHSIL,38,7489,1643,9132
KHANEWAL DISTRICT,MIAN CHANNU TEHSIL,39,8736,1533,10269
KHANEWAL DISTRICT,MIAN CHANNU TEHSIL,40,5970,1188,7158
KHANEWAL DISTRICT,MIAN CHANNU TEHSIL,41,7302,1406,8708
KHANEWAL DISTRICT,MIAN CHANNU TEHSIL,42,6539,1288,7827
KHANEWAL DISTRICT,MIAN CHANNU TEHSIL,43,5455,1215,6670
KHANEWAL DISTRICT,MIAN CHANNU TEHSIL,44,5339,1240,6579
KHANEWAL DISTRICT,MIAN CHANNU TEHSIL,45,4559,969,5528
KHANEWAL DISTRICT,MIAN CHANNU TEHSIL,46,5039,1139,6178
KHANEWAL DISTRICT,MIAN CHANNU TEHSIL,47,5768,1072,6840
KHANEWAL DISTRICT,MIAN CHANNU TEHSIL,48,4766,1104,5870
KHANEWAL DISTRICT,MIAN CHANNU TEHSIL,49,5606,1210,6816
KHANEWAL DISTRICT,MIAN CHANNU TEHSIL,50,4366,949,5315
KHANEWAL DISTRICT,MIAN CHANNU TEHSIL,51,5681,1133,6814
KHANEWAL DISTRICT,MIAN CHANNU TEHSIL,52,5428,1092,6520
KHANEWAL DISTRICT,MIAN CHANNU TEHSIL,53,4551,1049,5600
KHANEWAL DISTRICT,MIAN CHANNU TEHSIL,54,4314,919,5233
KHANEWAL DISTRICT,MIAN CHANNU TEHSIL,55,3493,755,4248
KHANEWAL DISTRICT,MIAN CHANNU TEHSIL,56,3779,740,4519
KHANEWAL DISTRICT,MIAN CHANNU TEHSIL,57,3939,739,4678
KHANEWAL DISTRICT,MIAN CHANNU TEHSIL,58,2938,711,3649
KHANEWAL DISTRICT,MIAN CHANNU TEHSIL,59,3493,630,4123
KHANEWAL DISTRICT,MIAN CHANNU TEHSIL,60,2537,521,3058
KHANEWAL DISTRICT,MIAN CHANNU TEHSIL,61,3294,638,3932
KHANEWAL DISTRICT,MIAN CHANNU TEHSIL,62,3268,652,3920
KHANEWAL DISTRICT,MIAN CHANNU TEHSIL,63,2695,593,3288
KHANEWAL DISTRICT,MIAN CHANNU TEHSIL,64,2844,555,3399
KHANEWAL DISTRICT,MIAN CHANNU TEHSIL,65,2153,402,2555
KHANEWAL DISTRICT,MIAN CHANNU TEHSIL,66,2108,431,2539
KHANEWAL DISTRICT,MIAN CHANNU TEHSIL,67,2214,350,2564
KHANEWAL DISTRICT,MIAN CHANNU TEHSIL,68,1846,324,2170
KHANEWAL DISTRICT,MIAN CHANNU TEHSIL,69,2095,352,2447
KHANEWAL DISTRICT,MIAN CHANNU TEHSIL,70,1454,242,1696
KHANEWAL DISTRICT,MIAN CHANNU TEHSIL,71,1723,309,2032
KHANEWAL DISTRICT,MIAN CHANNU TEHSIL,72,1482,281,1763
KHANEWAL DISTRICT,MIAN CHANNU TEHSIL,73,1289,250,1539
KHANEWAL DISTRICT,MIAN CHANNU TEHSIL,74,1349,223,1572
KHANEWAL DISTRICT,MIAN CHANNU TEHSIL,>=75,9007,1580,10587
KHARAN DISTRICT,KHARAN TEHSIL,<1,1078,1347,2425
KHARAN DISTRICT,KHARAN TEHSIL,1,1105,1393,2498
KHARAN DISTRICT,KHARAN TEHSIL,2,1454,1658,3112
KHARAN DISTRICT,KHARAN TEHSIL,3,1256,1743,2999
KHARAN DISTRICT,KHARAN TEHSIL,4,1427,1793,3220
KHARAN DISTRICT,KHARAN TEHSIL,5,1110,1720,2830
KHARAN DISTRICT,KHARAN TEHSIL,6,1269,1530,2799
KHARAN DISTRICT,KHARAN TEHSIL,7,1093,1772,2865
KHARAN DISTRICT,KHARAN TEHSIL,8,1212,1668,2880
KHARAN DISTRICT,KHARAN TEHSIL,9,1094,1739,2833
KHARAN DISTRICT,KHARAN TEHSIL,10,1013,1836,2849
KHARAN DISTRICT,KHARAN TEHSIL,11,791,1421,2212
KHARAN DISTRICT,KHARAN TEHSIL,12,742,1483,2225
KHARAN DISTRICT,KHARAN TEHSIL,13,620,1311,1931
KHARAN DISTRICT,KHARAN TEHSIL,14,626,1394,2020
KHARAN DISTRICT,KHARAN TEHSIL,15,536,1316,1852
KHARAN DISTRICT,KHARAN TEHSIL,16,489,1238,1727
KHARAN DISTRICT,KHARAN TEHSIL,17,424,1209,1633
KHARAN DISTRICT,KHARAN TEHSIL,18,596,1142,1738
KHARAN DISTRICT,KHARAN TEHSIL,19,554,1013,1567
KHARAN DISTRICT,KHARAN TEHSIL,20,551,1173,1724
KHARAN DISTRICT,KHARAN TEHSIL,21,390,914,1304
KHARAN DISTRICT,KHARAN TEHSIL,22,389,821,1210
KHARAN DISTRICT,KHARAN TEHSIL,23,335,661,996
KHARAN DISTRICT,KHARAN TEHSIL,24,293,645,938
KHARAN DISTRICT,KHARAN TEHSIL,25,526,975,1501
KHARAN DISTRICT,KHARAN TEHSIL,26,252,697,949
KHARAN DISTRICT,KHARAN TEHSIL,27,381,685,1066
KHARAN DISTRICT,KHARAN TEHSIL,28,365,738,1103
KHARAN DISTRICT,KHARAN TEHSIL,29,336,692,1028
KHARAN DISTRICT,KHARAN TEHSIL,30,447,892,1339
KHARAN DISTRICT,KHARAN TEHSIL,31,344,628,972
KHARAN DISTRICT,KHARAN TEHSIL,32,286,554,840
KHARAN DISTRICT,KHARAN TEHSIL,33,270,517,787
KHARAN DISTRICT,KHARAN TEHSIL,34,241,451,692
KHARAN DISTRICT,KHARAN TEHSIL,35,360,697,1057
KHARAN DISTRICT,KHARAN TEHSIL,36,188,419,607
KHARAN DISTRICT,KHARAN TEHSIL,37,291,461,752
KHARAN DISTRICT,KHARAN TEHSIL,38,251,560,811
KHARAN DISTRICT,KHARAN TEHSIL,39,232,500,732
KHARAN DISTRICT,KHARAN TEHSIL,40,290,699,989
KHARAN DISTRICT,KHARAN TEHSIL,41,189,459,648
KHARAN DISTRICT,KHARAN TEHSIL,42,187,360,547
KHARAN DISTRICT,KHARAN TEHSIL,43,174,353,527
KHARAN DISTRICT,KHARAN TEHSIL,44,141,326,467
KHARAN DISTRICT,KHARAN TEHSIL,45,175,396,571
KHARAN DISTRICT,KHARAN TEHSIL,46,122,291,413
KHARAN DISTRICT,KHARAN TEHSIL,47,188,281,469
KHARAN DISTRICT,KHARAN TEHSIL,48,168,333,501
KHARAN DISTRICT,KHARAN TEHSIL,49,163,336,499
KHARAN DISTRICT,KHARAN TEHSIL,50,169,344,513
KHARAN DISTRICT,KHARAN TEHSIL,51,120,241,361
KHARAN DISTRICT,KHARAN TEHSIL,52,132,210,342
KHARAN DISTRICT,KHARAN TEHSIL,53,104,221,325
KHARAN DISTRICT,KHARAN TEHSIL,54,99,193,292
KHARAN DISTRICT,KHARAN TEHSIL,55,127,266,393
KHARAN DISTRICT,KHARAN TEHSIL,56,77,172,249
KHARAN DISTRICT,KHARAN TEHSIL,57,108,163,271
KHARAN DISTRICT,KHARAN TEHSIL,58,91,190,281
KHARAN DISTRICT,KHARAN TEHSIL,59,109,196,305
KHARAN DISTRICT,KHARAN TEHSIL,60,101,199,300
KHARAN DISTRICT,KHARAN TEHSIL,61,63,172,235
KHARAN DISTRICT,KHARAN TEHSIL,62,70,109,179
KHARAN DISTRICT,KHARAN TEHSIL,63,84,139,223
KHARAN DISTRICT,KHARAN TEHSIL,64,56,129,185
KHARAN DISTRICT,KHARAN TEHSIL,65,94,131,225
KHARAN DISTRICT,KHARAN TEHSIL,66,56,89,145
KHARAN DISTRICT,KHARAN TEHSIL,67,45,86,131
KHARAN DISTRICT,KHARAN TEHSIL,68,44,95,139
KHARAN DISTRICT,KHARAN TEHSIL,69,77,82,159
KHARAN DISTRICT,KHARAN TEHSIL,70,78,75,153
KHARAN DISTRICT,KHARAN TEHSIL,71,49,58,107
KHARAN DISTRICT,KHARAN TEHSIL,72,29,65,94
KHARAN DISTRICT,KHARAN TEHSIL,73,29,49,78
KHARAN DISTRICT,KHARAN TEHSIL,74,30,57,87
KHARAN DISTRICT,KHARAN TEHSIL,>=75,260,417,677
KHARAN DISTRICT,SAR KHARAN TEHSIL,<1,1702,0,1702
KHARAN DISTRICT,SAR KHARAN TEHSIL,1,1667,0,1667
KHARAN DISTRICT,SAR KHARAN TEHSIL,2,2219,0,2219
KHARAN DISTRICT,SAR KHARAN TEHSIL,3,1807,0,1807
KHARAN DISTRICT,SAR KHARAN TEHSIL,4,2051,0,2051
KHARAN DISTRICT,SAR KHARAN TEHSIL,5,1785,0,1785
KHARAN DISTRICT,SAR KHARAN TEHSIL,6,1846,0,1846
KHARAN DISTRICT,SAR KHARAN TEHSIL,7,1737,0,1737
KHARAN DISTRICT,SAR KHARAN TEHSIL,8,1911,0,1911
KHARAN DISTRICT,SAR KHARAN TEHSIL,9,1586,0,1586
KHARAN DISTRICT,SAR KHARAN TEHSIL,10,1714,0,1714
KHARAN DISTRICT,SAR KHARAN TEHSIL,11,1159,0,1159
KHARAN DISTRICT,SAR KHARAN TEHSIL,12,1329,0,1329
KHARAN DISTRICT,SAR KHARAN TEHSIL,13,976,0,976
KHARAN DISTRICT,SAR KHARAN TEHSIL,14,1220,0,1220
KHARAN DISTRICT,SAR KHARAN TEHSIL,15,944,0,944
KHARAN DISTRICT,SAR KHARAN TEHSIL,16,1059,0,1059
KHARAN DISTRICT,SAR KHARAN TEHSIL,17,907,0,907
KHARAN DISTRICT,SAR KHARAN TEHSIL,18,1224,0,1224
KHARAN DISTRICT,SAR KHARAN TEHSIL,19,937,0,937
KHARAN DISTRICT,SAR KHARAN TEHSIL,20,1039,0,1039
KHARAN DISTRICT,SAR KHARAN TEHSIL,21,799,0,799
KHARAN DISTRICT,SAR KHARAN TEHSIL,22,708,0,708
KHARAN DISTRICT,SAR KHARAN TEHSIL,23,591,0,591
KHARAN DISTRICT,SAR KHARAN TEHSIL,24,591,0,591
KHARAN DISTRICT,SAR KHARAN TEHSIL,25,806,0,806
KHARAN DISTRICT,SAR KHARAN TEHSIL,26,653,0,653
KHARAN DISTRICT,SAR KHARAN TEHSIL,27,691,0,691
KHARAN DISTRICT,SAR KHARAN TEHSIL,28,742,0,742
KHARAN DISTRICT,SAR KHARAN TEHSIL,29,620,0,620
KHARAN DISTRICT,SAR KHARAN TEHSIL,30,831,0,831
KHARAN DISTRICT,SAR KHARAN TEHSIL,31,652,0,652
KHARAN DISTRICT,SAR KHARAN TEHSIL,32,504,0,504
KHARAN DISTRICT,SAR KHARAN TEHSIL,33,521,0,521
KHARAN DISTRICT,SAR KHARAN TEHSIL,34,417,0,417
KHARAN DISTRICT,SAR KHARAN TEHSIL,35,587,0,587
KHARAN DISTRICT,SAR KHARAN TEHSIL,36,413,0,413
KHARAN DISTRICT,SAR KHARAN TEHSIL,37,524,0,524
KHARAN DISTRICT,SAR KHARAN TEHSIL,38,487,0,487
KHARAN DISTRICT,SAR KHARAN TEHSIL,39,431,0,431
KHARAN DISTRICT,SAR KHARAN TEHSIL,40,552,0,552
KHARAN DISTRICT,SAR KHARAN TEHSIL,41,355,0,355
KHARAN DISTRICT,SAR KHARAN TEHSIL,42,345,0,345
KHARAN DISTRICT,SAR KHARAN TEHSIL,43,306,0,306
KHARAN DISTRICT,SAR KHARAN TEHSIL,44,276,0,276
KHARAN DISTRICT,SAR KHARAN TEHSIL,45,350,0,350
KHARAN DISTRICT,SAR KHARAN TEHSIL,46,221,0,221
KHARAN DISTRICT,SAR KHARAN TEHSIL,47,272,0,272
KHARAN DISTRICT,SAR KHARAN TEHSIL,48,251,0,251
KHARAN DISTRICT,SAR KHARAN TEHSIL,49,246,0,246
KHARAN DISTRICT,SAR KHARAN TEHSIL,50,317,0,317
KHARAN DISTRICT,SAR KHARAN TEHSIL,51,202,0,202
KHARAN DISTRICT,SAR KHARAN TEHSIL,52,190,0,190
KHARAN DISTRICT,SAR KHARAN TEHSIL,53,190,0,190
KHARAN DISTRICT,SAR KHARAN TEHSIL,54,175,0,175
KHARAN DISTRICT,SAR KHARAN TEHSIL,55,230,0,230
KHARAN DISTRICT,SAR KHARAN TEHSIL,56,171,0,171
KHARAN DISTRICT,SAR KHARAN TEHSIL,57,177,0,177
KHARAN DISTRICT,SAR KHARAN TEHSIL,58,120,0,120
KHARAN DISTRICT,SAR KHARAN TEHSIL,59,156,0,156
KHARAN DISTRICT,SAR KHARAN TEHSIL,60,183,0,183
KHARAN DISTRICT,SAR KHARAN TEHSIL,61,146,0,146
KHARAN DISTRICT,SAR KHARAN TEHSIL,62,117,0,117
KHARAN DISTRICT,SAR KHARAN TEHSIL,63,120,0,120
KHARAN DISTRICT,SAR KHARAN TEHSIL,64,132,0,132
KHARAN DISTRICT,SAR KHARAN TEHSIL,65,139,0,139
KHARAN DISTRICT,SAR KHARAN TEHSIL,66,102,0,102
KHARAN DISTRICT,SAR KHARAN TEHSIL,67,112,0,112
KHARAN DISTRICT,SAR KHARAN TEHSIL,68,91,0,91
KHARAN DISTRICT,SAR KHARAN TEHSIL,69,86,0,86
KHARAN DISTRICT,SAR KHARAN TEHSIL,70,81,0,81
KHARAN DISTRICT,SAR KHARAN TEHSIL,71,76,0,76
KHARAN DISTRICT,SAR KHARAN TEHSIL,72,50,0,50
KHARAN DISTRICT,SAR KHARAN TEHSIL,73,62,0,62
KHARAN DISTRICT,SAR KHARAN TEHSIL,74,63,0,63
KHARAN DISTRICT,SAR KHARAN TEHSIL,>=75,344,0,344
KHARAN DISTRICT,SUB TEHSIL TOHMULK,<1,1045,0,1045
KHARAN DISTRICT,SUB TEHSIL TOHMULK,1,1226,0,1226
KHARAN DISTRICT,SUB TEHSIL TOHMULK,2,1498,0,1498
KHARAN DISTRICT,SUB TEHSIL TOHMULK,3,1208,0,1208
KHARAN DISTRICT,SUB TEHSIL TOHMULK,4,1418,0,1418
KHARAN DISTRICT,SUB TEHSIL TOHMULK,5,1309,0,1309
KHARAN DISTRICT,SUB TEHSIL TOHMULK,6,1241,0,1241
KHARAN DISTRICT,SUB TEHSIL TOHMULK,7,1198,0,1198
KHARAN DISTRICT,SUB TEHSIL TOHMULK,8,1313,0,1313
KHARAN DISTRICT,SUB TEHSIL TOHMULK,9,1039,0,1039
KHARAN DISTRICT,SUB TEHSIL TOHMULK,10,1144,0,1144
KHARAN DISTRICT,SUB TEHSIL TOHMULK,11,744,0,744
KHARAN DISTRICT,SUB TEHSIL TOHMULK,12,880,0,880
KHARAN DISTRICT,SUB TEHSIL TOHMULK,13,662,0,662
KHARAN DISTRICT,SUB TEHSIL TOHMULK,14,708,0,708
KHARAN DISTRICT,SUB TEHSIL TOHMULK,15,664,0,664
KHARAN DISTRICT,SUB TEHSIL TOHMULK,16,605,0,605
KHARAN DISTRICT,SUB TEHSIL TOHMULK,17,548,0,548
KHARAN DISTRICT,SUB TEHSIL TOHMULK,18,688,0,688
KHARAN DISTRICT,SUB TEHSIL TOHMULK,19,541,0,541
KHARAN DISTRICT,SUB TEHSIL TOHMULK,20,700,0,700
KHARAN DISTRICT,SUB TEHSIL TOHMULK,21,520,0,520
KHARAN DISTRICT,SUB TEHSIL TOHMULK,22,398,0,398
KHARAN DISTRICT,SUB TEHSIL TOHMULK,23,414,0,414
KHARAN DISTRICT,SUB TEHSIL TOHMULK,24,379,0,379
KHARAN DISTRICT,SUB TEHSIL TOHMULK,25,630,0,630
KHARAN DISTRICT,SUB TEHSIL TOHMULK,26,405,0,405
KHARAN DISTRICT,SUB TEHSIL TOHMULK,27,492,0,492
KHARAN DISTRICT,SUB TEHSIL TOHMULK,28,477,0,477
KHARAN DISTRICT,SUB TEHSIL TOHMULK,29,442,0,442
KHARAN DISTRICT,SUB TEHSIL TOHMULK,30,489,0,489
KHARAN DISTRICT,SUB TEHSIL TOHMULK,31,413,0,413
KHARAN DISTRICT,SUB TEHSIL TOHMULK,32,337,0,337
KHARAN DISTRICT,SUB TEHSIL TOHMULK,33,330,0,330
KHARAN DISTRICT,SUB TEHSIL TOHMULK,34,289,0,289
KHARAN DISTRICT,SUB TEHSIL TOHMULK,35,350,0,350
KHARAN DISTRICT,SUB TEHSIL TOHMULK,36,282,0,282
KHARAN DISTRICT,SUB TEHSIL TOHMULK,37,352,0,352
KHARAN DISTRICT,SUB TEHSIL TOHMULK,38,286,0,286
KHARAN DISTRICT,SUB TEHSIL TOHMULK,39,269,0,269
KHARAN DISTRICT,SUB TEHSIL TOHMULK,40,302,0,302
KHARAN DISTRICT,SUB TEHSIL TOHMULK,41,239,0,239
KHARAN DISTRICT,SUB TEHSIL TOHMULK,42,167,0,167
KHARAN DISTRICT,SUB TEHSIL TOHMULK,43,196,0,196
KHARAN DISTRICT,SUB TEHSIL TOHMULK,44,199,0,199
KHARAN DISTRICT,SUB TEHSIL TOHMULK,45,203,0,203
KHARAN DISTRICT,SUB TEHSIL TOHMULK,46,208,0,208
KHARAN DISTRICT,SUB TEHSIL TOHMULK,47,212,0,212
KHARAN DISTRICT,SUB TEHSIL TOHMULK,48,181,0,181
KHARAN DISTRICT,SUB TEHSIL TOHMULK,49,135,0,135
KHARAN DISTRICT,SUB TEHSIL TOHMULK,50,203,0,203
KHARAN DISTRICT,SUB TEHSIL TOHMULK,51,186,0,186
KHARAN DISTRICT,SUB TEHSIL TOHMULK,52,126,0,126
KHARAN DISTRICT,SUB TEHSIL TOHMULK,53,147,0,147
KHARAN DISTRICT,SUB TEHSIL TOHMULK,54,147,0,147
KHARAN DISTRICT,SUB TEHSIL TOHMULK,55,121,0,121
KHARAN DISTRICT,SUB TEHSIL TOHMULK,56,119,0,119
KHARAN DISTRICT,SUB TEHSIL TOHMULK,57,111,0,111
KHARAN DISTRICT,SUB TEHSIL TOHMULK,58,82,0,82
KHARAN DISTRICT,SUB TEHSIL TOHMULK,59,110,0,110
KHARAN DISTRICT,SUB TEHSIL TOHMULK,60,116,0,116
KHARAN DISTRICT,SUB TEHSIL TOHMULK,61,110,0,110
KHARAN DISTRICT,SUB TEHSIL TOHMULK,62,77,0,77
KHARAN DISTRICT,SUB TEHSIL TOHMULK,63,93,0,93
KHARAN DISTRICT,SUB TEHSIL TOHMULK,64,80,0,80
KHARAN DISTRICT,SUB TEHSIL TOHMULK,65,74,0,74
KHARAN DISTRICT,SUB TEHSIL TOHMULK,66,59,0,59
KHARAN DISTRICT,SUB TEHSIL TOHMULK,67,81,0,81
KHARAN DISTRICT,SUB TEHSIL TOHMULK,68,60,0,60
KHARAN DISTRICT,SUB TEHSIL TOHMULK,69,62,0,62
KHARAN DISTRICT,SUB TEHSIL TOHMULK,70,62,0,62
KHARAN DISTRICT,SUB TEHSIL TOHMULK,71,56,0,56
KHARAN DISTRICT,SUB TEHSIL TOHMULK,72,32,0,32
KHARAN DISTRICT,SUB TEHSIL TOHMULK,73,60,0,60
KHARAN DISTRICT,SUB TEHSIL TOHMULK,74,50,0,50
KHARAN DISTRICT,SUB TEHSIL TOHMULK,>=75,271,0,271
KHUSHAB DISTRICT,KHUSHAB TEHSIL,<1,7877,6353,14230
KHUSHAB DISTRICT,KHUSHAB TEHSIL,1,9005,6683,15688
KHUSHAB DISTRICT,KHUSHAB TEHSIL,2,9004,6888,15892
KHUSHAB DISTRICT,KHUSHAB TEHSIL,3,9678,7334,17012
KHUSHAB DISTRICT,KHUSHAB TEHSIL,4,9677,6923,16600
KHUSHAB DISTRICT,KHUSHAB TEHSIL,5,9433,6826,16259
KHUSHAB DISTRICT,KHUSHAB TEHSIL,6,9193,6747,15940
KHUSHAB DISTRICT,KHUSHAB TEHSIL,7,9769,7343,17112
KHUSHAB DISTRICT,KHUSHAB TEHSIL,8,9011,6499,15510
KHUSHAB DISTRICT,KHUSHAB TEHSIL,9,10025,7405,17430
KHUSHAB DISTRICT,KHUSHAB TEHSIL,10,8509,6290,14799
KHUSHAB DISTRICT,KHUSHAB TEHSIL,11,9354,7197,16551
KHUSHAB DISTRICT,KHUSHAB TEHSIL,12,8209,6016,14225
KHUSHAB DISTRICT,KHUSHAB TEHSIL,13,8690,6657,15347
KHUSHAB DISTRICT,KHUSHAB TEHSIL,14,8021,6051,14072
KHUSHAB DISTRICT,KHUSHAB TEHSIL,15,8413,6314,14727
KHUSHAB DISTRICT,KHUSHAB TEHSIL,16,8332,6214,14546
KHUSHAB DISTRICT,KHUSHAB TEHSIL,17,8803,6755,15558
KHUSHAB DISTRICT,KHUSHAB TEHSIL,18,7170,5503,12673
KHUSHAB DISTRICT,KHUSHAB TEHSIL,19,8151,6449,14600
KHUSHAB DISTRICT,KHUSHAB TEHSIL,20,6791,5296,12087
KHUSHAB DISTRICT,KHUSHAB TEHSIL,21,8226,6390,14616
KHUSHAB DISTRICT,KHUSHAB TEHSIL,22,7129,5312,12441
KHUSHAB DISTRICT,KHUSHAB TEHSIL,23,7507,5744,13251
KHUSHAB DISTRICT,KHUSHAB TEHSIL,24,6980,5542,12522
KHUSHAB DISTRICT,KHUSHAB TEHSIL,25,5834,4607,10441
KHUSHAB DISTRICT,KHUSHAB TEHSIL,26,6380,5070,11450
KHUSHAB DISTRICT,KHUSHAB TEHSIL,27,6387,5265,11652
KHUSHAB DISTRICT,KHUSHAB TEHSIL,28,6066,4840,10906
KHUSHAB DISTRICT,KHUSHAB TEHSIL,29,6715,5261,11976
KHUSHAB DISTRICT,KHUSHAB TEHSIL,30,5176,4365,9541
KHUSHAB DISTRICT,KHUSHAB TEHSIL,31,5695,4718,10413
KHUSHAB DISTRICT,KHUSHAB TEHSIL,32,5184,4220,9404
KHUSHAB DISTRICT,KHUSHAB TEHSIL,33,5349,4274,9623
KHUSHAB DISTRICT,KHUSHAB TEHSIL,34,5313,4127,9440
KHUSHAB DISTRICT,KHUSHAB TEHSIL,35,4420,3670,8090
KHUSHAB DISTRICT,KHUSHAB TEHSIL,36,4970,3885,8855
KHUSHAB DISTRICT,KHUSHAB TEHSIL,37,4684,3637,8321
KHUSHAB DISTRICT,KHUSHAB TEHSIL,38,4746,3794,8540
KHUSHAB DISTRICT,KHUSHAB TEHSIL,39,4684,3682,8366
KHUSHAB DISTRICT,KHUSHAB TEHSIL,40,3733,3279,7012
KHUSHAB DISTRICT,KHUSHAB TEHSIL,41,4174,3140,7314
KHUSHAB DISTRICT,KHUSHAB TEHSIL,42,3771,2945,6716
KHUSHAB DISTRICT,KHUSHAB TEHSIL,43,3666,3048,6714
KHUSHAB DISTRICT,KHUSHAB TEHSIL,44,3791,2855,6646
KHUSHAB DISTRICT,KHUSHAB TEHSIL,45,3084,2598,5682
KHUSHAB DISTRICT,KHUSHAB TEHSIL,46,3744,2639,6383
KHUSHAB DISTRICT,KHUSHAB TEHSIL,47,3456,2630,6086
KHUSHAB DISTRICT,KHUSHAB TEHSIL,48,3806,2837,6643
KHUSHAB DISTRICT,KHUSHAB TEHSIL,49,3813,2898,6711
KHUSHAB DISTRICT,KHUSHAB TEHSIL,50,3079,2673,5752
KHUSHAB DISTRICT,KHUSHAB TEHSIL,51,3752,2776,6528
KHUSHAB DISTRICT,KHUSHAB TEHSIL,52,3688,2747,6435
KHUSHAB DISTRICT,KHUSHAB TEHSIL,53,3500,2711,6211
KHUSHAB DISTRICT,KHUSHAB TEHSIL,54,3293,2519,5812
KHUSHAB DISTRICT,KHUSHAB TEHSIL,55,2462,1897,4359
KHUSHAB DISTRICT,KHUSHAB TEHSIL,56,2512,1961,4473
KHUSHAB DISTRICT,KHUSHAB TEHSIL,57,2421,1787,4208
KHUSHAB DISTRICT,KHUSHAB TEHSIL,58,2377,1743,4120
KHUSHAB DISTRICT,KHUSHAB TEHSIL,59,2282,1636,3918
KHUSHAB DISTRICT,KHUSHAB TEHSIL,60,1857,1434,3291
KHUSHAB DISTRICT,KHUSHAB TEHSIL,61,2198,1634,3832
KHUSHAB DISTRICT,KHUSHAB TEHSIL,62,2069,1616,3685
KHUSHAB DISTRICT,KHUSHAB TEHSIL,63,2080,1577,3657
KHUSHAB DISTRICT,KHUSHAB TEHSIL,64,1980,1279,3259
KHUSHAB DISTRICT,KHUSHAB TEHSIL,65,1671,1070,2741
KHUSHAB DISTRICT,KHUSHAB TEHSIL,66,1406,938,2344
KHUSHAB DISTRICT,KHUSHAB TEHSIL,67,1545,1069,2614
KHUSHAB DISTRICT,KHUSHAB TEHSIL,68,1642,1095,2737
KHUSHAB DISTRICT,KHUSHAB TEHSIL,69,1447,859,2306
KHUSHAB DISTRICT,KHUSHAB TEHSIL,70,1271,723,1994
KHUSHAB DISTRICT,KHUSHAB TEHSIL,71,1140,782,1922
KHUSHAB DISTRICT,KHUSHAB TEHSIL,72,1238,807,2045
KHUSHAB DISTRICT,KHUSHAB TEHSIL,73,1103,767,1870
KHUSHAB DISTRICT,KHUSHAB TEHSIL,74,1043,491,1534
KHUSHAB DISTRICT,KHUSHAB TEHSIL,>=75,7489,4408,11897
KHUSHAB DISTRICT,NOORPUR TEHSIL,<1,4521,391,4912
KHUSHAB DISTRICT,NOORPUR TEHSIL,1,5214,494,5708
KHUSHAB DISTRICT,NOORPUR TEHSIL,2,5426,454,5880
KHUSHAB DISTRICT,NOORPUR TEHSIL,3,6083,533,6616
KHUSHAB DISTRICT,NOORPUR TEHSIL,4,6168,456,6624
KHUSHAB DISTRICT,NOORPUR TEHSIL,5,5740,502,6242
KHUSHAB DISTRICT,NOORPUR TEHSIL,6,5569,451,6020
KHUSHAB DISTRICT,NOORPUR TEHSIL,7,6037,510,6547
KHUSHAB DISTRICT,NOORPUR TEHSIL,8,5861,472,6333
KHUSHAB DISTRICT,NOORPUR TEHSIL,9,6004,503,6507
KHUSHAB DISTRICT,NOORPUR TEHSIL,10,5083,416,5499
KHUSHAB DISTRICT,NOORPUR TEHSIL,11,5171,482,5653
KHUSHAB DISTRICT,NOORPUR TEHSIL,12,4808,357,5165
KHUSHAB DISTRICT,NOORPUR TEHSIL,13,4901,456,5357
KHUSHAB DISTRICT,NOORPUR TEHSIL,14,4500,419,4919
KHUSHAB DISTRICT,NOORPUR TEHSIL,15,4597,413,5010
KHUSHAB DISTRICT,NOORPUR TEHSIL,16,4538,443,4981
KHUSHAB DISTRICT,NOORPUR TEHSIL,17,4988,582,5570
KHUSHAB DISTRICT,NOORPUR TEHSIL,18,3474,305,3779
KHUSHAB DISTRICT,NOORPUR TEHSIL,19,3743,380,4123
KHUSHAB DISTRICT,NOORPUR TEHSIL,20,3398,292,3690
KHUSHAB DISTRICT,NOORPUR TEHSIL,21,3779,410,4189
KHUSHAB DISTRICT,NOORPUR TEHSIL,22,3538,325,3863
KHUSHAB DISTRICT,NOORPUR TEHSIL,23,3764,343,4107
KHUSHAB DISTRICT,NOORPUR TEHSIL,24,3599,321,3920
KHUSHAB DISTRICT,NOORPUR TEHSIL,25,3199,256,3455
KHUSHAB DISTRICT,NOORPUR TEHSIL,26,3680,305,3985
KHUSHAB DISTRICT,NOORPUR TEHSIL,27,3637,332,3969
KHUSHAB DISTRICT,NOORPUR TEHSIL,28,3337,325,3662
KHUSHAB DISTRICT,NOORPUR TEHSIL,29,3684,335,4019
KHUSHAB DISTRICT,NOORPUR TEHSIL,30,2799,247,3046
KHUSHAB DISTRICT,NOORPUR TEHSIL,31,3234,307,3541
KHUSHAB DISTRICT,NOORPUR TEHSIL,32,2812,301,3113
KHUSHAB DISTRICT,NOORPUR TEHSIL,33,3075,318,3393
KHUSHAB DISTRICT,NOORPUR TEHSIL,34,3351,328,3679
KHUSHAB DISTRICT,NOORPUR TEHSIL,35,2577,250,2827
KHUSHAB DISTRICT,NOORPUR TEHSIL,36,3074,271,3345
KHUSHAB DISTRICT,NOORPUR TEHSIL,37,2889,251,3140
KHUSHAB DISTRICT,NOORPUR TEHSIL,38,2666,248,2914
KHUSHAB DISTRICT,NOORPUR TEHSIL,39,2818,259,3077
KHUSHAB DISTRICT,NOORPUR TEHSIL,40,1998,181,2179
KHUSHAB DISTRICT,NOORPUR TEHSIL,41,2651,206,2857
KHUSHAB DISTRICT,NOORPUR TEHSIL,42,2137,156,2293
KHUSHAB DISTRICT,NOORPUR TEHSIL,43,2239,211,2450
KHUSHAB DISTRICT,NOORPUR TEHSIL,44,2300,183,2483
KHUSHAB DISTRICT,NOORPUR TEHSIL,45,1606,121,1727
KHUSHAB DISTRICT,NOORPUR TEHSIL,46,2200,197,2397
KHUSHAB DISTRICT,NOORPUR TEHSIL,47,1986,173,2159
KHUSHAB DISTRICT,NOORPUR TEHSIL,48,2027,184,2211
KHUSHAB DISTRICT,NOORPUR TEHSIL,49,2178,175,2353
KHUSHAB DISTRICT,NOORPUR TEHSIL,50,1621,145,1766
KHUSHAB DISTRICT,NOORPUR TEHSIL,51,2420,217,2637
KHUSHAB DISTRICT,NOORPUR TEHSIL,52,1948,179,2127
KHUSHAB DISTRICT,NOORPUR TEHSIL,53,1959,189,2148
KHUSHAB DISTRICT,NOORPUR TEHSIL,54,1848,161,2009
KHUSHAB DISTRICT,NOORPUR TEHSIL,55,1188,93,1281
KHUSHAB DISTRICT,NOORPUR TEHSIL,56,1472,131,1603
KHUSHAB DISTRICT,NOORPUR TEHSIL,57,1292,116,1408
KHUSHAB DISTRICT,NOORPUR TEHSIL,58,1221,91,1312
KHUSHAB DISTRICT,NOORPUR TEHSIL,59,1302,106,1408
KHUSHAB DISTRICT,NOORPUR TEHSIL,60,914,82,996
KHUSHAB DISTRICT,NOORPUR TEHSIL,61,1334,118,1452
KHUSHAB DISTRICT,NOORPUR TEHSIL,62,1159,103,1262
KHUSHAB DISTRICT,NOORPUR TEHSIL,63,1283,113,1396
KHUSHAB DISTRICT,NOORPUR TEHSIL,64,1254,120,1374
KHUSHAB DISTRICT,NOORPUR TEHSIL,65,775,72,847
KHUSHAB DISTRICT,NOORPUR TEHSIL,66,1087,90,1177
KHUSHAB DISTRICT,NOORPUR TEHSIL,67,968,87,1055
KHUSHAB DISTRICT,NOORPUR TEHSIL,68,880,74,954
KHUSHAB DISTRICT,NOORPUR TEHSIL,69,810,61,871
KHUSHAB DISTRICT,NOORPUR TEHSIL,70,622,48,670
KHUSHAB DISTRICT,NOORPUR TEHSIL,71,856,58,914
KHUSHAB DISTRICT,NOORPUR TEHSIL,72,820,55,875
KHUSHAB DISTRICT,NOORPUR TEHSIL,73,601,60,661
KHUSHAB DISTRICT,NOORPUR TEHSIL,74,536,38,574
KHUSHAB DISTRICT,NOORPUR TEHSIL,>=75,4223,343,4566
KHUSHAB DISTRICT,NOWSHERA TEHSIL,<1,2285,295,2580
KHUSHAB DISTRICT,NOWSHERA TEHSIL,1,2260,275,2535
KHUSHAB DISTRICT,NOWSHERA TEHSIL,2,2375,321,2696
KHUSHAB DISTRICT,NOWSHERA TEHSIL,3,2476,259,2735
KHUSHAB DISTRICT,NOWSHERA TEHSIL,4,2430,254,2684
KHUSHAB DISTRICT,NOWSHERA TEHSIL,5,2336,256,2592
KHUSHAB DISTRICT,NOWSHERA TEHSIL,6,2151,268,2419
KHUSHAB DISTRICT,NOWSHERA TEHSIL,7,2402,269,2671
KHUSHAB DISTRICT,NOWSHERA TEHSIL,8,2082,244,2326
KHUSHAB DISTRICT,NOWSHERA TEHSIL,9,2546,320,2866
KHUSHAB DISTRICT,NOWSHERA TEHSIL,10,1908,253,2161
KHUSHAB DISTRICT,NOWSHERA TEHSIL,11,2468,310,2778
KHUSHAB DISTRICT,NOWSHERA TEHSIL,12,1905,264,2169
KHUSHAB DISTRICT,NOWSHERA TEHSIL,13,2236,286,2522
KHUSHAB DISTRICT,NOWSHERA TEHSIL,14,1979,281,2260
KHUSHAB DISTRICT,NOWSHERA TEHSIL,15,2146,257,2403
KHUSHAB DISTRICT,NOWSHERA TEHSIL,16,2078,286,2364
KHUSHAB DISTRICT,NOWSHERA TEHSIL,17,2412,297,2709
KHUSHAB DISTRICT,NOWSHERA TEHSIL,18,1594,228,1822
KHUSHAB DISTRICT,NOWSHERA TEHSIL,19,2144,346,2490
KHUSHAB DISTRICT,NOWSHERA TEHSIL,20,1569,238,1807
KHUSHAB DISTRICT,NOWSHERA TEHSIL,21,2252,290,2542
KHUSHAB DISTRICT,NOWSHERA TEHSIL,22,1752,223,1975
KHUSHAB DISTRICT,NOWSHERA TEHSIL,23,1947,279,2226
KHUSHAB DISTRICT,NOWSHERA TEHSIL,24,1781,251,2032
KHUSHAB DISTRICT,NOWSHERA TEHSIL,25,1378,197,1575
KHUSHAB DISTRICT,NOWSHERA TEHSIL,26,1627,199,1826
KHUSHAB DISTRICT,NOWSHERA TEHSIL,27,1835,234,2069
KHUSHAB DISTRICT,NOWSHERA TEHSIL,28,1506,201,1707
KHUSHAB DISTRICT,NOWSHERA TEHSIL,29,1765,221,1986
KHUSHAB DISTRICT,NOWSHERA TEHSIL,30,1167,148,1315
KHUSHAB DISTRICT,NOWSHERA TEHSIL,31,1610,234,1844
KHUSHAB DISTRICT,NOWSHERA TEHSIL,32,1414,180,1594
KHUSHAB DISTRICT,NOWSHERA TEHSIL,33,1494,228,1722
KHUSHAB DISTRICT,NOWSHERA TEHSIL,34,1520,225,1745
KHUSHAB DISTRICT,NOWSHERA TEHSIL,35,1019,140,1159
KHUSHAB DISTRICT,NOWSHERA TEHSIL,36,1287,162,1449
KHUSHAB DISTRICT,NOWSHERA TEHSIL,37,1371,188,1559
KHUSHAB DISTRICT,NOWSHERA TEHSIL,38,1106,193,1299
KHUSHAB DISTRICT,NOWSHERA TEHSIL,39,1308,162,1470
KHUSHAB DISTRICT,NOWSHERA TEHSIL,40,749,113,862
KHUSHAB DISTRICT,NOWSHERA TEHSIL,41,1135,159,1294
KHUSHAB DISTRICT,NOWSHERA TEHSIL,42,995,118,1113
KHUSHAB DISTRICT,NOWSHERA TEHSIL,43,1023,162,1185
KHUSHAB DISTRICT,NOWSHERA TEHSIL,44,987,123,1110
KHUSHAB DISTRICT,NOWSHERA TEHSIL,45,697,87,784
KHUSHAB DISTRICT,NOWSHERA TEHSIL,46,968,149,1117
KHUSHAB DISTRICT,NOWSHERA TEHSIL,47,1003,157,1160
KHUSHAB DISTRICT,NOWSHERA TEHSIL,48,954,139,1093
KHUSHAB DISTRICT,NOWSHERA TEHSIL,49,1006,136,1142
KHUSHAB DISTRICT,NOWSHERA TEHSIL,50,696,96,792
KHUSHAB DISTRICT,NOWSHERA TEHSIL,51,1095,163,1258
KHUSHAB DISTRICT,NOWSHERA TEHSIL,52,1052,132,1184
KHUSHAB DISTRICT,NOWSHERA TEHSIL,53,935,169,1104
KHUSHAB DISTRICT,NOWSHERA TEHSIL,54,909,154,1063
KHUSHAB DISTRICT,NOWSHERA TEHSIL,55,596,74,670
KHUSHAB DISTRICT,NOWSHERA TEHSIL,56,797,118,915
KHUSHAB DISTRICT,NOWSHERA TEHSIL,57,820,106,926
KHUSHAB DISTRICT,NOWSHERA TEHSIL,58,691,96,787
KHUSHAB DISTRICT,NOWSHERA TEHSIL,59,738,111,849
KHUSHAB DISTRICT,NOWSHERA TEHSIL,60,450,65,515
KHUSHAB DISTRICT,NOWSHERA TEHSIL,61,777,121,898
KHUSHAB DISTRICT,NOWSHERA TEHSIL,62,719,106,825
KHUSHAB DISTRICT,NOWSHERA TEHSIL,63,707,93,800
KHUSHAB DISTRICT,NOWSHERA TEHSIL,64,672,80,752
KHUSHAB DISTRICT,NOWSHERA TEHSIL,65,452,61,513
KHUSHAB DISTRICT,NOWSHERA TEHSIL,66,526,60,586
KHUSHAB DISTRICT,NOWSHERA TEHSIL,67,598,78,676
KHUSHAB DISTRICT,NOWSHERA TEHSIL,68,588,82,670
KHUSHAB DISTRICT,NOWSHERA TEHSIL,69,544,63,607
KHUSHAB DISTRICT,NOWSHERA TEHSIL,70,319,38,357
KHUSHAB DISTRICT,NOWSHERA TEHSIL,71,407,60,467
KHUSHAB DISTRICT,NOWSHERA TEHSIL,72,440,70,510
KHUSHAB DISTRICT,NOWSHERA TEHSIL,73,403,54,457
KHUSHAB DISTRICT,NOWSHERA TEHSIL,74,356,44,400
KHUSHAB DISTRICT,NOWSHERA TEHSIL,>=75,2878,354,3232
KHUSHAB DISTRICT,QUAIDABAD TEHSIL,<1,4577,445,5022
KHUSHAB DISTRICT,QUAIDABAD TEHSIL,1,5049,581,5630
KHUSHAB DISTRICT,QUAIDABAD TEHSIL,2,5353,534,5887
KHUSHAB DISTRICT,QUAIDABAD TEHSIL,3,5551,567,6118
KHUSHAB DISTRICT,QUAIDABAD TEHSIL,4,5624,530,6154
KHUSHAB DISTRICT,QUAIDABAD TEHSIL,5,5500,560,6060
KHUSHAB DISTRICT,QUAIDABAD TEHSIL,6,5184,528,5712
KHUSHAB DISTRICT,QUAIDABAD TEHSIL,7,5579,591,6170
KHUSHAB DISTRICT,QUAIDABAD TEHSIL,8,5166,523,5689
KHUSHAB DISTRICT,QUAIDABAD TEHSIL,9,5407,604,6011
KHUSHAB DISTRICT,QUAIDABAD TEHSIL,10,4770,422,5192
KHUSHAB DISTRICT,QUAIDABAD TEHSIL,11,4761,555,5316
KHUSHAB DISTRICT,QUAIDABAD TEHSIL,12,4365,453,4818
KHUSHAB DISTRICT,QUAIDABAD TEHSIL,13,4511,510,5021
KHUSHAB DISTRICT,QUAIDABAD TEHSIL,14,4299,406,4705
KHUSHAB DISTRICT,QUAIDABAD TEHSIL,15,4382,455,4837
KHUSHAB DISTRICT,QUAIDABAD TEHSIL,16,4335,410,4745
KHUSHAB DISTRICT,QUAIDABAD TEHSIL,17,4439,491,4930
KHUSHAB DISTRICT,QUAIDABAD TEHSIL,18,3747,368,4115
KHUSHAB DISTRICT,QUAIDABAD TEHSIL,19,4116,476,4592
KHUSHAB DISTRICT,QUAIDABAD TEHSIL,20,3494,341,3835
KHUSHAB DISTRICT,QUAIDABAD TEHSIL,21,3795,484,4279
KHUSHAB DISTRICT,QUAIDABAD TEHSIL,22,3550,375,3925
KHUSHAB DISTRICT,QUAIDABAD TEHSIL,23,3679,369,4048
KHUSHAB DISTRICT,QUAIDABAD TEHSIL,24,3259,367,3626
KHUSHAB DISTRICT,QUAIDABAD TEHSIL,25,3048,297,3345
KHUSHAB DISTRICT,QUAIDABAD TEHSIL,26,3262,433,3695
KHUSHAB DISTRICT,QUAIDABAD TEHSIL,27,3247,386,3633
KHUSHAB DISTRICT,QUAIDABAD TEHSIL,28,3316,400,3716
KHUSHAB DISTRICT,QUAIDABAD TEHSIL,29,3543,382,3925
KHUSHAB DISTRICT,QUAIDABAD TEHSIL,30,2915,296,3211
KHUSHAB DISTRICT,QUAIDABAD TEHSIL,31,3004,379,3383
KHUSHAB DISTRICT,QUAIDABAD TEHSIL,32,2725,297,3022
KHUSHAB DISTRICT,QUAIDABAD TEHSIL,33,2762,309,3071
KHUSHAB DISTRICT,QUAIDABAD TEHSIL,34,2829,285,3114
KHUSHAB DISTRICT,QUAIDABAD TEHSIL,35,2360,279,2639
KHUSHAB DISTRICT,QUAIDABAD TEHSIL,36,2689,295,2984
KHUSHAB DISTRICT,QUAIDABAD TEHSIL,37,2596,269,2865
KHUSHAB DISTRICT,QUAIDABAD TEHSIL,38,2469,280,2749
KHUSHAB DISTRICT,QUAIDABAD TEHSIL,39,2495,266,2761
KHUSHAB DISTRICT,QUAIDABAD TEHSIL,40,1848,202,2050
KHUSHAB DISTRICT,QUAIDABAD TEHSIL,41,2163,259,2422
KHUSHAB DISTRICT,QUAIDABAD TEHSIL,42,1928,183,2111
KHUSHAB DISTRICT,QUAIDABAD TEHSIL,43,1986,201,2187
KHUSHAB DISTRICT,QUAIDABAD TEHSIL,44,1892,171,2063
KHUSHAB DISTRICT,QUAIDABAD TEHSIL,45,1514,161,1675
KHUSHAB DISTRICT,QUAIDABAD TEHSIL,46,1860,166,2026
KHUSHAB DISTRICT,QUAIDABAD TEHSIL,47,1790,173,1963
KHUSHAB DISTRICT,QUAIDABAD TEHSIL,48,1904,187,2091
KHUSHAB DISTRICT,QUAIDABAD TEHSIL,49,1915,176,2091
KHUSHAB DISTRICT,QUAIDABAD TEHSIL,50,1644,157,1801
KHUSHAB DISTRICT,QUAIDABAD TEHSIL,51,2012,198,2210
KHUSHAB DISTRICT,QUAIDABAD TEHSIL,52,2025,160,2185
KHUSHAB DISTRICT,QUAIDABAD TEHSIL,53,1787,171,1958
KHUSHAB DISTRICT,QUAIDABAD TEHSIL,54,1661,148,1809
KHUSHAB DISTRICT,QUAIDABAD TEHSIL,55,1186,133,1319
KHUSHAB DISTRICT,QUAIDABAD TEHSIL,56,1343,117,1460
KHUSHAB DISTRICT,QUAIDABAD TEHSIL,57,1174,92,1266
KHUSHAB DISTRICT,QUAIDABAD TEHSIL,58,1202,122,1324
KHUSHAB DISTRICT,QUAIDABAD TEHSIL,59,1149,105,1254
KHUSHAB DISTRICT,QUAIDABAD TEHSIL,60,914,77,991
KHUSHAB DISTRICT,QUAIDABAD TEHSIL,61,1222,126,1348
KHUSHAB DISTRICT,QUAIDABAD TEHSIL,62,1197,119,1316
KHUSHAB DISTRICT,QUAIDABAD TEHSIL,63,1145,101,1246
KHUSHAB DISTRICT,QUAIDABAD TEHSIL,64,1171,78,1249
KHUSHAB DISTRICT,QUAIDABAD TEHSIL,65,803,76,879
KHUSHAB DISTRICT,QUAIDABAD TEHSIL,66,884,56,940
KHUSHAB DISTRICT,QUAIDABAD TEHSIL,67,995,62,1057
KHUSHAB DISTRICT,QUAIDABAD TEHSIL,68,848,79,927
KHUSHAB DISTRICT,QUAIDABAD TEHSIL,69,779,52,831
KHUSHAB DISTRICT,QUAIDABAD TEHSIL,70,607,56,663
KHUSHAB DISTRICT,QUAIDABAD TEHSIL,71,684,43,727
KHUSHAB DISTRICT,QUAIDABAD TEHSIL,72,794,60,854
KHUSHAB DISTRICT,QUAIDABAD TEHSIL,73,562,41,603
KHUSHAB DISTRICT,QUAIDABAD TEHSIL,74,487,36,523
KHUSHAB DISTRICT,QUAIDABAD TEHSIL,>=75,3788,271,4059
KHUZDAR DISTRICT,ARANJI SUB-TEHSIL,<1,1884,0,1884
KHUZDAR DISTRICT,ARANJI SUB-TEHSIL,1,1295,0,1295
KHUZDAR DISTRICT,ARANJI SUB-TEHSIL,2,2160,0,2160
KHUZDAR DISTRICT,ARANJI SUB-TEHSIL,3,1452,0,1452
KHUZDAR DISTRICT,ARANJI SUB-TEHSIL,4,2167,0,2167
KHUZDAR DISTRICT,ARANJI SUB-TEHSIL,5,1476,0,1476
KHUZDAR DISTRICT,ARANJI SUB-TEHSIL,6,1989,0,1989
KHUZDAR DISTRICT,ARANJI SUB-TEHSIL,7,1303,0,1303
KHUZDAR DISTRICT,ARANJI SUB-TEHSIL,8,1946,0,1946
KHUZDAR DISTRICT,ARANJI SUB-TEHSIL,9,1262,0,1262
KHUZDAR DISTRICT,ARANJI SUB-TEHSIL,10,1692,0,1692
KHUZDAR DISTRICT,ARANJI SUB-TEHSIL,11,824,0,824
KHUZDAR DISTRICT,ARANJI SUB-TEHSIL,12,1182,0,1182
KHUZDAR DISTRICT,ARANJI SUB-TEHSIL,13,686,0,686
KHUZDAR DISTRICT,ARANJI SUB-TEHSIL,14,809,0,809
KHUZDAR DISTRICT,ARANJI SUB-TEHSIL,15,687,0,687
KHUZDAR DISTRICT,ARANJI SUB-TEHSIL,16,551,0,551
KHUZDAR DISTRICT,ARANJI SUB-TEHSIL,17,441,0,441
KHUZDAR DISTRICT,ARANJI SUB-TEHSIL,18,880,0,880
KHUZDAR DISTRICT,ARANJI SUB-TEHSIL,19,476,0,476
KHUZDAR DISTRICT,ARANJI SUB-TEHSIL,20,973,0,973
KHUZDAR DISTRICT,ARANJI SUB-TEHSIL,21,513,0,513
KHUZDAR DISTRICT,ARANJI SUB-TEHSIL,22,453,0,453
KHUZDAR DISTRICT,ARANJI SUB-TEHSIL,23,396,0,396
KHUZDAR DISTRICT,ARANJI SUB-TEHSIL,24,374,0,374
KHUZDAR DISTRICT,ARANJI SUB-TEHSIL,25,858,0,858
KHUZDAR DISTRICT,ARANJI SUB-TEHSIL,26,455,0,455
KHUZDAR DISTRICT,ARANJI SUB-TEHSIL,27,444,0,444
KHUZDAR DISTRICT,ARANJI SUB-TEHSIL,28,560,0,560
KHUZDAR DISTRICT,ARANJI SUB-TEHSIL,29,481,0,481
KHUZDAR DISTRICT,ARANJI SUB-TEHSIL,30,722,0,722
KHUZDAR DISTRICT,ARANJI SUB-TEHSIL,31,502,0,502
KHUZDAR DISTRICT,ARANJI SUB-TEHSIL,32,366,0,366
KHUZDAR DISTRICT,ARANJI SUB-TEHSIL,33,425,0,425
KHUZDAR DISTRICT,ARANJI SUB-TEHSIL,34,292,0,292
KHUZDAR DISTRICT,ARANJI SUB-TEHSIL,35,553,0,553
KHUZDAR DISTRICT,ARANJI SUB-TEHSIL,36,324,0,324
KHUZDAR DISTRICT,ARANJI SUB-TEHSIL,37,367,0,367
KHUZDAR DISTRICT,ARANJI SUB-TEHSIL,38,447,0,447
KHUZDAR DISTRICT,ARANJI SUB-TEHSIL,39,401,0,401
KHUZDAR DISTRICT,ARANJI SUB-TEHSIL,40,581,0,581
KHUZDAR DISTRICT,ARANJI SUB-TEHSIL,41,358,0,358
KHUZDAR DISTRICT,ARANJI SUB-TEHSIL,42,232,0,232
KHUZDAR DISTRICT,ARANJI SUB-TEHSIL,43,307,0,307
KHUZDAR DISTRICT,ARANJI SUB-TEHSIL,44,269,0,269
KHUZDAR DISTRICT,ARANJI SUB-TEHSIL,45,385,0,385
KHUZDAR DISTRICT,ARANJI SUB-TEHSIL,46,257,0,257
KHUZDAR DISTRICT,ARANJI SUB-TEHSIL,47,216,0,216
KHUZDAR DISTRICT,ARANJI SUB-TEHSIL,48,286,0,286
KHUZDAR DISTRICT,ARANJI SUB-TEHSIL,49,297,0,297
KHUZDAR DISTRICT,ARANJI SUB-TEHSIL,50,419,0,419
KHUZDAR DISTRICT,ARANJI SUB-TEHSIL,51,182,0,182
KHUZDAR DISTRICT,ARANJI SUB-TEHSIL,52,151,0,151
KHUZDAR DISTRICT,ARANJI SUB-TEHSIL,53,208,0,208
KHUZDAR DISTRICT,ARANJI SUB-TEHSIL,54,184,0,184
KHUZDAR DISTRICT,ARANJI SUB-TEHSIL,55,213,0,213
KHUZDAR DISTRICT,ARANJI SUB-TEHSIL,56,138,0,138
KHUZDAR DISTRICT,ARANJI SUB-TEHSIL,57,147,0,147
KHUZDAR DISTRICT,ARANJI SUB-TEHSIL,58,135,0,135
KHUZDAR DISTRICT,ARANJI SUB-TEHSIL,59,155,0,155
KHUZDAR DISTRICT,ARANJI SUB-TEHSIL,60,262,0,262
KHUZDAR DISTRICT,ARANJI SUB-TEHSIL,61,133,0,133
KHUZDAR DISTRICT,ARANJI SUB-TEHSIL,62,74,0,74
KHUZDAR DISTRICT,ARANJI SUB-TEHSIL,63,152,0,152
KHUZDAR DISTRICT,ARANJI SUB-TEHSIL,64,142,0,142
KHUZDAR DISTRICT,ARANJI SUB-TEHSIL,65,139,0,139
KHUZDAR DISTRICT,ARANJI SUB-TEHSIL,66,82,0,82
KHUZDAR DISTRICT,ARANJI SUB-TEHSIL,67,66,0,66
KHUZDAR DISTRICT,ARANJI SUB-TEHSIL,68,89,0,89
KHUZDAR DISTRICT,ARANJI SUB-TEHSIL,69,100,0,100
KHUZDAR DISTRICT,ARANJI SUB-TEHSIL,70,126,0,126
KHUZDAR DISTRICT,ARANJI SUB-TEHSIL,71,69,0,69
KHUZDAR DISTRICT,ARANJI SUB-TEHSIL,72,35,0,35
KHUZDAR DISTRICT,ARANJI SUB-TEHSIL,73,64,0,64
KHUZDAR DISTRICT,ARANJI SUB-TEHSIL,74,73,0,73
KHUZDAR DISTRICT,ARANJI SUB-TEHSIL,>=75,524,0,524
KHUZDAR DISTRICT,KARAKH SUB-TEHSIL,<1,966,0,966
KHUZDAR DISTRICT,KARAKH SUB-TEHSIL,1,880,0,880
KHUZDAR DISTRICT,KARAKH SUB-TEHSIL,2,1222,0,1222
KHUZDAR DISTRICT,KARAKH SUB-TEHSIL,3,1123,0,1123
KHUZDAR DISTRICT,KARAKH SUB-TEHSIL,4,1214,0,1214
KHUZDAR DISTRICT,KARAKH SUB-TEHSIL,5,1120,0,1120
KHUZDAR DISTRICT,KARAKH SUB-TEHSIL,6,1201,0,1201
KHUZDAR DISTRICT,KARAKH SUB-TEHSIL,7,1041,0,1041
KHUZDAR DISTRICT,KARAKH SUB-TEHSIL,8,1277,0,1277
KHUZDAR DISTRICT,KARAKH SUB-TEHSIL,9,948,0,948
KHUZDAR DISTRICT,KARAKH SUB-TEHSIL,10,1289,0,1289
KHUZDAR DISTRICT,KARAKH SUB-TEHSIL,11,745,0,745
KHUZDAR DISTRICT,KARAKH SUB-TEHSIL,12,879,0,879
KHUZDAR DISTRICT,KARAKH SUB-TEHSIL,13,620,0,620
KHUZDAR DISTRICT,KARAKH SUB-TEHSIL,14,713,0,713
KHUZDAR DISTRICT,KARAKH SUB-TEHSIL,15,700,0,700
KHUZDAR DISTRICT,KARAKH SUB-TEHSIL,16,592,0,592
KHUZDAR DISTRICT,KARAKH SUB-TEHSIL,17,494,0,494
KHUZDAR DISTRICT,KARAKH SUB-TEHSIL,18,799,0,799
KHUZDAR DISTRICT,KARAKH SUB-TEHSIL,19,444,0,444
KHUZDAR DISTRICT,KARAKH SUB-TEHSIL,20,694,0,694
KHUZDAR DISTRICT,KARAKH SUB-TEHSIL,21,457,0,457
KHUZDAR DISTRICT,KARAKH SUB-TEHSIL,22,461,0,461
KHUZDAR DISTRICT,KARAKH SUB-TEHSIL,23,343,0,343
KHUZDAR DISTRICT,KARAKH SUB-TEHSIL,24,328,0,328
KHUZDAR DISTRICT,KARAKH SUB-TEHSIL,25,673,0,673
KHUZDAR DISTRICT,KARAKH SUB-TEHSIL,26,368,0,368
KHUZDAR DISTRICT,KARAKH SUB-TEHSIL,27,355,0,355
KHUZDAR DISTRICT,KARAKH SUB-TEHSIL,28,467,0,467
KHUZDAR DISTRICT,KARAKH SUB-TEHSIL,29,308,0,308
KHUZDAR DISTRICT,KARAKH SUB-TEHSIL,30,607,0,607
KHUZDAR DISTRICT,KARAKH SUB-TEHSIL,31,344,0,344
KHUZDAR DISTRICT,KARAKH SUB-TEHSIL,32,285,0,285
KHUZDAR DISTRICT,KARAKH SUB-TEHSIL,33,280,0,280
KHUZDAR DISTRICT,KARAKH SUB-TEHSIL,34,211,0,211
KHUZDAR DISTRICT,KARAKH SUB-TEHSIL,35,431,0,431
KHUZDAR DISTRICT,KARAKH SUB-TEHSIL,36,191,0,191
KHUZDAR DISTRICT,KARAKH SUB-TEHSIL,37,216,0,216
KHUZDAR DISTRICT,KARAKH SUB-TEHSIL,38,372,0,372
KHUZDAR DISTRICT,KARAKH SUB-TEHSIL,39,269,0,269
KHUZDAR DISTRICT,KARAKH SUB-TEHSIL,40,508,0,508
KHUZDAR DISTRICT,KARAKH SUB-TEHSIL,41,270,0,270
KHUZDAR DISTRICT,KARAKH SUB-TEHSIL,42,171,0,171
KHUZDAR DISTRICT,KARAKH SUB-TEHSIL,43,218,0,218
KHUZDAR DISTRICT,KARAKH SUB-TEHSIL,44,191,0,191
KHUZDAR DISTRICT,KARAKH SUB-TEHSIL,45,334,0,334
KHUZDAR DISTRICT,KARAKH SUB-TEHSIL,46,146,0,146
KHUZDAR DISTRICT,KARAKH SUB-TEHSIL,47,148,0,148
KHUZDAR DISTRICT,KARAKH SUB-TEHSIL,48,191,0,191
KHUZDAR DISTRICT,KARAKH SUB-TEHSIL,49,158,0,158
KHUZDAR DISTRICT,KARAKH SUB-TEHSIL,50,298,0,298
KHUZDAR DISTRICT,KARAKH SUB-TEHSIL,51,138,0,138
KHUZDAR DISTRICT,KARAKH SUB-TEHSIL,52,78,0,78
KHUZDAR DISTRICT,KARAKH SUB-TEHSIL,53,146,0,146
KHUZDAR DISTRICT,KARAKH SUB-TEHSIL,54,110,0,110
KHUZDAR DISTRICT,KARAKH SUB-TEHSIL,55,197,0,197
KHUZDAR DISTRICT,KARAKH SUB-TEHSIL,56,81,0,81
KHUZDAR DISTRICT,KARAKH SUB-TEHSIL,57,72,0,72
KHUZDAR DISTRICT,KARAKH SUB-TEHSIL,58,116,0,116
KHUZDAR DISTRICT,KARAKH SUB-TEHSIL,59,77,0,77
KHUZDAR DISTRICT,KARAKH SUB-TEHSIL,60,207,0,207
KHUZDAR DISTRICT,KARAKH SUB-TEHSIL,61,95,0,95
KHUZDAR DISTRICT,KARAKH SUB-TEHSIL,62,87,0,87
KHUZDAR DISTRICT,KARAKH SUB-TEHSIL,63,92,0,92
KHUZDAR DISTRICT,KARAKH SUB-TEHSIL,64,80,0,80
KHUZDAR DISTRICT,KARAKH SUB-TEHSIL,65,112,0,112
KHUZDAR DISTRICT,KARAKH SUB-TEHSIL,66,57,0,57
KHUZDAR DISTRICT,KARAKH SUB-TEHSIL,67,45,0,45
KHUZDAR DISTRICT,KARAKH SUB-TEHSIL,68,75,0,75
KHUZDAR DISTRICT,KARAKH SUB-TEHSIL,69,37,0,37
KHUZDAR DISTRICT,KARAKH SUB-TEHSIL,70,97,0,97
KHUZDAR DISTRICT,KARAKH SUB-TEHSIL,71,37,0,37
KHUZDAR DISTRICT,KARAKH SUB-TEHSIL,72,35,0,35
KHUZDAR DISTRICT,KARAKH SUB-TEHSIL,73,32,0,32
KHUZDAR DISTRICT,KARAKH SUB-TEHSIL,74,38,0,38
KHUZDAR DISTRICT,KARAKH SUB-TEHSIL,>=75,315,0,315
KHUZDAR DISTRICT,KHUZDAR TEHSIL,<1,4049,4837,8886
KHUZDAR DISTRICT,KHUZDAR TEHSIL,1,4278,6035,10313
KHUZDAR DISTRICT,KHUZDAR TEHSIL,2,5091,7327,12418
KHUZDAR DISTRICT,KHUZDAR TEHSIL,3,4800,6498,11298
KHUZDAR DISTRICT,KHUZDAR TEHSIL,4,5170,7140,12310
KHUZDAR DISTRICT,KHUZDAR TEHSIL,5,4548,6359,10907
KHUZDAR DISTRICT,KHUZDAR TEHSIL,6,4977,6799,11776
KHUZDAR DISTRICT,KHUZDAR TEHSIL,7,4362,6409,10771
KHUZDAR DISTRICT,KHUZDAR TEHSIL,8,5110,6932,12042
KHUZDAR DISTRICT,KHUZDAR TEHSIL,9,3706,5830,9536
KHUZDAR DISTRICT,KHUZDAR TEHSIL,10,4508,6674,11182
KHUZDAR DISTRICT,KHUZDAR TEHSIL,11,2967,4822,7789
KHUZDAR DISTRICT,KHUZDAR TEHSIL,12,3386,5566,8952
KHUZDAR DISTRICT,KHUZDAR TEHSIL,13,2368,4294,6662
KHUZDAR DISTRICT,KHUZDAR TEHSIL,14,2742,4619,7361
KHUZDAR DISTRICT,KHUZDAR TEHSIL,15,2218,4219,6437
KHUZDAR DISTRICT,KHUZDAR TEHSIL,16,2219,3881,6100
KHUZDAR DISTRICT,KHUZDAR TEHSIL,17,1587,3330,4917
KHUZDAR DISTRICT,KHUZDAR TEHSIL,18,2569,4093,6662
KHUZDAR DISTRICT,KHUZDAR TEHSIL,19,1747,3374,5121
KHUZDAR DISTRICT,KHUZDAR TEHSIL,20,2586,4167,6753
KHUZDAR DISTRICT,KHUZDAR TEHSIL,21,1628,3202,4830
KHUZDAR DISTRICT,KHUZDAR TEHSIL,22,1604,2987,4591
KHUZDAR DISTRICT,KHUZDAR TEHSIL,23,1288,2530,3818
KHUZDAR DISTRICT,KHUZDAR TEHSIL,24,970,2186,3156
KHUZDAR DISTRICT,KHUZDAR TEHSIL,25,2256,3448,5704
KHUZDAR DISTRICT,KHUZDAR TEHSIL,26,1189,2173,3362
KHUZDAR DISTRICT,KHUZDAR TEHSIL,27,1235,2427,3662
KHUZDAR DISTRICT,KHUZDAR TEHSIL,28,1558,2634,4192
KHUZDAR DISTRICT,KHUZDAR TEHSIL,29,1243,2334,3577
KHUZDAR DISTRICT,KHUZDAR TEHSIL,30,2114,2948,5062
KHUZDAR DISTRICT,KHUZDAR TEHSIL,31,1226,2216,3442
KHUZDAR DISTRICT,KHUZDAR TEHSIL,32,1034,1890,2924
KHUZDAR DISTRICT,KHUZDAR TEHSIL,33,1226,2018,3244
KHUZDAR DISTRICT,KHUZDAR TEHSIL,34,807,1534,2341
KHUZDAR DISTRICT,KHUZDAR TEHSIL,35,1462,2287,3749
KHUZDAR DISTRICT,KHUZDAR TEHSIL,36,749,1302,2051
KHUZDAR DISTRICT,KHUZDAR TEHSIL,37,972,1578,2550
KHUZDAR DISTRICT,KHUZDAR TEHSIL,38,1041,1841,2882
KHUZDAR DISTRICT,KHUZDAR TEHSIL,39,906,1569,2475
KHUZDAR DISTRICT,KHUZDAR TEHSIL,40,1513,2170,3683
KHUZDAR DISTRICT,KHUZDAR TEHSIL,41,898,1343,2241
KHUZDAR DISTRICT,KHUZDAR TEHSIL,42,654,1098,1752
KHUZDAR DISTRICT,KHUZDAR TEHSIL,43,819,1190,2009
KHUZDAR DISTRICT,KHUZDAR TEHSIL,44,649,1092,1741
KHUZDAR DISTRICT,KHUZDAR TEHSIL,45,983,1426,2409
KHUZDAR DISTRICT,KHUZDAR TEHSIL,46,474,836,1310
KHUZDAR DISTRICT,KHUZDAR TEHSIL,47,487,959,1446
KHUZDAR DISTRICT,KHUZDAR TEHSIL,48,632,1037,1669
KHUZDAR DISTRICT,KHUZDAR TEHSIL,49,582,1061,1643
KHUZDAR DISTRICT,KHUZDAR TEHSIL,50,980,1306,2286
KHUZDAR DISTRICT,KHUZDAR TEHSIL,51,488,838,1326
KHUZDAR DISTRICT,KHUZDAR TEHSIL,52,358,618,976
KHUZDAR DISTRICT,KHUZDAR TEHSIL,53,453,663,1116
KHUZDAR DISTRICT,KHUZDAR TEHSIL,54,397,672,1069
KHUZDAR DISTRICT,KHUZDAR TEHSIL,55,534,848,1382
KHUZDAR DISTRICT,KHUZDAR TEHSIL,56,280,511,791
KHUZDAR DISTRICT,KHUZDAR TEHSIL,57,290,562,852
KHUZDAR DISTRICT,KHUZDAR TEHSIL,58,327,485,812
KHUZDAR DISTRICT,KHUZDAR TEHSIL,59,309,451,760
KHUZDAR DISTRICT,KHUZDAR TEHSIL,60,647,759,1406
KHUZDAR DISTRICT,KHUZDAR TEHSIL,61,349,505,854
KHUZDAR DISTRICT,KHUZDAR TEHSIL,62,272,387,659
KHUZDAR DISTRICT,KHUZDAR TEHSIL,63,336,477,813
KHUZDAR DISTRICT,KHUZDAR TEHSIL,64,311,437,748
KHUZDAR DISTRICT,KHUZDAR TEHSIL,65,357,429,786
KHUZDAR DISTRICT,KHUZDAR TEHSIL,66,200,299,499
KHUZDAR DISTRICT,KHUZDAR TEHSIL,67,240,345,585
KHUZDAR DISTRICT,KHUZDAR TEHSIL,68,184,281,465
KHUZDAR DISTRICT,KHUZDAR TEHSIL,69,241,285,526
KHUZDAR DISTRICT,KHUZDAR TEHSIL,70,294,369,663
KHUZDAR DISTRICT,KHUZDAR TEHSIL,71,191,233,424
KHUZDAR DISTRICT,KHUZDAR TEHSIL,72,165,245,410
KHUZDAR DISTRICT,KHUZDAR TEHSIL,73,193,193,386
KHUZDAR DISTRICT,KHUZDAR TEHSIL,74,155,202,357
KHUZDAR DISTRICT,KHUZDAR TEHSIL,>=75,1282,1523,2805
KHUZDAR DISTRICT,MOOLA SUB-TEHSIL,<1,1012,0,1012
KHUZDAR DISTRICT,MOOLA SUB-TEHSIL,1,1015,0,1015
KHUZDAR DISTRICT,MOOLA SUB-TEHSIL,2,1182,0,1182
KHUZDAR DISTRICT,MOOLA SUB-TEHSIL,3,1039,0,1039
KHUZDAR DISTRICT,MOOLA SUB-TEHSIL,4,1063,0,1063
KHUZDAR DISTRICT,MOOLA SUB-TEHSIL,5,906,0,906
KHUZDAR DISTRICT,MOOLA SUB-TEHSIL,6,1037,0,1037
KHUZDAR DISTRICT,MOOLA SUB-TEHSIL,7,903,0,903
KHUZDAR DISTRICT,MOOLA SUB-TEHSIL,8,963,0,963
KHUZDAR DISTRICT,MOOLA SUB-TEHSIL,9,790,0,790
KHUZDAR DISTRICT,MOOLA SUB-TEHSIL,10,843,0,843
KHUZDAR DISTRICT,MOOLA SUB-TEHSIL,11,557,0,557
KHUZDAR DISTRICT,MOOLA SUB-TEHSIL,12,596,0,596
KHUZDAR DISTRICT,MOOLA SUB-TEHSIL,13,451,0,451
KHUZDAR DISTRICT,MOOLA SUB-TEHSIL,14,485,0,485
KHUZDAR DISTRICT,MOOLA SUB-TEHSIL,15,387,0,387
KHUZDAR DISTRICT,MOOLA SUB-TEHSIL,16,395,0,395
KHUZDAR DISTRICT,MOOLA SUB-TEHSIL,17,367,0,367
KHUZDAR DISTRICT,MOOLA SUB-TEHSIL,18,445,0,445
KHUZDAR DISTRICT,MOOLA SUB-TEHSIL,19,294,0,294
KHUZDAR DISTRICT,MOOLA SUB-TEHSIL,20,494,0,494
KHUZDAR DISTRICT,MOOLA SUB-TEHSIL,21,291,0,291
KHUZDAR DISTRICT,MOOLA SUB-TEHSIL,22,263,0,263
KHUZDAR DISTRICT,MOOLA SUB-TEHSIL,23,193,0,193
KHUZDAR DISTRICT,MOOLA SUB-TEHSIL,24,213,0,213
KHUZDAR DISTRICT,MOOLA SUB-TEHSIL,25,458,0,458
KHUZDAR DISTRICT,MOOLA SUB-TEHSIL,26,224,0,224
KHUZDAR DISTRICT,MOOLA SUB-TEHSIL,27,272,0,272
KHUZDAR DISTRICT,MOOLA SUB-TEHSIL,28,222,0,222
KHUZDAR DISTRICT,MOOLA SUB-TEHSIL,29,281,0,281
KHUZDAR DISTRICT,MOOLA SUB-TEHSIL,30,409,0,409
KHUZDAR DISTRICT,MOOLA SUB-TEHSIL,31,239,0,239
KHUZDAR DISTRICT,MOOLA SUB-TEHSIL,32,232,0,232
KHUZDAR DISTRICT,MOOLA SUB-TEHSIL,33,197,0,197
KHUZDAR DISTRICT,MOOLA SUB-TEHSIL,34,182,0,182
KHUZDAR DISTRICT,MOOLA SUB-TEHSIL,35,304,0,304
KHUZDAR DISTRICT,MOOLA SUB-TEHSIL,36,133,0,133
KHUZDAR DISTRICT,MOOLA SUB-TEHSIL,37,238,0,238
KHUZDAR DISTRICT,MOOLA SUB-TEHSIL,38,178,0,178
KHUZDAR DISTRICT,MOOLA SUB-TEHSIL,39,185,0,185
KHUZDAR DISTRICT,MOOLA SUB-TEHSIL,40,272,0,272
KHUZDAR DISTRICT,MOOLA SUB-TEHSIL,41,143,0,143
KHUZDAR DISTRICT,MOOLA SUB-TEHSIL,42,170,0,170
KHUZDAR DISTRICT,MOOLA SUB-TEHSIL,43,142,0,142
KHUZDAR DISTRICT,MOOLA SUB-TEHSIL,44,141,0,141
KHUZDAR DISTRICT,MOOLA SUB-TEHSIL,45,159,0,159
KHUZDAR DISTRICT,MOOLA SUB-TEHSIL,46,93,0,93
KHUZDAR DISTRICT,MOOLA SUB-TEHSIL,47,115,0,115
KHUZDAR DISTRICT,MOOLA SUB-TEHSIL,48,110,0,110
KHUZDAR DISTRICT,MOOLA SUB-TEHSIL,49,128,0,128
KHUZDAR DISTRICT,MOOLA SUB-TEHSIL,50,181,0,181
KHUZDAR DISTRICT,MOOLA SUB-TEHSIL,51,86,0,86
KHUZDAR DISTRICT,MOOLA SUB-TEHSIL,52,94,0,94
KHUZDAR DISTRICT,MOOLA SUB-TEHSIL,53,118,0,118
KHUZDAR DISTRICT,MOOLA SUB-TEHSIL,54,88,0,88
KHUZDAR DISTRICT,MOOLA SUB-TEHSIL,55,106,0,106
KHUZDAR DISTRICT,MOOLA SUB-TEHSIL,56,66,0,66
KHUZDAR DISTRICT,MOOLA SUB-TEHSIL,57,80,0,80
KHUZDAR DISTRICT,MOOLA SUB-TEHSIL,58,68,0,68
KHUZDAR DISTRICT,MOOLA SUB-TEHSIL,59,84,0,84
KHUZDAR DISTRICT,MOOLA SUB-TEHSIL,60,127,0,127
KHUZDAR DISTRICT,MOOLA SUB-TEHSIL,61,68,0,68
KHUZDAR DISTRICT,MOOLA SUB-TEHSIL,62,61,0,61
KHUZDAR DISTRICT,MOOLA SUB-TEHSIL,63,60,0,60
KHUZDAR DISTRICT,MOOLA SUB-TEHSIL,64,62,0,62
KHUZDAR DISTRICT,MOOLA SUB-TEHSIL,65,52,0,52
KHUZDAR DISTRICT,MOOLA SUB-TEHSIL,66,43,0,43
KHUZDAR DISTRICT,MOOLA SUB-TEHSIL,67,47,0,47
KHUZDAR DISTRICT,MOOLA SUB-TEHSIL,68,26,0,26
KHUZDAR DISTRICT,MOOLA SUB-TEHSIL,69,41,0,41
KHUZDAR DISTRICT,MOOLA SUB-TEHSIL,70,75,0,75
KHUZDAR DISTRICT,MOOLA SUB-TEHSIL,71,48,0,48
KHUZDAR DISTRICT,MOOLA SUB-TEHSIL,72,26,0,26
KHUZDAR DISTRICT,MOOLA SUB-TEHSIL,73,36,0,36
KHUZDAR DISTRICT,MOOLA SUB-TEHSIL,74,25,0,25
KHUZDAR DISTRICT,MOOLA SUB-TEHSIL,>=75,207,0,207
KHUZDAR DISTRICT,NAL SUB-TEHSIL,<1,4660,1632,6292
KHUZDAR DISTRICT,NAL SUB-TEHSIL,1,3742,896,4638
KHUZDAR DISTRICT,NAL SUB-TEHSIL,2,4765,1571,6336
KHUZDAR DISTRICT,NAL SUB-TEHSIL,3,3629,1182,4811
KHUZDAR DISTRICT,NAL SUB-TEHSIL,4,4396,1564,5960
KHUZDAR DISTRICT,NAL SUB-TEHSIL,5,3601,1130,4731
KHUZDAR DISTRICT,NAL SUB-TEHSIL,6,4330,1507,5837
KHUZDAR DISTRICT,NAL SUB-TEHSIL,7,3251,1141,4392
KHUZDAR DISTRICT,NAL SUB-TEHSIL,8,4390,1536,5926
KHUZDAR DISTRICT,NAL SUB-TEHSIL,9,3322,1108,4430
KHUZDAR DISTRICT,NAL SUB-TEHSIL,10,4016,1499,5515
KHUZDAR DISTRICT,NAL SUB-TEHSIL,11,2617,950,3567
KHUZDAR DISTRICT,NAL SUB-TEHSIL,12,2941,1090,4031
KHUZDAR DISTRICT,NAL SUB-TEHSIL,13,2026,809,2835
KHUZDAR DISTRICT,NAL SUB-TEHSIL,14,2482,975,3457
KHUZDAR DISTRICT,NAL SUB-TEHSIL,15,1929,715,2644
KHUZDAR DISTRICT,NAL SUB-TEHSIL,16,2030,742,2772
KHUZDAR DISTRICT,NAL SUB-TEHSIL,17,1414,637,2051
KHUZDAR DISTRICT,NAL SUB-TEHSIL,18,1994,699,2693
KHUZDAR DISTRICT,NAL SUB-TEHSIL,19,1253,488,1741
KHUZDAR DISTRICT,NAL SUB-TEHSIL,20,2089,576,2665
KHUZDAR DISTRICT,NAL SUB-TEHSIL,21,1224,489,1713
KHUZDAR DISTRICT,NAL SUB-TEHSIL,22,1173,366,1539
KHUZDAR DISTRICT,NAL SUB-TEHSIL,23,943,363,1306
KHUZDAR DISTRICT,NAL SUB-TEHSIL,24,895,365,1260
KHUZDAR DISTRICT,NAL SUB-TEHSIL,25,1562,477,2039
KHUZDAR DISTRICT,NAL SUB-TEHSIL,26,923,323,1246
KHUZDAR DISTRICT,NAL SUB-TEHSIL,27,1148,403,1551
KHUZDAR DISTRICT,NAL SUB-TEHSIL,28,1277,435,1712
KHUZDAR DISTRICT,NAL SUB-TEHSIL,29,1041,394,1435
KHUZDAR DISTRICT,NAL SUB-TEHSIL,30,1546,448,1994
KHUZDAR DISTRICT,NAL SUB-TEHSIL,31,1096,366,1462
KHUZDAR DISTRICT,NAL SUB-TEHSIL,32,974,319,1293
KHUZDAR DISTRICT,NAL SUB-TEHSIL,33,929,347,1276
KHUZDAR DISTRICT,NAL SUB-TEHSIL,34,720,242,962
KHUZDAR DISTRICT,NAL SUB-TEHSIL,35,1079,343,1422
KHUZDAR DISTRICT,NAL SUB-TEHSIL,36,690,236,926
KHUZDAR DISTRICT,NAL SUB-TEHSIL,37,974,303,1277
KHUZDAR DISTRICT,NAL SUB-TEHSIL,38,922,292,1214
KHUZDAR DISTRICT,NAL SUB-TEHSIL,39,718,264,982
KHUZDAR DISTRICT,NAL SUB-TEHSIL,40,1190,298,1488
KHUZDAR DISTRICT,NAL SUB-TEHSIL,41,599,186,785
KHUZDAR DISTRICT,NAL SUB-TEHSIL,42,485,191,676
KHUZDAR DISTRICT,NAL SUB-TEHSIL,43,567,179,746
KHUZDAR DISTRICT,NAL SUB-TEHSIL,44,436,134,570
KHUZDAR DISTRICT,NAL SUB-TEHSIL,45,621,204,825
KHUZDAR DISTRICT,NAL SUB-TEHSIL,46,347,138,485
KHUZDAR DISTRICT,NAL SUB-TEHSIL,47,425,158,583
KHUZDAR DISTRICT,NAL SUB-TEHSIL,48,421,160,581
KHUZDAR DISTRICT,NAL SUB-TEHSIL,49,405,151,556
KHUZDAR DISTRICT,NAL SUB-TEHSIL,50,646,198,844
KHUZDAR DISTRICT,NAL SUB-TEHSIL,51,320,143,463
KHUZDAR DISTRICT,NAL SUB-TEHSIL,52,322,118,440
KHUZDAR DISTRICT,NAL SUB-TEHSIL,53,291,116,407
KHUZDAR DISTRICT,NAL SUB-TEHSIL,54,331,119,450
KHUZDAR DISTRICT,NAL SUB-TEHSIL,55,359,108,467
KHUZDAR DISTRICT,NAL SUB-TEHSIL,56,217,78,295
KHUZDAR DISTRICT,NAL SUB-TEHSIL,57,272,105,377
KHUZDAR DISTRICT,NAL SUB-TEHSIL,58,269,70,339
KHUZDAR DISTRICT,NAL SUB-TEHSIL,59,301,86,387
KHUZDAR DISTRICT,NAL SUB-TEHSIL,60,405,105,510
KHUZDAR DISTRICT,NAL SUB-TEHSIL,61,257,90,347
KHUZDAR DISTRICT,NAL SUB-TEHSIL,62,252,75,327
KHUZDAR DISTRICT,NAL SUB-TEHSIL,63,240,69,309
KHUZDAR DISTRICT,NAL SUB-TEHSIL,64,277,67,344
KHUZDAR DISTRICT,NAL SUB-TEHSIL,65,223,67,290
KHUZDAR DISTRICT,NAL SUB-TEHSIL,66,190,68,258
KHUZDAR DISTRICT,NAL SUB-TEHSIL,67,209,74,283
KHUZDAR DISTRICT,NAL SUB-TEHSIL,68,139,51,190
KHUZDAR DISTRICT,NAL SUB-TEHSIL,69,173,50,223
KHUZDAR DISTRICT,NAL SUB-TEHSIL,70,207,35,242
KHUZDAR DISTRICT,NAL SUB-TEHSIL,71,152,51,203
KHUZDAR DISTRICT,NAL SUB-TEHSIL,72,151,49,200
KHUZDAR DISTRICT,NAL SUB-TEHSIL,73,132,29,161
KHUZDAR DISTRICT,NAL SUB-TEHSIL,74,132,33,165
KHUZDAR DISTRICT,NAL SUB-TEHSIL,>=75,902,246,1148
KHUZDAR DISTRICT,ORNACH SUB-TEHSIl,<1,1187,0,1187
KHUZDAR DISTRICT,ORNACH SUB-TEHSIl,1,1194,0,1194
KHUZDAR DISTRICT,ORNACH SUB-TEHSIl,2,1445,0,1445
KHUZDAR DISTRICT,ORNACH SUB-TEHSIl,3,1265,0,1265
KHUZDAR DISTRICT,ORNACH SUB-TEHSIl,4,1406,0,1406
KHUZDAR DISTRICT,ORNACH SUB-TEHSIl,5,1368,0,1368
KHUZDAR DISTRICT,ORNACH SUB-TEHSIl,6,1446,0,1446
KHUZDAR DISTRICT,ORNACH SUB-TEHSIl,7,1305,0,1305
KHUZDAR DISTRICT,ORNACH SUB-TEHSIl,8,1430,0,1430
KHUZDAR DISTRICT,ORNACH SUB-TEHSIl,9,1237,0,1237
KHUZDAR DISTRICT,ORNACH SUB-TEHSIl,10,1521,0,1521
KHUZDAR DISTRICT,ORNACH SUB-TEHSIl,11,1023,0,1023
KHUZDAR DISTRICT,ORNACH SUB-TEHSIl,12,928,0,928
KHUZDAR DISTRICT,ORNACH SUB-TEHSIl,13,803,0,803
KHUZDAR DISTRICT,ORNACH SUB-TEHSIl,14,787,0,787
KHUZDAR DISTRICT,ORNACH SUB-TEHSIl,15,826,0,826
KHUZDAR DISTRICT,ORNACH SUB-TEHSIl,16,573,0,573
KHUZDAR DISTRICT,ORNACH SUB-TEHSIl,17,566,0,566
KHUZDAR DISTRICT,ORNACH SUB-TEHSIl,18,775,0,775
KHUZDAR DISTRICT,ORNACH SUB-TEHSIl,19,679,0,679
KHUZDAR DISTRICT,ORNACH SUB-TEHSIl,20,1011,0,1011
KHUZDAR DISTRICT,ORNACH SUB-TEHSIl,21,719,0,719
KHUZDAR DISTRICT,ORNACH SUB-TEHSIl,22,498,0,498
KHUZDAR DISTRICT,ORNACH SUB-TEHSIl,23,521,0,521
KHUZDAR DISTRICT,ORNACH SUB-TEHSIl,24,396,0,396
KHUZDAR DISTRICT,ORNACH SUB-TEHSIl,25,844,0,844
KHUZDAR DISTRICT,ORNACH SUB-TEHSIl,26,431,0,431
KHUZDAR DISTRICT,ORNACH SUB-TEHSIl,27,502,0,502
KHUZDAR DISTRICT,ORNACH SUB-TEHSIl,28,528,0,528
KHUZDAR DISTRICT,ORNACH SUB-TEHSIl,29,529,0,529
KHUZDAR DISTRICT,ORNACH SUB-TEHSIl,30,780,0,780
KHUZDAR DISTRICT,ORNACH SUB-TEHSIl,31,487,0,487
KHUZDAR DISTRICT,ORNACH SUB-TEHSIl,32,364,0,364
KHUZDAR DISTRICT,ORNACH SUB-TEHSIl,33,391,0,391
KHUZDAR DISTRICT,ORNACH SUB-TEHSIl,34,275,0,275
KHUZDAR DISTRICT,ORNACH SUB-TEHSIl,35,411,0,411
KHUZDAR DISTRICT,ORNACH SUB-TEHSIl,36,204,0,204
KHUZDAR DISTRICT,ORNACH SUB-TEHSIl,37,315,0,315
KHUZDAR DISTRICT,ORNACH SUB-TEHSIl,38,344,0,344
KHUZDAR DISTRICT,ORNACH SUB-TEHSIl,39,329,0,329
KHUZDAR DISTRICT,ORNACH SUB-TEHSIl,40,487,0,487
KHUZDAR DISTRICT,ORNACH SUB-TEHSIl,41,261,0,261
KHUZDAR DISTRICT,ORNACH SUB-TEHSIl,42,220,0,220
KHUZDAR DISTRICT,ORNACH SUB-TEHSIl,43,251,0,251
KHUZDAR DISTRICT,ORNACH SUB-TEHSIl,44,213,0,213
KHUZDAR DISTRICT,ORNACH SUB-TEHSIl,45,343,0,343
KHUZDAR DISTRICT,ORNACH SUB-TEHSIl,46,214,0,214
KHUZDAR DISTRICT,ORNACH SUB-TEHSIl,47,219,0,219
KHUZDAR DISTRICT,ORNACH SUB-TEHSIl,48,282,0,282
KHUZDAR DISTRICT,ORNACH SUB-TEHSIl,49,242,0,242
KHUZDAR DISTRICT,ORNACH SUB-TEHSIl,50,328,0,328
KHUZDAR DISTRICT,ORNACH SUB-TEHSIl,51,183,0,183
KHUZDAR DISTRICT,ORNACH SUB-TEHSIl,52,185,0,185
KHUZDAR DISTRICT,ORNACH SUB-TEHSIl,53,128,0,128
KHUZDAR DISTRICT,ORNACH SUB-TEHSIl,54,192,0,192
KHUZDAR DISTRICT,ORNACH SUB-TEHSIl,55,155,0,155
KHUZDAR DISTRICT,ORNACH SUB-TEHSIl,56,106,0,106
KHUZDAR DISTRICT,ORNACH SUB-TEHSIl,57,137,0,137
KHUZDAR DISTRICT,ORNACH SUB-TEHSIl,58,91,0,91
KHUZDAR DISTRICT,ORNACH SUB-TEHSIl,59,132,0,132
KHUZDAR DISTRICT,ORNACH SUB-TEHSIl,60,159,0,159
KHUZDAR DISTRICT,ORNACH SUB-TEHSIl,61,112,0,112
KHUZDAR DISTRICT,ORNACH SUB-TEHSIl,62,79,0,79
KHUZDAR DISTRICT,ORNACH SUB-TEHSIl,63,110,0,110
KHUZDAR DISTRICT,ORNACH SUB-TEHSIl,64,138,0,138
KHUZDAR DISTRICT,ORNACH SUB-TEHSIl,65,111,0,111
KHUZDAR DISTRICT,ORNACH SUB-TEHSIl,66,69,0,69
KHUZDAR DISTRICT,ORNACH SUB-TEHSIl,67,71,0,71
KHUZDAR DISTRICT,ORNACH SUB-TEHSIl,68,64,0,64
KHUZDAR DISTRICT,ORNACH SUB-TEHSIl,69,74,0,74
KHUZDAR DISTRICT,ORNACH SUB-TEHSIl,70,102,0,102
KHUZDAR DISTRICT,ORNACH SUB-TEHSIl,71,68,0,68
KHUZDAR DISTRICT,ORNACH SUB-TEHSIl,72,41,0,41
KHUZDAR DISTRICT,ORNACH SUB-TEHSIl,73,38,0,38
KHUZDAR DISTRICT,ORNACH SUB-TEHSIl,74,59,0,59
KHUZDAR DISTRICT,ORNACH SUB-TEHSIl,>=75,281,0,281
KHUZDAR DISTRICT,SAROONA SUB-TEHSIL,<1,800,0,800
KHUZDAR DISTRICT,SAROONA SUB-TEHSIL,1,925,0,925
KHUZDAR DISTRICT,SAROONA SUB-TEHSIL,2,1126,0,1126
KHUZDAR DISTRICT,SAROONA SUB-TEHSIL,3,1090,0,1090
KHUZDAR DISTRICT,SAROONA SUB-TEHSIL,4,1189,0,1189
KHUZDAR DISTRICT,SAROONA SUB-TEHSIL,5,982,0,982
KHUZDAR DISTRICT,SAROONA SUB-TEHSIL,6,1321,0,1321
KHUZDAR DISTRICT,SAROONA SUB-TEHSIL,7,809,0,809
KHUZDAR DISTRICT,SAROONA SUB-TEHSIL,8,1317,0,1317
KHUZDAR DISTRICT,SAROONA SUB-TEHSIL,9,786,0,786
KHUZDAR DISTRICT,SAROONA SUB-TEHSIL,10,1192,0,1192
KHUZDAR DISTRICT,SAROONA SUB-TEHSIL,11,601,0,601
KHUZDAR DISTRICT,SAROONA SUB-TEHSIL,12,863,0,863
KHUZDAR DISTRICT,SAROONA SUB-TEHSIL,13,406,0,406
KHUZDAR DISTRICT,SAROONA SUB-TEHSIL,14,568,0,568
KHUZDAR DISTRICT,SAROONA SUB-TEHSIL,15,607,0,607
KHUZDAR DISTRICT,SAROONA SUB-TEHSIL,16,514,0,514
KHUZDAR DISTRICT,SAROONA SUB-TEHSIL,17,261,0,261
KHUZDAR DISTRICT,SAROONA SUB-TEHSIL,18,746,0,746
KHUZDAR DISTRICT,SAROONA SUB-TEHSIL,19,347,0,347
KHUZDAR DISTRICT,SAROONA SUB-TEHSIL,20,857,0,857
KHUZDAR DISTRICT,SAROONA SUB-TEHSIL,21,436,0,436
KHUZDAR DISTRICT,SAROONA SUB-TEHSIL,22,510,0,510
KHUZDAR DISTRICT,SAROONA SUB-TEHSIL,23,464,0,464
KHUZDAR DISTRICT,SAROONA SUB-TEHSIL,24,300,0,300
KHUZDAR DISTRICT,SAROONA SUB-TEHSIL,25,804,0,804
KHUZDAR DISTRICT,SAROONA SUB-TEHSIL,26,387,0,387
KHUZDAR DISTRICT,SAROONA SUB-TEHSIL,27,389,0,389
KHUZDAR DISTRICT,SAROONA SUB-TEHSIL,28,495,0,495
KHUZDAR DISTRICT,SAROONA SUB-TEHSIL,29,457,0,457
KHUZDAR DISTRICT,SAROONA SUB-TEHSIL,30,732,0,732
KHUZDAR DISTRICT,SAROONA SUB-TEHSIL,31,440,0,440
KHUZDAR DISTRICT,SAROONA SUB-TEHSIL,32,360,0,360
KHUZDAR DISTRICT,SAROONA SUB-TEHSIL,33,377,0,377
KHUZDAR DISTRICT,SAROONA SUB-TEHSIL,34,301,0,301
KHUZDAR DISTRICT,SAROONA SUB-TEHSIL,35,566,0,566
KHUZDAR DISTRICT,SAROONA SUB-TEHSIL,36,283,0,283
KHUZDAR DISTRICT,SAROONA SUB-TEHSIL,37,333,0,333
KHUZDAR DISTRICT,SAROONA SUB-TEHSIL,38,369,0,369
KHUZDAR DISTRICT,SAROONA SUB-TEHSIL,39,319,0,319
KHUZDAR DISTRICT,SAROONA SUB-TEHSIL,40,529,0,529
KHUZDAR DISTRICT,SAROONA SUB-TEHSIL,41,276,0,276
KHUZDAR DISTRICT,SAROONA SUB-TEHSIL,42,237,0,237
KHUZDAR DISTRICT,SAROONA SUB-TEHSIL,43,289,0,289
KHUZDAR DISTRICT,SAROONA SUB-TEHSIL,44,234,0,234
KHUZDAR DISTRICT,SAROONA SUB-TEHSIL,45,374,0,374
KHUZDAR DISTRICT,SAROONA SUB-TEHSIL,46,226,0,226
KHUZDAR DISTRICT,SAROONA SUB-TEHSIL,47,287,0,287
KHUZDAR DISTRICT,SAROONA SUB-TEHSIL,48,287,0,287
KHUZDAR DISTRICT,SAROONA SUB-TEHSIL,49,245,0,245
KHUZDAR DISTRICT,SAROONA SUB-TEHSIL,50,335,0,335
KHUZDAR DISTRICT,SAROONA SUB-TEHSIL,51,171,0,171
KHUZDAR DISTRICT,SAROONA SUB-TEHSIL,52,162,0,162
KHUZDAR DISTRICT,SAROONA SUB-TEHSIL,53,202,0,202
KHUZDAR DISTRICT,SAROONA SUB-TEHSIL,54,166,0,166
KHUZDAR DISTRICT,SAROONA SUB-TEHSIL,55,197,0,197
KHUZDAR DISTRICT,SAROONA SUB-TEHSIL,56,123,0,123
KHUZDAR DISTRICT,SAROONA SUB-TEHSIL,57,182,0,182
KHUZDAR DISTRICT,SAROONA SUB-TEHSIL,58,113,0,113
KHUZDAR DISTRICT,SAROONA SUB-TEHSIL,59,132,0,132
KHUZDAR DISTRICT,SAROONA SUB-TEHSIL,60,177,0,177
KHUZDAR DISTRICT,SAROONA SUB-TEHSIL,61,121,0,121
KHUZDAR DISTRICT,SAROONA SUB-TEHSIL,62,67,0,67
KHUZDAR DISTRICT,SAROONA SUB-TEHSIL,63,124,0,124
KHUZDAR DISTRICT,SAROONA SUB-TEHSIL,64,132,0,132
KHUZDAR DISTRICT,SAROONA SUB-TEHSIL,65,96,0,96
KHUZDAR DISTRICT,SAROONA SUB-TEHSIL,66,77,0,77
KHUZDAR DISTRICT,SAROONA SUB-TEHSIL,67,67,0,67
KHUZDAR DISTRICT,SAROONA SUB-TEHSIL,68,77,0,77
KHUZDAR DISTRICT,SAROONA SUB-TEHSIL,69,80,0,80
KHUZDAR DISTRICT,SAROONA SUB-TEHSIL,70,96,0,96
KHUZDAR DISTRICT,SAROONA SUB-TEHSIL,71,47,0,47
KHUZDAR DISTRICT,SAROONA SUB-TEHSIL,72,36,0,36
KHUZDAR DISTRICT,SAROONA SUB-TEHSIL,73,45,0,45
KHUZDAR DISTRICT,SAROONA SUB-TEHSIL,74,52,0,52
KHUZDAR DISTRICT,SAROONA SUB-TEHSIL,>=75,435,0,435
KHUZDAR DISTRICT,WADH TEHSIL,<1,2938,781,3719
KHUZDAR DISTRICT,WADH TEHSIL,1,2789,943,3732
KHUZDAR DISTRICT,WADH TEHSIL,2,3657,1040,4697
KHUZDAR DISTRICT,WADH TEHSIL,3,2954,890,3844
KHUZDAR DISTRICT,WADH TEHSIL,4,3644,1016,4660
KHUZDAR DISTRICT,WADH TEHSIL,5,2802,840,3642
KHUZDAR DISTRICT,WADH TEHSIL,6,3577,959,4536
KHUZDAR DISTRICT,WADH TEHSIL,7,2504,691,3195
KHUZDAR DISTRICT,WADH TEHSIL,8,3577,947,4524
KHUZDAR DISTRICT,WADH TEHSIL,9,2395,735,3130
KHUZDAR DISTRICT,WADH TEHSIL,10,3137,818,3955
KHUZDAR DISTRICT,WADH TEHSIL,11,1879,557,2436
KHUZDAR DISTRICT,WADH TEHSIL,12,2272,667,2939
KHUZDAR DISTRICT,WADH TEHSIL,13,1463,458,1921
KHUZDAR DISTRICT,WADH TEHSIL,14,1884,618,2502
KHUZDAR DISTRICT,WADH TEHSIL,15,1375,448,1823
KHUZDAR DISTRICT,WADH TEHSIL,16,1369,463,1832
KHUZDAR DISTRICT,WADH TEHSIL,17,887,347,1234
KHUZDAR DISTRICT,WADH TEHSIL,18,1694,451,2145
KHUZDAR DISTRICT,WADH TEHSIL,19,1050,305,1355
KHUZDAR DISTRICT,WADH TEHSIL,20,1517,364,1881
KHUZDAR DISTRICT,WADH TEHSIL,21,969,277,1246
KHUZDAR DISTRICT,WADH TEHSIL,22,857,261,1118
KHUZDAR DISTRICT,WADH TEHSIL,23,801,271,1072
KHUZDAR DISTRICT,WADH TEHSIL,24,722,314,1036
KHUZDAR DISTRICT,WADH TEHSIL,25,1283,340,1623
KHUZDAR DISTRICT,WADH TEHSIL,26,961,288,1249
KHUZDAR DISTRICT,WADH TEHSIL,27,1083,270,1353
KHUZDAR DISTRICT,WADH TEHSIL,28,1018,329,1347
KHUZDAR DISTRICT,WADH TEHSIL,29,1018,292,1310
KHUZDAR DISTRICT,WADH TEHSIL,30,1173,319,1492
KHUZDAR DISTRICT,WADH TEHSIL,31,942,287,1229
KHUZDAR DISTRICT,WADH TEHSIL,32,769,211,980
KHUZDAR DISTRICT,WADH TEHSIL,33,841,251,1092
KHUZDAR DISTRICT,WADH TEHSIL,34,627,195,822
KHUZDAR DISTRICT,WADH TEHSIL,35,913,244,1157
KHUZDAR DISTRICT,WADH TEHSIL,36,533,195,728
KHUZDAR DISTRICT,WADH TEHSIL,37,840,170,1010
KHUZDAR DISTRICT,WADH TEHSIL,38,635,171,806
KHUZDAR DISTRICT,WADH TEHSIL,39,733,157,890
KHUZDAR DISTRICT,WADH TEHSIL,40,749,186,935
KHUZDAR DISTRICT,WADH TEHSIL,41,510,134,644
KHUZDAR DISTRICT,WADH TEHSIL,42,378,118,496
KHUZDAR DISTRICT,WADH TEHSIL,43,445,136,581
KHUZDAR DISTRICT,WADH TEHSIL,44,426,119,545
KHUZDAR DISTRICT,WADH TEHSIL,45,563,137,700
KHUZDAR DISTRICT,WADH TEHSIL,46,459,134,593
KHUZDAR DISTRICT,WADH TEHSIL,47,495,111,606
KHUZDAR DISTRICT,WADH TEHSIL,48,411,95,506
KHUZDAR DISTRICT,WADH TEHSIL,49,516,141,657
KHUZDAR DISTRICT,WADH TEHSIL,50,453,118,571
KHUZDAR DISTRICT,WADH TEHSIL,51,397,99,496
KHUZDAR DISTRICT,WADH TEHSIL,52,323,93,416
KHUZDAR DISTRICT,WADH TEHSIL,53,313,88,401
KHUZDAR DISTRICT,WADH TEHSIL,54,315,95,410
KHUZDAR DISTRICT,WADH TEHSIL,55,257,78,335
KHUZDAR DISTRICT,WADH TEHSIL,56,213,64,277
KHUZDAR DISTRICT,WADH TEHSIL,57,310,55,365
KHUZDAR DISTRICT,WADH TEHSIL,58,252,74,326
KHUZDAR DISTRICT,WADH TEHSIL,59,281,81,362
KHUZDAR DISTRICT,WADH TEHSIL,60,308,74,382
KHUZDAR DISTRICT,WADH TEHSIL,61,235,80,315
KHUZDAR DISTRICT,WADH TEHSIL,62,182,57,239
KHUZDAR DISTRICT,WADH TEHSIL,63,217,59,276
KHUZDAR DISTRICT,WADH TEHSIL,64,291,73,364
KHUZDAR DISTRICT,WADH TEHSIL,65,193,47,240
KHUZDAR DISTRICT,WADH TEHSIL,66,168,52,220
KHUZDAR DISTRICT,WADH TEHSIL,67,173,41,214
KHUZDAR DISTRICT,WADH TEHSIL,68,170,40,210
KHUZDAR DISTRICT,WADH TEHSIL,69,243,41,284
KHUZDAR DISTRICT,WADH TEHSIL,70,175,34,209
KHUZDAR DISTRICT,WADH TEHSIL,71,131,33,164
KHUZDAR DISTRICT,WADH TEHSIL,72,115,20,135
KHUZDAR DISTRICT,WADH TEHSIL,73,105,19,124
KHUZDAR DISTRICT,WADH TEHSIL,74,175,29,204
KHUZDAR DISTRICT,WADH TEHSIL,>=75,877,174,1051
KHUZDAR DISTRICT,ZEHRI TEHSIL,<1,2823,1652,4475
KHUZDAR DISTRICT,ZEHRI TEHSIL,1,2502,1162,3664
KHUZDAR DISTRICT,ZEHRI TEHSIL,2,3416,1903,5319
KHUZDAR DISTRICT,ZEHRI TEHSIL,3,2728,1258,3986
KHUZDAR DISTRICT,ZEHRI TEHSIL,4,3277,1838,5115
KHUZDAR DISTRICT,ZEHRI TEHSIL,5,2597,1183,3780
KHUZDAR DISTRICT,ZEHRI TEHSIL,6,2906,1890,4796
KHUZDAR DISTRICT,ZEHRI TEHSIL,7,2671,1211,3882
KHUZDAR DISTRICT,ZEHRI TEHSIL,8,2501,1662,4163
KHUZDAR DISTRICT,ZEHRI TEHSIL,9,2569,1294,3863
KHUZDAR DISTRICT,ZEHRI TEHSIL,10,2218,1845,4063
KHUZDAR DISTRICT,ZEHRI TEHSIL,11,1846,1143,2989
KHUZDAR DISTRICT,ZEHRI TEHSIL,12,1781,1297,3078
KHUZDAR DISTRICT,ZEHRI TEHSIL,13,1397,927,2324
KHUZDAR DISTRICT,ZEHRI TEHSIL,14,1680,1234,2914
KHUZDAR DISTRICT,ZEHRI TEHSIL,15,1179,920,2099
KHUZDAR DISTRICT,ZEHRI TEHSIL,16,1147,960,2107
KHUZDAR DISTRICT,ZEHRI TEHSIL,17,964,681,1645
KHUZDAR DISTRICT,ZEHRI TEHSIL,18,1206,822,2028
KHUZDAR DISTRICT,ZEHRI TEHSIL,19,1078,622,1700
KHUZDAR DISTRICT,ZEHRI TEHSIL,20,1046,605,1651
KHUZDAR DISTRICT,ZEHRI TEHSIL,21,853,477,1330
KHUZDAR DISTRICT,ZEHRI TEHSIL,22,642,448,1090
KHUZDAR DISTRICT,ZEHRI TEHSIL,23,605,345,950
KHUZDAR DISTRICT,ZEHRI TEHSIL,24,603,337,940
KHUZDAR DISTRICT,ZEHRI TEHSIL,25,811,511,1322
KHUZDAR DISTRICT,ZEHRI TEHSIL,26,550,337,887
KHUZDAR DISTRICT,ZEHRI TEHSIL,27,649,367,1016
KHUZDAR DISTRICT,ZEHRI TEHSIL,28,712,416,1128
KHUZDAR DISTRICT,ZEHRI TEHSIL,29,744,473,1217
KHUZDAR DISTRICT,ZEHRI TEHSIL,30,905,542,1447
KHUZDAR DISTRICT,ZEHRI TEHSIL,31,731,458,1189
KHUZDAR DISTRICT,ZEHRI TEHSIL,32,536,289,825
KHUZDAR DISTRICT,ZEHRI TEHSIL,33,611,395,1006
KHUZDAR DISTRICT,ZEHRI TEHSIL,34,458,236,694
KHUZDAR DISTRICT,ZEHRI TEHSIL,35,703,424,1127
KHUZDAR DISTRICT,ZEHRI TEHSIL,36,369,263,632
KHUZDAR DISTRICT,ZEHRI TEHSIL,37,549,353,902
KHUZDAR DISTRICT,ZEHRI TEHSIL,38,527,410,937
KHUZDAR DISTRICT,ZEHRI TEHSIL,39,489,380,869
KHUZDAR DISTRICT,ZEHRI TEHSIL,40,741,417,1158
KHUZDAR DISTRICT,ZEHRI TEHSIL,41,484,234,718
KHUZDAR DISTRICT,ZEHRI TEHSIL,42,377,210,587
KHUZDAR DISTRICT,ZEHRI TEHSIL,43,434,209,643
KHUZDAR DISTRICT,ZEHRI TEHSIL,44,332,148,480
KHUZDAR DISTRICT,ZEHRI TEHSIL,45,443,187,630
KHUZDAR DISTRICT,ZEHRI TEHSIL,46,234,99,333
KHUZDAR DISTRICT,ZEHRI TEHSIL,47,282,163,445
KHUZDAR DISTRICT,ZEHRI TEHSIL,48,292,158,450
KHUZDAR DISTRICT,ZEHRI TEHSIL,49,276,193,469
KHUZDAR DISTRICT,ZEHRI TEHSIL,50,402,165,567
KHUZDAR DISTRICT,ZEHRI TEHSIL,51,237,110,347
KHUZDAR DISTRICT,ZEHRI TEHSIL,52,204,81,285
KHUZDAR DISTRICT,ZEHRI TEHSIL,53,211,102,313
KHUZDAR DISTRICT,ZEHRI TEHSIL,54,179,91,270
KHUZDAR DISTRICT,ZEHRI TEHSIL,55,237,106,343
KHUZDAR DISTRICT,ZEHRI TEHSIL,56,144,110,254
KHUZDAR DISTRICT,ZEHRI TEHSIL,57,176,120,296
KHUZDAR DISTRICT,ZEHRI TEHSIL,58,146,60,206
KHUZDAR DISTRICT,ZEHRI TEHSIL,59,154,92,246
KHUZDAR DISTRICT,ZEHRI TEHSIL,60,262,111,373
KHUZDAR DISTRICT,ZEHRI TEHSIL,61,183,77,260
KHUZDAR DISTRICT,ZEHRI TEHSIL,62,130,82,212
KHUZDAR DISTRICT,ZEHRI TEHSIL,63,156,67,223
KHUZDAR DISTRICT,ZEHRI TEHSIL,64,155,69,224
KHUZDAR DISTRICT,ZEHRI TEHSIL,65,152,89,241
KHUZDAR DISTRICT,ZEHRI TEHSIL,66,122,44,166
KHUZDAR DISTRICT,ZEHRI TEHSIL,67,118,62,180
KHUZDAR DISTRICT,ZEHRI TEHSIL,68,114,54,168
KHUZDAR DISTRICT,ZEHRI TEHSIL,69,126,57,183
KHUZDAR DISTRICT,ZEHRI TEHSIL,70,142,54,196
KHUZDAR DISTRICT,ZEHRI TEHSIL,71,93,39,132
KHUZDAR DISTRICT,ZEHRI TEHSIL,72,79,33,112
KHUZDAR DISTRICT,ZEHRI TEHSIL,73,89,23,112
KHUZDAR DISTRICT,ZEHRI TEHSIL,74,94,25,119
KHUZDAR DISTRICT,ZEHRI TEHSIL,>=75,620,277,897
KHYBER AGENCY,BARA TEHSIL,<1,12729,0,12729
KHYBER AGENCY,BARA TEHSIL,1,16608,0,16608
KHYBER AGENCY,BARA TEHSIL,2,17885,0,17885
KHYBER AGENCY,BARA TEHSIL,3,18172,0,18172
KHYBER AGENCY,BARA TEHSIL,4,17768,0,17768
KHYBER AGENCY,BARA TEHSIL,5,16979,0,16979
KHYBER AGENCY,BARA TEHSIL,6,16770,0,16770
KHYBER AGENCY,BARA TEHSIL,7,16301,0,16301
KHYBER AGENCY,BARA TEHSIL,8,16750,0,16750
KHYBER AGENCY,BARA TEHSIL,9,14649,0,14649
KHYBER AGENCY,BARA TEHSIL,10,14805,0,14805
KHYBER AGENCY,BARA TEHSIL,11,12384,0,12384
KHYBER AGENCY,BARA TEHSIL,12,12256,0,12256
KHYBER AGENCY,BARA TEHSIL,13,11737,0,11737
KHYBER AGENCY,BARA TEHSIL,14,10705,0,10705
KHYBER AGENCY,BARA TEHSIL,15,10634,0,10634
KHYBER AGENCY,BARA TEHSIL,16,9147,0,9147
KHYBER AGENCY,BARA TEHSIL,17,8096,0,8096
KHYBER AGENCY,BARA TEHSIL,18,8567,0,8567
KHYBER AGENCY,BARA TEHSIL,19,7791,0,7791
KHYBER AGENCY,BARA TEHSIL,20,8295,0,8295
KHYBER AGENCY,BARA TEHSIL,21,8054,0,8054
KHYBER AGENCY,BARA TEHSIL,22,7221,0,7221
KHYBER AGENCY,BARA TEHSIL,23,8336,0,8336
KHYBER AGENCY,BARA TEHSIL,24,6778,0,6778
KHYBER AGENCY,BARA TEHSIL,25,7353,0,7353
KHYBER AGENCY,BARA TEHSIL,26,6156,0,6156
KHYBER AGENCY,BARA TEHSIL,27,7019,0,7019
KHYBER AGENCY,BARA TEHSIL,28,5814,0,5814
KHYBER AGENCY,BARA TEHSIL,29,5964,0,5964
KHYBER AGENCY,BARA TEHSIL,30,5593,0,5593
KHYBER AGENCY,BARA TEHSIL,31,5001,0,5001
KHYBER AGENCY,BARA TEHSIL,32,4981,0,4981
KHYBER AGENCY,BARA TEHSIL,33,5191,0,5191
KHYBER AGENCY,BARA TEHSIL,34,3914,0,3914
KHYBER AGENCY,BARA TEHSIL,35,4059,0,4059
KHYBER AGENCY,BARA TEHSIL,36,3061,0,3061
KHYBER AGENCY,BARA TEHSIL,37,3845,0,3845
KHYBER AGENCY,BARA TEHSIL,38,3389,0,3389
KHYBER AGENCY,BARA TEHSIL,39,3346,0,3346
KHYBER AGENCY,BARA TEHSIL,40,3734,0,3734
KHYBER AGENCY,BARA TEHSIL,41,2666,0,2666
KHYBER AGENCY,BARA TEHSIL,42,2646,0,2646
KHYBER AGENCY,BARA TEHSIL,43,2656,0,2656
KHYBER AGENCY,BARA TEHSIL,44,2256,0,2256
KHYBER AGENCY,BARA TEHSIL,45,2464,0,2464
KHYBER AGENCY,BARA TEHSIL,46,1759,0,1759
KHYBER AGENCY,BARA TEHSIL,47,2367,0,2367
KHYBER AGENCY,BARA TEHSIL,48,1892,0,1892
KHYBER AGENCY,BARA TEHSIL,49,2025,0,2025
KHYBER AGENCY,BARA TEHSIL,50,2457,0,2457
KHYBER AGENCY,BARA TEHSIL,51,1678,0,1678
KHYBER AGENCY,BARA TEHSIL,52,1855,0,1855
KHYBER AGENCY,BARA TEHSIL,53,1771,0,1771
KHYBER AGENCY,BARA TEHSIL,54,1596,0,1596
KHYBER AGENCY,BARA TEHSIL,55,2019,0,2019
KHYBER AGENCY,BARA TEHSIL,56,1347,0,1347
KHYBER AGENCY,BARA TEHSIL,57,1943,0,1943
KHYBER AGENCY,BARA TEHSIL,58,1460,0,1460
KHYBER AGENCY,BARA TEHSIL,59,1399,0,1399
KHYBER AGENCY,BARA TEHSIL,60,1779,0,1779
KHYBER AGENCY,BARA TEHSIL,61,1261,0,1261
KHYBER AGENCY,BARA TEHSIL,62,1284,0,1284
KHYBER AGENCY,BARA TEHSIL,63,1219,0,1219
KHYBER AGENCY,BARA TEHSIL,64,1058,0,1058
KHYBER AGENCY,BARA TEHSIL,65,1045,0,1045
KHYBER AGENCY,BARA TEHSIL,66,704,0,704
KHYBER AGENCY,BARA TEHSIL,67,883,0,883
KHYBER AGENCY,BARA TEHSIL,68,721,0,721
KHYBER AGENCY,BARA TEHSIL,69,687,0,687
KHYBER AGENCY,BARA TEHSIL,70,728,0,728
KHYBER AGENCY,BARA TEHSIL,71,503,0,503
KHYBER AGENCY,BARA TEHSIL,72,563,0,563
KHYBER AGENCY,BARA TEHSIL,73,507,0,507
KHYBER AGENCY,BARA TEHSIL,74,449,0,449
KHYBER AGENCY,BARA TEHSIL,>=75,3965,0,3965
KHYBER AGENCY,JAMRUD TEHSIL,<1,4979,1528,6507
KHYBER AGENCY,JAMRUD TEHSIL,1,6632,2147,8779
KHYBER AGENCY,JAMRUD TEHSIL,2,6100,2242,8342
KHYBER AGENCY,JAMRUD TEHSIL,3,6422,2293,8715
KHYBER AGENCY,JAMRUD TEHSIL,4,6483,2471,8954
KHYBER AGENCY,JAMRUD TEHSIL,5,6258,2247,8505
KHYBER AGENCY,JAMRUD TEHSIL,6,6257,2079,8336
KHYBER AGENCY,JAMRUD TEHSIL,7,5859,2131,7990
KHYBER AGENCY,JAMRUD TEHSIL,8,6197,2067,8264
KHYBER AGENCY,JAMRUD TEHSIL,9,5495,2012,7507
KHYBER AGENCY,JAMRUD TEHSIL,10,5464,1967,7431
KHYBER AGENCY,JAMRUD TEHSIL,11,4749,1798,6547
KHYBER AGENCY,JAMRUD TEHSIL,12,4751,1666,6417
KHYBER AGENCY,JAMRUD TEHSIL,13,4711,1697,6408
KHYBER AGENCY,JAMRUD TEHSIL,14,4327,1596,5923
KHYBER AGENCY,JAMRUD TEHSIL,15,4189,1670,5859
KHYBER AGENCY,JAMRUD TEHSIL,16,3796,1431,5227
KHYBER AGENCY,JAMRUD TEHSIL,17,3624,1390,5014
KHYBER AGENCY,JAMRUD TEHSIL,18,3545,1391,4936
KHYBER AGENCY,JAMRUD TEHSIL,19,2904,1231,4135
KHYBER AGENCY,JAMRUD TEHSIL,20,3110,1240,4350
KHYBER AGENCY,JAMRUD TEHSIL,21,2671,1142,3813
KHYBER AGENCY,JAMRUD TEHSIL,22,2516,1045,3561
KHYBER AGENCY,JAMRUD TEHSIL,23,2679,1107,3786
KHYBER AGENCY,JAMRUD TEHSIL,24,2212,944,3156
KHYBER AGENCY,JAMRUD TEHSIL,25,2736,1135,3871
KHYBER AGENCY,JAMRUD TEHSIL,26,2179,947,3126
KHYBER AGENCY,JAMRUD TEHSIL,27,2333,1023,3356
KHYBER AGENCY,JAMRUD TEHSIL,28,2183,981,3164
KHYBER AGENCY,JAMRUD TEHSIL,29,1974,924,2898
KHYBER AGENCY,JAMRUD TEHSIL,30,2118,972,3090
KHYBER AGENCY,JAMRUD TEHSIL,31,1608,721,2329
KHYBER AGENCY,JAMRUD TEHSIL,32,1718,730,2448
KHYBER AGENCY,JAMRUD TEHSIL,33,1784,811,2595
KHYBER AGENCY,JAMRUD TEHSIL,34,1339,608,1947
KHYBER AGENCY,JAMRUD TEHSIL,35,1604,759,2363
KHYBER AGENCY,JAMRUD TEHSIL,36,1051,457,1508
KHYBER AGENCY,JAMRUD TEHSIL,37,1242,602,1844
KHYBER AGENCY,JAMRUD TEHSIL,38,1433,637,2070
KHYBER AGENCY,JAMRUD TEHSIL,39,1292,626,1918
KHYBER AGENCY,JAMRUD TEHSIL,40,1517,684,2201
KHYBER AGENCY,JAMRUD TEHSIL,41,1085,466,1551
KHYBER AGENCY,JAMRUD TEHSIL,42,1004,461,1465
KHYBER AGENCY,JAMRUD TEHSIL,43,970,457,1427
KHYBER AGENCY,JAMRUD TEHSIL,44,874,403,1277
KHYBER AGENCY,JAMRUD TEHSIL,45,1081,440,1521
KHYBER AGENCY,JAMRUD TEHSIL,46,659,262,921
KHYBER AGENCY,JAMRUD TEHSIL,47,774,402,1176
KHYBER AGENCY,JAMRUD TEHSIL,48,755,362,1117
KHYBER AGENCY,JAMRUD TEHSIL,49,704,345,1049
KHYBER AGENCY,JAMRUD TEHSIL,50,996,482,1478
KHYBER AGENCY,JAMRUD TEHSIL,51,666,278,944
KHYBER AGENCY,JAMRUD TEHSIL,52,661,293,954
KHYBER AGENCY,JAMRUD TEHSIL,53,692,279,971
KHYBER AGENCY,JAMRUD TEHSIL,54,560,252,812
KHYBER AGENCY,JAMRUD TEHSIL,55,787,318,1105
KHYBER AGENCY,JAMRUD TEHSIL,56,486,182,668
KHYBER AGENCY,JAMRUD TEHSIL,57,672,328,1000
KHYBER AGENCY,JAMRUD TEHSIL,58,461,235,696
KHYBER AGENCY,JAMRUD TEHSIL,59,492,225,717
KHYBER AGENCY,JAMRUD TEHSIL,60,630,220,850
KHYBER AGENCY,JAMRUD TEHSIL,61,363,160,523
KHYBER AGENCY,JAMRUD TEHSIL,62,448,146,594
KHYBER AGENCY,JAMRUD TEHSIL,63,401,191,592
KHYBER AGENCY,JAMRUD TEHSIL,64,337,155,492
KHYBER AGENCY,JAMRUD TEHSIL,65,364,173,537
KHYBER AGENCY,JAMRUD TEHSIL,66,194,80,274
KHYBER AGENCY,JAMRUD TEHSIL,67,238,103,341
KHYBER AGENCY,JAMRUD TEHSIL,68,229,75,304
KHYBER AGENCY,JAMRUD TEHSIL,69,216,76,292
KHYBER AGENCY,JAMRUD TEHSIL,70,241,97,338
KHYBER AGENCY,JAMRUD TEHSIL,71,157,59,216
KHYBER AGENCY,JAMRUD TEHSIL,72,154,60,214
KHYBER AGENCY,JAMRUD TEHSIL,73,143,51,194
KHYBER AGENCY,JAMRUD TEHSIL,74,118,56,174
KHYBER AGENCY,JAMRUD TEHSIL,>=75,1176,407,1583
KHYBER AGENCY,LANDI KOTAL TEHSIL,<1,6689,869,7558
KHYBER AGENCY,LANDI KOTAL TEHSIL,1,7870,1081,8951
KHYBER AGENCY,LANDI KOTAL TEHSIL,2,9523,1127,10650
KHYBER AGENCY,LANDI KOTAL TEHSIL,3,9829,1311,11140
KHYBER AGENCY,LANDI KOTAL TEHSIL,4,9969,1351,11320
KHYBER AGENCY,LANDI KOTAL TEHSIL,5,9651,1334,10985
KHYBER AGENCY,LANDI KOTAL TEHSIL,6,9482,1252,10734
KHYBER AGENCY,LANDI KOTAL TEHSIL,7,9094,1269,10363
KHYBER AGENCY,LANDI KOTAL TEHSIL,8,9294,1142,10436
KHYBER AGENCY,LANDI KOTAL TEHSIL,9,8132,1126,9258
KHYBER AGENCY,LANDI KOTAL TEHSIL,10,7870,939,8809
KHYBER AGENCY,LANDI KOTAL TEHSIL,11,6538,885,7423
KHYBER AGENCY,LANDI KOTAL TEHSIL,12,6429,853,7282
KHYBER AGENCY,LANDI KOTAL TEHSIL,13,6023,858,6881
KHYBER AGENCY,LANDI KOTAL TEHSIL,14,5530,784,6314
KHYBER AGENCY,LANDI KOTAL TEHSIL,15,5541,851,6392
KHYBER AGENCY,LANDI KOTAL TEHSIL,16,4904,742,5646
KHYBER AGENCY,LANDI KOTAL TEHSIL,17,4530,760,5290
KHYBER AGENCY,LANDI KOTAL TEHSIL,18,4830,629,5459
KHYBER AGENCY,LANDI KOTAL TEHSIL,19,4202,680,4882
KHYBER AGENCY,LANDI KOTAL TEHSIL,20,4805,661,5466
KHYBER AGENCY,LANDI KOTAL TEHSIL,21,4155,630,4785
KHYBER AGENCY,LANDI KOTAL TEHSIL,22,3714,542,4256
KHYBER AGENCY,LANDI KOTAL TEHSIL,23,4037,626,4663
KHYBER AGENCY,LANDI KOTAL TEHSIL,24,3336,477,3813
KHYBER AGENCY,LANDI KOTAL TEHSIL,25,4001,528,4529
KHYBER AGENCY,LANDI KOTAL TEHSIL,26,3236,470,3706
KHYBER AGENCY,LANDI KOTAL TEHSIL,27,3705,581,4286
KHYBER AGENCY,LANDI KOTAL TEHSIL,28,3461,553,4014
KHYBER AGENCY,LANDI KOTAL TEHSIL,29,3418,462,3880
KHYBER AGENCY,LANDI KOTAL TEHSIL,30,3245,479,3724
KHYBER AGENCY,LANDI KOTAL TEHSIL,31,2734,386,3120
KHYBER AGENCY,LANDI KOTAL TEHSIL,32,2508,431,2939
KHYBER AGENCY,LANDI KOTAL TEHSIL,33,2820,461,3281
KHYBER AGENCY,LANDI KOTAL TEHSIL,34,2232,355,2587
KHYBER AGENCY,LANDI KOTAL TEHSIL,35,2369,376,2745
KHYBER AGENCY,LANDI KOTAL TEHSIL,36,1618,247,1865
KHYBER AGENCY,LANDI KOTAL TEHSIL,37,2241,353,2594
KHYBER AGENCY,LANDI KOTAL TEHSIL,38,2140,368,2508
KHYBER AGENCY,LANDI KOTAL TEHSIL,39,2112,327,2439
KHYBER AGENCY,LANDI KOTAL TEHSIL,40,2200,316,2516
KHYBER AGENCY,LANDI KOTAL TEHSIL,41,1599,278,1877
KHYBER AGENCY,LANDI KOTAL TEHSIL,42,1573,259,1832
KHYBER AGENCY,LANDI KOTAL TEHSIL,43,1600,259,1859
KHYBER AGENCY,LANDI KOTAL TEHSIL,44,1313,214,1527
KHYBER AGENCY,LANDI KOTAL TEHSIL,45,1540,229,1769
KHYBER AGENCY,LANDI KOTAL TEHSIL,46,931,136,1067
KHYBER AGENCY,LANDI KOTAL TEHSIL,47,1331,180,1511
KHYBER AGENCY,LANDI KOTAL TEHSIL,48,1273,186,1459
KHYBER AGENCY,LANDI KOTAL TEHSIL,49,1127,193,1320
KHYBER AGENCY,LANDI KOTAL TEHSIL,50,1391,204,1595
KHYBER AGENCY,LANDI KOTAL TEHSIL,51,958,156,1114
KHYBER AGENCY,LANDI KOTAL TEHSIL,52,1121,171,1292
KHYBER AGENCY,LANDI KOTAL TEHSIL,53,977,125,1102
KHYBER AGENCY,LANDI KOTAL TEHSIL,54,895,117,1012
KHYBER AGENCY,LANDI KOTAL TEHSIL,55,1121,152,1273
KHYBER AGENCY,LANDI KOTAL TEHSIL,56,666,82,748
KHYBER AGENCY,LANDI KOTAL TEHSIL,57,920,151,1071
KHYBER AGENCY,LANDI KOTAL TEHSIL,58,792,92,884
KHYBER AGENCY,LANDI KOTAL TEHSIL,59,726,111,837
KHYBER AGENCY,LANDI KOTAL TEHSIL,60,793,114,907
KHYBER AGENCY,LANDI KOTAL TEHSIL,61,507,61,568
KHYBER AGENCY,LANDI KOTAL TEHSIL,62,645,74,719
KHYBER AGENCY,LANDI KOTAL TEHSIL,63,528,76,604
KHYBER AGENCY,LANDI KOTAL TEHSIL,64,432,69,501
KHYBER AGENCY,LANDI KOTAL TEHSIL,65,532,82,614
KHYBER AGENCY,LANDI KOTAL TEHSIL,66,292,31,323
KHYBER AGENCY,LANDI KOTAL TEHSIL,67,426,47,473
KHYBER AGENCY,LANDI KOTAL TEHSIL,68,300,36,336
KHYBER AGENCY,LANDI KOTAL TEHSIL,69,328,43,371
KHYBER AGENCY,LANDI KOTAL TEHSIL,70,330,36,366
KHYBER AGENCY,LANDI KOTAL TEHSIL,71,197,24,221
KHYBER AGENCY,LANDI KOTAL TEHSIL,72,260,33,293
KHYBER AGENCY,LANDI KOTAL TEHSIL,73,185,20,205
KHYBER AGENCY,LANDI KOTAL TEHSIL,74,167,27,194
KHYBER AGENCY,LANDI KOTAL TEHSIL,>=75,1530,189,1719
KHYBER AGENCY,MULLA GORI TEHSIL,<1,909,0,909
KHYBER AGENCY,MULLA GORI TEHSIL,1,1501,0,1501
KHYBER AGENCY,MULLA GORI TEHSIL,2,1470,0,1470
KHYBER AGENCY,MULLA GORI TEHSIL,3,1556,0,1556
KHYBER AGENCY,MULLA GORI TEHSIL,4,1749,0,1749
KHYBER AGENCY,MULLA GORI TEHSIL,5,1446,0,1446
KHYBER AGENCY,MULLA GORI TEHSIL,6,1356,0,1356
KHYBER AGENCY,MULLA GORI TEHSIL,7,1470,0,1470
KHYBER AGENCY,MULLA GORI TEHSIL,8,1339,0,1339
KHYBER AGENCY,MULLA GORI TEHSIL,9,1382,0,1382
KHYBER AGENCY,MULLA GORI TEHSIL,10,1189,0,1189
KHYBER AGENCY,MULLA GORI TEHSIL,11,1163,0,1163
KHYBER AGENCY,MULLA GORI TEHSIL,12,1029,0,1029
KHYBER AGENCY,MULLA GORI TEHSIL,13,1060,0,1060
KHYBER AGENCY,MULLA GORI TEHSIL,14,1141,0,1141
KHYBER AGENCY,MULLA GORI TEHSIL,15,1050,0,1050
KHYBER AGENCY,MULLA GORI TEHSIL,16,836,0,836
KHYBER AGENCY,MULLA GORI TEHSIL,17,1013,0,1013
KHYBER AGENCY,MULLA GORI TEHSIL,18,706,0,706
KHYBER AGENCY,MULLA GORI TEHSIL,19,752,0,752
KHYBER AGENCY,MULLA GORI TEHSIL,20,712,0,712
KHYBER AGENCY,MULLA GORI TEHSIL,21,732,0,732
KHYBER AGENCY,MULLA GORI TEHSIL,22,666,0,666
KHYBER AGENCY,MULLA GORI TEHSIL,23,702,0,702
KHYBER AGENCY,MULLA GORI TEHSIL,24,711,0,711
KHYBER AGENCY,MULLA GORI TEHSIL,25,597,0,597
KHYBER AGENCY,MULLA GORI TEHSIL,26,678,0,678
KHYBER AGENCY,MULLA GORI TEHSIL,27,622,0,622
KHYBER AGENCY,MULLA GORI TEHSIL,28,554,0,554
KHYBER AGENCY,MULLA GORI TEHSIL,29,617,0,617
KHYBER AGENCY,MULLA GORI TEHSIL,30,478,0,478
KHYBER AGENCY,MULLA GORI TEHSIL,31,466,0,466
KHYBER AGENCY,MULLA GORI TEHSIL,32,569,0,569
KHYBER AGENCY,MULLA GORI TEHSIL,33,433,0,433
KHYBER AGENCY,MULLA GORI TEHSIL,34,447,0,447
KHYBER AGENCY,MULLA GORI TEHSIL,35,337,0,337
KHYBER AGENCY,MULLA GORI TEHSIL,36,403,0,403
KHYBER AGENCY,MULLA GORI TEHSIL,37,354,0,354
KHYBER AGENCY,MULLA GORI TEHSIL,38,378,0,378
KHYBER AGENCY,MULLA GORI TEHSIL,39,325,0,325
KHYBER AGENCY,MULLA GORI TEHSIL,40,342,0,342
KHYBER AGENCY,MULLA GORI TEHSIL,41,294,0,294
KHYBER AGENCY,MULLA GORI TEHSIL,42,289,0,289
KHYBER AGENCY,MULLA GORI TEHSIL,43,234,0,234
KHYBER AGENCY,MULLA GORI TEHSIL,44,217,0,217
KHYBER AGENCY,MULLA GORI TEHSIL,45,205,0,205
KHYBER AGENCY,MULLA GORI TEHSIL,46,207,0,207
KHYBER AGENCY,MULLA GORI TEHSIL,47,204,0,204
KHYBER AGENCY,MULLA GORI TEHSIL,48,201,0,201
KHYBER AGENCY,MULLA GORI TEHSIL,49,152,0,152
KHYBER AGENCY,MULLA GORI TEHSIL,50,159,0,159
KHYBER AGENCY,MULLA GORI TEHSIL,51,149,0,149
KHYBER AGENCY,MULLA GORI TEHSIL,52,194,0,194
KHYBER AGENCY,MULLA GORI TEHSIL,53,150,0,150
KHYBER AGENCY,MULLA GORI TEHSIL,54,199,0,199
KHYBER AGENCY,MULLA GORI TEHSIL,55,147,0,147
KHYBER AGENCY,MULLA GORI TEHSIL,56,153,0,153
KHYBER AGENCY,MULLA GORI TEHSIL,57,173,0,173
KHYBER AGENCY,MULLA GORI TEHSIL,58,181,0,181
KHYBER AGENCY,MULLA GORI TEHSIL,59,129,0,129
KHYBER AGENCY,MULLA GORI TEHSIL,60,134,0,134
KHYBER AGENCY,MULLA GORI TEHSIL,61,89,0,89
KHYBER AGENCY,MULLA GORI TEHSIL,62,87,0,87
KHYBER AGENCY,MULLA GORI TEHSIL,63,94,0,94
KHYBER AGENCY,MULLA GORI TEHSIL,64,74,0,74
KHYBER AGENCY,MULLA GORI TEHSIL,65,84,0,84
KHYBER AGENCY,MULLA GORI TEHSIL,66,72,0,72
KHYBER AGENCY,MULLA GORI TEHSIL,67,46,0,46
KHYBER AGENCY,MULLA GORI TEHSIL,68,79,0,79
KHYBER AGENCY,MULLA GORI TEHSIL,69,56,0,56
KHYBER AGENCY,MULLA GORI TEHSIL,70,58,0,58
KHYBER AGENCY,MULLA GORI TEHSIL,71,43,0,43
KHYBER AGENCY,MULLA GORI TEHSIL,72,59,0,59
KHYBER AGENCY,MULLA GORI TEHSIL,73,40,0,40
KHYBER AGENCY,MULLA GORI TEHSIL,74,33,0,33
KHYBER AGENCY,MULLA GORI TEHSIL,>=75,263,0,263
KILLA ABDULLAH DISTRICT,CHAMAN TEHSIL,<1,8613,3232,11845
KILLA ABDULLAH DISTRICT,CHAMAN TEHSIL,1,13713,4519,18232
KILLA ABDULLAH DISTRICT,CHAMAN TEHSIL,2,13265,4609,17874
KILLA ABDULLAH DISTRICT,CHAMAN TEHSIL,3,13253,4840,18093
KILLA ABDULLAH DISTRICT,CHAMAN TEHSIL,4,12621,4480,17101
KILLA ABDULLAH DISTRICT,CHAMAN TEHSIL,5,12519,4633,17152
KILLA ABDULLAH DISTRICT,CHAMAN TEHSIL,6,12070,4390,16460
KILLA ABDULLAH DISTRICT,CHAMAN TEHSIL,7,12530,4613,17143
KILLA ABDULLAH DISTRICT,CHAMAN TEHSIL,8,10863,4105,14968
KILLA ABDULLAH DISTRICT,CHAMAN TEHSIL,9,11533,4516,16049
KILLA ABDULLAH DISTRICT,CHAMAN TEHSIL,10,9747,3821,13568
KILLA ABDULLAH DISTRICT,CHAMAN TEHSIL,11,10238,4254,14492
KILLA ABDULLAH DISTRICT,CHAMAN TEHSIL,12,8395,3344,11739
KILLA ABDULLAH DISTRICT,CHAMAN TEHSIL,13,9026,3774,12800
KILLA ABDULLAH DISTRICT,CHAMAN TEHSIL,14,8012,3190,11202
KILLA ABDULLAH DISTRICT,CHAMAN TEHSIL,15,7742,3298,11040
KILLA ABDULLAH DISTRICT,CHAMAN TEHSIL,16,7019,2955,9974
KILLA ABDULLAH DISTRICT,CHAMAN TEHSIL,17,6687,2851,9538
KILLA ABDULLAH DISTRICT,CHAMAN TEHSIL,18,6910,2870,9780
KILLA ABDULLAH DISTRICT,CHAMAN TEHSIL,19,6730,2813,9543
KILLA ABDULLAH DISTRICT,CHAMAN TEHSIL,20,5890,2470,8360
KILLA ABDULLAH DISTRICT,CHAMAN TEHSIL,21,5481,2477,7958
KILLA ABDULLAH DISTRICT,CHAMAN TEHSIL,22,4578,1926,6504
KILLA ABDULLAH DISTRICT,CHAMAN TEHSIL,23,4655,2078,6733
KILLA ABDULLAH DISTRICT,CHAMAN TEHSIL,24,4129,1662,5791
KILLA ABDULLAH DISTRICT,CHAMAN TEHSIL,25,4578,1848,6426
KILLA ABDULLAH DISTRICT,CHAMAN TEHSIL,26,3638,1613,5251
KILLA ABDULLAH DISTRICT,CHAMAN TEHSIL,27,4461,1775,6236
KILLA ABDULLAH DISTRICT,CHAMAN TEHSIL,28,3746,1605,5351
KILLA ABDULLAH DISTRICT,CHAMAN TEHSIL,29,4480,1697,6177
KILLA ABDULLAH DISTRICT,CHAMAN TEHSIL,30,3459,1458,4917
KILLA ABDULLAH DISTRICT,CHAMAN TEHSIL,31,3781,1545,5326
KILLA ABDULLAH DISTRICT,CHAMAN TEHSIL,32,3129,1258,4387
KILLA ABDULLAH DISTRICT,CHAMAN TEHSIL,33,3253,1388,4641
KILLA ABDULLAH DISTRICT,CHAMAN TEHSIL,34,2600,1085,3685
KILLA ABDULLAH DISTRICT,CHAMAN TEHSIL,35,2536,1136,3672
KILLA ABDULLAH DISTRICT,CHAMAN TEHSIL,36,2139,1013,3152
KILLA ABDULLAH DISTRICT,CHAMAN TEHSIL,37,3427,1257,4684
KILLA ABDULLAH DISTRICT,CHAMAN TEHSIL,38,2227,1018,3245
KILLA ABDULLAH DISTRICT,CHAMAN TEHSIL,39,2565,1062,3627
KILLA ABDULLAH DISTRICT,CHAMAN TEHSIL,40,1868,897,2765
KILLA ABDULLAH DISTRICT,CHAMAN TEHSIL,41,1944,900,2844
KILLA ABDULLAH DISTRICT,CHAMAN TEHSIL,42,1618,697,2315
KILLA ABDULLAH DISTRICT,CHAMAN TEHSIL,43,1380,729,2109
KILLA ABDULLAH DISTRICT,CHAMAN TEHSIL,44,1227,563,1790
KILLA ABDULLAH DISTRICT,CHAMAN TEHSIL,45,1252,566,1818
KILLA ABDULLAH DISTRICT,CHAMAN TEHSIL,46,1084,503,1587
KILLA ABDULLAH DISTRICT,CHAMAN TEHSIL,47,1811,691,2502
KILLA ABDULLAH DISTRICT,CHAMAN TEHSIL,48,1167,494,1661
KILLA ABDULLAH DISTRICT,CHAMAN TEHSIL,49,1390,571,1961
KILLA ABDULLAH DISTRICT,CHAMAN TEHSIL,50,1129,592,1721
KILLA ABDULLAH DISTRICT,CHAMAN TEHSIL,51,1477,612,2089
KILLA ABDULLAH DISTRICT,CHAMAN TEHSIL,52,1156,498,1654
KILLA ABDULLAH DISTRICT,CHAMAN TEHSIL,53,1111,460,1571
KILLA ABDULLAH DISTRICT,CHAMAN TEHSIL,54,970,417,1387
KILLA ABDULLAH DISTRICT,CHAMAN TEHSIL,55,777,335,1112
KILLA ABDULLAH DISTRICT,CHAMAN TEHSIL,56,736,300,1036
KILLA ABDULLAH DISTRICT,CHAMAN TEHSIL,57,1069,424,1493
KILLA ABDULLAH DISTRICT,CHAMAN TEHSIL,58,675,304,979
KILLA ABDULLAH DISTRICT,CHAMAN TEHSIL,59,765,306,1071
KILLA ABDULLAH DISTRICT,CHAMAN TEHSIL,60,557,286,843
KILLA ABDULLAH DISTRICT,CHAMAN TEHSIL,61,686,269,955
KILLA ABDULLAH DISTRICT,CHAMAN TEHSIL,62,660,286,946
KILLA ABDULLAH DISTRICT,CHAMAN TEHSIL,63,704,256,960
KILLA ABDULLAH DISTRICT,CHAMAN TEHSIL,64,642,207,849
KILLA ABDULLAH DISTRICT,CHAMAN TEHSIL,65,417,174,591
KILLA ABDULLAH DISTRICT,CHAMAN TEHSIL,66,456,181,637
KILLA ABDULLAH DISTRICT,CHAMAN TEHSIL,67,664,246,910
KILLA ABDULLAH DISTRICT,CHAMAN TEHSIL,68,591,214,805
KILLA ABDULLAH DISTRICT,CHAMAN TEHSIL,69,542,176,718
KILLA ABDULLAH DISTRICT,CHAMAN TEHSIL,70,317,151,468
KILLA ABDULLAH DISTRICT,CHAMAN TEHSIL,71,407,146,553
KILLA ABDULLAH DISTRICT,CHAMAN TEHSIL,72,398,162,560
KILLA ABDULLAH DISTRICT,CHAMAN TEHSIL,73,490,169,659
KILLA ABDULLAH DISTRICT,CHAMAN TEHSIL,74,284,112,396
KILLA ABDULLAH DISTRICT,CHAMAN TEHSIL,>=75,2696,834,3530
KILLA ABDULLAH DISTRICT,DOBANDI SUB-TEHSIL,<1,1702,0,1702
KILLA ABDULLAH DISTRICT,DOBANDI SUB-TEHSIL,1,2828,0,2828
KILLA ABDULLAH DISTRICT,DOBANDI SUB-TEHSIL,2,2886,0,2886
KILLA ABDULLAH DISTRICT,DOBANDI SUB-TEHSIL,3,2634,0,2634
KILLA ABDULLAH DISTRICT,DOBANDI SUB-TEHSIL,4,2891,0,2891
KILLA ABDULLAH DISTRICT,DOBANDI SUB-TEHSIL,5,2450,0,2450
KILLA ABDULLAH DISTRICT,DOBANDI SUB-TEHSIL,6,2761,0,2761
KILLA ABDULLAH DISTRICT,DOBANDI SUB-TEHSIL,7,2330,0,2330
KILLA ABDULLAH DISTRICT,DOBANDI SUB-TEHSIL,8,2452,0,2452
KILLA ABDULLAH DISTRICT,DOBANDI SUB-TEHSIL,9,2434,0,2434
KILLA ABDULLAH DISTRICT,DOBANDI SUB-TEHSIL,10,2216,0,2216
KILLA ABDULLAH DISTRICT,DOBANDI SUB-TEHSIL,11,1880,0,1880
KILLA ABDULLAH DISTRICT,DOBANDI SUB-TEHSIL,12,1701,0,1701
KILLA ABDULLAH DISTRICT,DOBANDI SUB-TEHSIL,13,1584,0,1584
KILLA ABDULLAH DISTRICT,DOBANDI SUB-TEHSIL,14,1518,0,1518
KILLA ABDULLAH DISTRICT,DOBANDI SUB-TEHSIL,15,1335,0,1335
KILLA ABDULLAH DISTRICT,DOBANDI SUB-TEHSIL,16,1187,0,1187
KILLA ABDULLAH DISTRICT,DOBANDI SUB-TEHSIL,17,1053,0,1053
KILLA ABDULLAH DISTRICT,DOBANDI SUB-TEHSIL,18,1192,0,1192
KILLA ABDULLAH DISTRICT,DOBANDI SUB-TEHSIL,19,1033,0,1033
KILLA ABDULLAH DISTRICT,DOBANDI SUB-TEHSIL,20,1080,0,1080
KILLA ABDULLAH DISTRICT,DOBANDI SUB-TEHSIL,21,943,0,943
KILLA ABDULLAH DISTRICT,DOBANDI SUB-TEHSIL,22,781,0,781
KILLA ABDULLAH DISTRICT,DOBANDI SUB-TEHSIL,23,794,0,794
KILLA ABDULLAH DISTRICT,DOBANDI SUB-TEHSIL,24,788,0,788
KILLA ABDULLAH DISTRICT,DOBANDI SUB-TEHSIL,25,918,0,918
KILLA ABDULLAH DISTRICT,DOBANDI SUB-TEHSIL,26,762,0,762
KILLA ABDULLAH DISTRICT,DOBANDI SUB-TEHSIL,27,914,0,914
KILLA ABDULLAH DISTRICT,DOBANDI SUB-TEHSIL,28,684,0,684
KILLA ABDULLAH DISTRICT,DOBANDI SUB-TEHSIL,29,856,0,856
KILLA ABDULLAH DISTRICT,DOBANDI SUB-TEHSIL,30,725,0,725
KILLA ABDULLAH DISTRICT,DOBANDI SUB-TEHSIL,31,748,0,748
KILLA ABDULLAH DISTRICT,DOBANDI SUB-TEHSIL,32,611,0,611
KILLA ABDULLAH DISTRICT,DOBANDI SUB-TEHSIL,33,600,0,600
KILLA ABDULLAH DISTRICT,DOBANDI SUB-TEHSIL,34,439,0,439
KILLA ABDULLAH DISTRICT,DOBANDI SUB-TEHSIL,35,521,0,521
KILLA ABDULLAH DISTRICT,DOBANDI SUB-TEHSIL,36,518,0,518
KILLA ABDULLAH DISTRICT,DOBANDI SUB-TEHSIL,37,658,0,658
KILLA ABDULLAH DISTRICT,DOBANDI SUB-TEHSIL,38,401,0,401
KILLA ABDULLAH DISTRICT,DOBANDI SUB-TEHSIL,39,504,0,504
KILLA ABDULLAH DISTRICT,DOBANDI SUB-TEHSIL,40,402,0,402
KILLA ABDULLAH DISTRICT,DOBANDI SUB-TEHSIL,41,371,0,371
KILLA ABDULLAH DISTRICT,DOBANDI SUB-TEHSIL,42,325,0,325
KILLA ABDULLAH DISTRICT,DOBANDI SUB-TEHSIL,43,298,0,298
KILLA ABDULLAH DISTRICT,DOBANDI SUB-TEHSIL,44,230,0,230
KILLA ABDULLAH DISTRICT,DOBANDI SUB-TEHSIL,45,281,0,281
KILLA ABDULLAH DISTRICT,DOBANDI SUB-TEHSIL,46,205,0,205
KILLA ABDULLAH DISTRICT,DOBANDI SUB-TEHSIL,47,388,0,388
KILLA ABDULLAH DISTRICT,DOBANDI SUB-TEHSIL,48,184,0,184
KILLA ABDULLAH DISTRICT,DOBANDI SUB-TEHSIL,49,276,0,276
KILLA ABDULLAH DISTRICT,DOBANDI SUB-TEHSIL,50,245,0,245
KILLA ABDULLAH DISTRICT,DOBANDI SUB-TEHSIL,51,275,0,275
KILLA ABDULLAH DISTRICT,DOBANDI SUB-TEHSIL,52,246,0,246
KILLA ABDULLAH DISTRICT,DOBANDI SUB-TEHSIL,53,243,0,243
KILLA ABDULLAH DISTRICT,DOBANDI SUB-TEHSIL,54,202,0,202
KILLA ABDULLAH DISTRICT,DOBANDI SUB-TEHSIL,55,169,0,169
KILLA ABDULLAH DISTRICT,DOBANDI SUB-TEHSIL,56,161,0,161
KILLA ABDULLAH DISTRICT,DOBANDI SUB-TEHSIL,57,220,0,220
KILLA ABDULLAH DISTRICT,DOBANDI SUB-TEHSIL,58,154,0,154
KILLA ABDULLAH DISTRICT,DOBANDI SUB-TEHSIL,59,177,0,177
KILLA ABDULLAH DISTRICT,DOBANDI SUB-TEHSIL,60,153,0,153
KILLA ABDULLAH DISTRICT,DOBANDI SUB-TEHSIL,61,135,0,135
KILLA ABDULLAH DISTRICT,DOBANDI SUB-TEHSIL,62,178,0,178
KILLA ABDULLAH DISTRICT,DOBANDI SUB-TEHSIL,63,167,0,167
KILLA ABDULLAH DISTRICT,DOBANDI SUB-TEHSIL,64,197,0,197
KILLA ABDULLAH DISTRICT,DOBANDI SUB-TEHSIL,65,101,0,101
KILLA ABDULLAH DISTRICT,DOBANDI SUB-TEHSIL,66,108,0,108
KILLA ABDULLAH DISTRICT,DOBANDI SUB-TEHSIL,67,191,0,191
KILLA ABDULLAH DISTRICT,DOBANDI SUB-TEHSIL,68,113,0,113
KILLA ABDULLAH DISTRICT,DOBANDI SUB-TEHSIL,69,128,0,128
KILLA ABDULLAH DISTRICT,DOBANDI SUB-TEHSIL,70,66,0,66
KILLA ABDULLAH DISTRICT,DOBANDI SUB-TEHSIL,71,97,0,97
KILLA ABDULLAH DISTRICT,DOBANDI SUB-TEHSIL,72,100,0,100
KILLA ABDULLAH DISTRICT,DOBANDI SUB-TEHSIL,73,53,0,53
KILLA ABDULLAH DISTRICT,DOBANDI SUB-TEHSIL,74,92,0,92
KILLA ABDULLAH DISTRICT,DOBANDI SUB-TEHSIL,>=75,498,0,498
KILLA ABDULLAH DISTRICT,GULISTAN TEHSIL,<1,3735,0,3735
KILLA ABDULLAH DISTRICT,GULISTAN TEHSIL,1,4578,0,4578
KILLA ABDULLAH DISTRICT,GULISTAN TEHSIL,2,4789,0,4789
KILLA ABDULLAH DISTRICT,GULISTAN TEHSIL,3,4472,0,4472
KILLA ABDULLAH DISTRICT,GULISTAN TEHSIL,4,4473,0,4473
KILLA ABDULLAH DISTRICT,GULISTAN TEHSIL,5,4147,0,4147
KILLA ABDULLAH DISTRICT,GULISTAN TEHSIL,6,4176,0,4176
KILLA ABDULLAH DISTRICT,GULISTAN TEHSIL,7,4106,0,4106
KILLA ABDULLAH DISTRICT,GULISTAN TEHSIL,8,3845,0,3845
KILLA ABDULLAH DISTRICT,GULISTAN TEHSIL,9,4019,0,4019
KILLA ABDULLAH DISTRICT,GULISTAN TEHSIL,10,3444,0,3444
KILLA ABDULLAH DISTRICT,GULISTAN TEHSIL,11,3640,0,3640
KILLA ABDULLAH DISTRICT,GULISTAN TEHSIL,12,2884,0,2884
KILLA ABDULLAH DISTRICT,GULISTAN TEHSIL,13,3046,0,3046
KILLA ABDULLAH DISTRICT,GULISTAN TEHSIL,14,2784,0,2784
KILLA ABDULLAH DISTRICT,GULISTAN TEHSIL,15,2738,0,2738
KILLA ABDULLAH DISTRICT,GULISTAN TEHSIL,16,2406,0,2406
KILLA ABDULLAH DISTRICT,GULISTAN TEHSIL,17,2341,0,2341
KILLA ABDULLAH DISTRICT,GULISTAN TEHSIL,18,2380,0,2380
KILLA ABDULLAH DISTRICT,GULISTAN TEHSIL,19,2396,0,2396
KILLA ABDULLAH DISTRICT,GULISTAN TEHSIL,20,2217,0,2217
KILLA ABDULLAH DISTRICT,GULISTAN TEHSIL,21,2225,0,2225
KILLA ABDULLAH DISTRICT,GULISTAN TEHSIL,22,1746,0,1746
KILLA ABDULLAH DISTRICT,GULISTAN TEHSIL,23,1715,0,1715
KILLA ABDULLAH DISTRICT,GULISTAN TEHSIL,24,1764,0,1764
KILLA ABDULLAH DISTRICT,GULISTAN TEHSIL,25,1771,0,1771
KILLA ABDULLAH DISTRICT,GULISTAN TEHSIL,26,1651,0,1651
KILLA ABDULLAH DISTRICT,GULISTAN TEHSIL,27,1784,0,1784
KILLA ABDULLAH DISTRICT,GULISTAN TEHSIL,28,1574,0,1574
KILLA ABDULLAH DISTRICT,GULISTAN TEHSIL,29,1648,0,1648
KILLA ABDULLAH DISTRICT,GULISTAN TEHSIL,30,1453,0,1453
KILLA ABDULLAH DISTRICT,GULISTAN TEHSIL,31,1607,0,1607
KILLA ABDULLAH DISTRICT,GULISTAN TEHSIL,32,1291,0,1291
KILLA ABDULLAH DISTRICT,GULISTAN TEHSIL,33,1352,0,1352
KILLA ABDULLAH DISTRICT,GULISTAN TEHSIL,34,1127,0,1127
KILLA ABDULLAH DISTRICT,GULISTAN TEHSIL,35,1053,0,1053
KILLA ABDULLAH DISTRICT,GULISTAN TEHSIL,36,891,0,891
KILLA ABDULLAH DISTRICT,GULISTAN TEHSIL,37,1277,0,1277
KILLA ABDULLAH DISTRICT,GULISTAN TEHSIL,38,947,0,947
KILLA ABDULLAH DISTRICT,GULISTAN TEHSIL,39,954,0,954
KILLA ABDULLAH DISTRICT,GULISTAN TEHSIL,40,825,0,825
KILLA ABDULLAH DISTRICT,GULISTAN TEHSIL,41,714,0,714
KILLA ABDULLAH DISTRICT,GULISTAN TEHSIL,42,694,0,694
KILLA ABDULLAH DISTRICT,GULISTAN TEHSIL,43,570,0,570
KILLA ABDULLAH DISTRICT,GULISTAN TEHSIL,44,532,0,532
KILLA ABDULLAH DISTRICT,GULISTAN TEHSIL,45,543,0,543
KILLA ABDULLAH DISTRICT,GULISTAN TEHSIL,46,468,0,468
KILLA ABDULLAH DISTRICT,GULISTAN TEHSIL,47,648,0,648
KILLA ABDULLAH DISTRICT,GULISTAN TEHSIL,48,495,0,495
KILLA ABDULLAH DISTRICT,GULISTAN TEHSIL,49,578,0,578
KILLA ABDULLAH DISTRICT,GULISTAN TEHSIL,50,573,0,573
KILLA ABDULLAH DISTRICT,GULISTAN TEHSIL,51,528,0,528
KILLA ABDULLAH DISTRICT,GULISTAN TEHSIL,52,529,0,529
KILLA ABDULLAH DISTRICT,GULISTAN TEHSIL,53,445,0,445
KILLA ABDULLAH DISTRICT,GULISTAN TEHSIL,54,450,0,450
KILLA ABDULLAH DISTRICT,GULISTAN TEHSIL,55,352,0,352
KILLA ABDULLAH DISTRICT,GULISTAN TEHSIL,56,275,0,275
KILLA ABDULLAH DISTRICT,GULISTAN TEHSIL,57,394,0,394
KILLA ABDULLAH DISTRICT,GULISTAN TEHSIL,58,299,0,299
KILLA ABDULLAH DISTRICT,GULISTAN TEHSIL,59,338,0,338
KILLA ABDULLAH DISTRICT,GULISTAN TEHSIL,60,284,0,284
KILLA ABDULLAH DISTRICT,GULISTAN TEHSIL,61,333,0,333
KILLA ABDULLAH DISTRICT,GULISTAN TEHSIL,62,290,0,290
KILLA ABDULLAH DISTRICT,GULISTAN TEHSIL,63,289,0,289
KILLA ABDULLAH DISTRICT,GULISTAN TEHSIL,64,348,0,348
KILLA ABDULLAH DISTRICT,GULISTAN TEHSIL,65,215,0,215
KILLA ABDULLAH DISTRICT,GULISTAN TEHSIL,66,212,0,212
KILLA ABDULLAH DISTRICT,GULISTAN TEHSIL,67,288,0,288
KILLA ABDULLAH DISTRICT,GULISTAN TEHSIL,68,213,0,213
KILLA ABDULLAH DISTRICT,GULISTAN TEHSIL,69,231,0,231
KILLA ABDULLAH DISTRICT,GULISTAN TEHSIL,70,161,0,161
KILLA ABDULLAH DISTRICT,GULISTAN TEHSIL,71,171,0,171
KILLA ABDULLAH DISTRICT,GULISTAN TEHSIL,72,168,0,168
KILLA ABDULLAH DISTRICT,GULISTAN TEHSIL,73,135,0,135
KILLA ABDULLAH DISTRICT,GULISTAN TEHSIL,74,148,0,148
KILLA ABDULLAH DISTRICT,GULISTAN TEHSIL,>=75,802,0,802
KILLA ABDULLAH DISTRICT,KILLA ABDULLAH TEHSIL,<1,4502,963,5465
KILLA ABDULLAH DISTRICT,KILLA ABDULLAH TEHSIL,1,4613,844,5457
KILLA ABDULLAH DISTRICT,KILLA ABDULLAH TEHSIL,2,4977,1097,6074
KILLA ABDULLAH DISTRICT,KILLA ABDULLAH TEHSIL,3,4681,1026,5707
KILLA ABDULLAH DISTRICT,KILLA ABDULLAH TEHSIL,4,4445,975,5420
KILLA ABDULLAH DISTRICT,KILLA ABDULLAH TEHSIL,5,4276,1029,5305
KILLA ABDULLAH DISTRICT,KILLA ABDULLAH TEHSIL,6,4227,908,5135
KILLA ABDULLAH DISTRICT,KILLA ABDULLAH TEHSIL,7,4244,965,5209
KILLA ABDULLAH DISTRICT,KILLA ABDULLAH TEHSIL,8,3914,882,4796
KILLA ABDULLAH DISTRICT,KILLA ABDULLAH TEHSIL,9,3993,1007,5000
KILLA ABDULLAH DISTRICT,KILLA ABDULLAH TEHSIL,10,3627,794,4421
KILLA ABDULLAH DISTRICT,KILLA ABDULLAH TEHSIL,11,3686,899,4585
KILLA ABDULLAH DISTRICT,KILLA ABDULLAH TEHSIL,12,3121,694,3815
KILLA ABDULLAH DISTRICT,KILLA ABDULLAH TEHSIL,13,3245,866,4111
KILLA ABDULLAH DISTRICT,KILLA ABDULLAH TEHSIL,14,3073,732,3805
KILLA ABDULLAH DISTRICT,KILLA ABDULLAH TEHSIL,15,2973,687,3660
KILLA ABDULLAH DISTRICT,KILLA ABDULLAH TEHSIL,16,2789,643,3432
KILLA ABDULLAH DISTRICT,KILLA ABDULLAH TEHSIL,17,2567,603,3170
KILLA ABDULLAH DISTRICT,KILLA ABDULLAH TEHSIL,18,2663,610,3273
KILLA ABDULLAH DISTRICT,KILLA ABDULLAH TEHSIL,19,2820,577,3397
KILLA ABDULLAH DISTRICT,KILLA ABDULLAH TEHSIL,20,2353,509,2862
KILLA ABDULLAH DISTRICT,KILLA ABDULLAH TEHSIL,21,2349,441,2790
KILLA ABDULLAH DISTRICT,KILLA ABDULLAH TEHSIL,22,1841,406,2247
KILLA ABDULLAH DISTRICT,KILLA ABDULLAH TEHSIL,23,1835,388,2223
KILLA ABDULLAH DISTRICT,KILLA ABDULLAH TEHSIL,24,1793,301,2094
KILLA ABDULLAH DISTRICT,KILLA ABDULLAH TEHSIL,25,1801,334,2135
KILLA ABDULLAH DISTRICT,KILLA ABDULLAH TEHSIL,26,1813,262,2075
KILLA ABDULLAH DISTRICT,KILLA ABDULLAH TEHSIL,27,1899,386,2285
KILLA ABDULLAH DISTRICT,KILLA ABDULLAH TEHSIL,28,1602,256,1858
KILLA ABDULLAH DISTRICT,KILLA ABDULLAH TEHSIL,29,1834,344,2178
KILLA ABDULLAH DISTRICT,KILLA ABDULLAH TEHSIL,30,1514,248,1762
KILLA ABDULLAH DISTRICT,KILLA ABDULLAH TEHSIL,31,1753,297,2050
KILLA ABDULLAH DISTRICT,KILLA ABDULLAH TEHSIL,32,1437,291,1728
KILLA ABDULLAH DISTRICT,KILLA ABDULLAH TEHSIL,33,1429,300,1729
KILLA ABDULLAH DISTRICT,KILLA ABDULLAH TEHSIL,34,1248,214,1462
KILLA ABDULLAH DISTRICT,KILLA ABDULLAH TEHSIL,35,1005,235,1240
KILLA ABDULLAH DISTRICT,KILLA ABDULLAH TEHSIL,36,1085,165,1250
KILLA ABDULLAH DISTRICT,KILLA ABDULLAH TEHSIL,37,1433,404,1837
KILLA ABDULLAH DISTRICT,KILLA ABDULLAH TEHSIL,38,1024,168,1192
KILLA ABDULLAH DISTRICT,KILLA ABDULLAH TEHSIL,39,1024,234,1258
KILLA ABDULLAH DISTRICT,KILLA ABDULLAH TEHSIL,40,719,133,852
KILLA ABDULLAH DISTRICT,KILLA ABDULLAH TEHSIL,41,770,147,917
KILLA ABDULLAH DISTRICT,KILLA ABDULLAH TEHSIL,42,621,167,788
KILLA ABDULLAH DISTRICT,KILLA ABDULLAH TEHSIL,43,584,126,710
KILLA ABDULLAH DISTRICT,KILLA ABDULLAH TEHSIL,44,572,95,667
KILLA ABDULLAH DISTRICT,KILLA ABDULLAH TEHSIL,45,498,98,596
KILLA ABDULLAH DISTRICT,KILLA ABDULLAH TEHSIL,46,564,91,655
KILLA ABDULLAH DISTRICT,KILLA ABDULLAH TEHSIL,47,754,208,962
KILLA ABDULLAH DISTRICT,KILLA ABDULLAH TEHSIL,48,539,97,636
KILLA ABDULLAH DISTRICT,KILLA ABDULLAH TEHSIL,49,641,144,785
KILLA ABDULLAH DISTRICT,KILLA ABDULLAH TEHSIL,50,537,98,635
KILLA ABDULLAH DISTRICT,KILLA ABDULLAH TEHSIL,51,643,137,780
KILLA ABDULLAH DISTRICT,KILLA ABDULLAH TEHSIL,52,551,130,681
KILLA ABDULLAH DISTRICT,KILLA ABDULLAH TEHSIL,53,472,99,571
KILLA ABDULLAH DISTRICT,KILLA ABDULLAH TEHSIL,54,377,87,464
KILLA ABDULLAH DISTRICT,KILLA ABDULLAH TEHSIL,55,333,71,404
KILLA ABDULLAH DISTRICT,KILLA ABDULLAH TEHSIL,56,363,51,414
KILLA ABDULLAH DISTRICT,KILLA ABDULLAH TEHSIL,57,416,137,553
KILLA ABDULLAH DISTRICT,KILLA ABDULLAH TEHSIL,58,272,53,325
KILLA ABDULLAH DISTRICT,KILLA ABDULLAH TEHSIL,59,317,69,386
KILLA ABDULLAH DISTRICT,KILLA ABDULLAH TEHSIL,60,260,62,322
KILLA ABDULLAH DISTRICT,KILLA ABDULLAH TEHSIL,61,311,60,371
KILLA ABDULLAH DISTRICT,KILLA ABDULLAH TEHSIL,62,311,66,377
KILLA ABDULLAH DISTRICT,KILLA ABDULLAH TEHSIL,63,322,32,354
KILLA ABDULLAH DISTRICT,KILLA ABDULLAH TEHSIL,64,263,68,331
KILLA ABDULLAH DISTRICT,KILLA ABDULLAH TEHSIL,65,197,34,231
KILLA ABDULLAH DISTRICT,KILLA ABDULLAH TEHSIL,66,230,35,265
KILLA ABDULLAH DISTRICT,KILLA ABDULLAH TEHSIL,67,255,84,339
KILLA ABDULLAH DISTRICT,KILLA ABDULLAH TEHSIL,68,202,44,246
KILLA ABDULLAH DISTRICT,KILLA ABDULLAH TEHSIL,69,171,62,233
KILLA ABDULLAH DISTRICT,KILLA ABDULLAH TEHSIL,70,104,27,131
KILLA ABDULLAH DISTRICT,KILLA ABDULLAH TEHSIL,71,175,36,211
KILLA ABDULLAH DISTRICT,KILLA ABDULLAH TEHSIL,72,139,43,182
KILLA ABDULLAH DISTRICT,KILLA ABDULLAH TEHSIL,73,124,31,155
KILLA ABDULLAH DISTRICT,KILLA ABDULLAH TEHSIL,74,100,34,134
KILLA ABDULLAH DISTRICT,KILLA ABDULLAH TEHSIL,>=75,729,184,913
KILLA SAIFULLAH DISTRICT,BADINI SUB-TEHSIL,<1,737,0,737
KILLA SAIFULLAH DISTRICT,BADINI SUB-TEHSIL,1,594,0,594
KILLA SAIFULLAH DISTRICT,BADINI SUB-TEHSIL,2,710,0,710
KILLA SAIFULLAH DISTRICT,BADINI SUB-TEHSIL,3,674,0,674
KILLA SAIFULLAH DISTRICT,BADINI SUB-TEHSIL,4,713,0,713
KILLA SAIFULLAH DISTRICT,BADINI SUB-TEHSIL,5,647,0,647
KILLA SAIFULLAH DISTRICT,BADINI SUB-TEHSIL,6,693,0,693
KILLA SAIFULLAH DISTRICT,BADINI SUB-TEHSIL,7,587,0,587
KILLA SAIFULLAH DISTRICT,BADINI SUB-TEHSIL,8,687,0,687
KILLA SAIFULLAH DISTRICT,BADINI SUB-TEHSIL,9,620,0,620
KILLA SAIFULLAH DISTRICT,BADINI SUB-TEHSIL,10,622,0,622
KILLA SAIFULLAH DISTRICT,BADINI SUB-TEHSIL,11,480,0,480
KILLA SAIFULLAH DISTRICT,BADINI SUB-TEHSIL,12,398,0,398
KILLA SAIFULLAH DISTRICT,BADINI SUB-TEHSIL,13,411,0,411
KILLA SAIFULLAH DISTRICT,BADINI SUB-TEHSIL,14,376,0,376
KILLA SAIFULLAH DISTRICT,BADINI SUB-TEHSIL,15,340,0,340
KILLA SAIFULLAH DISTRICT,BADINI SUB-TEHSIL,16,279,0,279
KILLA SAIFULLAH DISTRICT,BADINI SUB-TEHSIL,17,253,0,253
KILLA SAIFULLAH DISTRICT,BADINI SUB-TEHSIL,18,241,0,241
KILLA SAIFULLAH DISTRICT,BADINI SUB-TEHSIL,19,214,0,214
KILLA SAIFULLAH DISTRICT,BADINI SUB-TEHSIL,20,253,0,253
KILLA SAIFULLAH DISTRICT,BADINI SUB-TEHSIL,21,198,0,198
KILLA SAIFULLAH DISTRICT,BADINI SUB-TEHSIL,22,146,0,146
KILLA SAIFULLAH DISTRICT,BADINI SUB-TEHSIL,23,156,0,156
KILLA SAIFULLAH DISTRICT,BADINI SUB-TEHSIL,24,137,0,137
KILLA SAIFULLAH DISTRICT,BADINI SUB-TEHSIL,25,193,0,193
KILLA SAIFULLAH DISTRICT,BADINI SUB-TEHSIL,26,164,0,164
KILLA SAIFULLAH DISTRICT,BADINI SUB-TEHSIL,27,179,0,179
KILLA SAIFULLAH DISTRICT,BADINI SUB-TEHSIL,28,150,0,150
KILLA SAIFULLAH DISTRICT,BADINI SUB-TEHSIL,29,187,0,187
KILLA SAIFULLAH DISTRICT,BADINI SUB-TEHSIL,30,203,0,203
KILLA SAIFULLAH DISTRICT,BADINI SUB-TEHSIL,31,184,0,184
KILLA SAIFULLAH DISTRICT,BADINI SUB-TEHSIL,32,160,0,160
KILLA SAIFULLAH DISTRICT,BADINI SUB-TEHSIL,33,145,0,145
KILLA SAIFULLAH DISTRICT,BADINI SUB-TEHSIL,34,130,0,130
KILLA SAIFULLAH DISTRICT,BADINI SUB-TEHSIL,35,126,0,126
KILLA SAIFULLAH DISTRICT,BADINI SUB-TEHSIL,36,103,0,103
KILLA SAIFULLAH DISTRICT,BADINI SUB-TEHSIL,37,160,0,160
KILLA SAIFULLAH DISTRICT,BADINI SUB-TEHSIL,38,90,0,90
KILLA SAIFULLAH DISTRICT,BADINI SUB-TEHSIL,39,123,0,123
KILLA SAIFULLAH DISTRICT,BADINI SUB-TEHSIL,40,136,0,136
KILLA SAIFULLAH DISTRICT,BADINI SUB-TEHSIL,41,84,0,84
KILLA SAIFULLAH DISTRICT,BADINI SUB-TEHSIL,42,72,0,72
KILLA SAIFULLAH DISTRICT,BADINI SUB-TEHSIL,43,65,0,65
KILLA SAIFULLAH DISTRICT,BADINI SUB-TEHSIL,44,62,0,62
KILLA SAIFULLAH DISTRICT,BADINI SUB-TEHSIL,45,73,0,73
KILLA SAIFULLAH DISTRICT,BADINI SUB-TEHSIL,46,71,0,71
KILLA SAIFULLAH DISTRICT,BADINI SUB-TEHSIL,47,82,0,82
KILLA SAIFULLAH DISTRICT,BADINI SUB-TEHSIL,48,41,0,41
KILLA SAIFULLAH DISTRICT,BADINI SUB-TEHSIL,49,66,0,66
KILLA SAIFULLAH DISTRICT,BADINI SUB-TEHSIL,50,71,0,71
KILLA SAIFULLAH DISTRICT,BADINI SUB-TEHSIL,51,63,0,63
KILLA SAIFULLAH DISTRICT,BADINI SUB-TEHSIL,52,45,0,45
KILLA SAIFULLAH DISTRICT,BADINI SUB-TEHSIL,53,46,0,46
KILLA SAIFULLAH DISTRICT,BADINI SUB-TEHSIL,54,49,0,49
KILLA SAIFULLAH DISTRICT,BADINI SUB-TEHSIL,55,38,0,38
KILLA SAIFULLAH DISTRICT,BADINI SUB-TEHSIL,56,29,0,29
KILLA SAIFULLAH DISTRICT,BADINI SUB-TEHSIL,57,38,0,38
KILLA SAIFULLAH DISTRICT,BADINI SUB-TEHSIL,58,39,0,39
KILLA SAIFULLAH DISTRICT,BADINI SUB-TEHSIL,59,37,0,37
KILLA SAIFULLAH DISTRICT,BADINI SUB-TEHSIL,60,54,0,54
KILLA SAIFULLAH DISTRICT,BADINI SUB-TEHSIL,61,38,0,38
KILLA SAIFULLAH DISTRICT,BADINI SUB-TEHSIL,62,29,0,29
KILLA SAIFULLAH DISTRICT,BADINI SUB-TEHSIL,63,38,0,38
KILLA SAIFULLAH DISTRICT,BADINI SUB-TEHSIL,64,38,0,38
KILLA SAIFULLAH DISTRICT,BADINI SUB-TEHSIL,65,29,0,29
KILLA SAIFULLAH DISTRICT,BADINI SUB-TEHSIL,66,32,0,32
KILLA SAIFULLAH DISTRICT,BADINI SUB-TEHSIL,67,35,0,35
KILLA SAIFULLAH DISTRICT,BADINI SUB-TEHSIL,68,26,0,26
KILLA SAIFULLAH DISTRICT,BADINI SUB-TEHSIL,69,46,0,46
KILLA SAIFULLAH DISTRICT,BADINI SUB-TEHSIL,70,23,0,23
KILLA SAIFULLAH DISTRICT,BADINI SUB-TEHSIL,71,24,0,24
KILLA SAIFULLAH DISTRICT,BADINI SUB-TEHSIL,72,19,0,19
KILLA SAIFULLAH DISTRICT,BADINI SUB-TEHSIL,73,21,0,21
KILLA SAIFULLAH DISTRICT,BADINI SUB-TEHSIL,74,23,0,23
KILLA SAIFULLAH DISTRICT,BADINI SUB-TEHSIL,>=75,200,0,200
KILLA SAIFULLAH DISTRICT,KAN MEHTARZAI SUB-TEHSIL,<1,1089,0,1089
KILLA SAIFULLAH DISTRICT,KAN MEHTARZAI SUB-TEHSIL,1,1301,0,1301
KILLA SAIFULLAH DISTRICT,KAN MEHTARZAI SUB-TEHSIL,2,1260,0,1260
KILLA SAIFULLAH DISTRICT,KAN MEHTARZAI SUB-TEHSIL,3,1343,0,1343
KILLA SAIFULLAH DISTRICT,KAN MEHTARZAI SUB-TEHSIL,4,1221,0,1221
KILLA SAIFULLAH DISTRICT,KAN MEHTARZAI SUB-TEHSIL,5,1255,0,1255
KILLA SAIFULLAH DISTRICT,KAN MEHTARZAI SUB-TEHSIL,6,1162,0,1162
KILLA SAIFULLAH DISTRICT,KAN MEHTARZAI SUB-TEHSIL,7,1206,0,1206
KILLA SAIFULLAH DISTRICT,KAN MEHTARZAI SUB-TEHSIL,8,1051,0,1051
KILLA SAIFULLAH DISTRICT,KAN MEHTARZAI SUB-TEHSIL,9,1096,0,1096
KILLA SAIFULLAH DISTRICT,KAN MEHTARZAI SUB-TEHSIL,10,912,0,912
KILLA SAIFULLAH DISTRICT,KAN MEHTARZAI SUB-TEHSIL,11,957,0,957
KILLA SAIFULLAH DISTRICT,KAN MEHTARZAI SUB-TEHSIL,12,802,0,802
KILLA SAIFULLAH DISTRICT,KAN MEHTARZAI SUB-TEHSIL,13,864,0,864
KILLA SAIFULLAH DISTRICT,KAN MEHTARZAI SUB-TEHSIL,14,771,0,771
KILLA SAIFULLAH DISTRICT,KAN MEHTARZAI SUB-TEHSIL,15,734,0,734
KILLA SAIFULLAH DISTRICT,KAN MEHTARZAI SUB-TEHSIL,16,664,0,664
KILLA SAIFULLAH DISTRICT,KAN MEHTARZAI SUB-TEHSIL,17,642,0,642
KILLA SAIFULLAH DISTRICT,KAN MEHTARZAI SUB-TEHSIL,18,694,0,694
KILLA SAIFULLAH DISTRICT,KAN MEHTARZAI SUB-TEHSIL,19,666,0,666
KILLA SAIFULLAH DISTRICT,KAN MEHTARZAI SUB-TEHSIL,20,597,0,597
KILLA SAIFULLAH DISTRICT,KAN MEHTARZAI SUB-TEHSIL,21,568,0,568
KILLA SAIFULLAH DISTRICT,KAN MEHTARZAI SUB-TEHSIL,22,510,0,510
KILLA SAIFULLAH DISTRICT,KAN MEHTARZAI SUB-TEHSIL,23,506,0,506
KILLA SAIFULLAH DISTRICT,KAN MEHTARZAI SUB-TEHSIL,24,433,0,433
KILLA SAIFULLAH DISTRICT,KAN MEHTARZAI SUB-TEHSIL,25,541,0,541
KILLA SAIFULLAH DISTRICT,KAN MEHTARZAI SUB-TEHSIL,26,597,0,597
KILLA SAIFULLAH DISTRICT,KAN MEHTARZAI SUB-TEHSIL,27,546,0,546
KILLA SAIFULLAH DISTRICT,KAN MEHTARZAI SUB-TEHSIL,28,470,0,470
KILLA SAIFULLAH DISTRICT,KAN MEHTARZAI SUB-TEHSIL,29,592,0,592
KILLA SAIFULLAH DISTRICT,KAN MEHTARZAI SUB-TEHSIL,30,451,0,451
KILLA SAIFULLAH DISTRICT,KAN MEHTARZAI SUB-TEHSIL,31,528,0,528
KILLA SAIFULLAH DISTRICT,KAN MEHTARZAI SUB-TEHSIL,32,398,0,398
KILLA SAIFULLAH DISTRICT,KAN MEHTARZAI SUB-TEHSIL,33,386,0,386
KILLA SAIFULLAH DISTRICT,KAN MEHTARZAI SUB-TEHSIL,34,348,0,348
KILLA SAIFULLAH DISTRICT,KAN MEHTARZAI SUB-TEHSIL,35,285,0,285
KILLA SAIFULLAH DISTRICT,KAN MEHTARZAI SUB-TEHSIL,36,323,0,323
KILLA SAIFULLAH DISTRICT,KAN MEHTARZAI SUB-TEHSIL,37,374,0,374
KILLA SAIFULLAH DISTRICT,KAN MEHTARZAI SUB-TEHSIL,38,256,0,256
KILLA SAIFULLAH DISTRICT,KAN MEHTARZAI SUB-TEHSIL,39,262,0,262
KILLA SAIFULLAH DISTRICT,KAN MEHTARZAI SUB-TEHSIL,40,211,0,211
KILLA SAIFULLAH DISTRICT,KAN MEHTARZAI SUB-TEHSIL,41,234,0,234
KILLA SAIFULLAH DISTRICT,KAN MEHTARZAI SUB-TEHSIL,42,206,0,206
KILLA SAIFULLAH DISTRICT,KAN MEHTARZAI SUB-TEHSIL,43,163,0,163
KILLA SAIFULLAH DISTRICT,KAN MEHTARZAI SUB-TEHSIL,44,140,0,140
KILLA SAIFULLAH DISTRICT,KAN MEHTARZAI SUB-TEHSIL,45,165,0,165
KILLA SAIFULLAH DISTRICT,KAN MEHTARZAI SUB-TEHSIL,46,184,0,184
KILLA SAIFULLAH DISTRICT,KAN MEHTARZAI SUB-TEHSIL,47,198,0,198
KILLA SAIFULLAH DISTRICT,KAN MEHTARZAI SUB-TEHSIL,48,163,0,163
KILLA SAIFULLAH DISTRICT,KAN MEHTARZAI SUB-TEHSIL,49,160,0,160
KILLA SAIFULLAH DISTRICT,KAN MEHTARZAI SUB-TEHSIL,50,143,0,143
KILLA SAIFULLAH DISTRICT,KAN MEHTARZAI SUB-TEHSIL,51,160,0,160
KILLA SAIFULLAH DISTRICT,KAN MEHTARZAI SUB-TEHSIL,52,185,0,185
KILLA SAIFULLAH DISTRICT,KAN MEHTARZAI SUB-TEHSIL,53,146,0,146
KILLA SAIFULLAH DISTRICT,KAN MEHTARZAI SUB-TEHSIL,54,121,0,121
KILLA SAIFULLAH DISTRICT,KAN MEHTARZAI SUB-TEHSIL,55,129,0,129
KILLA SAIFULLAH DISTRICT,KAN MEHTARZAI SUB-TEHSIL,56,133,0,133
KILLA SAIFULLAH DISTRICT,KAN MEHTARZAI SUB-TEHSIL,57,143,0,143
KILLA SAIFULLAH DISTRICT,KAN MEHTARZAI SUB-TEHSIL,58,111,0,111
KILLA SAIFULLAH DISTRICT,KAN MEHTARZAI SUB-TEHSIL,59,103,0,103
KILLA SAIFULLAH DISTRICT,KAN MEHTARZAI SUB-TEHSIL,60,105,0,105
KILLA SAIFULLAH DISTRICT,KAN MEHTARZAI SUB-TEHSIL,61,116,0,116
KILLA SAIFULLAH DISTRICT,KAN MEHTARZAI SUB-TEHSIL,62,98,0,98
KILLA SAIFULLAH DISTRICT,KAN MEHTARZAI SUB-TEHSIL,63,87,0,87
KILLA SAIFULLAH DISTRICT,KAN MEHTARZAI SUB-TEHSIL,64,82,0,82
KILLA SAIFULLAH DISTRICT,KAN MEHTARZAI SUB-TEHSIL,65,58,0,58
KILLA SAIFULLAH DISTRICT,KAN MEHTARZAI SUB-TEHSIL,66,89,0,89
KILLA SAIFULLAH DISTRICT,KAN MEHTARZAI SUB-TEHSIL,67,95,0,95
KILLA SAIFULLAH DISTRICT,KAN MEHTARZAI SUB-TEHSIL,68,71,0,71
KILLA SAIFULLAH DISTRICT,KAN MEHTARZAI SUB-TEHSIL,69,72,0,72
KILLA SAIFULLAH DISTRICT,KAN MEHTARZAI SUB-TEHSIL,70,60,0,60
KILLA SAIFULLAH DISTRICT,KAN MEHTARZAI SUB-TEHSIL,71,71,0,71
KILLA SAIFULLAH DISTRICT,KAN MEHTARZAI SUB-TEHSIL,72,45,0,45
KILLA SAIFULLAH DISTRICT,KAN MEHTARZAI SUB-TEHSIL,73,29,0,29
KILLA SAIFULLAH DISTRICT,KAN MEHTARZAI SUB-TEHSIL,74,35,0,35
KILLA SAIFULLAH DISTRICT,KAN MEHTARZAI SUB-TEHSIL,>=75,270,0,270
KILLA SAIFULLAH DISTRICT,KILLA SAIFULLAH TEHSIL,<1,2968,1111,4079
KILLA SAIFULLAH DISTRICT,KILLA SAIFULLAH TEHSIL,1,4001,1197,5198
KILLA SAIFULLAH DISTRICT,KILLA SAIFULLAH TEHSIL,2,4376,1347,5723
KILLA SAIFULLAH DISTRICT,KILLA SAIFULLAH TEHSIL,3,4284,1431,5715
KILLA SAIFULLAH DISTRICT,KILLA SAIFULLAH TEHSIL,4,4191,1352,5543
KILLA SAIFULLAH DISTRICT,KILLA SAIFULLAH TEHSIL,5,4064,1358,5422
KILLA SAIFULLAH DISTRICT,KILLA SAIFULLAH TEHSIL,6,3907,1291,5198
KILLA SAIFULLAH DISTRICT,KILLA SAIFULLAH TEHSIL,7,3965,1299,5264
KILLA SAIFULLAH DISTRICT,KILLA SAIFULLAH TEHSIL,8,3712,1272,4984
KILLA SAIFULLAH DISTRICT,KILLA SAIFULLAH TEHSIL,9,3684,1246,4930
KILLA SAIFULLAH DISTRICT,KILLA SAIFULLAH TEHSIL,10,3336,1026,4362
KILLA SAIFULLAH DISTRICT,KILLA SAIFULLAH TEHSIL,11,2872,1035,3907
KILLA SAIFULLAH DISTRICT,KILLA SAIFULLAH TEHSIL,12,2651,884,3535
KILLA SAIFULLAH DISTRICT,KILLA SAIFULLAH TEHSIL,13,2551,908,3459
KILLA SAIFULLAH DISTRICT,KILLA SAIFULLAH TEHSIL,14,2178,803,2981
KILLA SAIFULLAH DISTRICT,KILLA SAIFULLAH TEHSIL,15,2232,770,3002
KILLA SAIFULLAH DISTRICT,KILLA SAIFULLAH TEHSIL,16,1895,711,2606
KILLA SAIFULLAH DISTRICT,KILLA SAIFULLAH TEHSIL,17,1741,607,2348
KILLA SAIFULLAH DISTRICT,KILLA SAIFULLAH TEHSIL,18,1955,768,2723
KILLA SAIFULLAH DISTRICT,KILLA SAIFULLAH TEHSIL,19,1798,719,2517
KILLA SAIFULLAH DISTRICT,KILLA SAIFULLAH TEHSIL,20,1818,685,2503
KILLA SAIFULLAH DISTRICT,KILLA SAIFULLAH TEHSIL,21,1485,613,2098
KILLA SAIFULLAH DISTRICT,KILLA SAIFULLAH TEHSIL,22,1163,528,1691
KILLA SAIFULLAH DISTRICT,KILLA SAIFULLAH TEHSIL,23,1256,550,1806
KILLA SAIFULLAH DISTRICT,KILLA SAIFULLAH TEHSIL,24,1047,442,1489
KILLA SAIFULLAH DISTRICT,KILLA SAIFULLAH TEHSIL,25,1616,624,2240
KILLA SAIFULLAH DISTRICT,KILLA SAIFULLAH TEHSIL,26,1202,469,1671
KILLA SAIFULLAH DISTRICT,KILLA SAIFULLAH TEHSIL,27,1256,465,1721
KILLA SAIFULLAH DISTRICT,KILLA SAIFULLAH TEHSIL,28,1154,488,1642
KILLA SAIFULLAH DISTRICT,KILLA SAIFULLAH TEHSIL,29,1205,479,1684
KILLA SAIFULLAH DISTRICT,KILLA SAIFULLAH TEHSIL,30,1306,519,1825
KILLA SAIFULLAH DISTRICT,KILLA SAIFULLAH TEHSIL,31,1146,405,1551
KILLA SAIFULLAH DISTRICT,KILLA SAIFULLAH TEHSIL,32,867,331,1198
KILLA SAIFULLAH DISTRICT,KILLA SAIFULLAH TEHSIL,33,900,375,1275
KILLA SAIFULLAH DISTRICT,KILLA SAIFULLAH TEHSIL,34,742,278,1020
KILLA SAIFULLAH DISTRICT,KILLA SAIFULLAH TEHSIL,35,968,369,1337
KILLA SAIFULLAH DISTRICT,KILLA SAIFULLAH TEHSIL,36,839,289,1128
KILLA SAIFULLAH DISTRICT,KILLA SAIFULLAH TEHSIL,37,810,305,1115
KILLA SAIFULLAH DISTRICT,KILLA SAIFULLAH TEHSIL,38,711,312,1023
KILLA SAIFULLAH DISTRICT,KILLA SAIFULLAH TEHSIL,39,719,287,1006
KILLA SAIFULLAH DISTRICT,KILLA SAIFULLAH TEHSIL,40,924,365,1289
KILLA SAIFULLAH DISTRICT,KILLA SAIFULLAH TEHSIL,41,635,258,893
KILLA SAIFULLAH DISTRICT,KILLA SAIFULLAH TEHSIL,42,475,189,664
KILLA SAIFULLAH DISTRICT,KILLA SAIFULLAH TEHSIL,43,524,218,742
KILLA SAIFULLAH DISTRICT,KILLA SAIFULLAH TEHSIL,44,433,188,621
KILLA SAIFULLAH DISTRICT,KILLA SAIFULLAH TEHSIL,45,560,263,823
KILLA SAIFULLAH DISTRICT,KILLA SAIFULLAH TEHSIL,46,510,169,679
KILLA SAIFULLAH DISTRICT,KILLA SAIFULLAH TEHSIL,47,506,188,694
KILLA SAIFULLAH DISTRICT,KILLA SAIFULLAH TEHSIL,48,410,176,586
KILLA SAIFULLAH DISTRICT,KILLA SAIFULLAH TEHSIL,49,437,173,610
KILLA SAIFULLAH DISTRICT,KILLA SAIFULLAH TEHSIL,50,514,204,718
KILLA SAIFULLAH DISTRICT,KILLA SAIFULLAH TEHSIL,51,421,158,579
KILLA SAIFULLAH DISTRICT,KILLA SAIFULLAH TEHSIL,52,306,135,441
KILLA SAIFULLAH DISTRICT,KILLA SAIFULLAH TEHSIL,53,352,131,483
KILLA SAIFULLAH DISTRICT,KILLA SAIFULLAH TEHSIL,54,305,99,404
KILLA SAIFULLAH DISTRICT,KILLA SAIFULLAH TEHSIL,55,337,158,495
KILLA SAIFULLAH DISTRICT,KILLA SAIFULLAH TEHSIL,56,324,113,437
KILLA SAIFULLAH DISTRICT,KILLA SAIFULLAH TEHSIL,57,303,111,414
KILLA SAIFULLAH DISTRICT,KILLA SAIFULLAH TEHSIL,58,264,110,374
KILLA SAIFULLAH DISTRICT,KILLA SAIFULLAH TEHSIL,59,260,104,364
KILLA SAIFULLAH DISTRICT,KILLA SAIFULLAH TEHSIL,60,364,161,525
KILLA SAIFULLAH DISTRICT,KILLA SAIFULLAH TEHSIL,61,269,89,358
KILLA SAIFULLAH DISTRICT,KILLA SAIFULLAH TEHSIL,62,208,72,280
KILLA SAIFULLAH DISTRICT,KILLA SAIFULLAH TEHSIL,63,250,98,348
KILLA SAIFULLAH DISTRICT,KILLA SAIFULLAH TEHSIL,64,277,94,371
KILLA SAIFULLAH DISTRICT,KILLA SAIFULLAH TEHSIL,65,221,73,294
KILLA SAIFULLAH DISTRICT,KILLA SAIFULLAH TEHSIL,66,216,55,271
KILLA SAIFULLAH DISTRICT,KILLA SAIFULLAH TEHSIL,67,206,62,268
KILLA SAIFULLAH DISTRICT,KILLA SAIFULLAH TEHSIL,68,179,65,244
KILLA SAIFULLAH DISTRICT,KILLA SAIFULLAH TEHSIL,69,178,65,243
KILLA SAIFULLAH DISTRICT,KILLA SAIFULLAH TEHSIL,70,182,57,239
KILLA SAIFULLAH DISTRICT,KILLA SAIFULLAH TEHSIL,71,150,52,202
KILLA SAIFULLAH DISTRICT,KILLA SAIFULLAH TEHSIL,72,103,43,146
KILLA SAIFULLAH DISTRICT,KILLA SAIFULLAH TEHSIL,73,165,48,213
KILLA SAIFULLAH DISTRICT,KILLA SAIFULLAH TEHSIL,74,136,38,174
KILLA SAIFULLAH DISTRICT,KILLA SAIFULLAH TEHSIL,>=75,1006,335,1341
KILLA SAIFULLAH DISTRICT,LOIBAND TEHSIL,<1,1111,0,1111
KILLA SAIFULLAH DISTRICT,LOIBAND TEHSIL,1,1051,0,1051
KILLA SAIFULLAH DISTRICT,LOIBAND TEHSIL,2,1308,0,1308
KILLA SAIFULLAH DISTRICT,LOIBAND TEHSIL,3,1272,0,1272
KILLA SAIFULLAH DISTRICT,LOIBAND TEHSIL,4,1315,0,1315
KILLA SAIFULLAH DISTRICT,LOIBAND TEHSIL,5,1161,0,1161
KILLA SAIFULLAH DISTRICT,LOIBAND TEHSIL,6,1257,0,1257
KILLA SAIFULLAH DISTRICT,LOIBAND TEHSIL,7,1090,0,1090
KILLA SAIFULLAH DISTRICT,LOIBAND TEHSIL,8,1103,0,1103
KILLA SAIFULLAH DISTRICT,LOIBAND TEHSIL,9,1040,0,1040
KILLA SAIFULLAH DISTRICT,LOIBAND TEHSIL,10,923,0,923
KILLA SAIFULLAH DISTRICT,LOIBAND TEHSIL,11,840,0,840
KILLA SAIFULLAH DISTRICT,LOIBAND TEHSIL,12,740,0,740
KILLA SAIFULLAH DISTRICT,LOIBAND TEHSIL,13,683,0,683
KILLA SAIFULLAH DISTRICT,LOIBAND TEHSIL,14,636,0,636
KILLA SAIFULLAH DISTRICT,LOIBAND TEHSIL,15,574,0,574
KILLA SAIFULLAH DISTRICT,LOIBAND TEHSIL,16,463,0,463
KILLA SAIFULLAH DISTRICT,LOIBAND TEHSIL,17,442,0,442
KILLA SAIFULLAH DISTRICT,LOIBAND TEHSIL,18,534,0,534
KILLA SAIFULLAH DISTRICT,LOIBAND TEHSIL,19,437,0,437
KILLA SAIFULLAH DISTRICT,LOIBAND TEHSIL,20,461,0,461
KILLA SAIFULLAH DISTRICT,LOIBAND TEHSIL,21,349,0,349
KILLA SAIFULLAH DISTRICT,LOIBAND TEHSIL,22,355,0,355
KILLA SAIFULLAH DISTRICT,LOIBAND TEHSIL,23,368,0,368
KILLA SAIFULLAH DISTRICT,LOIBAND TEHSIL,24,298,0,298
KILLA SAIFULLAH DISTRICT,LOIBAND TEHSIL,25,407,0,407
KILLA SAIFULLAH DISTRICT,LOIBAND TEHSIL,26,426,0,426
KILLA SAIFULLAH DISTRICT,LOIBAND TEHSIL,27,413,0,413
KILLA SAIFULLAH DISTRICT,LOIBAND TEHSIL,28,376,0,376
KILLA SAIFULLAH DISTRICT,LOIBAND TEHSIL,29,437,0,437
KILLA SAIFULLAH DISTRICT,LOIBAND TEHSIL,30,348,0,348
KILLA SAIFULLAH DISTRICT,LOIBAND TEHSIL,31,330,0,330
KILLA SAIFULLAH DISTRICT,LOIBAND TEHSIL,32,280,0,280
KILLA SAIFULLAH DISTRICT,LOIBAND TEHSIL,33,309,0,309
KILLA SAIFULLAH DISTRICT,LOIBAND TEHSIL,34,263,0,263
KILLA SAIFULLAH DISTRICT,LOIBAND TEHSIL,35,216,0,216
KILLA SAIFULLAH DISTRICT,LOIBAND TEHSIL,36,199,0,199
KILLA SAIFULLAH DISTRICT,LOIBAND TEHSIL,37,292,0,292
KILLA SAIFULLAH DISTRICT,LOIBAND TEHSIL,38,184,0,184
KILLA SAIFULLAH DISTRICT,LOIBAND TEHSIL,39,223,0,223
KILLA SAIFULLAH DISTRICT,LOIBAND TEHSIL,40,176,0,176
KILLA SAIFULLAH DISTRICT,LOIBAND TEHSIL,41,168,0,168
KILLA SAIFULLAH DISTRICT,LOIBAND TEHSIL,42,170,0,170
KILLA SAIFULLAH DISTRICT,LOIBAND TEHSIL,43,146,0,146
KILLA SAIFULLAH DISTRICT,LOIBAND TEHSIL,44,143,0,143
KILLA SAIFULLAH DISTRICT,LOIBAND TEHSIL,45,121,0,121
KILLA SAIFULLAH DISTRICT,LOIBAND TEHSIL,46,109,0,109
KILLA SAIFULLAH DISTRICT,LOIBAND TEHSIL,47,160,0,160
KILLA SAIFULLAH DISTRICT,LOIBAND TEHSIL,48,116,0,116
KILLA SAIFULLAH DISTRICT,LOIBAND TEHSIL,49,145,0,145
KILLA SAIFULLAH DISTRICT,LOIBAND TEHSIL,50,100,0,100
KILLA SAIFULLAH DISTRICT,LOIBAND TEHSIL,51,134,0,134
KILLA SAIFULLAH DISTRICT,LOIBAND TEHSIL,52,104,0,104
KILLA SAIFULLAH DISTRICT,LOIBAND TEHSIL,53,95,0,95
KILLA SAIFULLAH DISTRICT,LOIBAND TEHSIL,54,86,0,86
KILLA SAIFULLAH DISTRICT,LOIBAND TEHSIL,55,75,0,75
KILLA SAIFULLAH DISTRICT,LOIBAND TEHSIL,56,59,0,59
KILLA SAIFULLAH DISTRICT,LOIBAND TEHSIL,57,75,0,75
KILLA SAIFULLAH DISTRICT,LOIBAND TEHSIL,58,81,0,81
KILLA SAIFULLAH DISTRICT,LOIBAND TEHSIL,59,110,0,110
KILLA SAIFULLAH DISTRICT,LOIBAND TEHSIL,60,67,0,67
KILLA SAIFULLAH DISTRICT,LOIBAND TEHSIL,61,78,0,78
KILLA SAIFULLAH DISTRICT,LOIBAND TEHSIL,62,49,0,49
KILLA SAIFULLAH DISTRICT,LOIBAND TEHSIL,63,76,0,76
KILLA SAIFULLAH DISTRICT,LOIBAND TEHSIL,64,105,0,105
KILLA SAIFULLAH DISTRICT,LOIBAND TEHSIL,65,57,0,57
KILLA SAIFULLAH DISTRICT,LOIBAND TEHSIL,66,54,0,54
KILLA SAIFULLAH DISTRICT,LOIBAND TEHSIL,67,57,0,57
KILLA SAIFULLAH DISTRICT,LOIBAND TEHSIL,68,56,0,56
KILLA SAIFULLAH DISTRICT,LOIBAND TEHSIL,69,69,0,69
KILLA SAIFULLAH DISTRICT,LOIBAND TEHSIL,70,34,0,34
KILLA SAIFULLAH DISTRICT,LOIBAND TEHSIL,71,33,0,33
KILLA SAIFULLAH DISTRICT,LOIBAND TEHSIL,72,28,0,28
KILLA SAIFULLAH DISTRICT,LOIBAND TEHSIL,73,40,0,40
KILLA SAIFULLAH DISTRICT,LOIBAND TEHSIL,74,47,0,47
KILLA SAIFULLAH DISTRICT,LOIBAND TEHSIL,>=75,225,0,225
KILLA SAIFULLAH DISTRICT,MUSLIM BAGH TEHSIL,<1,1753,765,2518
KILLA SAIFULLAH DISTRICT,MUSLIM BAGH TEHSIL,1,2098,1157,3255
KILLA SAIFULLAH DISTRICT,MUSLIM BAGH TEHSIL,2,2327,1080,3407
KILLA SAIFULLAH DISTRICT,MUSLIM BAGH TEHSIL,3,2079,1113,3192
KILLA SAIFULLAH DISTRICT,MUSLIM BAGH TEHSIL,4,2194,1097,3291
KILLA SAIFULLAH DISTRICT,MUSLIM BAGH TEHSIL,5,1989,1023,3012
KILLA SAIFULLAH DISTRICT,MUSLIM BAGH TEHSIL,6,2151,993,3144
KILLA SAIFULLAH DISTRICT,MUSLIM BAGH TEHSIL,7,1863,991,2854
KILLA SAIFULLAH DISTRICT,MUSLIM BAGH TEHSIL,8,1884,865,2749
KILLA SAIFULLAH DISTRICT,MUSLIM BAGH TEHSIL,9,1735,870,2605
KILLA SAIFULLAH DISTRICT,MUSLIM BAGH TEHSIL,10,1607,721,2328
KILLA SAIFULLAH DISTRICT,MUSLIM BAGH TEHSIL,11,1398,744,2142
KILLA SAIFULLAH DISTRICT,MUSLIM BAGH TEHSIL,12,1292,658,1950
KILLA SAIFULLAH DISTRICT,MUSLIM BAGH TEHSIL,13,1225,671,1896
KILLA SAIFULLAH DISTRICT,MUSLIM BAGH TEHSIL,14,1164,593,1757
KILLA SAIFULLAH DISTRICT,MUSLIM BAGH TEHSIL,15,972,588,1560
KILLA SAIFULLAH DISTRICT,MUSLIM BAGH TEHSIL,16,997,576,1573
KILLA SAIFULLAH DISTRICT,MUSLIM BAGH TEHSIL,17,817,590,1407
KILLA SAIFULLAH DISTRICT,MUSLIM BAGH TEHSIL,18,1047,604,1651
KILLA SAIFULLAH DISTRICT,MUSLIM BAGH TEHSIL,19,863,563,1426
KILLA SAIFULLAH DISTRICT,MUSLIM BAGH TEHSIL,20,918,495,1413
KILLA SAIFULLAH DISTRICT,MUSLIM BAGH TEHSIL,21,774,572,1346
KILLA SAIFULLAH DISTRICT,MUSLIM BAGH TEHSIL,22,671,464,1135
KILLA SAIFULLAH DISTRICT,MUSLIM BAGH TEHSIL,23,629,475,1104
KILLA SAIFULLAH DISTRICT,MUSLIM BAGH TEHSIL,24,588,421,1009
KILLA SAIFULLAH DISTRICT,MUSLIM BAGH TEHSIL,25,781,454,1235
KILLA SAIFULLAH DISTRICT,MUSLIM BAGH TEHSIL,26,769,554,1323
KILLA SAIFULLAH DISTRICT,MUSLIM BAGH TEHSIL,27,706,457,1163
KILLA SAIFULLAH DISTRICT,MUSLIM BAGH TEHSIL,28,719,445,1164
KILLA SAIFULLAH DISTRICT,MUSLIM BAGH TEHSIL,29,731,488,1219
KILLA SAIFULLAH DISTRICT,MUSLIM BAGH TEHSIL,30,640,383,1023
KILLA SAIFULLAH DISTRICT,MUSLIM BAGH TEHSIL,31,695,404,1099
KILLA SAIFULLAH DISTRICT,MUSLIM BAGH TEHSIL,32,470,348,818
KILLA SAIFULLAH DISTRICT,MUSLIM BAGH TEHSIL,33,534,315,849
KILLA SAIFULLAH DISTRICT,MUSLIM BAGH TEHSIL,34,472,339,811
KILLA SAIFULLAH DISTRICT,MUSLIM BAGH TEHSIL,35,451,260,711
KILLA SAIFULLAH DISTRICT,MUSLIM BAGH TEHSIL,36,506,299,805
KILLA SAIFULLAH DISTRICT,MUSLIM BAGH TEHSIL,37,453,305,758
KILLA SAIFULLAH DISTRICT,MUSLIM BAGH TEHSIL,38,394,265,659
KILLA SAIFULLAH DISTRICT,MUSLIM BAGH TEHSIL,39,396,284,680
KILLA SAIFULLAH DISTRICT,MUSLIM BAGH TEHSIL,40,417,228,645
KILLA SAIFULLAH DISTRICT,MUSLIM BAGH TEHSIL,41,334,209,543
KILLA SAIFULLAH DISTRICT,MUSLIM BAGH TEHSIL,42,232,185,417
KILLA SAIFULLAH DISTRICT,MUSLIM BAGH TEHSIL,43,266,173,439
KILLA SAIFULLAH DISTRICT,MUSLIM BAGH TEHSIL,44,222,157,379
KILLA SAIFULLAH DISTRICT,MUSLIM BAGH TEHSIL,45,247,141,388
KILLA SAIFULLAH DISTRICT,MUSLIM BAGH TEHSIL,46,282,169,451
KILLA SAIFULLAH DISTRICT,MUSLIM BAGH TEHSIL,47,213,157,370
KILLA SAIFULLAH DISTRICT,MUSLIM BAGH TEHSIL,48,194,148,342
KILLA SAIFULLAH DISTRICT,MUSLIM BAGH TEHSIL,49,229,157,386
KILLA SAIFULLAH DISTRICT,MUSLIM BAGH TEHSIL,50,260,132,392
KILLA SAIFULLAH DISTRICT,MUSLIM BAGH TEHSIL,51,202,143,345
KILLA SAIFULLAH DISTRICT,MUSLIM BAGH TEHSIL,52,152,126,278
KILLA SAIFULLAH DISTRICT,MUSLIM BAGH TEHSIL,53,175,145,320
KILLA SAIFULLAH DISTRICT,MUSLIM BAGH TEHSIL,54,183,109,292
KILLA SAIFULLAH DISTRICT,MUSLIM BAGH TEHSIL,55,158,119,277
KILLA SAIFULLAH DISTRICT,MUSLIM BAGH TEHSIL,56,191,123,314
KILLA SAIFULLAH DISTRICT,MUSLIM BAGH TEHSIL,57,170,85,255
KILLA SAIFULLAH DISTRICT,MUSLIM BAGH TEHSIL,58,177,102,279
KILLA SAIFULLAH DISTRICT,MUSLIM BAGH TEHSIL,59,155,114,269
KILLA SAIFULLAH DISTRICT,MUSLIM BAGH TEHSIL,60,199,77,276
KILLA SAIFULLAH DISTRICT,MUSLIM BAGH TEHSIL,61,158,98,256
KILLA SAIFULLAH DISTRICT,MUSLIM BAGH TEHSIL,62,119,82,201
KILLA SAIFULLAH DISTRICT,MUSLIM BAGH TEHSIL,63,163,73,236
KILLA SAIFULLAH DISTRICT,MUSLIM BAGH TEHSIL,64,146,92,238
KILLA SAIFULLAH DISTRICT,MUSLIM BAGH TEHSIL,65,103,63,166
KILLA SAIFULLAH DISTRICT,MUSLIM BAGH TEHSIL,66,148,81,229
KILLA SAIFULLAH DISTRICT,MUSLIM BAGH TEHSIL,67,96,76,172
KILLA SAIFULLAH DISTRICT,MUSLIM BAGH TEHSIL,68,107,50,157
KILLA SAIFULLAH DISTRICT,MUSLIM BAGH TEHSIL,69,111,48,159
KILLA SAIFULLAH DISTRICT,MUSLIM BAGH TEHSIL,70,81,42,123
KILLA SAIFULLAH DISTRICT,MUSLIM BAGH TEHSIL,71,74,59,133
KILLA SAIFULLAH DISTRICT,MUSLIM BAGH TEHSIL,72,44,34,78
KILLA SAIFULLAH DISTRICT,MUSLIM BAGH TEHSIL,73,77,48,125
KILLA SAIFULLAH DISTRICT,MUSLIM BAGH TEHSIL,74,48,32,80
KILLA SAIFULLAH DISTRICT,MUSLIM BAGH TEHSIL,>=75,398,262,660
KILLA SAIFULLAH DISTRICT,SHINKI SUB-TEHSIL,<1,1534,0,1534
KILLA SAIFULLAH DISTRICT,SHINKI SUB-TEHSIL,1,2408,0,2408
KILLA SAIFULLAH DISTRICT,SHINKI SUB-TEHSIL,2,2593,0,2593
KILLA SAIFULLAH DISTRICT,SHINKI SUB-TEHSIL,3,2750,0,2750
KILLA SAIFULLAH DISTRICT,SHINKI SUB-TEHSIL,4,2617,0,2617
KILLA SAIFULLAH DISTRICT,SHINKI SUB-TEHSIL,5,2401,0,2401
KILLA SAIFULLAH DISTRICT,SHINKI SUB-TEHSIL,6,2418,0,2418
KILLA SAIFULLAH DISTRICT,SHINKI SUB-TEHSIL,7,2371,0,2371
KILLA SAIFULLAH DISTRICT,SHINKI SUB-TEHSIL,8,2302,0,2302
KILLA SAIFULLAH DISTRICT,SHINKI SUB-TEHSIL,9,1986,0,1986
KILLA SAIFULLAH DISTRICT,SHINKI SUB-TEHSIL,10,1832,0,1832
KILLA SAIFULLAH DISTRICT,SHINKI SUB-TEHSIL,11,1421,0,1421
KILLA SAIFULLAH DISTRICT,SHINKI SUB-TEHSIL,12,1354,0,1354
KILLA SAIFULLAH DISTRICT,SHINKI SUB-TEHSIL,13,1246,0,1246
KILLA SAIFULLAH DISTRICT,SHINKI SUB-TEHSIL,14,994,0,994
KILLA SAIFULLAH DISTRICT,SHINKI SUB-TEHSIL,15,1011,0,1011
KILLA SAIFULLAH DISTRICT,SHINKI SUB-TEHSIL,16,794,0,794
KILLA SAIFULLAH DISTRICT,SHINKI SUB-TEHSIL,17,775,0,775
KILLA SAIFULLAH DISTRICT,SHINKI SUB-TEHSIL,18,1040,0,1040
KILLA SAIFULLAH DISTRICT,SHINKI SUB-TEHSIL,19,940,0,940
KILLA SAIFULLAH DISTRICT,SHINKI SUB-TEHSIL,20,965,0,965
KILLA SAIFULLAH DISTRICT,SHINKI SUB-TEHSIL,21,779,0,779
KILLA SAIFULLAH DISTRICT,SHINKI SUB-TEHSIL,22,643,0,643
KILLA SAIFULLAH DISTRICT,SHINKI SUB-TEHSIL,23,592,0,592
KILLA SAIFULLAH DISTRICT,SHINKI SUB-TEHSIL,24,513,0,513
KILLA SAIFULLAH DISTRICT,SHINKI SUB-TEHSIL,25,829,0,829
KILLA SAIFULLAH DISTRICT,SHINKI SUB-TEHSIL,26,620,0,620
KILLA SAIFULLAH DISTRICT,SHINKI SUB-TEHSIL,27,721,0,721
KILLA SAIFULLAH DISTRICT,SHINKI SUB-TEHSIL,28,694,0,694
KILLA SAIFULLAH DISTRICT,SHINKI SUB-TEHSIL,29,724,0,724
KILLA SAIFULLAH DISTRICT,SHINKI SUB-TEHSIL,30,693,0,693
KILLA SAIFULLAH DISTRICT,SHINKI SUB-TEHSIL,31,755,0,755
KILLA SAIFULLAH DISTRICT,SHINKI SUB-TEHSIL,32,607,0,607
KILLA SAIFULLAH DISTRICT,SHINKI SUB-TEHSIL,33,548,0,548
KILLA SAIFULLAH DISTRICT,SHINKI SUB-TEHSIL,34,406,0,406
KILLA SAIFULLAH DISTRICT,SHINKI SUB-TEHSIL,35,498,0,498
KILLA SAIFULLAH DISTRICT,SHINKI SUB-TEHSIL,36,347,0,347
KILLA SAIFULLAH DISTRICT,SHINKI SUB-TEHSIL,37,769,0,769
KILLA SAIFULLAH DISTRICT,SHINKI SUB-TEHSIL,38,440,0,440
KILLA SAIFULLAH DISTRICT,SHINKI SUB-TEHSIL,39,538,0,538
KILLA SAIFULLAH DISTRICT,SHINKI SUB-TEHSIL,40,501,0,501
KILLA SAIFULLAH DISTRICT,SHINKI SUB-TEHSIL,41,384,0,384
KILLA SAIFULLAH DISTRICT,SHINKI SUB-TEHSIL,42,379,0,379
KILLA SAIFULLAH DISTRICT,SHINKI SUB-TEHSIL,43,288,0,288
KILLA SAIFULLAH DISTRICT,SHINKI SUB-TEHSIL,44,273,0,273
KILLA SAIFULLAH DISTRICT,SHINKI SUB-TEHSIL,45,284,0,284
KILLA SAIFULLAH DISTRICT,SHINKI SUB-TEHSIL,46,237,0,237
KILLA SAIFULLAH DISTRICT,SHINKI SUB-TEHSIL,47,427,0,427
KILLA SAIFULLAH DISTRICT,SHINKI SUB-TEHSIL,48,198,0,198
KILLA SAIFULLAH DISTRICT,SHINKI SUB-TEHSIL,49,321,0,321
KILLA SAIFULLAH DISTRICT,SHINKI SUB-TEHSIL,50,275,0,275
KILLA SAIFULLAH DISTRICT,SHINKI SUB-TEHSIL,51,259,0,259
KILLA SAIFULLAH DISTRICT,SHINKI SUB-TEHSIL,52,217,0,217
KILLA SAIFULLAH DISTRICT,SHINKI SUB-TEHSIL,53,183,0,183
KILLA SAIFULLAH DISTRICT,SHINKI SUB-TEHSIL,54,160,0,160
KILLA SAIFULLAH DISTRICT,SHINKI SUB-TEHSIL,55,146,0,146
KILLA SAIFULLAH DISTRICT,SHINKI SUB-TEHSIL,56,122,0,122
KILLA SAIFULLAH DISTRICT,SHINKI SUB-TEHSIL,57,268,0,268
KILLA SAIFULLAH DISTRICT,SHINKI SUB-TEHSIL,58,138,0,138
KILLA SAIFULLAH DISTRICT,SHINKI SUB-TEHSIL,59,194,0,194
KILLA SAIFULLAH DISTRICT,SHINKI SUB-TEHSIL,60,161,0,161
KILLA SAIFULLAH DISTRICT,SHINKI SUB-TEHSIL,61,158,0,158
KILLA SAIFULLAH DISTRICT,SHINKI SUB-TEHSIL,62,148,0,148
KILLA SAIFULLAH DISTRICT,SHINKI SUB-TEHSIL,63,133,0,133
KILLA SAIFULLAH DISTRICT,SHINKI SUB-TEHSIL,64,186,0,186
KILLA SAIFULLAH DISTRICT,SHINKI SUB-TEHSIL,65,133,0,133
KILLA SAIFULLAH DISTRICT,SHINKI SUB-TEHSIL,66,121,0,121
KILLA SAIFULLAH DISTRICT,SHINKI SUB-TEHSIL,67,194,0,194
KILLA SAIFULLAH DISTRICT,SHINKI SUB-TEHSIL,68,93,0,93
KILLA SAIFULLAH DISTRICT,SHINKI SUB-TEHSIL,69,235,0,235
KILLA SAIFULLAH DISTRICT,SHINKI SUB-TEHSIL,70,76,0,76
KILLA SAIFULLAH DISTRICT,SHINKI SUB-TEHSIL,71,103,0,103
KILLA SAIFULLAH DISTRICT,SHINKI SUB-TEHSIL,72,76,0,76
KILLA SAIFULLAH DISTRICT,SHINKI SUB-TEHSIL,73,66,0,66
KILLA SAIFULLAH DISTRICT,SHINKI SUB-TEHSIL,74,100,0,100
KILLA SAIFULLAH DISTRICT,SHINKI SUB-TEHSIL,>=75,621,0,621
KOHAT DISTRICT,KOHAT TEHSIL,<1,15488,5008,20496
KOHAT DISTRICT,KOHAT TEHSIL,1,18284,5898,24182
KOHAT DISTRICT,KOHAT TEHSIL,2,19004,5837,24841
KOHAT DISTRICT,KOHAT TEHSIL,3,19769,6298,26067
KOHAT DISTRICT,KOHAT TEHSIL,4,18933,5842,24775
KOHAT DISTRICT,KOHAT TEHSIL,5,20046,5924,25970
KOHAT DISTRICT,KOHAT TEHSIL,6,18208,5625,23833
KOHAT DISTRICT,KOHAT TEHSIL,7,19299,5921,25220
KOHAT DISTRICT,KOHAT TEHSIL,8,18207,5479,23686
KOHAT DISTRICT,KOHAT TEHSIL,9,18465,5747,24212
KOHAT DISTRICT,KOHAT TEHSIL,10,16354,5072,21426
KOHAT DISTRICT,KOHAT TEHSIL,11,16880,5554,22434
KOHAT DISTRICT,KOHAT TEHSIL,12,15168,4921,20089
KOHAT DISTRICT,KOHAT TEHSIL,13,15957,5313,21270
KOHAT DISTRICT,KOHAT TEHSIL,14,14590,4902,19492
KOHAT DISTRICT,KOHAT TEHSIL,15,14934,4946,19880
KOHAT DISTRICT,KOHAT TEHSIL,16,14213,4919,19132
KOHAT DISTRICT,KOHAT TEHSIL,17,14641,5220,19861
KOHAT DISTRICT,KOHAT TEHSIL,18,12698,4823,17521
KOHAT DISTRICT,KOHAT TEHSIL,19,12680,5622,18302
KOHAT DISTRICT,KOHAT TEHSIL,20,11434,4938,16372
KOHAT DISTRICT,KOHAT TEHSIL,21,11701,5653,17354
KOHAT DISTRICT,KOHAT TEHSIL,22,10259,4615,14874
KOHAT DISTRICT,KOHAT TEHSIL,23,10916,4942,15858
KOHAT DISTRICT,KOHAT TEHSIL,24,9792,4175,13967
KOHAT DISTRICT,KOHAT TEHSIL,25,10248,3912,14160
KOHAT DISTRICT,KOHAT TEHSIL,26,9503,3913,13416
KOHAT DISTRICT,KOHAT TEHSIL,27,9890,4118,14008
KOHAT DISTRICT,KOHAT TEHSIL,28,9182,3783,12965
KOHAT DISTRICT,KOHAT TEHSIL,29,8839,3661,12500
KOHAT DISTRICT,KOHAT TEHSIL,30,8926,3745,12671
KOHAT DISTRICT,KOHAT TEHSIL,31,7913,3504,11417
KOHAT DISTRICT,KOHAT TEHSIL,32,7294,3340,10634
KOHAT DISTRICT,KOHAT TEHSIL,33,7127,3268,10395
KOHAT DISTRICT,KOHAT TEHSIL,34,6332,2867,9199
KOHAT DISTRICT,KOHAT TEHSIL,35,6830,2886,9716
KOHAT DISTRICT,KOHAT TEHSIL,36,5548,2596,8144
KOHAT DISTRICT,KOHAT TEHSIL,37,5733,2483,8216
KOHAT DISTRICT,KOHAT TEHSIL,38,6195,2982,9177
KOHAT DISTRICT,KOHAT TEHSIL,39,5695,2594,8289
KOHAT DISTRICT,KOHAT TEHSIL,40,6246,2835,9081
KOHAT DISTRICT,KOHAT TEHSIL,41,5051,2246,7297
KOHAT DISTRICT,KOHAT TEHSIL,42,4456,2130,6586
KOHAT DISTRICT,KOHAT TEHSIL,43,4968,2161,7129
KOHAT DISTRICT,KOHAT TEHSIL,44,4120,1829,5949
KOHAT DISTRICT,KOHAT TEHSIL,45,4646,1953,6599
KOHAT DISTRICT,KOHAT TEHSIL,46,3779,1560,5339
KOHAT DISTRICT,KOHAT TEHSIL,47,3877,1519,5396
KOHAT DISTRICT,KOHAT TEHSIL,48,4203,1810,6013
KOHAT DISTRICT,KOHAT TEHSIL,49,3913,1589,5502
KOHAT DISTRICT,KOHAT TEHSIL,50,4640,1893,6533
KOHAT DISTRICT,KOHAT TEHSIL,51,3533,1400,4933
KOHAT DISTRICT,KOHAT TEHSIL,52,3381,1516,4897
KOHAT DISTRICT,KOHAT TEHSIL,53,3537,1428,4965
KOHAT DISTRICT,KOHAT TEHSIL,54,3240,1319,4559
KOHAT DISTRICT,KOHAT TEHSIL,55,3548,1312,4860
KOHAT DISTRICT,KOHAT TEHSIL,56,2657,1029,3686
KOHAT DISTRICT,KOHAT TEHSIL,57,2684,1036,3720
KOHAT DISTRICT,KOHAT TEHSIL,58,2897,1102,3999
KOHAT DISTRICT,KOHAT TEHSIL,59,2671,964,3635
KOHAT DISTRICT,KOHAT TEHSIL,60,3101,1133,4234
KOHAT DISTRICT,KOHAT TEHSIL,61,2619,966,3585
KOHAT DISTRICT,KOHAT TEHSIL,62,2529,870,3399
KOHAT DISTRICT,KOHAT TEHSIL,63,2576,940,3516
KOHAT DISTRICT,KOHAT TEHSIL,64,2236,803,3039
KOHAT DISTRICT,KOHAT TEHSIL,65,2181,772,2953
KOHAT DISTRICT,KOHAT TEHSIL,66,1735,578,2313
KOHAT DISTRICT,KOHAT TEHSIL,67,1757,564,2321
KOHAT DISTRICT,KOHAT TEHSIL,68,1755,644,2399
KOHAT DISTRICT,KOHAT TEHSIL,69,1572,516,2088
KOHAT DISTRICT,KOHAT TEHSIL,70,1629,533,2162
KOHAT DISTRICT,KOHAT TEHSIL,71,1379,453,1832
KOHAT DISTRICT,KOHAT TEHSIL,72,1406,370,1776
KOHAT DISTRICT,KOHAT TEHSIL,73,1279,384,1663
KOHAT DISTRICT,KOHAT TEHSIL,74,1039,339,1378
KOHAT DISTRICT,KOHAT TEHSIL,>=75,10427,3213,13640
KOHAT DISTRICT,LACHI TEHSIL,<1,2902,1166,4068
KOHAT DISTRICT,LACHI TEHSIL,1,2969,1053,4022
KOHAT DISTRICT,LACHI TEHSIL,2,3121,1090,4211
KOHAT DISTRICT,LACHI TEHSIL,3,3310,1232,4542
KOHAT DISTRICT,LACHI TEHSIL,4,2924,1125,4049
KOHAT DISTRICT,LACHI TEHSIL,5,3117,1078,4195
KOHAT DISTRICT,LACHI TEHSIL,6,2568,1029,3597
KOHAT DISTRICT,LACHI TEHSIL,7,2994,1050,4044
KOHAT DISTRICT,LACHI TEHSIL,8,2696,949,3645
KOHAT DISTRICT,LACHI TEHSIL,9,2795,1064,3859
KOHAT DISTRICT,LACHI TEHSIL,10,2497,855,3352
KOHAT DISTRICT,LACHI TEHSIL,11,2649,1032,3681
KOHAT DISTRICT,LACHI TEHSIL,12,2194,878,3072
KOHAT DISTRICT,LACHI TEHSIL,13,2466,985,3451
KOHAT DISTRICT,LACHI TEHSIL,14,2220,830,3050
KOHAT DISTRICT,LACHI TEHSIL,15,2300,826,3126
KOHAT DISTRICT,LACHI TEHSIL,16,2336,836,3172
KOHAT DISTRICT,LACHI TEHSIL,17,2344,936,3280
KOHAT DISTRICT,LACHI TEHSIL,18,1985,750,2735
KOHAT DISTRICT,LACHI TEHSIL,19,2260,835,3095
KOHAT DISTRICT,LACHI TEHSIL,20,1878,792,2670
KOHAT DISTRICT,LACHI TEHSIL,21,1978,820,2798
KOHAT DISTRICT,LACHI TEHSIL,22,1705,775,2480
KOHAT DISTRICT,LACHI TEHSIL,23,1932,805,2737
KOHAT DISTRICT,LACHI TEHSIL,24,1684,716,2400
KOHAT DISTRICT,LACHI TEHSIL,25,1665,717,2382
KOHAT DISTRICT,LACHI TEHSIL,26,1608,668,2276
KOHAT DISTRICT,LACHI TEHSIL,27,1598,686,2284
KOHAT DISTRICT,LACHI TEHSIL,28,1548,686,2234
KOHAT DISTRICT,LACHI TEHSIL,29,1547,605,2152
KOHAT DISTRICT,LACHI TEHSIL,30,1451,726,2177
KOHAT DISTRICT,LACHI TEHSIL,31,1332,598,1930
KOHAT DISTRICT,LACHI TEHSIL,32,1204,573,1777
KOHAT DISTRICT,LACHI TEHSIL,33,1198,593,1791
KOHAT DISTRICT,LACHI TEHSIL,34,1064,432,1496
KOHAT DISTRICT,LACHI TEHSIL,35,1067,545,1612
KOHAT DISTRICT,LACHI TEHSIL,36,1039,412,1451
KOHAT DISTRICT,LACHI TEHSIL,37,896,425,1321
KOHAT DISTRICT,LACHI TEHSIL,38,1103,528,1631
KOHAT DISTRICT,LACHI TEHSIL,39,936,452,1388
KOHAT DISTRICT,LACHI TEHSIL,40,1066,556,1622
KOHAT DISTRICT,LACHI TEHSIL,41,820,412,1232
KOHAT DISTRICT,LACHI TEHSIL,42,790,362,1152
KOHAT DISTRICT,LACHI TEHSIL,43,816,410,1226
KOHAT DISTRICT,LACHI TEHSIL,44,781,348,1129
KOHAT DISTRICT,LACHI TEHSIL,45,716,381,1097
KOHAT DISTRICT,LACHI TEHSIL,46,691,298,989
KOHAT DISTRICT,LACHI TEHSIL,47,613,290,903
KOHAT DISTRICT,LACHI TEHSIL,48,820,354,1174
KOHAT DISTRICT,LACHI TEHSIL,49,702,303,1005
KOHAT DISTRICT,LACHI TEHSIL,50,799,408,1207
KOHAT DISTRICT,LACHI TEHSIL,51,675,262,937
KOHAT DISTRICT,LACHI TEHSIL,52,687,281,968
KOHAT DISTRICT,LACHI TEHSIL,53,685,287,972
KOHAT DISTRICT,LACHI TEHSIL,54,639,274,913
KOHAT DISTRICT,LACHI TEHSIL,55,677,313,990
KOHAT DISTRICT,LACHI TEHSIL,56,547,200,747
KOHAT DISTRICT,LACHI TEHSIL,57,515,209,724
KOHAT DISTRICT,LACHI TEHSIL,58,597,226,823
KOHAT DISTRICT,LACHI TEHSIL,59,537,201,738
KOHAT DISTRICT,LACHI TEHSIL,60,538,275,813
KOHAT DISTRICT,LACHI TEHSIL,61,414,180,594
KOHAT DISTRICT,LACHI TEHSIL,62,435,204,639
KOHAT DISTRICT,LACHI TEHSIL,63,493,218,711
KOHAT DISTRICT,LACHI TEHSIL,64,417,204,621
KOHAT DISTRICT,LACHI TEHSIL,65,392,155,547
KOHAT DISTRICT,LACHI TEHSIL,66,289,108,397
KOHAT DISTRICT,LACHI TEHSIL,67,317,127,444
KOHAT DISTRICT,LACHI TEHSIL,68,351,139,490
KOHAT DISTRICT,LACHI TEHSIL,69,305,132,437
KOHAT DISTRICT,LACHI TEHSIL,70,311,113,424
KOHAT DISTRICT,LACHI TEHSIL,71,224,90,314
KOHAT DISTRICT,LACHI TEHSIL,72,249,102,351
KOHAT DISTRICT,LACHI TEHSIL,73,223,96,319
KOHAT DISTRICT,LACHI TEHSIL,74,236,97,333
KOHAT DISTRICT,LACHI TEHSIL,>=75,1612,603,2215
KOHAT DISTRICT,TRIBAL AREA ADJ. KOHAT DISTRICT,<1,2823,0,2823
KOHAT DISTRICT,TRIBAL AREA ADJ. KOHAT DISTRICT,1,3700,0,3700
KOHAT DISTRICT,TRIBAL AREA ADJ. KOHAT DISTRICT,2,3533,0,3533
KOHAT DISTRICT,TRIBAL AREA ADJ. KOHAT DISTRICT,3,3779,0,3779
KOHAT DISTRICT,TRIBAL AREA ADJ. KOHAT DISTRICT,4,3619,0,3619
KOHAT DISTRICT,TRIBAL AREA ADJ. KOHAT DISTRICT,5,3624,0,3624
KOHAT DISTRICT,TRIBAL AREA ADJ. KOHAT DISTRICT,6,3493,0,3493
KOHAT DISTRICT,TRIBAL AREA ADJ. KOHAT DISTRICT,7,3638,0,3638
KOHAT DISTRICT,TRIBAL AREA ADJ. KOHAT DISTRICT,8,3248,0,3248
KOHAT DISTRICT,TRIBAL AREA ADJ. KOHAT DISTRICT,9,3508,0,3508
KOHAT DISTRICT,TRIBAL AREA ADJ. KOHAT DISTRICT,10,2959,0,2959
KOHAT DISTRICT,TRIBAL AREA ADJ. KOHAT DISTRICT,11,3392,0,3392
KOHAT DISTRICT,TRIBAL AREA ADJ. KOHAT DISTRICT,12,2690,0,2690
KOHAT DISTRICT,TRIBAL AREA ADJ. KOHAT DISTRICT,13,3016,0,3016
KOHAT DISTRICT,TRIBAL AREA ADJ. KOHAT DISTRICT,14,2629,0,2629
KOHAT DISTRICT,TRIBAL AREA ADJ. KOHAT DISTRICT,15,2629,0,2629
KOHAT DISTRICT,TRIBAL AREA ADJ. KOHAT DISTRICT,16,2674,0,2674
KOHAT DISTRICT,TRIBAL AREA ADJ. KOHAT DISTRICT,17,2660,0,2660
KOHAT DISTRICT,TRIBAL AREA ADJ. KOHAT DISTRICT,18,2342,0,2342
KOHAT DISTRICT,TRIBAL AREA ADJ. KOHAT DISTRICT,19,2478,0,2478
KOHAT DISTRICT,TRIBAL AREA ADJ. KOHAT DISTRICT,20,2213,0,2213
KOHAT DISTRICT,TRIBAL AREA ADJ. KOHAT DISTRICT,21,2370,0,2370
KOHAT DISTRICT,TRIBAL AREA ADJ. KOHAT DISTRICT,22,2067,0,2067
KOHAT DISTRICT,TRIBAL AREA ADJ. KOHAT DISTRICT,23,2328,0,2328
KOHAT DISTRICT,TRIBAL AREA ADJ. KOHAT DISTRICT,24,2085,0,2085
KOHAT DISTRICT,TRIBAL AREA ADJ. KOHAT DISTRICT,25,1981,0,1981
KOHAT DISTRICT,TRIBAL AREA ADJ. KOHAT DISTRICT,26,2102,0,2102
KOHAT DISTRICT,TRIBAL AREA ADJ. KOHAT DISTRICT,27,2221,0,2221
KOHAT DISTRICT,TRIBAL AREA ADJ. KOHAT DISTRICT,28,1923,0,1923
KOHAT DISTRICT,TRIBAL AREA ADJ. KOHAT DISTRICT,29,1927,0,1927
KOHAT DISTRICT,TRIBAL AREA ADJ. KOHAT DISTRICT,30,1637,0,1637
KOHAT DISTRICT,TRIBAL AREA ADJ. KOHAT DISTRICT,31,1722,0,1722
KOHAT DISTRICT,TRIBAL AREA ADJ. KOHAT DISTRICT,32,1501,0,1501
KOHAT DISTRICT,TRIBAL AREA ADJ. KOHAT DISTRICT,33,1650,0,1650
KOHAT DISTRICT,TRIBAL AREA ADJ. KOHAT DISTRICT,34,1385,0,1385
KOHAT DISTRICT,TRIBAL AREA ADJ. KOHAT DISTRICT,35,1193,0,1193
KOHAT DISTRICT,TRIBAL AREA ADJ. KOHAT DISTRICT,36,1157,0,1157
KOHAT DISTRICT,TRIBAL AREA ADJ. KOHAT DISTRICT,37,1182,0,1182
KOHAT DISTRICT,TRIBAL AREA ADJ. KOHAT DISTRICT,38,1163,0,1163
KOHAT DISTRICT,TRIBAL AREA ADJ. KOHAT DISTRICT,39,1128,0,1128
KOHAT DISTRICT,TRIBAL AREA ADJ. KOHAT DISTRICT,40,1037,0,1037
KOHAT DISTRICT,TRIBAL AREA ADJ. KOHAT DISTRICT,41,973,0,973
KOHAT DISTRICT,TRIBAL AREA ADJ. KOHAT DISTRICT,42,918,0,918
KOHAT DISTRICT,TRIBAL AREA ADJ. KOHAT DISTRICT,43,887,0,887
KOHAT DISTRICT,TRIBAL AREA ADJ. KOHAT DISTRICT,44,797,0,797
KOHAT DISTRICT,TRIBAL AREA ADJ. KOHAT DISTRICT,45,804,0,804
KOHAT DISTRICT,TRIBAL AREA ADJ. KOHAT DISTRICT,46,801,0,801
KOHAT DISTRICT,TRIBAL AREA ADJ. KOHAT DISTRICT,47,798,0,798
KOHAT DISTRICT,TRIBAL AREA ADJ. KOHAT DISTRICT,48,682,0,682
KOHAT DISTRICT,TRIBAL AREA ADJ. KOHAT DISTRICT,49,676,0,676
KOHAT DISTRICT,TRIBAL AREA ADJ. KOHAT DISTRICT,50,721,0,721
KOHAT DISTRICT,TRIBAL AREA ADJ. KOHAT DISTRICT,51,649,0,649
KOHAT DISTRICT,TRIBAL AREA ADJ. KOHAT DISTRICT,52,618,0,618
KOHAT DISTRICT,TRIBAL AREA ADJ. KOHAT DISTRICT,53,603,0,603
KOHAT DISTRICT,TRIBAL AREA ADJ. KOHAT DISTRICT,54,569,0,569
KOHAT DISTRICT,TRIBAL AREA ADJ. KOHAT DISTRICT,55,558,0,558
KOHAT DISTRICT,TRIBAL AREA ADJ. KOHAT DISTRICT,56,548,0,548
KOHAT DISTRICT,TRIBAL AREA ADJ. KOHAT DISTRICT,57,607,0,607
KOHAT DISTRICT,TRIBAL AREA ADJ. KOHAT DISTRICT,58,541,0,541
KOHAT DISTRICT,TRIBAL AREA ADJ. KOHAT DISTRICT,59,545,0,545
KOHAT DISTRICT,TRIBAL AREA ADJ. KOHAT DISTRICT,60,466,0,466
KOHAT DISTRICT,TRIBAL AREA ADJ. KOHAT DISTRICT,61,489,0,489
KOHAT DISTRICT,TRIBAL AREA ADJ. KOHAT DISTRICT,62,469,0,469
KOHAT DISTRICT,TRIBAL AREA ADJ. KOHAT DISTRICT,63,418,0,418
KOHAT DISTRICT,TRIBAL AREA ADJ. KOHAT DISTRICT,64,398,0,398
KOHAT DISTRICT,TRIBAL AREA ADJ. KOHAT DISTRICT,65,370,0,370
KOHAT DISTRICT,TRIBAL AREA ADJ. KOHAT DISTRICT,66,339,0,339
KOHAT DISTRICT,TRIBAL AREA ADJ. KOHAT DISTRICT,67,353,0,353
KOHAT DISTRICT,TRIBAL AREA ADJ. KOHAT DISTRICT,68,292,0,292
KOHAT DISTRICT,TRIBAL AREA ADJ. KOHAT DISTRICT,69,293,0,293
KOHAT DISTRICT,TRIBAL AREA ADJ. KOHAT DISTRICT,70,265,0,265
KOHAT DISTRICT,TRIBAL AREA ADJ. KOHAT DISTRICT,71,233,0,233
KOHAT DISTRICT,TRIBAL AREA ADJ. KOHAT DISTRICT,72,219,0,219
KOHAT DISTRICT,TRIBAL AREA ADJ. KOHAT DISTRICT,73,204,0,204
KOHAT DISTRICT,TRIBAL AREA ADJ. KOHAT DISTRICT,74,229,0,229
KOHAT DISTRICT,TRIBAL AREA ADJ. KOHAT DISTRICT,>=75,2101,0,2101
KOHISTAN DISTRICT,DASSU SUB-DIVISION,<1,4880,0,4880
KOHISTAN DISTRICT,DASSU SUB-DIVISION,1,5585,0,5585
KOHISTAN DISTRICT,DASSU SUB-DIVISION,2,9056,0,9056
KOHISTAN DISTRICT,DASSU SUB-DIVISION,3,7731,0,7731
KOHISTAN DISTRICT,DASSU SUB-DIVISION,4,9100,0,9100
KOHISTAN DISTRICT,DASSU SUB-DIVISION,5,7816,0,7816
KOHISTAN DISTRICT,DASSU SUB-DIVISION,6,9534,0,9534
KOHISTAN DISTRICT,DASSU SUB-DIVISION,7,6822,0,6822
KOHISTAN DISTRICT,DASSU SUB-DIVISION,8,10261,0,10261
KOHISTAN DISTRICT,DASSU SUB-DIVISION,9,6579,0,6579
KOHISTAN DISTRICT,DASSU SUB-DIVISION,10,10042,0,10042
KOHISTAN DISTRICT,DASSU SUB-DIVISION,11,4704,0,4704
KOHISTAN DISTRICT,DASSU SUB-DIVISION,12,8329,0,8329
KOHISTAN DISTRICT,DASSU SUB-DIVISION,13,4882,0,4882
KOHISTAN DISTRICT,DASSU SUB-DIVISION,14,5344,0,5344
KOHISTAN DISTRICT,DASSU SUB-DIVISION,15,5633,0,5633
KOHISTAN DISTRICT,DASSU SUB-DIVISION,16,4428,0,4428
KOHISTAN DISTRICT,DASSU SUB-DIVISION,17,3695,0,3695
KOHISTAN DISTRICT,DASSU SUB-DIVISION,18,6234,0,6234
KOHISTAN DISTRICT,DASSU SUB-DIVISION,19,2290,0,2290
KOHISTAN DISTRICT,DASSU SUB-DIVISION,20,6791,0,6791
KOHISTAN DISTRICT,DASSU SUB-DIVISION,21,1533,0,1533
KOHISTAN DISTRICT,DASSU SUB-DIVISION,22,2872,0,2872
KOHISTAN DISTRICT,DASSU SUB-DIVISION,23,1905,0,1905
KOHISTAN DISTRICT,DASSU SUB-DIVISION,24,1783,0,1783
KOHISTAN DISTRICT,DASSU SUB-DIVISION,25,6527,0,6527
KOHISTAN DISTRICT,DASSU SUB-DIVISION,26,1724,0,1724
KOHISTAN DISTRICT,DASSU SUB-DIVISION,27,1696,0,1696
KOHISTAN DISTRICT,DASSU SUB-DIVISION,28,3456,0,3456
KOHISTAN DISTRICT,DASSU SUB-DIVISION,29,1009,0,1009
KOHISTAN DISTRICT,DASSU SUB-DIVISION,30,7654,0,7654
KOHISTAN DISTRICT,DASSU SUB-DIVISION,31,773,0,773
KOHISTAN DISTRICT,DASSU SUB-DIVISION,32,1631,0,1631
KOHISTAN DISTRICT,DASSU SUB-DIVISION,33,1350,0,1350
KOHISTAN DISTRICT,DASSU SUB-DIVISION,34,798,0,798
KOHISTAN DISTRICT,DASSU SUB-DIVISION,35,5771,0,5771
KOHISTAN DISTRICT,DASSU SUB-DIVISION,36,906,0,906
KOHISTAN DISTRICT,DASSU SUB-DIVISION,37,881,0,881
KOHISTAN DISTRICT,DASSU SUB-DIVISION,38,1943,0,1943
KOHISTAN DISTRICT,DASSU SUB-DIVISION,39,742,0,742
KOHISTAN DISTRICT,DASSU SUB-DIVISION,40,6950,0,6950
KOHISTAN DISTRICT,DASSU SUB-DIVISION,41,582,0,582
KOHISTAN DISTRICT,DASSU SUB-DIVISION,42,695,0,695
KOHISTAN DISTRICT,DASSU SUB-DIVISION,43,665,0,665
KOHISTAN DISTRICT,DASSU SUB-DIVISION,44,637,0,637
KOHISTAN DISTRICT,DASSU SUB-DIVISION,45,4059,0,4059
KOHISTAN DISTRICT,DASSU SUB-DIVISION,46,429,0,429
KOHISTAN DISTRICT,DASSU SUB-DIVISION,47,582,0,582
KOHISTAN DISTRICT,DASSU SUB-DIVISION,48,1235,0,1235
KOHISTAN DISTRICT,DASSU SUB-DIVISION,49,455,0,455
KOHISTAN DISTRICT,DASSU SUB-DIVISION,50,5206,0,5206
KOHISTAN DISTRICT,DASSU SUB-DIVISION,51,368,0,368
KOHISTAN DISTRICT,DASSU SUB-DIVISION,52,434,0,434
KOHISTAN DISTRICT,DASSU SUB-DIVISION,53,373,0,373
KOHISTAN DISTRICT,DASSU SUB-DIVISION,54,249,0,249
KOHISTAN DISTRICT,DASSU SUB-DIVISION,55,2585,0,2585
KOHISTAN DISTRICT,DASSU SUB-DIVISION,56,274,0,274
KOHISTAN DISTRICT,DASSU SUB-DIVISION,57,277,0,277
KOHISTAN DISTRICT,DASSU SUB-DIVISION,58,472,0,472
KOHISTAN DISTRICT,DASSU SUB-DIVISION,59,183,0,183
KOHISTAN DISTRICT,DASSU SUB-DIVISION,60,3970,0,3970
KOHISTAN DISTRICT,DASSU SUB-DIVISION,61,208,0,208
KOHISTAN DISTRICT,DASSU SUB-DIVISION,62,187,0,187
KOHISTAN DISTRICT,DASSU SUB-DIVISION,63,165,0,165
KOHISTAN DISTRICT,DASSU SUB-DIVISION,64,88,0,88
KOHISTAN DISTRICT,DASSU SUB-DIVISION,65,1221,0,1221
KOHISTAN DISTRICT,DASSU SUB-DIVISION,66,179,0,179
KOHISTAN DISTRICT,DASSU SUB-DIVISION,67,152,0,152
KOHISTAN DISTRICT,DASSU SUB-DIVISION,68,250,0,250
KOHISTAN DISTRICT,DASSU SUB-DIVISION,69,76,0,76
KOHISTAN DISTRICT,DASSU SUB-DIVISION,70,850,0,850
KOHISTAN DISTRICT,DASSU SUB-DIVISION,71,714,0,714
KOHISTAN DISTRICT,DASSU SUB-DIVISION,72,506,0,506
KOHISTAN DISTRICT,DASSU SUB-DIVISION,73,310,0,310
KOHISTAN DISTRICT,DASSU SUB-DIVISION,74,147,0,147
KOHISTAN DISTRICT,DASSU SUB-DIVISION,>=75,3013,0,3013
KOHISTAN DISTRICT,KANDIA SUB-DIVISION,<1,1829,0,1829
KOHISTAN DISTRICT,KANDIA SUB-DIVISION,1,2094,0,2094
KOHISTAN DISTRICT,KANDIA SUB-DIVISION,2,3396,0,3396
KOHISTAN DISTRICT,KANDIA SUB-DIVISION,3,2899,0,2899
KOHISTAN DISTRICT,KANDIA SUB-DIVISION,4,3413,0,3413
KOHISTAN DISTRICT,KANDIA SUB-DIVISION,5,2932,0,2932
KOHISTAN DISTRICT,KANDIA SUB-DIVISION,6,3577,0,3577
KOHISTAN DISTRICT,KANDIA SUB-DIVISION,7,2559,0,2559
KOHISTAN DISTRICT,KANDIA SUB-DIVISION,8,3851,0,3851
KOHISTAN DISTRICT,KANDIA SUB-DIVISION,9,2468,0,2468
KOHISTAN DISTRICT,KANDIA SUB-DIVISION,10,3768,0,3768
KOHISTAN DISTRICT,KANDIA SUB-DIVISION,11,1765,0,1765
KOHISTAN DISTRICT,KANDIA SUB-DIVISION,12,3127,0,3127
KOHISTAN DISTRICT,KANDIA SUB-DIVISION,13,1845,0,1845
KOHISTAN DISTRICT,KANDIA SUB-DIVISION,14,2025,0,2025
KOHISTAN DISTRICT,KANDIA SUB-DIVISION,15,2114,0,2114
KOHISTAN DISTRICT,KANDIA SUB-DIVISION,16,1661,0,1661
KOHISTAN DISTRICT,KANDIA SUB-DIVISION,17,1386,0,1386
KOHISTAN DISTRICT,KANDIA SUB-DIVISION,18,2339,0,2339
KOHISTAN DISTRICT,KANDIA SUB-DIVISION,19,856,0,856
KOHISTAN DISTRICT,KANDIA SUB-DIVISION,20,2549,0,2549
KOHISTAN DISTRICT,KANDIA SUB-DIVISION,21,581,0,581
KOHISTAN DISTRICT,KANDIA SUB-DIVISION,22,1077,0,1077
KOHISTAN DISTRICT,KANDIA SUB-DIVISION,23,716,0,716
KOHISTAN DISTRICT,KANDIA SUB-DIVISION,24,669,0,669
KOHISTAN DISTRICT,KANDIA SUB-DIVISION,25,2448,0,2448
KOHISTAN DISTRICT,KANDIA SUB-DIVISION,26,647,0,647
KOHISTAN DISTRICT,KANDIA SUB-DIVISION,27,635,0,635
KOHISTAN DISTRICT,KANDIA SUB-DIVISION,28,1296,0,1296
KOHISTAN DISTRICT,KANDIA SUB-DIVISION,29,378,0,378
KOHISTAN DISTRICT,KANDIA SUB-DIVISION,30,2871,0,2871
KOHISTAN DISTRICT,KANDIA SUB-DIVISION,31,290,0,290
KOHISTAN DISTRICT,KANDIA SUB-DIVISION,32,612,0,612
KOHISTAN DISTRICT,KANDIA SUB-DIVISION,33,507,0,507
KOHISTAN DISTRICT,KANDIA SUB-DIVISION,34,298,0,298
KOHISTAN DISTRICT,KANDIA SUB-DIVISION,35,2164,0,2164
KOHISTAN DISTRICT,KANDIA SUB-DIVISION,36,340,0,340
KOHISTAN DISTRICT,KANDIA SUB-DIVISION,37,331,0,331
KOHISTAN DISTRICT,KANDIA SUB-DIVISION,38,727,0,727
KOHISTAN DISTRICT,KANDIA SUB-DIVISION,39,278,0,278
KOHISTAN DISTRICT,KANDIA SUB-DIVISION,40,2607,0,2607
KOHISTAN DISTRICT,KANDIA SUB-DIVISION,41,218,0,218
KOHISTAN DISTRICT,KANDIA SUB-DIVISION,42,259,0,259
KOHISTAN DISTRICT,KANDIA SUB-DIVISION,43,248,0,248
KOHISTAN DISTRICT,KANDIA SUB-DIVISION,44,238,0,238
KOHISTAN DISTRICT,KANDIA SUB-DIVISION,45,1521,0,1521
KOHISTAN DISTRICT,KANDIA SUB-DIVISION,46,160,0,160
KOHISTAN DISTRICT,KANDIA SUB-DIVISION,47,217,0,217
KOHISTAN DISTRICT,KANDIA SUB-DIVISION,48,462,0,462
KOHISTAN DISTRICT,KANDIA SUB-DIVISION,49,170,0,170
KOHISTAN DISTRICT,KANDIA SUB-DIVISION,50,1954,0,1954
KOHISTAN DISTRICT,KANDIA SUB-DIVISION,51,137,0,137
KOHISTAN DISTRICT,KANDIA SUB-DIVISION,52,162,0,162
KOHISTAN DISTRICT,KANDIA SUB-DIVISION,53,139,0,139
KOHISTAN DISTRICT,KANDIA SUB-DIVISION,54,112,0,112
KOHISTAN DISTRICT,KANDIA SUB-DIVISION,55,968,0,968
KOHISTAN DISTRICT,KANDIA SUB-DIVISION,56,102,0,102
KOHISTAN DISTRICT,KANDIA SUB-DIVISION,57,103,0,103
KOHISTAN DISTRICT,KANDIA SUB-DIVISION,58,176,0,176
KOHISTAN DISTRICT,KANDIA SUB-DIVISION,59,68,0,68
KOHISTAN DISTRICT,KANDIA SUB-DIVISION,60,1490,0,1490
KOHISTAN DISTRICT,KANDIA SUB-DIVISION,61,77,0,77
KOHISTAN DISTRICT,KANDIA SUB-DIVISION,62,71,0,71
KOHISTAN DISTRICT,KANDIA SUB-DIVISION,63,61,0,61
KOHISTAN DISTRICT,KANDIA SUB-DIVISION,64,32,0,32
KOHISTAN DISTRICT,KANDIA SUB-DIVISION,65,210,0,210
KOHISTAN DISTRICT,KANDIA SUB-DIVISION,66,175,0,175
KOHISTAN DISTRICT,KANDIA SUB-DIVISION,67,140,0,140
KOHISTAN DISTRICT,KANDIA SUB-DIVISION,68,106,0,106
KOHISTAN DISTRICT,KANDIA SUB-DIVISION,69,71,0,71
KOHISTAN DISTRICT,KANDIA SUB-DIVISION,70,284,0,284
KOHISTAN DISTRICT,KANDIA SUB-DIVISION,71,237,0,237
KOHISTAN DISTRICT,KANDIA SUB-DIVISION,72,190,0,190
KOHISTAN DISTRICT,KANDIA SUB-DIVISION,73,143,0,143
KOHISTAN DISTRICT,KANDIA SUB-DIVISION,74,94,0,94
KOHISTAN DISTRICT,KANDIA SUB-DIVISION,>=75,1130,0,1130
KOHISTAN DISTRICT,PALAS SUB-DIVISION,<1,5004,0,5004
KOHISTAN DISTRICT,PALAS SUB-DIVISION,1,6172,0,6172
KOHISTAN DISTRICT,PALAS SUB-DIVISION,2,10141,0,10141
KOHISTAN DISTRICT,PALAS SUB-DIVISION,3,9011,0,9011
KOHISTAN DISTRICT,PALAS SUB-DIVISION,4,11197,0,11197
KOHISTAN DISTRICT,PALAS SUB-DIVISION,5,9616,0,9616
KOHISTAN DISTRICT,PALAS SUB-DIVISION,6,11730,0,11730
KOHISTAN DISTRICT,PALAS SUB-DIVISION,7,8393,0,8393
KOHISTAN DISTRICT,PALAS SUB-DIVISION,8,12624,0,12624
KOHISTAN DISTRICT,PALAS SUB-DIVISION,9,8093,0,8093
KOHISTAN DISTRICT,PALAS SUB-DIVISION,10,12355,0,12355
KOHISTAN DISTRICT,PALAS SUB-DIVISION,11,6786,0,6786
KOHISTAN DISTRICT,PALAS SUB-DIVISION,12,10528,0,10528
KOHISTAN DISTRICT,PALAS SUB-DIVISION,13,7006,0,7006
KOHISTAN DISTRICT,PALAS SUB-DIVISION,14,8422,0,8422
KOHISTAN DISTRICT,PALAS SUB-DIVISION,15,6930,0,6930
KOHISTAN DISTRICT,PALAS SUB-DIVISION,16,5460,0,5460
KOHISTAN DISTRICT,PALAS SUB-DIVISION,17,4546,0,4546
KOHISTAN DISTRICT,PALAS SUB-DIVISION,18,7669,0,7669
KOHISTAN DISTRICT,PALAS SUB-DIVISION,19,2806,0,2806
KOHISTAN DISTRICT,PALAS SUB-DIVISION,20,8355,0,8355
KOHISTAN DISTRICT,PALAS SUB-DIVISION,21,1885,0,1885
KOHISTAN DISTRICT,PALAS SUB-DIVISION,22,3533,0,3533
KOHISTAN DISTRICT,PALAS SUB-DIVISION,23,2342,0,2342
KOHISTAN DISTRICT,PALAS SUB-DIVISION,24,2194,0,2194
KOHISTAN DISTRICT,PALAS SUB-DIVISION,25,8030,0,8030
KOHISTAN DISTRICT,PALAS SUB-DIVISION,26,2121,0,2121
KOHISTAN DISTRICT,PALAS SUB-DIVISION,27,2086,0,2086
KOHISTAN DISTRICT,PALAS SUB-DIVISION,28,4252,0,4252
KOHISTAN DISTRICT,PALAS SUB-DIVISION,29,1276,0,1276
KOHISTAN DISTRICT,PALAS SUB-DIVISION,30,9416,0,9416
KOHISTAN DISTRICT,PALAS SUB-DIVISION,31,949,0,949
KOHISTAN DISTRICT,PALAS SUB-DIVISION,32,2007,0,2007
KOHISTAN DISTRICT,PALAS SUB-DIVISION,33,1661,0,1661
KOHISTAN DISTRICT,PALAS SUB-DIVISION,34,980,0,980
KOHISTAN DISTRICT,PALAS SUB-DIVISION,35,7099,0,7099
KOHISTAN DISTRICT,PALAS SUB-DIVISION,36,1114,0,1114
KOHISTAN DISTRICT,PALAS SUB-DIVISION,37,1084,0,1084
KOHISTAN DISTRICT,PALAS SUB-DIVISION,38,2389,0,2389
KOHISTAN DISTRICT,PALAS SUB-DIVISION,39,913,0,913
KOHISTAN DISTRICT,PALAS SUB-DIVISION,40,8551,0,8551
KOHISTAN DISTRICT,PALAS SUB-DIVISION,41,715,0,715
KOHISTAN DISTRICT,PALAS SUB-DIVISION,42,854,0,854
KOHISTAN DISTRICT,PALAS SUB-DIVISION,43,817,0,817
KOHISTAN DISTRICT,PALAS SUB-DIVISION,44,784,0,784
KOHISTAN DISTRICT,PALAS SUB-DIVISION,45,4993,0,4993
KOHISTAN DISTRICT,PALAS SUB-DIVISION,46,457,0,457
KOHISTAN DISTRICT,PALAS SUB-DIVISION,47,625,0,625
KOHISTAN DISTRICT,PALAS SUB-DIVISION,48,1518,0,1518
KOHISTAN DISTRICT,PALAS SUB-DIVISION,49,460,0,460
KOHISTAN DISTRICT,PALAS SUB-DIVISION,50,6405,0,6405
KOHISTAN DISTRICT,PALAS SUB-DIVISION,51,453,0,453
KOHISTAN DISTRICT,PALAS SUB-DIVISION,52,502,0,502
KOHISTAN DISTRICT,PALAS SUB-DIVISION,53,458,0,458
KOHISTAN DISTRICT,PALAS SUB-DIVISION,54,256,0,256
KOHISTAN DISTRICT,PALAS SUB-DIVISION,55,3180,0,3180
KOHISTAN DISTRICT,PALAS SUB-DIVISION,56,336,0,336
KOHISTAN DISTRICT,PALAS SUB-DIVISION,57,249,0,249
KOHISTAN DISTRICT,PALAS SUB-DIVISION,58,396,0,396
KOHISTAN DISTRICT,PALAS SUB-DIVISION,59,156,0,156
KOHISTAN DISTRICT,PALAS SUB-DIVISION,60,4884,0,4884
KOHISTAN DISTRICT,PALAS SUB-DIVISION,61,255,0,255
KOHISTAN DISTRICT,PALAS SUB-DIVISION,62,231,0,231
KOHISTAN DISTRICT,PALAS SUB-DIVISION,63,204,0,204
KOHISTAN DISTRICT,PALAS SUB-DIVISION,64,108,0,108
KOHISTAN DISTRICT,PALAS SUB-DIVISION,65,1501,0,1501
KOHISTAN DISTRICT,PALAS SUB-DIVISION,66,220,0,220
KOHISTAN DISTRICT,PALAS SUB-DIVISION,67,145,0,145
KOHISTAN DISTRICT,PALAS SUB-DIVISION,68,168,0,168
KOHISTAN DISTRICT,PALAS SUB-DIVISION,69,54,0,54
KOHISTAN DISTRICT,PALAS SUB-DIVISION,70,2676,0,2676
KOHISTAN DISTRICT,PALAS SUB-DIVISION,71,145,0,145
KOHISTAN DISTRICT,PALAS SUB-DIVISION,72,143,0,143
KOHISTAN DISTRICT,PALAS SUB-DIVISION,73,90,0,90
KOHISTAN DISTRICT,PALAS SUB-DIVISION,74,53,0,53
KOHISTAN DISTRICT,PALAS SUB-DIVISION,>=75,3706,0,3706
KOHISTAN DISTRICT,PATTAN SUB-DIVISION,<1,4433,0,4433
KOHISTAN DISTRICT,PATTAN SUB-DIVISION,1,5070,0,5070
KOHISTAN DISTRICT,PATTAN SUB-DIVISION,2,8221,0,8221
KOHISTAN DISTRICT,PATTAN SUB-DIVISION,3,7015,0,7015
KOHISTAN DISTRICT,PATTAN SUB-DIVISION,4,8255,0,8255
KOHISTAN DISTRICT,PATTAN SUB-DIVISION,5,7087,0,7087
KOHISTAN DISTRICT,PATTAN SUB-DIVISION,6,8641,0,8641
KOHISTAN DISTRICT,PATTAN SUB-DIVISION,7,6181,0,6181
KOHISTAN DISTRICT,PATTAN SUB-DIVISION,8,9291,0,9291
KOHISTAN DISTRICT,PATTAN SUB-DIVISION,9,5956,0,5956
KOHISTAN DISTRICT,PATTAN SUB-DIVISION,10,9087,0,9087
KOHISTAN DISTRICT,PATTAN SUB-DIVISION,11,4255,0,4255
KOHISTAN DISTRICT,PATTAN SUB-DIVISION,12,7533,0,7533
KOHISTAN DISTRICT,PATTAN SUB-DIVISION,13,4415,0,4415
KOHISTAN DISTRICT,PATTAN SUB-DIVISION,14,4864,0,4864
KOHISTAN DISTRICT,PATTAN SUB-DIVISION,15,5091,0,5091
KOHISTAN DISTRICT,PATTAN SUB-DIVISION,16,4005,0,4005
KOHISTAN DISTRICT,PATTAN SUB-DIVISION,17,3341,0,3341
KOHISTAN DISTRICT,PATTAN SUB-DIVISION,18,5642,0,5642
KOHISTAN DISTRICT,PATTAN SUB-DIVISION,19,2067,0,2067
KOHISTAN DISTRICT,PATTAN SUB-DIVISION,20,6153,0,6153
KOHISTAN DISTRICT,PATTAN SUB-DIVISION,21,1405,0,1405
KOHISTAN DISTRICT,PATTAN SUB-DIVISION,22,2601,0,2601
KOHISTAN DISTRICT,PATTAN SUB-DIVISION,23,1727,0,1727
KOHISTAN DISTRICT,PATTAN SUB-DIVISION,24,1618,0,1618
KOHISTAN DISTRICT,PATTAN SUB-DIVISION,25,5915,0,5915
KOHISTAN DISTRICT,PATTAN SUB-DIVISION,26,1562,0,1562
KOHISTAN DISTRICT,PATTAN SUB-DIVISION,27,1537,0,1537
KOHISTAN DISTRICT,PATTAN SUB-DIVISION,28,3138,0,3138
KOHISTAN DISTRICT,PATTAN SUB-DIVISION,29,916,0,916
KOHISTAN DISTRICT,PATTAN SUB-DIVISION,30,6938,0,6938
KOHISTAN DISTRICT,PATTAN SUB-DIVISION,31,700,0,700
KOHISTAN DISTRICT,PATTAN SUB-DIVISION,32,1480,0,1480
KOHISTAN DISTRICT,PATTAN SUB-DIVISION,33,1225,0,1225
KOHISTAN DISTRICT,PATTAN SUB-DIVISION,34,744,0,744
KOHISTAN DISTRICT,PATTAN SUB-DIVISION,35,5232,0,5232
KOHISTAN DISTRICT,PATTAN SUB-DIVISION,36,822,0,822
KOHISTAN DISTRICT,PATTAN SUB-DIVISION,37,800,0,800
KOHISTAN DISTRICT,PATTAN SUB-DIVISION,38,1766,0,1766
KOHISTAN DISTRICT,PATTAN SUB-DIVISION,39,674,0,674
KOHISTAN DISTRICT,PATTAN SUB-DIVISION,40,6301,0,6301
KOHISTAN DISTRICT,PATTAN SUB-DIVISION,41,528,0,528
KOHISTAN DISTRICT,PATTAN SUB-DIVISION,42,631,0,631
KOHISTAN DISTRICT,PATTAN SUB-DIVISION,43,603,0,603
KOHISTAN DISTRICT,PATTAN SUB-DIVISION,44,578,0,578
KOHISTAN DISTRICT,PATTAN SUB-DIVISION,45,3682,0,3682
KOHISTAN DISTRICT,PATTAN SUB-DIVISION,46,389,0,389
KOHISTAN DISTRICT,PATTAN SUB-DIVISION,47,528,0,528
KOHISTAN DISTRICT,PATTAN SUB-DIVISION,48,1122,0,1122
KOHISTAN DISTRICT,PATTAN SUB-DIVISION,49,413,0,413
KOHISTAN DISTRICT,PATTAN SUB-DIVISION,50,4713,0,4713
KOHISTAN DISTRICT,PATTAN SUB-DIVISION,51,334,0,334
KOHISTAN DISTRICT,PATTAN SUB-DIVISION,52,392,0,392
KOHISTAN DISTRICT,PATTAN SUB-DIVISION,53,337,0,337
KOHISTAN DISTRICT,PATTAN SUB-DIVISION,54,225,0,225
KOHISTAN DISTRICT,PATTAN SUB-DIVISION,55,2346,0,2346
KOHISTAN DISTRICT,PATTAN SUB-DIVISION,56,248,0,248
KOHISTAN DISTRICT,PATTAN SUB-DIVISION,57,250,0,250
KOHISTAN DISTRICT,PATTAN SUB-DIVISION,58,428,0,428
KOHISTAN DISTRICT,PATTAN SUB-DIVISION,59,166,0,166
KOHISTAN DISTRICT,PATTAN SUB-DIVISION,60,3590,0,3590
KOHISTAN DISTRICT,PATTAN SUB-DIVISION,61,188,0,188
KOHISTAN DISTRICT,PATTAN SUB-DIVISION,62,168,0,168
KOHISTAN DISTRICT,PATTAN SUB-DIVISION,63,149,0,149
KOHISTAN DISTRICT,PATTAN SUB-DIVISION,64,79,0,79
KOHISTAN DISTRICT,PATTAN SUB-DIVISION,65,1107,0,1107
KOHISTAN DISTRICT,PATTAN SUB-DIVISION,66,162,0,162
KOHISTAN DISTRICT,PATTAN SUB-DIVISION,67,137,0,137
KOHISTAN DISTRICT,PATTAN SUB-DIVISION,68,228,0,228
KOHISTAN DISTRICT,PATTAN SUB-DIVISION,69,69,0,69
KOHISTAN DISTRICT,PATTAN SUB-DIVISION,70,1965,0,1965
KOHISTAN DISTRICT,PATTAN SUB-DIVISION,71,107,0,107
KOHISTAN DISTRICT,PATTAN SUB-DIVISION,72,105,0,105
KOHISTAN DISTRICT,PATTAN SUB-DIVISION,73,66,0,66
KOHISTAN DISTRICT,PATTAN SUB-DIVISION,74,39,0,39
KOHISTAN DISTRICT,PATTAN SUB-DIVISION,>=75,2726,0,2726
KORANGI DISTRICT,KORANGI SUB-DIVISION,<1,0,25814,25814
KORANGI DISTRICT,KORANGI SUB-DIVISION,1,0,25801,25801
KORANGI DISTRICT,KORANGI SUB-DIVISION,2,0,27326,27326
KORANGI DISTRICT,KORANGI SUB-DIVISION,3,0,29889,29889
KORANGI DISTRICT,KORANGI SUB-DIVISION,4,0,27030,27030
KORANGI DISTRICT,KORANGI SUB-DIVISION,5,0,27677,27677
KORANGI DISTRICT,KORANGI SUB-DIVISION,6,0,26470,26470
KORANGI DISTRICT,KORANGI SUB-DIVISION,7,0,28546,28546
KORANGI DISTRICT,KORANGI SUB-DIVISION,8,0,24896,24896
KORANGI DISTRICT,KORANGI SUB-DIVISION,9,0,28031,28031
KORANGI DISTRICT,KORANGI SUB-DIVISION,10,0,22973,22973
KORANGI DISTRICT,KORANGI SUB-DIVISION,11,0,26996,26996
KORANGI DISTRICT,KORANGI SUB-DIVISION,12,0,22738,22738
KORANGI DISTRICT,KORANGI SUB-DIVISION,13,0,23629,23629
KORANGI DISTRICT,KORANGI SUB-DIVISION,14,0,21553,21553
KORANGI DISTRICT,KORANGI SUB-DIVISION,15,0,22514,22514
KORANGI DISTRICT,KORANGI SUB-DIVISION,16,0,22886,22886
KORANGI DISTRICT,KORANGI SUB-DIVISION,17,0,24891,24891
KORANGI DISTRICT,KORANGI SUB-DIVISION,18,0,22645,22645
KORANGI DISTRICT,KORANGI SUB-DIVISION,19,0,25510,25510
KORANGI DISTRICT,KORANGI SUB-DIVISION,20,0,22742,22742
KORANGI DISTRICT,KORANGI SUB-DIVISION,21,0,25358,25358
KORANGI DISTRICT,KORANGI SUB-DIVISION,22,0,24042,24042
KORANGI DISTRICT,KORANGI SUB-DIVISION,23,0,23205,23205
KORANGI DISTRICT,KORANGI SUB-DIVISION,24,0,23348,23348
KORANGI DISTRICT,KORANGI SUB-DIVISION,25,0,20676,20676
KORANGI DISTRICT,KORANGI SUB-DIVISION,26,0,22849,22849
KORANGI DISTRICT,KORANGI SUB-DIVISION,27,0,21950,21950
KORANGI DISTRICT,KORANGI SUB-DIVISION,28,0,21268,21268
KORANGI DISTRICT,KORANGI SUB-DIVISION,29,0,20666,20666
KORANGI DISTRICT,KORANGI SUB-DIVISION,30,0,20057,20057
KORANGI DISTRICT,KORANGI SUB-DIVISION,31,0,19428,19428
KORANGI DISTRICT,KORANGI SUB-DIVISION,32,0,19065,19065
KORANGI DISTRICT,KORANGI SUB-DIVISION,33,0,18300,18300
KORANGI DISTRICT,KORANGI SUB-DIVISION,34,0,17013,17013
KORANGI DISTRICT,KORANGI SUB-DIVISION,35,0,15798,15798
KORANGI DISTRICT,KORANGI SUB-DIVISION,36,0,15510,15510
KORANGI DISTRICT,KORANGI SUB-DIVISION,37,0,14433,14433
KORANGI DISTRICT,KORANGI SUB-DIVISION,38,0,15489,15489
KORANGI DISTRICT,KORANGI SUB-DIVISION,39,0,14785,14785
KORANGI DISTRICT,KORANGI SUB-DIVISION,40,0,13513,13513
KORANGI DISTRICT,KORANGI SUB-DIVISION,41,0,12429,12429
KORANGI DISTRICT,KORANGI SUB-DIVISION,42,0,11491,11491
KORANGI DISTRICT,KORANGI SUB-DIVISION,43,0,11230,11230
KORANGI DISTRICT,KORANGI SUB-DIVISION,44,0,10234,10234
KORANGI DISTRICT,KORANGI SUB-DIVISION,45,0,9541,9541
KORANGI DISTRICT,KORANGI SUB-DIVISION,46,0,8915,8915
KORANGI DISTRICT,KORANGI SUB-DIVISION,47,0,8520,8520
KORANGI DISTRICT,KORANGI SUB-DIVISION,48,0,8934,8934
KORANGI DISTRICT,KORANGI SUB-DIVISION,49,0,9029,9029
KORANGI DISTRICT,KORANGI SUB-DIVISION,50,0,8731,8731
KORANGI DISTRICT,KORANGI SUB-DIVISION,51,0,8151,8151
KORANGI DISTRICT,KORANGI SUB-DIVISION,52,0,7971,7971
KORANGI DISTRICT,KORANGI SUB-DIVISION,53,0,7666,7666
KORANGI DISTRICT,KORANGI SUB-DIVISION,54,0,6908,6908
KORANGI DISTRICT,KORANGI SUB-DIVISION,55,0,6137,6137
KORANGI DISTRICT,KORANGI SUB-DIVISION,56,0,5597,5597
KORANGI DISTRICT,KORANGI SUB-DIVISION,57,0,5389,5389
KORANGI DISTRICT,KORANGI SUB-DIVISION,58,0,5049,5049
KORANGI DISTRICT,KORANGI SUB-DIVISION,59,0,5078,5078
KORANGI DISTRICT,KORANGI SUB-DIVISION,60,0,4702,4702
KORANGI DISTRICT,KORANGI SUB-DIVISION,61,0,4968,4968
KORANGI DISTRICT,KORANGI SUB-DIVISION,62,0,4680,4680
KORANGI DISTRICT,KORANGI SUB-DIVISION,63,0,4524,4524
KORANGI DISTRICT,KORANGI SUB-DIVISION,64,0,3595,3595
KORANGI DISTRICT,KORANGI SUB-DIVISION,65,0,2996,2996
KORANGI DISTRICT,KORANGI SUB-DIVISION,66,0,2598,2598
KORANGI DISTRICT,KORANGI SUB-DIVISION,67,0,2474,2474
KORANGI DISTRICT,KORANGI SUB-DIVISION,68,0,2547,2547
KORANGI DISTRICT,KORANGI SUB-DIVISION,69,0,2305,2305
KORANGI DISTRICT,KORANGI SUB-DIVISION,70,0,1776,1776
KORANGI DISTRICT,KORANGI SUB-DIVISION,71,0,1809,1809
KORANGI DISTRICT,KORANGI SUB-DIVISION,72,0,1564,1564
KORANGI DISTRICT,KORANGI SUB-DIVISION,73,0,1597,1597
KORANGI DISTRICT,KORANGI SUB-DIVISION,74,0,1241,1241
KORANGI DISTRICT,KORANGI SUB-DIVISION,>=75,0,8455,8455
KORANGI DISTRICT,LANDHI SUB-DIVISION,<1,0,11266,11266
KORANGI DISTRICT,LANDHI SUB-DIVISION,1,0,11201,11201
KORANGI DISTRICT,LANDHI SUB-DIVISION,2,0,11966,11966
KORANGI DISTRICT,LANDHI SUB-DIVISION,3,0,12637,12637
KORANGI DISTRICT,LANDHI SUB-DIVISION,4,0,11247,11247
KORANGI DISTRICT,LANDHI SUB-DIVISION,5,0,11821,11821
KORANGI DISTRICT,LANDHI SUB-DIVISION,6,0,11537,11537
KORANGI DISTRICT,LANDHI SUB-DIVISION,7,0,12215,12215
KORANGI DISTRICT,LANDHI SUB-DIVISION,8,0,10773,10773
KORANGI DISTRICT,LANDHI SUB-DIVISION,9,0,12432,12432
KORANGI DISTRICT,LANDHI SUB-DIVISION,10,0,9966,9966
KORANGI DISTRICT,LANDHI SUB-DIVISION,11,0,12429,12429
KORANGI DISTRICT,LANDHI SUB-DIVISION,12,0,9958,9958
KORANGI DISTRICT,LANDHI SUB-DIVISION,13,0,10964,10964
KORANGI DISTRICT,LANDHI SUB-DIVISION,14,0,10103,10103
KORANGI DISTRICT,LANDHI SUB-DIVISION,15,0,10494,10494
KORANGI DISTRICT,LANDHI SUB-DIVISION,16,0,10620,10620
KORANGI DISTRICT,LANDHI SUB-DIVISION,17,0,11756,11756
KORANGI DISTRICT,LANDHI SUB-DIVISION,18,0,9512,9512
KORANGI DISTRICT,LANDHI SUB-DIVISION,19,0,11495,11495
KORANGI DISTRICT,LANDHI SUB-DIVISION,20,0,9564,9564
KORANGI DISTRICT,LANDHI SUB-DIVISION,21,0,11795,11795
KORANGI DISTRICT,LANDHI SUB-DIVISION,22,0,10315,10315
KORANGI DISTRICT,LANDHI SUB-DIVISION,23,0,10945,10945
KORANGI DISTRICT,LANDHI SUB-DIVISION,24,0,11139,11139
KORANGI DISTRICT,LANDHI SUB-DIVISION,25,0,8850,8850
KORANGI DISTRICT,LANDHI SUB-DIVISION,26,0,11066,11066
KORANGI DISTRICT,LANDHI SUB-DIVISION,27,0,10574,10574
KORANGI DISTRICT,LANDHI SUB-DIVISION,28,0,10047,10047
KORANGI DISTRICT,LANDHI SUB-DIVISION,29,0,10609,10609
KORANGI DISTRICT,LANDHI SUB-DIVISION,30,0,8932,8932
KORANGI DISTRICT,LANDHI SUB-DIVISION,31,0,10451,10451
KORANGI DISTRICT,LANDHI SUB-DIVISION,32,0,9828,9828
KORANGI DISTRICT,LANDHI SUB-DIVISION,33,0,9870,9870
KORANGI DISTRICT,LANDHI SUB-DIVISION,34,0,9489,9489
KORANGI DISTRICT,LANDHI SUB-DIVISION,35,0,7216,7216
KORANGI DISTRICT,LANDHI SUB-DIVISION,36,0,8687,8687
KORANGI DISTRICT,LANDHI SUB-DIVISION,37,0,7880,7880
KORANGI DISTRICT,LANDHI SUB-DIVISION,38,0,8807,8807
KORANGI DISTRICT,LANDHI SUB-DIVISION,39,0,8040,8040
KORANGI DISTRICT,LANDHI SUB-DIVISION,40,0,6642,6642
KORANGI DISTRICT,LANDHI SUB-DIVISION,41,0,7160,7160
KORANGI DISTRICT,LANDHI SUB-DIVISION,42,0,6301,6301
KORANGI DISTRICT,LANDHI SUB-DIVISION,43,0,6466,6466
KORANGI DISTRICT,LANDHI SUB-DIVISION,44,0,6008,6008
KORANGI DISTRICT,LANDHI SUB-DIVISION,45,0,4570,4570
KORANGI DISTRICT,LANDHI SUB-DIVISION,46,0,5370,5370
KORANGI DISTRICT,LANDHI SUB-DIVISION,47,0,4924,4924
KORANGI DISTRICT,LANDHI SUB-DIVISION,48,0,5275,5275
KORANGI DISTRICT,LANDHI SUB-DIVISION,49,0,5277,5277
KORANGI DISTRICT,LANDHI SUB-DIVISION,50,0,4145,4145
KORANGI DISTRICT,LANDHI SUB-DIVISION,51,0,5209,5209
KORANGI DISTRICT,LANDHI SUB-DIVISION,52,0,4721,4721
KORANGI DISTRICT,LANDHI SUB-DIVISION,53,0,4487,4487
KORANGI DISTRICT,LANDHI SUB-DIVISION,54,0,4219,4219
KORANGI DISTRICT,LANDHI SUB-DIVISION,55,0,3165,3165
KORANGI DISTRICT,LANDHI SUB-DIVISION,56,0,3420,3420
KORANGI DISTRICT,LANDHI SUB-DIVISION,57,0,3206,3206
KORANGI DISTRICT,LANDHI SUB-DIVISION,58,0,3177,3177
KORANGI DISTRICT,LANDHI SUB-DIVISION,59,0,2936,2936
KORANGI DISTRICT,LANDHI SUB-DIVISION,60,0,2191,2191
KORANGI DISTRICT,LANDHI SUB-DIVISION,61,0,2998,2998
KORANGI DISTRICT,LANDHI SUB-DIVISION,62,0,2723,2723
KORANGI DISTRICT,LANDHI SUB-DIVISION,63,0,2653,2653
KORANGI DISTRICT,LANDHI SUB-DIVISION,64,0,2242,2242
KORANGI DISTRICT,LANDHI SUB-DIVISION,65,0,1561,1561
KORANGI DISTRICT,LANDHI SUB-DIVISION,66,0,1617,1617
KORANGI DISTRICT,LANDHI SUB-DIVISION,67,0,1458,1458
KORANGI DISTRICT,LANDHI SUB-DIVISION,68,0,1587,1587
KORANGI DISTRICT,LANDHI SUB-DIVISION,69,0,1459,1459
KORANGI DISTRICT,LANDHI SUB-DIVISION,70,0,920,920
KORANGI DISTRICT,LANDHI SUB-DIVISION,71,0,1162,1162
KORANGI DISTRICT,LANDHI SUB-DIVISION,72,0,1053,1053
KORANGI DISTRICT,LANDHI SUB-DIVISION,73,0,1143,1143
KORANGI DISTRICT,LANDHI SUB-DIVISION,74,0,871,871
KORANGI DISTRICT,LANDHI SUB-DIVISION,>=75,0,5384,5384
KORANGI DISTRICT,MODEL COLONY SUB-DIVISION,<1,0,7410,7410
KORANGI DISTRICT,MODEL COLONY SUB-DIVISION,1,0,8171,8171
KORANGI DISTRICT,MODEL COLONY SUB-DIVISION,2,0,7800,7800
KORANGI DISTRICT,MODEL COLONY SUB-DIVISION,3,0,8371,8371
KORANGI DISTRICT,MODEL COLONY SUB-DIVISION,4,0,7717,7717
KORANGI DISTRICT,MODEL COLONY SUB-DIVISION,5,0,7850,7850
KORANGI DISTRICT,MODEL COLONY SUB-DIVISION,6,0,7806,7806
KORANGI DISTRICT,MODEL COLONY SUB-DIVISION,7,0,8095,8095
KORANGI DISTRICT,MODEL COLONY SUB-DIVISION,8,0,7205,7205
KORANGI DISTRICT,MODEL COLONY SUB-DIVISION,9,0,8238,8238
KORANGI DISTRICT,MODEL COLONY SUB-DIVISION,10,0,6619,6619
KORANGI DISTRICT,MODEL COLONY SUB-DIVISION,11,0,8409,8409
KORANGI DISTRICT,MODEL COLONY SUB-DIVISION,12,0,6856,6856
KORANGI DISTRICT,MODEL COLONY SUB-DIVISION,13,0,7354,7354
KORANGI DISTRICT,MODEL COLONY SUB-DIVISION,14,0,6751,6751
KORANGI DISTRICT,MODEL COLONY SUB-DIVISION,15,0,6938,6938
KORANGI DISTRICT,MODEL COLONY SUB-DIVISION,16,0,7240,7240
KORANGI DISTRICT,MODEL COLONY SUB-DIVISION,17,0,7893,7893
KORANGI DISTRICT,MODEL COLONY SUB-DIVISION,18,0,6254,6254
KORANGI DISTRICT,MODEL COLONY SUB-DIVISION,19,0,7645,7645
KORANGI DISTRICT,MODEL COLONY SUB-DIVISION,20,0,6329,6329
KORANGI DISTRICT,MODEL COLONY SUB-DIVISION,21,0,8059,8059
KORANGI DISTRICT,MODEL COLONY SUB-DIVISION,22,0,6985,6985
KORANGI DISTRICT,MODEL COLONY SUB-DIVISION,23,0,7386,7386
KORANGI DISTRICT,MODEL COLONY SUB-DIVISION,24,0,7576,7576
KORANGI DISTRICT,MODEL COLONY SUB-DIVISION,25,0,6011,6011
KORANGI DISTRICT,MODEL COLONY SUB-DIVISION,26,0,7507,7507
KORANGI DISTRICT,MODEL COLONY SUB-DIVISION,27,0,7334,7334
KORANGI DISTRICT,MODEL COLONY SUB-DIVISION,28,0,7051,7051
KORANGI DISTRICT,MODEL COLONY SUB-DIVISION,29,0,7234,7234
KORANGI DISTRICT,MODEL COLONY SUB-DIVISION,30,0,6454,6454
KORANGI DISTRICT,MODEL COLONY SUB-DIVISION,31,0,7343,7343
KORANGI DISTRICT,MODEL COLONY SUB-DIVISION,32,0,6896,6896
KORANGI DISTRICT,MODEL COLONY SUB-DIVISION,33,0,6811,6811
KORANGI DISTRICT,MODEL COLONY SUB-DIVISION,34,0,6615,6615
KORANGI DISTRICT,MODEL COLONY SUB-DIVISION,35,0,5139,5139
KORANGI DISTRICT,MODEL COLONY SUB-DIVISION,36,0,6069,6069
KORANGI DISTRICT,MODEL COLONY SUB-DIVISION,37,0,5451,5451
KORANGI DISTRICT,MODEL COLONY SUB-DIVISION,38,0,6161,6161
KORANGI DISTRICT,MODEL COLONY SUB-DIVISION,39,0,5625,5625
KORANGI DISTRICT,MODEL COLONY SUB-DIVISION,40,0,4848,4848
KORANGI DISTRICT,MODEL COLONY SUB-DIVISION,41,0,5024,5024
KORANGI DISTRICT,MODEL COLONY SUB-DIVISION,42,0,4588,4588
KORANGI DISTRICT,MODEL COLONY SUB-DIVISION,43,0,4771,4771
KORANGI DISTRICT,MODEL COLONY SUB-DIVISION,44,0,4477,4477
KORANGI DISTRICT,MODEL COLONY SUB-DIVISION,45,0,3493,3493
KORANGI DISTRICT,MODEL COLONY SUB-DIVISION,46,0,3981,3981
KORANGI DISTRICT,MODEL COLONY SUB-DIVISION,47,0,3590,3590
KORANGI DISTRICT,MODEL COLONY SUB-DIVISION,48,0,4115,4115
KORANGI DISTRICT,MODEL COLONY SUB-DIVISION,49,0,3995,3995
KORANGI DISTRICT,MODEL COLONY SUB-DIVISION,50,0,3420,3420
KORANGI DISTRICT,MODEL COLONY SUB-DIVISION,51,0,4047,4047
KORANGI DISTRICT,MODEL COLONY SUB-DIVISION,52,0,3729,3729
KORANGI DISTRICT,MODEL COLONY SUB-DIVISION,53,0,3767,3767
KORANGI DISTRICT,MODEL COLONY SUB-DIVISION,54,0,3459,3459
KORANGI DISTRICT,MODEL COLONY SUB-DIVISION,55,0,2645,2645
KORANGI DISTRICT,MODEL COLONY SUB-DIVISION,56,0,2873,2873
KORANGI DISTRICT,MODEL COLONY SUB-DIVISION,57,0,2641,2641
KORANGI DISTRICT,MODEL COLONY SUB-DIVISION,58,0,2650,2650
KORANGI DISTRICT,MODEL COLONY SUB-DIVISION,59,0,2459,2459
KORANGI DISTRICT,MODEL COLONY SUB-DIVISION,60,0,1857,1857
KORANGI DISTRICT,MODEL COLONY SUB-DIVISION,61,0,2317,2317
KORANGI DISTRICT,MODEL COLONY SUB-DIVISION,62,0,2294,2294
KORANGI DISTRICT,MODEL COLONY SUB-DIVISION,63,0,2196,2196
KORANGI DISTRICT,MODEL COLONY SUB-DIVISION,64,0,1772,1772
KORANGI DISTRICT,MODEL COLONY SUB-DIVISION,65,0,1335,1335
KORANGI DISTRICT,MODEL COLONY SUB-DIVISION,66,0,1349,1349
KORANGI DISTRICT,MODEL COLONY SUB-DIVISION,67,0,1199,1199
KORANGI DISTRICT,MODEL COLONY SUB-DIVISION,68,0,1287,1287
KORANGI DISTRICT,MODEL COLONY SUB-DIVISION,69,0,1100,1100
KORANGI DISTRICT,MODEL COLONY SUB-DIVISION,70,0,786,786
KORANGI DISTRICT,MODEL COLONY SUB-DIVISION,71,0,893,893
KORANGI DISTRICT,MODEL COLONY SUB-DIVISION,72,0,850,850
KORANGI DISTRICT,MODEL COLONY SUB-DIVISION,73,0,876,876
KORANGI DISTRICT,MODEL COLONY SUB-DIVISION,74,0,651,651
KORANGI DISTRICT,MODEL COLONY SUB-DIVISION,>=75,0,4397,4397
KORANGI DISTRICT,SHAH FAISAL SUB-DIVISION,<1,0,9838,9838
KORANGI DISTRICT,SHAH FAISAL SUB-DIVISION,1,0,10948,10948
KORANGI DISTRICT,SHAH FAISAL SUB-DIVISION,2,0,11246,11246
KORANGI DISTRICT,SHAH FAISAL SUB-DIVISION,3,0,11929,11929
KORANGI DISTRICT,SHAH FAISAL SUB-DIVISION,4,0,10858,10858
KORANGI DISTRICT,SHAH FAISAL SUB-DIVISION,5,0,11190,11190
KORANGI DISTRICT,SHAH FAISAL SUB-DIVISION,6,0,11243,11243
KORANGI DISTRICT,SHAH FAISAL SUB-DIVISION,7,0,11933,11933
KORANGI DISTRICT,SHAH FAISAL SUB-DIVISION,8,0,10325,10325
KORANGI DISTRICT,SHAH FAISAL SUB-DIVISION,9,0,12216,12216
KORANGI DISTRICT,SHAH FAISAL SUB-DIVISION,10,0,9859,9859
KORANGI DISTRICT,SHAH FAISAL SUB-DIVISION,11,0,12321,12321
KORANGI DISTRICT,SHAH FAISAL SUB-DIVISION,12,0,9675,9675
KORANGI DISTRICT,SHAH FAISAL SUB-DIVISION,13,0,10972,10972
KORANGI DISTRICT,SHAH FAISAL SUB-DIVISION,14,0,9563,9563
KORANGI DISTRICT,SHAH FAISAL SUB-DIVISION,15,0,9895,9895
KORANGI DISTRICT,SHAH FAISAL SUB-DIVISION,16,0,10132,10132
KORANGI DISTRICT,SHAH FAISAL SUB-DIVISION,17,0,10862,10862
KORANGI DISTRICT,SHAH FAISAL SUB-DIVISION,18,0,8960,8960
KORANGI DISTRICT,SHAH FAISAL SUB-DIVISION,19,0,10814,10814
KORANGI DISTRICT,SHAH FAISAL SUB-DIVISION,20,0,8677,8677
KORANGI DISTRICT,SHAH FAISAL SUB-DIVISION,21,0,11688,11688
KORANGI DISTRICT,SHAH FAISAL SUB-DIVISION,22,0,9962,9962
KORANGI DISTRICT,SHAH FAISAL SUB-DIVISION,23,0,10229,10229
KORANGI DISTRICT,SHAH FAISAL SUB-DIVISION,24,0,10143,10143
KORANGI DISTRICT,SHAH FAISAL SUB-DIVISION,25,0,7975,7975
KORANGI DISTRICT,SHAH FAISAL SUB-DIVISION,26,0,9919,9919
KORANGI DISTRICT,SHAH FAISAL SUB-DIVISION,27,0,9374,9374
KORANGI DISTRICT,SHAH FAISAL SUB-DIVISION,28,0,9043,9043
KORANGI DISTRICT,SHAH FAISAL SUB-DIVISION,29,0,9393,9393
KORANGI DISTRICT,SHAH FAISAL SUB-DIVISION,30,0,8277,8277
KORANGI DISTRICT,SHAH FAISAL SUB-DIVISION,31,0,9412,9412
KORANGI DISTRICT,SHAH FAISAL SUB-DIVISION,32,0,8947,8947
KORANGI DISTRICT,SHAH FAISAL SUB-DIVISION,33,0,8747,8747
KORANGI DISTRICT,SHAH FAISAL SUB-DIVISION,34,0,8466,8466
KORANGI DISTRICT,SHAH FAISAL SUB-DIVISION,35,0,6579,6579
KORANGI DISTRICT,SHAH FAISAL SUB-DIVISION,36,0,8172,8172
KORANGI DISTRICT,SHAH FAISAL SUB-DIVISION,37,0,7169,7169
KORANGI DISTRICT,SHAH FAISAL SUB-DIVISION,38,0,8279,8279
KORANGI DISTRICT,SHAH FAISAL SUB-DIVISION,39,0,7702,7702
KORANGI DISTRICT,SHAH FAISAL SUB-DIVISION,40,0,6882,6882
KORANGI DISTRICT,SHAH FAISAL SUB-DIVISION,41,0,7083,7083
KORANGI DISTRICT,SHAH FAISAL SUB-DIVISION,42,0,6831,6831
KORANGI DISTRICT,SHAH FAISAL SUB-DIVISION,43,0,6866,6866
KORANGI DISTRICT,SHAH FAISAL SUB-DIVISION,44,0,6101,6101
KORANGI DISTRICT,SHAH FAISAL SUB-DIVISION,45,0,4714,4714
KORANGI DISTRICT,SHAH FAISAL SUB-DIVISION,46,0,5349,5349
KORANGI DISTRICT,SHAH FAISAL SUB-DIVISION,47,0,4677,4677
KORANGI DISTRICT,SHAH FAISAL SUB-DIVISION,48,0,5294,5294
KORANGI DISTRICT,SHAH FAISAL SUB-DIVISION,49,0,5182,5182
KORANGI DISTRICT,SHAH FAISAL SUB-DIVISION,50,0,4297,4297
KORANGI DISTRICT,SHAH FAISAL SUB-DIVISION,51,0,4768,4768
KORANGI DISTRICT,SHAH FAISAL SUB-DIVISION,52,0,4534,4534
KORANGI DISTRICT,SHAH FAISAL SUB-DIVISION,53,0,4469,4469
KORANGI DISTRICT,SHAH FAISAL SUB-DIVISION,54,0,4187,4187
KORANGI DISTRICT,SHAH FAISAL SUB-DIVISION,55,0,3123,3123
KORANGI DISTRICT,SHAH FAISAL SUB-DIVISION,56,0,3502,3502
KORANGI DISTRICT,SHAH FAISAL SUB-DIVISION,57,0,3017,3017
KORANGI DISTRICT,SHAH FAISAL SUB-DIVISION,58,0,3048,3048
KORANGI DISTRICT,SHAH FAISAL SUB-DIVISION,59,0,2909,2909
KORANGI DISTRICT,SHAH FAISAL SUB-DIVISION,60,0,2337,2337
KORANGI DISTRICT,SHAH FAISAL SUB-DIVISION,61,0,2807,2807
KORANGI DISTRICT,SHAH FAISAL SUB-DIVISION,62,0,2675,2675
KORANGI DISTRICT,SHAH FAISAL SUB-DIVISION,63,0,2575,2575
KORANGI DISTRICT,SHAH FAISAL SUB-DIVISION,64,0,2223,2223
KORANGI DISTRICT,SHAH FAISAL SUB-DIVISION,65,0,1702,1702
KORANGI DISTRICT,SHAH FAISAL SUB-DIVISION,66,0,1600,1600
KORANGI DISTRICT,SHAH FAISAL SUB-DIVISION,67,0,1372,1372
KORANGI DISTRICT,SHAH FAISAL SUB-DIVISION,68,0,1542,1542
KORANGI DISTRICT,SHAH FAISAL SUB-DIVISION,69,0,1445,1445
KORANGI DISTRICT,SHAH FAISAL SUB-DIVISION,70,0,1029,1029
KORANGI DISTRICT,SHAH FAISAL SUB-DIVISION,71,0,1082,1082
KORANGI DISTRICT,SHAH FAISAL SUB-DIVISION,72,0,1098,1098
KORANGI DISTRICT,SHAH FAISAL SUB-DIVISION,73,0,1076,1076
KORANGI DISTRICT,SHAH FAISAL SUB-DIVISION,74,0,867,867
KORANGI DISTRICT,SHAH FAISAL SUB-DIVISION,>=75,0,5635,5635
KURRAM AGENCY,CENTRAL KURRAM F.R,<1,8079,0,8079
KURRAM AGENCY,CENTRAL KURRAM F.R,1,8126,0,8126
KURRAM AGENCY,CENTRAL KURRAM F.R,2,10143,0,10143
KURRAM AGENCY,CENTRAL KURRAM F.R,3,9605,0,9605
KURRAM AGENCY,CENTRAL KURRAM F.R,4,10293,0,10293
KURRAM AGENCY,CENTRAL KURRAM F.R,5,8993,0,8993
KURRAM AGENCY,CENTRAL KURRAM F.R,6,9525,0,9525
KURRAM AGENCY,CENTRAL KURRAM F.R,7,8456,0,8456
KURRAM AGENCY,CENTRAL KURRAM F.R,8,9250,0,9250
KURRAM AGENCY,CENTRAL KURRAM F.R,9,7838,0,7838
KURRAM AGENCY,CENTRAL KURRAM F.R,10,8212,0,8212
KURRAM AGENCY,CENTRAL KURRAM F.R,11,5885,0,5885
KURRAM AGENCY,CENTRAL KURRAM F.R,12,6044,0,6044
KURRAM AGENCY,CENTRAL KURRAM F.R,13,5162,0,5162
KURRAM AGENCY,CENTRAL KURRAM F.R,14,4874,0,4874
KURRAM AGENCY,CENTRAL KURRAM F.R,15,4658,0,4658
KURRAM AGENCY,CENTRAL KURRAM F.R,16,3822,0,3822
KURRAM AGENCY,CENTRAL KURRAM F.R,17,3295,0,3295
KURRAM AGENCY,CENTRAL KURRAM F.R,18,3619,0,3619
KURRAM AGENCY,CENTRAL KURRAM F.R,19,3545,0,3545
KURRAM AGENCY,CENTRAL KURRAM F.R,20,3697,0,3697
KURRAM AGENCY,CENTRAL KURRAM F.R,21,3286,0,3286
KURRAM AGENCY,CENTRAL KURRAM F.R,22,3069,0,3069
KURRAM AGENCY,CENTRAL KURRAM F.R,23,3608,0,3608
KURRAM AGENCY,CENTRAL KURRAM F.R,24,3769,0,3769
KURRAM AGENCY,CENTRAL KURRAM F.R,25,4004,0,4004
KURRAM AGENCY,CENTRAL KURRAM F.R,26,3607,0,3607
KURRAM AGENCY,CENTRAL KURRAM F.R,27,3881,0,3881
KURRAM AGENCY,CENTRAL KURRAM F.R,28,2939,0,2939
KURRAM AGENCY,CENTRAL KURRAM F.R,29,3267,0,3267
KURRAM AGENCY,CENTRAL KURRAM F.R,30,2754,0,2754
KURRAM AGENCY,CENTRAL KURRAM F.R,31,2780,0,2780
KURRAM AGENCY,CENTRAL KURRAM F.R,32,2491,0,2491
KURRAM AGENCY,CENTRAL KURRAM F.R,33,2317,0,2317
KURRAM AGENCY,CENTRAL KURRAM F.R,34,1929,0,1929
KURRAM AGENCY,CENTRAL KURRAM F.R,35,2012,0,2012
KURRAM AGENCY,CENTRAL KURRAM F.R,36,1678,0,1678
KURRAM AGENCY,CENTRAL KURRAM F.R,37,2224,0,2224
KURRAM AGENCY,CENTRAL KURRAM F.R,38,1650,0,1650
KURRAM AGENCY,CENTRAL KURRAM F.R,39,1884,0,1884
KURRAM AGENCY,CENTRAL KURRAM F.R,40,1936,0,1936
KURRAM AGENCY,CENTRAL KURRAM F.R,41,1753,0,1753
KURRAM AGENCY,CENTRAL KURRAM F.R,42,1618,0,1618
KURRAM AGENCY,CENTRAL KURRAM F.R,43,1411,0,1411
KURRAM AGENCY,CENTRAL KURRAM F.R,44,1162,0,1162
KURRAM AGENCY,CENTRAL KURRAM F.R,45,1201,0,1201
KURRAM AGENCY,CENTRAL KURRAM F.R,46,1134,0,1134
KURRAM AGENCY,CENTRAL KURRAM F.R,47,1499,0,1499
KURRAM AGENCY,CENTRAL KURRAM F.R,48,890,0,890
KURRAM AGENCY,CENTRAL KURRAM F.R,49,1025,0,1025
KURRAM AGENCY,CENTRAL KURRAM F.R,50,1250,0,1250
KURRAM AGENCY,CENTRAL KURRAM F.R,51,1183,0,1183
KURRAM AGENCY,CENTRAL KURRAM F.R,52,1095,0,1095
KURRAM AGENCY,CENTRAL KURRAM F.R,53,825,0,825
KURRAM AGENCY,CENTRAL KURRAM F.R,54,747,0,747
KURRAM AGENCY,CENTRAL KURRAM F.R,55,882,0,882
KURRAM AGENCY,CENTRAL KURRAM F.R,56,866,0,866
KURRAM AGENCY,CENTRAL KURRAM F.R,57,1258,0,1258
KURRAM AGENCY,CENTRAL KURRAM F.R,58,577,0,577
KURRAM AGENCY,CENTRAL KURRAM F.R,59,665,0,665
KURRAM AGENCY,CENTRAL KURRAM F.R,60,979,0,979
KURRAM AGENCY,CENTRAL KURRAM F.R,61,752,0,752
KURRAM AGENCY,CENTRAL KURRAM F.R,62,761,0,761
KURRAM AGENCY,CENTRAL KURRAM F.R,63,607,0,607
KURRAM AGENCY,CENTRAL KURRAM F.R,64,564,0,564
KURRAM AGENCY,CENTRAL KURRAM F.R,65,511,0,511
KURRAM AGENCY,CENTRAL KURRAM F.R,66,531,0,531
KURRAM AGENCY,CENTRAL KURRAM F.R,67,778,0,778
KURRAM AGENCY,CENTRAL KURRAM F.R,68,392,0,392
KURRAM AGENCY,CENTRAL KURRAM F.R,69,355,0,355
KURRAM AGENCY,CENTRAL KURRAM F.R,70,370,0,370
KURRAM AGENCY,CENTRAL KURRAM F.R,71,317,0,317
KURRAM AGENCY,CENTRAL KURRAM F.R,72,342,0,342
KURRAM AGENCY,CENTRAL KURRAM F.R,73,245,0,245
KURRAM AGENCY,CENTRAL KURRAM F.R,74,204,0,204
KURRAM AGENCY,CENTRAL KURRAM F.R,>=75,2052,0,2052
KURRAM AGENCY,LOWER KURRAM TEHSIL,<1,2809,977,3786
KURRAM AGENCY,LOWER KURRAM TEHSIL,1,3364,985,4349
KURRAM AGENCY,LOWER KURRAM TEHSIL,2,3750,1256,5006
KURRAM AGENCY,LOWER KURRAM TEHSIL,3,3692,1264,4956
KURRAM AGENCY,LOWER KURRAM TEHSIL,4,3860,1263,5123
KURRAM AGENCY,LOWER KURRAM TEHSIL,5,3633,1177,4810
KURRAM AGENCY,LOWER KURRAM TEHSIL,6,3382,1107,4489
KURRAM AGENCY,LOWER KURRAM TEHSIL,7,3224,1079,4303
KURRAM AGENCY,LOWER KURRAM TEHSIL,8,3343,994,4337
KURRAM AGENCY,LOWER KURRAM TEHSIL,9,3207,1026,4233
KURRAM AGENCY,LOWER KURRAM TEHSIL,10,3013,914,3927
KURRAM AGENCY,LOWER KURRAM TEHSIL,11,2465,881,3346
KURRAM AGENCY,LOWER KURRAM TEHSIL,12,2606,840,3446
KURRAM AGENCY,LOWER KURRAM TEHSIL,13,2523,833,3356
KURRAM AGENCY,LOWER KURRAM TEHSIL,14,2428,792,3220
KURRAM AGENCY,LOWER KURRAM TEHSIL,15,2429,804,3233
KURRAM AGENCY,LOWER KURRAM TEHSIL,16,2066,717,2783
KURRAM AGENCY,LOWER KURRAM TEHSIL,17,1902,646,2548
KURRAM AGENCY,LOWER KURRAM TEHSIL,18,2007,638,2645
KURRAM AGENCY,LOWER KURRAM TEHSIL,19,1896,652,2548
KURRAM AGENCY,LOWER KURRAM TEHSIL,20,1958,655,2613
KURRAM AGENCY,LOWER KURRAM TEHSIL,21,1758,621,2379
KURRAM AGENCY,LOWER KURRAM TEHSIL,22,1589,501,2090
KURRAM AGENCY,LOWER KURRAM TEHSIL,23,1668,612,2280
KURRAM AGENCY,LOWER KURRAM TEHSIL,24,1444,556,2000
KURRAM AGENCY,LOWER KURRAM TEHSIL,25,2074,647,2721
KURRAM AGENCY,LOWER KURRAM TEHSIL,26,1631,515,2146
KURRAM AGENCY,LOWER KURRAM TEHSIL,27,1610,605,2215
KURRAM AGENCY,LOWER KURRAM TEHSIL,28,1489,501,1990
KURRAM AGENCY,LOWER KURRAM TEHSIL,29,1532,499,2031
KURRAM AGENCY,LOWER KURRAM TEHSIL,30,1603,378,1981
KURRAM AGENCY,LOWER KURRAM TEHSIL,31,1268,403,1671
KURRAM AGENCY,LOWER KURRAM TEHSIL,32,1043,331,1374
KURRAM AGENCY,LOWER KURRAM TEHSIL,33,1225,358,1583
KURRAM AGENCY,LOWER KURRAM TEHSIL,34,910,271,1181
KURRAM AGENCY,LOWER KURRAM TEHSIL,35,1193,310,1503
KURRAM AGENCY,LOWER KURRAM TEHSIL,36,721,226,947
KURRAM AGENCY,LOWER KURRAM TEHSIL,37,931,337,1268
KURRAM AGENCY,LOWER KURRAM TEHSIL,38,868,271,1139
KURRAM AGENCY,LOWER KURRAM TEHSIL,39,951,295,1246
KURRAM AGENCY,LOWER KURRAM TEHSIL,40,1179,305,1484
KURRAM AGENCY,LOWER KURRAM TEHSIL,41,748,249,997
KURRAM AGENCY,LOWER KURRAM TEHSIL,42,638,217,855
KURRAM AGENCY,LOWER KURRAM TEHSIL,43,701,216,917
KURRAM AGENCY,LOWER KURRAM TEHSIL,44,588,177,765
KURRAM AGENCY,LOWER KURRAM TEHSIL,45,778,220,998
KURRAM AGENCY,LOWER KURRAM TEHSIL,46,512,112,624
KURRAM AGENCY,LOWER KURRAM TEHSIL,47,591,213,804
KURRAM AGENCY,LOWER KURRAM TEHSIL,48,516,146,662
KURRAM AGENCY,LOWER KURRAM TEHSIL,49,552,176,728
KURRAM AGENCY,LOWER KURRAM TEHSIL,50,711,212,923
KURRAM AGENCY,LOWER KURRAM TEHSIL,51,504,153,657
KURRAM AGENCY,LOWER KURRAM TEHSIL,52,495,195,690
KURRAM AGENCY,LOWER KURRAM TEHSIL,53,478,164,642
KURRAM AGENCY,LOWER KURRAM TEHSIL,54,398,119,517
KURRAM AGENCY,LOWER KURRAM TEHSIL,55,470,156,626
KURRAM AGENCY,LOWER KURRAM TEHSIL,56,403,91,494
KURRAM AGENCY,LOWER KURRAM TEHSIL,57,537,203,740
KURRAM AGENCY,LOWER KURRAM TEHSIL,58,327,92,419
KURRAM AGENCY,LOWER KURRAM TEHSIL,59,379,101,480
KURRAM AGENCY,LOWER KURRAM TEHSIL,60,511,120,631
KURRAM AGENCY,LOWER KURRAM TEHSIL,61,378,83,461
KURRAM AGENCY,LOWER KURRAM TEHSIL,62,359,95,454
KURRAM AGENCY,LOWER KURRAM TEHSIL,63,338,107,445
KURRAM AGENCY,LOWER KURRAM TEHSIL,64,280,69,349
KURRAM AGENCY,LOWER KURRAM TEHSIL,65,258,65,323
KURRAM AGENCY,LOWER KURRAM TEHSIL,66,230,54,284
KURRAM AGENCY,LOWER KURRAM TEHSIL,67,342,129,471
KURRAM AGENCY,LOWER KURRAM TEHSIL,68,186,44,230
KURRAM AGENCY,LOWER KURRAM TEHSIL,69,167,64,231
KURRAM AGENCY,LOWER KURRAM TEHSIL,70,208,54,262
KURRAM AGENCY,LOWER KURRAM TEHSIL,71,151,36,187
KURRAM AGENCY,LOWER KURRAM TEHSIL,72,136,57,193
KURRAM AGENCY,LOWER KURRAM TEHSIL,73,126,38,164
KURRAM AGENCY,LOWER KURRAM TEHSIL,74,104,30,134
KURRAM AGENCY,LOWER KURRAM TEHSIL,>=75,1042,244,1286
KURRAM AGENCY,UPPER KURRAM TEHSIL,<1,5957,121,6078
KURRAM AGENCY,UPPER KURRAM TEHSIL,1,6728,139,6867
KURRAM AGENCY,UPPER KURRAM TEHSIL,2,7365,143,7508
KURRAM AGENCY,UPPER KURRAM TEHSIL,3,8190,173,8363
KURRAM AGENCY,UPPER KURRAM TEHSIL,4,8371,161,8532
KURRAM AGENCY,UPPER KURRAM TEHSIL,5,7844,144,7988
KURRAM AGENCY,UPPER KURRAM TEHSIL,6,7499,163,7662
KURRAM AGENCY,UPPER KURRAM TEHSIL,7,7512,148,7660
KURRAM AGENCY,UPPER KURRAM TEHSIL,8,7221,141,7362
KURRAM AGENCY,UPPER KURRAM TEHSIL,9,7194,145,7339
KURRAM AGENCY,UPPER KURRAM TEHSIL,10,6664,128,6792
KURRAM AGENCY,UPPER KURRAM TEHSIL,11,6108,144,6252
KURRAM AGENCY,UPPER KURRAM TEHSIL,12,6380,132,6512
KURRAM AGENCY,UPPER KURRAM TEHSIL,13,5641,140,5781
KURRAM AGENCY,UPPER KURRAM TEHSIL,14,5974,127,6101
KURRAM AGENCY,UPPER KURRAM TEHSIL,15,5731,133,5864
KURRAM AGENCY,UPPER KURRAM TEHSIL,16,5359,120,5479
KURRAM AGENCY,UPPER KURRAM TEHSIL,17,4892,133,5025
KURRAM AGENCY,UPPER KURRAM TEHSIL,18,5245,116,5361
KURRAM AGENCY,UPPER KURRAM TEHSIL,19,4998,105,5103
KURRAM AGENCY,UPPER KURRAM TEHSIL,20,4709,103,4812
KURRAM AGENCY,UPPER KURRAM TEHSIL,21,4569,110,4679
KURRAM AGENCY,UPPER KURRAM TEHSIL,22,4554,89,4643
KURRAM AGENCY,UPPER KURRAM TEHSIL,23,4487,84,4571
KURRAM AGENCY,UPPER KURRAM TEHSIL,24,4266,97,4363
KURRAM AGENCY,UPPER KURRAM TEHSIL,25,4726,93,4819
KURRAM AGENCY,UPPER KURRAM TEHSIL,26,4206,82,4288
KURRAM AGENCY,UPPER KURRAM TEHSIL,27,4104,95,4199
KURRAM AGENCY,UPPER KURRAM TEHSIL,28,4201,89,4290
KURRAM AGENCY,UPPER KURRAM TEHSIL,29,3654,96,3750
KURRAM AGENCY,UPPER KURRAM TEHSIL,30,3882,97,3979
KURRAM AGENCY,UPPER KURRAM TEHSIL,31,3322,77,3399
KURRAM AGENCY,UPPER KURRAM TEHSIL,32,3090,75,3165
KURRAM AGENCY,UPPER KURRAM TEHSIL,33,3102,84,3186
KURRAM AGENCY,UPPER KURRAM TEHSIL,34,2591,75,2666
KURRAM AGENCY,UPPER KURRAM TEHSIL,35,3040,76,3116
KURRAM AGENCY,UPPER KURRAM TEHSIL,36,2180,48,2228
KURRAM AGENCY,UPPER KURRAM TEHSIL,37,2340,71,2411
KURRAM AGENCY,UPPER KURRAM TEHSIL,38,2579,74,2653
KURRAM AGENCY,UPPER KURRAM TEHSIL,39,2319,64,2383
KURRAM AGENCY,UPPER KURRAM TEHSIL,40,2809,73,2882
KURRAM AGENCY,UPPER KURRAM TEHSIL,41,1952,56,2008
KURRAM AGENCY,UPPER KURRAM TEHSIL,42,1837,40,1877
KURRAM AGENCY,UPPER KURRAM TEHSIL,43,1854,49,1903
KURRAM AGENCY,UPPER KURRAM TEHSIL,44,1566,36,1602
KURRAM AGENCY,UPPER KURRAM TEHSIL,45,1949,54,2003
KURRAM AGENCY,UPPER KURRAM TEHSIL,46,1402,36,1438
KURRAM AGENCY,UPPER KURRAM TEHSIL,47,1567,42,1609
KURRAM AGENCY,UPPER KURRAM TEHSIL,48,1464,41,1505
KURRAM AGENCY,UPPER KURRAM TEHSIL,49,1578,31,1609
KURRAM AGENCY,UPPER KURRAM TEHSIL,50,1839,38,1877
KURRAM AGENCY,UPPER KURRAM TEHSIL,51,1510,35,1545
KURRAM AGENCY,UPPER KURRAM TEHSIL,52,1384,39,1423
KURRAM AGENCY,UPPER KURRAM TEHSIL,53,1361,30,1391
KURRAM AGENCY,UPPER KURRAM TEHSIL,54,1258,26,1284
KURRAM AGENCY,UPPER KURRAM TEHSIL,55,1495,37,1532
KURRAM AGENCY,UPPER KURRAM TEHSIL,56,1069,20,1089
KURRAM AGENCY,UPPER KURRAM TEHSIL,57,1377,38,1415
KURRAM AGENCY,UPPER KURRAM TEHSIL,58,1072,31,1103
KURRAM AGENCY,UPPER KURRAM TEHSIL,59,1051,31,1082
KURRAM AGENCY,UPPER KURRAM TEHSIL,60,1261,20,1281
KURRAM AGENCY,UPPER KURRAM TEHSIL,61,1026,21,1047
KURRAM AGENCY,UPPER KURRAM TEHSIL,62,1168,33,1201
KURRAM AGENCY,UPPER KURRAM TEHSIL,63,978,20,998
KURRAM AGENCY,UPPER KURRAM TEHSIL,64,809,19,828
KURRAM AGENCY,UPPER KURRAM TEHSIL,65,795,22,817
KURRAM AGENCY,UPPER KURRAM TEHSIL,66,623,7,630
KURRAM AGENCY,UPPER KURRAM TEHSIL,67,737,23,760
KURRAM AGENCY,UPPER KURRAM TEHSIL,68,510,15,525
KURRAM AGENCY,UPPER KURRAM TEHSIL,69,504,15,519
KURRAM AGENCY,UPPER KURRAM TEHSIL,70,474,8,482
KURRAM AGENCY,UPPER KURRAM TEHSIL,71,416,13,429
KURRAM AGENCY,UPPER KURRAM TEHSIL,72,435,11,446
KURRAM AGENCY,UPPER KURRAM TEHSIL,73,348,3,351
KURRAM AGENCY,UPPER KURRAM TEHSIL,74,316,7,323
KURRAM AGENCY,UPPER KURRAM TEHSIL,>=75,2346,47,2393
LAHORE DISTRICT,LAHORE CANTT TEHSIL,<1,0,35872,35872
LAHORE DISTRICT,LAHORE CANTT TEHSIL,1,0,36873,36873
LAHORE DISTRICT,LAHORE CANTT TEHSIL,2,0,36935,36935
LAHORE DISTRICT,LAHORE CANTT TEHSIL,3,0,40435,40435
LAHORE DISTRICT,LAHORE CANTT TEHSIL,4,0,37050,37050
LAHORE DISTRICT,LAHORE CANTT TEHSIL,5,0,37783,37783
LAHORE DISTRICT,LAHORE CANTT TEHSIL,6,0,37035,37035
LAHORE DISTRICT,LAHORE CANTT TEHSIL,7,0,39725,39725
LAHORE DISTRICT,LAHORE CANTT TEHSIL,8,0,35514,35514
LAHORE DISTRICT,LAHORE CANTT TEHSIL,9,0,39117,39117
LAHORE DISTRICT,LAHORE CANTT TEHSIL,10,0,33481,33481
LAHORE DISTRICT,LAHORE CANTT TEHSIL,11,0,38000,38000
LAHORE DISTRICT,LAHORE CANTT TEHSIL,12,0,32325,32325
LAHORE DISTRICT,LAHORE CANTT TEHSIL,13,0,34359,34359
LAHORE DISTRICT,LAHORE CANTT TEHSIL,14,0,31095,31095
LAHORE DISTRICT,LAHORE CANTT TEHSIL,15,0,31831,31831
LAHORE DISTRICT,LAHORE CANTT TEHSIL,16,0,32075,32075
LAHORE DISTRICT,LAHORE CANTT TEHSIL,17,0,33660,33660
LAHORE DISTRICT,LAHORE CANTT TEHSIL,18,0,30400,30400
LAHORE DISTRICT,LAHORE CANTT TEHSIL,19,0,33810,33810
LAHORE DISTRICT,LAHORE CANTT TEHSIL,20,0,30256,30256
LAHORE DISTRICT,LAHORE CANTT TEHSIL,21,0,35403,35403
LAHORE DISTRICT,LAHORE CANTT TEHSIL,22,0,32859,32859
LAHORE DISTRICT,LAHORE CANTT TEHSIL,23,0,33443,33443
LAHORE DISTRICT,LAHORE CANTT TEHSIL,24,0,33275,33275
LAHORE DISTRICT,LAHORE CANTT TEHSIL,25,0,28603,28603
LAHORE DISTRICT,LAHORE CANTT TEHSIL,26,0,33074,33074
LAHORE DISTRICT,LAHORE CANTT TEHSIL,27,0,30644,30644
LAHORE DISTRICT,LAHORE CANTT TEHSIL,28,0,30517,30517
LAHORE DISTRICT,LAHORE CANTT TEHSIL,29,0,28115,28115
LAHORE DISTRICT,LAHORE CANTT TEHSIL,30,0,28650,28650
LAHORE DISTRICT,LAHORE CANTT TEHSIL,31,0,26675,26675
LAHORE DISTRICT,LAHORE CANTT TEHSIL,32,0,27132,27132
LAHORE DISTRICT,LAHORE CANTT TEHSIL,33,0,25665,25665
LAHORE DISTRICT,LAHORE CANTT TEHSIL,34,0,23763,23763
LAHORE DISTRICT,LAHORE CANTT TEHSIL,35,0,23076,23076
LAHORE DISTRICT,LAHORE CANTT TEHSIL,36,0,22376,22376
LAHORE DISTRICT,LAHORE CANTT TEHSIL,37,0,18967,18967
LAHORE DISTRICT,LAHORE CANTT TEHSIL,38,0,23577,23577
LAHORE DISTRICT,LAHORE CANTT TEHSIL,39,0,20339,20339
LAHORE DISTRICT,LAHORE CANTT TEHSIL,40,0,21342,21342
LAHORE DISTRICT,LAHORE CANTT TEHSIL,41,0,18105,18105
LAHORE DISTRICT,LAHORE CANTT TEHSIL,42,0,17287,17287
LAHORE DISTRICT,LAHORE CANTT TEHSIL,43,0,17288,17288
LAHORE DISTRICT,LAHORE CANTT TEHSIL,44,0,15233,15233
LAHORE DISTRICT,LAHORE CANTT TEHSIL,45,0,15580,15580
LAHORE DISTRICT,LAHORE CANTT TEHSIL,46,0,13197,13197
LAHORE DISTRICT,LAHORE CANTT TEHSIL,47,0,11845,11845
LAHORE DISTRICT,LAHORE CANTT TEHSIL,48,0,14480,14480
LAHORE DISTRICT,LAHORE CANTT TEHSIL,49,0,13482,13482
LAHORE DISTRICT,LAHORE CANTT TEHSIL,50,0,14620,14620
LAHORE DISTRICT,LAHORE CANTT TEHSIL,51,0,12337,12337
LAHORE DISTRICT,LAHORE CANTT TEHSIL,52,0,12852,12852
LAHORE DISTRICT,LAHORE CANTT TEHSIL,53,0,12336,12336
LAHORE DISTRICT,LAHORE CANTT TEHSIL,54,0,11367,11367
LAHORE DISTRICT,LAHORE CANTT TEHSIL,55,0,11162,11162
LAHORE DISTRICT,LAHORE CANTT TEHSIL,56,0,9452,9452
LAHORE DISTRICT,LAHORE CANTT TEHSIL,57,0,7740,7740
LAHORE DISTRICT,LAHORE CANTT TEHSIL,58,0,9069,9069
LAHORE DISTRICT,LAHORE CANTT TEHSIL,59,0,7896,7896
LAHORE DISTRICT,LAHORE CANTT TEHSIL,60,0,8582,8582
LAHORE DISTRICT,LAHORE CANTT TEHSIL,61,0,7504,7504
LAHORE DISTRICT,LAHORE CANTT TEHSIL,62,0,7813,7813
LAHORE DISTRICT,LAHORE CANTT TEHSIL,63,0,7708,7708
LAHORE DISTRICT,LAHORE CANTT TEHSIL,64,0,6597,6597
LAHORE DISTRICT,LAHORE CANTT TEHSIL,65,0,6409,6409
LAHORE DISTRICT,LAHORE CANTT TEHSIL,66,0,4838,4838
LAHORE DISTRICT,LAHORE CANTT TEHSIL,67,0,4024,4024
LAHORE DISTRICT,LAHORE CANTT TEHSIL,68,0,4899,4899
LAHORE DISTRICT,LAHORE CANTT TEHSIL,69,0,4371,4371
LAHORE DISTRICT,LAHORE CANTT TEHSIL,70,0,4381,4381
LAHORE DISTRICT,LAHORE CANTT TEHSIL,71,0,3573,3573
LAHORE DISTRICT,LAHORE CANTT TEHSIL,72,0,3734,3734
LAHORE DISTRICT,LAHORE CANTT TEHSIL,73,0,3374,3374
LAHORE DISTRICT,LAHORE CANTT TEHSIL,74,0,2957,2957
LAHORE DISTRICT,LAHORE CANTT TEHSIL,>=75,0,21484,21484
LAHORE DISTRICT,LAHORE CITY TEHSIL,<1,0,78437,78437
LAHORE DISTRICT,LAHORE CITY TEHSIL,1,0,81664,81664
LAHORE DISTRICT,LAHORE CITY TEHSIL,2,0,83444,83444
LAHORE DISTRICT,LAHORE CITY TEHSIL,3,0,91523,91523
LAHORE DISTRICT,LAHORE CITY TEHSIL,4,0,84023,84023
LAHORE DISTRICT,LAHORE CITY TEHSIL,5,0,85420,85420
LAHORE DISTRICT,LAHORE CITY TEHSIL,6,0,83495,83495
LAHORE DISTRICT,LAHORE CITY TEHSIL,7,0,89548,89548
LAHORE DISTRICT,LAHORE CITY TEHSIL,8,0,78934,78934
LAHORE DISTRICT,LAHORE CITY TEHSIL,9,0,86084,86084
LAHORE DISTRICT,LAHORE CITY TEHSIL,10,0,75934,75934
LAHORE DISTRICT,LAHORE CITY TEHSIL,11,0,84528,84528
LAHORE DISTRICT,LAHORE CITY TEHSIL,12,0,73782,73782
LAHORE DISTRICT,LAHORE CITY TEHSIL,13,0,76340,76340
LAHORE DISTRICT,LAHORE CITY TEHSIL,14,0,70041,70041
LAHORE DISTRICT,LAHORE CITY TEHSIL,15,0,71614,71614
LAHORE DISTRICT,LAHORE CITY TEHSIL,16,0,73159,73159
LAHORE DISTRICT,LAHORE CITY TEHSIL,17,0,76499,76499
LAHORE DISTRICT,LAHORE CITY TEHSIL,18,0,71910,71910
LAHORE DISTRICT,LAHORE CITY TEHSIL,19,0,76311,76311
LAHORE DISTRICT,LAHORE CITY TEHSIL,20,0,70063,70063
LAHORE DISTRICT,LAHORE CITY TEHSIL,21,0,79800,79800
LAHORE DISTRICT,LAHORE CITY TEHSIL,22,0,76368,76368
LAHORE DISTRICT,LAHORE CITY TEHSIL,23,0,74311,74311
LAHORE DISTRICT,LAHORE CITY TEHSIL,24,0,72949,72949
LAHORE DISTRICT,LAHORE CITY TEHSIL,25,0,64879,64879
LAHORE DISTRICT,LAHORE CITY TEHSIL,26,0,70445,70445
LAHORE DISTRICT,LAHORE CITY TEHSIL,27,0,65710,65710
LAHORE DISTRICT,LAHORE CITY TEHSIL,28,0,68122,68122
LAHORE DISTRICT,LAHORE CITY TEHSIL,29,0,59805,59805
LAHORE DISTRICT,LAHORE CITY TEHSIL,30,0,65276,65276
LAHORE DISTRICT,LAHORE CITY TEHSIL,31,0,56954,56954
LAHORE DISTRICT,LAHORE CITY TEHSIL,32,0,61436,61436
LAHORE DISTRICT,LAHORE CITY TEHSIL,33,0,55559,55559
LAHORE DISTRICT,LAHORE CITY TEHSIL,34,0,49484,49484
LAHORE DISTRICT,LAHORE CITY TEHSIL,35,0,54087,54087
LAHORE DISTRICT,LAHORE CITY TEHSIL,36,0,48400,48400
LAHORE DISTRICT,LAHORE CITY TEHSIL,37,0,41152,41152
LAHORE DISTRICT,LAHORE CITY TEHSIL,38,0,53410,53410
LAHORE DISTRICT,LAHORE CITY TEHSIL,39,0,43694,43694
LAHORE DISTRICT,LAHORE CITY TEHSIL,40,0,53015,53015
LAHORE DISTRICT,LAHORE CITY TEHSIL,41,0,39316,39316
LAHORE DISTRICT,LAHORE CITY TEHSIL,42,0,40679,40679
LAHORE DISTRICT,LAHORE CITY TEHSIL,43,0,39173,39173
LAHORE DISTRICT,LAHORE CITY TEHSIL,44,0,33882,33882
LAHORE DISTRICT,LAHORE CITY TEHSIL,45,0,39707,39707
LAHORE DISTRICT,LAHORE CITY TEHSIL,46,0,29213,29213
LAHORE DISTRICT,LAHORE CITY TEHSIL,47,0,26509,26509
LAHORE DISTRICT,LAHORE CITY TEHSIL,48,0,33336,33336
LAHORE DISTRICT,LAHORE CITY TEHSIL,49,0,30620,30620
LAHORE DISTRICT,LAHORE CITY TEHSIL,50,0,37528,37528
LAHORE DISTRICT,LAHORE CITY TEHSIL,51,0,26674,26674
LAHORE DISTRICT,LAHORE CITY TEHSIL,52,0,29207,29207
LAHORE DISTRICT,LAHORE CITY TEHSIL,53,0,27678,27678
LAHORE DISTRICT,LAHORE CITY TEHSIL,54,0,25343,25343
LAHORE DISTRICT,LAHORE CITY TEHSIL,55,0,27638,27638
LAHORE DISTRICT,LAHORE CITY TEHSIL,56,0,20815,20815
LAHORE DISTRICT,LAHORE CITY TEHSIL,57,0,16513,16513
LAHORE DISTRICT,LAHORE CITY TEHSIL,58,0,19963,19963
LAHORE DISTRICT,LAHORE CITY TEHSIL,59,0,17624,17624
LAHORE DISTRICT,LAHORE CITY TEHSIL,60,0,20722,20722
LAHORE DISTRICT,LAHORE CITY TEHSIL,61,0,15460,15460
LAHORE DISTRICT,LAHORE CITY TEHSIL,62,0,16620,16620
LAHORE DISTRICT,LAHORE CITY TEHSIL,63,0,16519,16519
LAHORE DISTRICT,LAHORE CITY TEHSIL,64,0,13986,13986
LAHORE DISTRICT,LAHORE CITY TEHSIL,65,0,15107,15107
LAHORE DISTRICT,LAHORE CITY TEHSIL,66,0,9698,9698
LAHORE DISTRICT,LAHORE CITY TEHSIL,67,0,7938,7938
LAHORE DISTRICT,LAHORE CITY TEHSIL,68,0,9682,9682
LAHORE DISTRICT,LAHORE CITY TEHSIL,69,0,8767,8767
LAHORE DISTRICT,LAHORE CITY TEHSIL,70,0,10046,10046
LAHORE DISTRICT,LAHORE CITY TEHSIL,71,0,7067,7067
LAHORE DISTRICT,LAHORE CITY TEHSIL,72,0,7526,7526
LAHORE DISTRICT,LAHORE CITY TEHSIL,73,0,7121,7121
LAHORE DISTRICT,LAHORE CITY TEHSIL,74,0,6202,6202
LAHORE DISTRICT,LAHORE CITY TEHSIL,>=75,0,42128,42128
LAHORE DISTRICT,MODEL TOWN TEHSIL,<1,0,60056,60056
LAHORE DISTRICT,MODEL TOWN TEHSIL,1,0,61405,61405
LAHORE DISTRICT,MODEL TOWN TEHSIL,2,0,62232,62232
LAHORE DISTRICT,MODEL TOWN TEHSIL,3,0,66910,66910
LAHORE DISTRICT,MODEL TOWN TEHSIL,4,0,60783,60783
LAHORE DISTRICT,MODEL TOWN TEHSIL,5,0,62492,62492
LAHORE DISTRICT,MODEL TOWN TEHSIL,6,0,60796,60796
LAHORE DISTRICT,MODEL TOWN TEHSIL,7,0,65257,65257
LAHORE DISTRICT,MODEL TOWN TEHSIL,8,0,58191,58191
LAHORE DISTRICT,MODEL TOWN TEHSIL,9,0,63736,63736
LAHORE DISTRICT,MODEL TOWN TEHSIL,10,0,55017,55017
LAHORE DISTRICT,MODEL TOWN TEHSIL,11,0,62171,62171
LAHORE DISTRICT,MODEL TOWN TEHSIL,12,0,53205,53205
LAHORE DISTRICT,MODEL TOWN TEHSIL,13,0,55762,55762
LAHORE DISTRICT,MODEL TOWN TEHSIL,14,0,51420,51420
LAHORE DISTRICT,MODEL TOWN TEHSIL,15,0,51913,51913
LAHORE DISTRICT,MODEL TOWN TEHSIL,16,0,53400,53400
LAHORE DISTRICT,MODEL TOWN TEHSIL,17,0,54720,54720
LAHORE DISTRICT,MODEL TOWN TEHSIL,18,0,53141,53141
LAHORE DISTRICT,MODEL TOWN TEHSIL,19,0,58180,58180
LAHORE DISTRICT,MODEL TOWN TEHSIL,20,0,54606,54606
LAHORE DISTRICT,MODEL TOWN TEHSIL,21,0,62919,62919
LAHORE DISTRICT,MODEL TOWN TEHSIL,22,0,59427,59427
LAHORE DISTRICT,MODEL TOWN TEHSIL,23,0,58963,58963
LAHORE DISTRICT,MODEL TOWN TEHSIL,24,0,58273,58273
LAHORE DISTRICT,MODEL TOWN TEHSIL,25,0,50481,50481
LAHORE DISTRICT,MODEL TOWN TEHSIL,26,0,54833,54833
LAHORE DISTRICT,MODEL TOWN TEHSIL,27,0,50930,50930
LAHORE DISTRICT,MODEL TOWN TEHSIL,28,0,50593,50593
LAHORE DISTRICT,MODEL TOWN TEHSIL,29,0,46651,46651
LAHORE DISTRICT,MODEL TOWN TEHSIL,30,0,47230,47230
LAHORE DISTRICT,MODEL TOWN TEHSIL,31,0,43084,43084
LAHORE DISTRICT,MODEL TOWN TEHSIL,32,0,43875,43875
LAHORE DISTRICT,MODEL TOWN TEHSIL,33,0,41583,41583
LAHORE DISTRICT,MODEL TOWN TEHSIL,34,0,37890,37890
LAHORE DISTRICT,MODEL TOWN TEHSIL,35,0,37906,37906
LAHORE DISTRICT,MODEL TOWN TEHSIL,36,0,36054,36054
LAHORE DISTRICT,MODEL TOWN TEHSIL,37,0,30774,30774
LAHORE DISTRICT,MODEL TOWN TEHSIL,38,0,38011,38011
LAHORE DISTRICT,MODEL TOWN TEHSIL,39,0,32568,32568
LAHORE DISTRICT,MODEL TOWN TEHSIL,40,0,35346,35346
LAHORE DISTRICT,MODEL TOWN TEHSIL,41,0,29351,29351
LAHORE DISTRICT,MODEL TOWN TEHSIL,42,0,28457,28457
LAHORE DISTRICT,MODEL TOWN TEHSIL,43,0,28116,28116
LAHORE DISTRICT,MODEL TOWN TEHSIL,44,0,24979,24979
LAHORE DISTRICT,MODEL TOWN TEHSIL,45,0,25967,25967
LAHORE DISTRICT,MODEL TOWN TEHSIL,46,0,21638,21638
LAHORE DISTRICT,MODEL TOWN TEHSIL,47,0,19127,19127
LAHORE DISTRICT,MODEL TOWN TEHSIL,48,0,23589,23589
LAHORE DISTRICT,MODEL TOWN TEHSIL,49,0,21941,21941
LAHORE DISTRICT,MODEL TOWN TEHSIL,50,0,24567,24567
LAHORE DISTRICT,MODEL TOWN TEHSIL,51,0,19737,19737
LAHORE DISTRICT,MODEL TOWN TEHSIL,52,0,20537,20537
LAHORE DISTRICT,MODEL TOWN TEHSIL,53,0,19687,19687
LAHORE DISTRICT,MODEL TOWN TEHSIL,54,0,18448,18448
LAHORE DISTRICT,MODEL TOWN TEHSIL,55,0,18364,18364
LAHORE DISTRICT,MODEL TOWN TEHSIL,56,0,15395,15395
LAHORE DISTRICT,MODEL TOWN TEHSIL,57,0,12006,12006
LAHORE DISTRICT,MODEL TOWN TEHSIL,58,0,14331,14331
LAHORE DISTRICT,MODEL TOWN TEHSIL,59,0,13106,13106
LAHORE DISTRICT,MODEL TOWN TEHSIL,60,0,13891,13891
LAHORE DISTRICT,MODEL TOWN TEHSIL,61,0,11494,11494
LAHORE DISTRICT,MODEL TOWN TEHSIL,62,0,12179,12179
LAHORE DISTRICT,MODEL TOWN TEHSIL,63,0,12105,12105
LAHORE DISTRICT,MODEL TOWN TEHSIL,64,0,10615,10615
LAHORE DISTRICT,MODEL TOWN TEHSIL,65,0,10162,10162
LAHORE DISTRICT,MODEL TOWN TEHSIL,66,0,7580,7580
LAHORE DISTRICT,MODEL TOWN TEHSIL,67,0,6343,6343
LAHORE DISTRICT,MODEL TOWN TEHSIL,68,0,7316,7316
LAHORE DISTRICT,MODEL TOWN TEHSIL,69,0,6735,6735
LAHORE DISTRICT,MODEL TOWN TEHSIL,70,0,7070,7070
LAHORE DISTRICT,MODEL TOWN TEHSIL,71,0,5556,5556
LAHORE DISTRICT,MODEL TOWN TEHSIL,72,0,5748,5748
LAHORE DISTRICT,MODEL TOWN TEHSIL,73,0,5448,5448
LAHORE DISTRICT,MODEL TOWN TEHSIL,74,0,4659,4659
LAHORE DISTRICT,MODEL TOWN TEHSIL,>=75,0,34541,34541
LAHORE DISTRICT,RAIWIND TEHSIL,<1,0,20020,20020
LAHORE DISTRICT,RAIWIND TEHSIL,1,0,21637,21637
LAHORE DISTRICT,RAIWIND TEHSIL,2,0,21612,21612
LAHORE DISTRICT,RAIWIND TEHSIL,3,0,22997,22997
LAHORE DISTRICT,RAIWIND TEHSIL,4,0,22039,22039
LAHORE DISTRICT,RAIWIND TEHSIL,5,0,21860,21860
LAHORE DISTRICT,RAIWIND TEHSIL,6,0,21660,21660
LAHORE DISTRICT,RAIWIND TEHSIL,7,0,22473,22473
LAHORE DISTRICT,RAIWIND TEHSIL,8,0,21200,21200
LAHORE DISTRICT,RAIWIND TEHSIL,9,0,21435,21435
LAHORE DISTRICT,RAIWIND TEHSIL,10,0,20158,20158
LAHORE DISTRICT,RAIWIND TEHSIL,11,0,20122,20122
LAHORE DISTRICT,RAIWIND TEHSIL,12,0,18892,18892
LAHORE DISTRICT,RAIWIND TEHSIL,13,0,18180,18180
LAHORE DISTRICT,RAIWIND TEHSIL,14,0,17670,17670
LAHORE DISTRICT,RAIWIND TEHSIL,15,0,17585,17585
LAHORE DISTRICT,RAIWIND TEHSIL,16,0,17779,17779
LAHORE DISTRICT,RAIWIND TEHSIL,17,0,17371,17371
LAHORE DISTRICT,RAIWIND TEHSIL,18,0,18284,18284
LAHORE DISTRICT,RAIWIND TEHSIL,19,0,19181,19181
LAHORE DISTRICT,RAIWIND TEHSIL,20,0,18724,18724
LAHORE DISTRICT,RAIWIND TEHSIL,21,0,19184,19184
LAHORE DISTRICT,RAIWIND TEHSIL,22,0,19111,19111
LAHORE DISTRICT,RAIWIND TEHSIL,23,0,17248,17248
LAHORE DISTRICT,RAIWIND TEHSIL,24,0,16771,16771
LAHORE DISTRICT,RAIWIND TEHSIL,25,0,15890,15890
LAHORE DISTRICT,RAIWIND TEHSIL,26,0,15714,15714
LAHORE DISTRICT,RAIWIND TEHSIL,27,0,14263,14263
LAHORE DISTRICT,RAIWIND TEHSIL,28,0,15112,15112
LAHORE DISTRICT,RAIWIND TEHSIL,29,0,13093,13093
LAHORE DISTRICT,RAIWIND TEHSIL,30,0,14678,14678
LAHORE DISTRICT,RAIWIND TEHSIL,31,0,12190,12190
LAHORE DISTRICT,RAIWIND TEHSIL,32,0,12623,12623
LAHORE DISTRICT,RAIWIND TEHSIL,33,0,11722,11722
LAHORE DISTRICT,RAIWIND TEHSIL,34,0,10707,10707
LAHORE DISTRICT,RAIWIND TEHSIL,35,0,11982,11982
LAHORE DISTRICT,RAIWIND TEHSIL,36,0,10414,10414
LAHORE DISTRICT,RAIWIND TEHSIL,37,0,8809,8809
LAHORE DISTRICT,RAIWIND TEHSIL,38,0,11027,11027
LAHORE DISTRICT,RAIWIND TEHSIL,39,0,9674,9674
LAHORE DISTRICT,RAIWIND TEHSIL,40,0,10998,10998
LAHORE DISTRICT,RAIWIND TEHSIL,41,0,8709,8709
LAHORE DISTRICT,RAIWIND TEHSIL,42,0,8021,8021
LAHORE DISTRICT,RAIWIND TEHSIL,43,0,7875,7875
LAHORE DISTRICT,RAIWIND TEHSIL,44,0,7034,7034
LAHORE DISTRICT,RAIWIND TEHSIL,45,0,7760,7760
LAHORE DISTRICT,RAIWIND TEHSIL,46,0,6322,6322
LAHORE DISTRICT,RAIWIND TEHSIL,47,0,5557,5557
LAHORE DISTRICT,RAIWIND TEHSIL,48,0,6532,6532
LAHORE DISTRICT,RAIWIND TEHSIL,49,0,6204,6204
LAHORE DISTRICT,RAIWIND TEHSIL,50,0,7261,7261
LAHORE DISTRICT,RAIWIND TEHSIL,51,0,5473,5473
LAHORE DISTRICT,RAIWIND TEHSIL,52,0,5395,5395
LAHORE DISTRICT,RAIWIND TEHSIL,53,0,5381,5381
LAHORE DISTRICT,RAIWIND TEHSIL,54,0,5019,5019
LAHORE DISTRICT,RAIWIND TEHSIL,55,0,5130,5130
LAHORE DISTRICT,RAIWIND TEHSIL,56,0,4121,4121
LAHORE DISTRICT,RAIWIND TEHSIL,57,0,3292,3292
LAHORE DISTRICT,RAIWIND TEHSIL,58,0,3911,3911
LAHORE DISTRICT,RAIWIND TEHSIL,59,0,3367,3367
LAHORE DISTRICT,RAIWIND TEHSIL,60,0,4200,4200
LAHORE DISTRICT,RAIWIND TEHSIL,61,0,3095,3095
LAHORE DISTRICT,RAIWIND TEHSIL,62,0,3066,3066
LAHORE DISTRICT,RAIWIND TEHSIL,63,0,3150,3150
LAHORE DISTRICT,RAIWIND TEHSIL,64,0,2832,2832
LAHORE DISTRICT,RAIWIND TEHSIL,65,0,2910,2910
LAHORE DISTRICT,RAIWIND TEHSIL,66,0,2026,2026
LAHORE DISTRICT,RAIWIND TEHSIL,67,0,1687,1687
LAHORE DISTRICT,RAIWIND TEHSIL,68,0,1925,1925
LAHORE DISTRICT,RAIWIND TEHSIL,69,0,1836,1836
LAHORE DISTRICT,RAIWIND TEHSIL,70,0,2063,2063
LAHORE DISTRICT,RAIWIND TEHSIL,71,0,1422,1422
LAHORE DISTRICT,RAIWIND TEHSIL,72,0,1516,1516
LAHORE DISTRICT,RAIWIND TEHSIL,73,0,1487,1487
LAHORE DISTRICT,RAIWIND TEHSIL,74,0,1262,1262
LAHORE DISTRICT,RAIWIND TEHSIL,>=75,0,9611,9611
LAHORE DISTRICT,SHALIMAR TEHSIL,<1,0,54319,54319
LAHORE DISTRICT,SHALIMAR TEHSIL,1,0,55412,55412
LAHORE DISTRICT,SHALIMAR TEHSIL,2,0,54721,54721
LAHORE DISTRICT,SHALIMAR TEHSIL,3,0,59602,59602
LAHORE DISTRICT,SHALIMAR TEHSIL,4,0,54203,54203
LAHORE DISTRICT,SHALIMAR TEHSIL,5,0,55583,55583
LAHORE DISTRICT,SHALIMAR TEHSIL,6,0,53718,53718
LAHORE DISTRICT,SHALIMAR TEHSIL,7,0,57902,57902
LAHORE DISTRICT,SHALIMAR TEHSIL,8,0,50510,50510
LAHORE DISTRICT,SHALIMAR TEHSIL,9,0,56287,56287
LAHORE DISTRICT,SHALIMAR TEHSIL,10,0,46671,46671
LAHORE DISTRICT,SHALIMAR TEHSIL,11,0,54355,54355
LAHORE DISTRICT,SHALIMAR TEHSIL,12,0,45414,45414
LAHORE DISTRICT,SHALIMAR TEHSIL,13,0,49054,49054
LAHORE DISTRICT,SHALIMAR TEHSIL,14,0,43973,43973
LAHORE DISTRICT,SHALIMAR TEHSIL,15,0,44845,44845
LAHORE DISTRICT,SHALIMAR TEHSIL,16,0,45803,45803
LAHORE DISTRICT,SHALIMAR TEHSIL,17,0,47899,47899
LAHORE DISTRICT,SHALIMAR TEHSIL,18,0,42642,42642
LAHORE DISTRICT,SHALIMAR TEHSIL,19,0,47744,47744
LAHORE DISTRICT,SHALIMAR TEHSIL,20,0,42145,42145
LAHORE DISTRICT,SHALIMAR TEHSIL,21,0,49678,49678
LAHORE DISTRICT,SHALIMAR TEHSIL,22,0,46084,46084
LAHORE DISTRICT,SHALIMAR TEHSIL,23,0,46535,46535
LAHORE DISTRICT,SHALIMAR TEHSIL,24,0,45646,45646
LAHORE DISTRICT,SHALIMAR TEHSIL,25,0,38706,38706
LAHORE DISTRICT,SHALIMAR TEHSIL,26,0,44348,44348
LAHORE DISTRICT,SHALIMAR TEHSIL,27,0,41645,41645
LAHORE DISTRICT,SHALIMAR TEHSIL,28,0,41879,41879
LAHORE DISTRICT,SHALIMAR TEHSIL,29,0,38987,38987
LAHORE DISTRICT,SHALIMAR TEHSIL,30,0,38123,38123
LAHORE DISTRICT,SHALIMAR TEHSIL,31,0,36816,36816
LAHORE DISTRICT,SHALIMAR TEHSIL,32,0,37343,37343
LAHORE DISTRICT,SHALIMAR TEHSIL,33,0,35316,35316
LAHORE DISTRICT,SHALIMAR TEHSIL,34,0,32444,32444
LAHORE DISTRICT,SHALIMAR TEHSIL,35,0,30986,30986
LAHORE DISTRICT,SHALIMAR TEHSIL,36,0,30593,30593
LAHORE DISTRICT,SHALIMAR TEHSIL,37,0,26066,26066
LAHORE DISTRICT,SHALIMAR TEHSIL,38,0,32919,32919
LAHORE DISTRICT,SHALIMAR TEHSIL,39,0,28351,28351
LAHORE DISTRICT,SHALIMAR TEHSIL,40,0,29525,29525
LAHORE DISTRICT,SHALIMAR TEHSIL,41,0,25114,25114
LAHORE DISTRICT,SHALIMAR TEHSIL,42,0,24408,24408
LAHORE DISTRICT,SHALIMAR TEHSIL,43,0,24128,24128
LAHORE DISTRICT,SHALIMAR TEHSIL,44,0,21379,21379
LAHORE DISTRICT,SHALIMAR TEHSIL,45,0,21982,21982
LAHORE DISTRICT,SHALIMAR TEHSIL,46,0,18610,18610
LAHORE DISTRICT,SHALIMAR TEHSIL,47,0,16708,16708
LAHORE DISTRICT,SHALIMAR TEHSIL,48,0,20346,20346
LAHORE DISTRICT,SHALIMAR TEHSIL,49,0,19268,19268
LAHORE DISTRICT,SHALIMAR TEHSIL,50,0,20149,20149
LAHORE DISTRICT,SHALIMAR TEHSIL,51,0,17529,17529
LAHORE DISTRICT,SHALIMAR TEHSIL,52,0,17643,17643
LAHORE DISTRICT,SHALIMAR TEHSIL,53,0,16938,16938
LAHORE DISTRICT,SHALIMAR TEHSIL,54,0,15908,15908
LAHORE DISTRICT,SHALIMAR TEHSIL,55,0,14915,14915
LAHORE DISTRICT,SHALIMAR TEHSIL,56,0,12975,12975
LAHORE DISTRICT,SHALIMAR TEHSIL,57,0,10587,10587
LAHORE DISTRICT,SHALIMAR TEHSIL,58,0,11616,11616
LAHORE DISTRICT,SHALIMAR TEHSIL,59,0,10966,10966
LAHORE DISTRICT,SHALIMAR TEHSIL,60,0,11055,11055
LAHORE DISTRICT,SHALIMAR TEHSIL,61,0,9837,9837
LAHORE DISTRICT,SHALIMAR TEHSIL,62,0,9917,9917
LAHORE DISTRICT,SHALIMAR TEHSIL,63,0,9739,9739
LAHORE DISTRICT,SHALIMAR TEHSIL,64,0,8152,8152
LAHORE DISTRICT,SHALIMAR TEHSIL,65,0,7933,7933
LAHORE DISTRICT,SHALIMAR TEHSIL,66,0,5922,5922
LAHORE DISTRICT,SHALIMAR TEHSIL,67,0,5097,5097
LAHORE DISTRICT,SHALIMAR TEHSIL,68,0,5833,5833
LAHORE DISTRICT,SHALIMAR TEHSIL,69,0,5469,5469
LAHORE DISTRICT,SHALIMAR TEHSIL,70,0,5377,5377
LAHORE DISTRICT,SHALIMAR TEHSIL,71,0,4381,4381
LAHORE DISTRICT,SHALIMAR TEHSIL,72,0,4438,4438
LAHORE DISTRICT,SHALIMAR TEHSIL,73,0,4027,4027
LAHORE DISTRICT,SHALIMAR TEHSIL,74,0,3575,3575
LAHORE DISTRICT,SHALIMAR TEHSIL,>=75,0,24844,24844
LAKKI MARWAT DISTRICT,LAKKI MARWAT TEHSIL,<1,15053,1530,16583
LAKKI MARWAT DISTRICT,LAKKI MARWAT TEHSIL,1,17024,1446,18470
LAKKI MARWAT DISTRICT,LAKKI MARWAT TEHSIL,2,19106,1649,20755
LAKKI MARWAT DISTRICT,LAKKI MARWAT TEHSIL,3,19880,1810,21690
LAKKI MARWAT DISTRICT,LAKKI MARWAT TEHSIL,4,21058,1754,22812
LAKKI MARWAT DISTRICT,LAKKI MARWAT TEHSIL,5,17060,1750,18810
LAKKI MARWAT DISTRICT,LAKKI MARWAT TEHSIL,6,16443,1641,18084
LAKKI MARWAT DISTRICT,LAKKI MARWAT TEHSIL,7,17207,1733,18940
LAKKI MARWAT DISTRICT,LAKKI MARWAT TEHSIL,8,16708,1550,18258
LAKKI MARWAT DISTRICT,LAKKI MARWAT TEHSIL,9,15726,1584,17310
LAKKI MARWAT DISTRICT,LAKKI MARWAT TEHSIL,10,14103,1465,15568
LAKKI MARWAT DISTRICT,LAKKI MARWAT TEHSIL,11,12940,1560,14500
LAKKI MARWAT DISTRICT,LAKKI MARWAT TEHSIL,12,11921,1297,13218
LAKKI MARWAT DISTRICT,LAKKI MARWAT TEHSIL,13,12212,1384,13596
LAKKI MARWAT DISTRICT,LAKKI MARWAT TEHSIL,14,12280,1442,13722
LAKKI MARWAT DISTRICT,LAKKI MARWAT TEHSIL,15,11971,1423,13394
LAKKI MARWAT DISTRICT,LAKKI MARWAT TEHSIL,16,11555,1474,13029
LAKKI MARWAT DISTRICT,LAKKI MARWAT TEHSIL,17,11949,1498,13447
LAKKI MARWAT DISTRICT,LAKKI MARWAT TEHSIL,18,9744,1254,10998
LAKKI MARWAT DISTRICT,LAKKI MARWAT TEHSIL,19,9633,1289,10922
LAKKI MARWAT DISTRICT,LAKKI MARWAT TEHSIL,20,10069,1241,11310
LAKKI MARWAT DISTRICT,LAKKI MARWAT TEHSIL,21,8532,1145,9677
LAKKI MARWAT DISTRICT,LAKKI MARWAT TEHSIL,22,8573,1025,9598
LAKKI MARWAT DISTRICT,LAKKI MARWAT TEHSIL,23,8306,1104,9410
LAKKI MARWAT DISTRICT,LAKKI MARWAT TEHSIL,24,7574,1011,8585
LAKKI MARWAT DISTRICT,LAKKI MARWAT TEHSIL,25,8572,1030,9602
LAKKI MARWAT DISTRICT,LAKKI MARWAT TEHSIL,26,7926,1072,8998
LAKKI MARWAT DISTRICT,LAKKI MARWAT TEHSIL,27,7421,957,8378
LAKKI MARWAT DISTRICT,LAKKI MARWAT TEHSIL,28,7386,1000,8386
LAKKI MARWAT DISTRICT,LAKKI MARWAT TEHSIL,29,7152,865,8017
LAKKI MARWAT DISTRICT,LAKKI MARWAT TEHSIL,30,7141,839,7980
LAKKI MARWAT DISTRICT,LAKKI MARWAT TEHSIL,31,5973,839,6812
LAKKI MARWAT DISTRICT,LAKKI MARWAT TEHSIL,32,5404,736,6140
LAKKI MARWAT DISTRICT,LAKKI MARWAT TEHSIL,33,5338,737,6075
LAKKI MARWAT DISTRICT,LAKKI MARWAT TEHSIL,34,4806,640,5446
LAKKI MARWAT DISTRICT,LAKKI MARWAT TEHSIL,35,4930,618,5548
LAKKI MARWAT DISTRICT,LAKKI MARWAT TEHSIL,36,4503,642,5145
LAKKI MARWAT DISTRICT,LAKKI MARWAT TEHSIL,37,4130,537,4667
LAKKI MARWAT DISTRICT,LAKKI MARWAT TEHSIL,38,4461,608,5069
LAKKI MARWAT DISTRICT,LAKKI MARWAT TEHSIL,39,4046,519,4565
LAKKI MARWAT DISTRICT,LAKKI MARWAT TEHSIL,40,4999,562,5561
LAKKI MARWAT DISTRICT,LAKKI MARWAT TEHSIL,41,3978,509,4487
LAKKI MARWAT DISTRICT,LAKKI MARWAT TEHSIL,42,3857,519,4376
LAKKI MARWAT DISTRICT,LAKKI MARWAT TEHSIL,43,3719,518,4237
LAKKI MARWAT DISTRICT,LAKKI MARWAT TEHSIL,44,3379,493,3872
LAKKI MARWAT DISTRICT,LAKKI MARWAT TEHSIL,45,3707,465,4172
LAKKI MARWAT DISTRICT,LAKKI MARWAT TEHSIL,46,3246,472,3718
LAKKI MARWAT DISTRICT,LAKKI MARWAT TEHSIL,47,3229,376,3605
LAKKI MARWAT DISTRICT,LAKKI MARWAT TEHSIL,48,3549,474,4023
LAKKI MARWAT DISTRICT,LAKKI MARWAT TEHSIL,49,3291,409,3700
LAKKI MARWAT DISTRICT,LAKKI MARWAT TEHSIL,50,3878,507,4385
LAKKI MARWAT DISTRICT,LAKKI MARWAT TEHSIL,51,2910,384,3294
LAKKI MARWAT DISTRICT,LAKKI MARWAT TEHSIL,52,2902,367,3269
LAKKI MARWAT DISTRICT,LAKKI MARWAT TEHSIL,53,2907,390,3297
LAKKI MARWAT DISTRICT,LAKKI MARWAT TEHSIL,54,2628,364,2992
LAKKI MARWAT DISTRICT,LAKKI MARWAT TEHSIL,55,2806,294,3100
LAKKI MARWAT DISTRICT,LAKKI MARWAT TEHSIL,56,2224,306,2530
LAKKI MARWAT DISTRICT,LAKKI MARWAT TEHSIL,57,2161,224,2385
LAKKI MARWAT DISTRICT,LAKKI MARWAT TEHSIL,58,2696,329,3025
LAKKI MARWAT DISTRICT,LAKKI MARWAT TEHSIL,59,2371,287,2658
LAKKI MARWAT DISTRICT,LAKKI MARWAT TEHSIL,60,2622,274,2896
LAKKI MARWAT DISTRICT,LAKKI MARWAT TEHSIL,61,2109,285,2394
LAKKI MARWAT DISTRICT,LAKKI MARWAT TEHSIL,62,2154,273,2427
LAKKI MARWAT DISTRICT,LAKKI MARWAT TEHSIL,63,2152,256,2408
LAKKI MARWAT DISTRICT,LAKKI MARWAT TEHSIL,64,1953,220,2173
LAKKI MARWAT DISTRICT,LAKKI MARWAT TEHSIL,65,1880,195,2075
LAKKI MARWAT DISTRICT,LAKKI MARWAT TEHSIL,66,1408,188,1596
LAKKI MARWAT DISTRICT,LAKKI MARWAT TEHSIL,67,1216,155,1371
LAKKI MARWAT DISTRICT,LAKKI MARWAT TEHSIL,68,1366,158,1524
LAKKI MARWAT DISTRICT,LAKKI MARWAT TEHSIL,69,1328,145,1473
LAKKI MARWAT DISTRICT,LAKKI MARWAT TEHSIL,70,1245,110,1355
LAKKI MARWAT DISTRICT,LAKKI MARWAT TEHSIL,71,1023,119,1142
LAKKI MARWAT DISTRICT,LAKKI MARWAT TEHSIL,72,843,100,943
LAKKI MARWAT DISTRICT,LAKKI MARWAT TEHSIL,73,837,90,927
LAKKI MARWAT DISTRICT,LAKKI MARWAT TEHSIL,74,848,103,951
LAKKI MARWAT DISTRICT,LAKKI MARWAT TEHSIL,>=75,6364,655,7019
LAKKI MARWAT DISTRICT,SARAI NAURANG TEHSIL,<1,7485,828,8313
LAKKI MARWAT DISTRICT,SARAI NAURANG TEHSIL,1,8840,863,9703
LAKKI MARWAT DISTRICT,SARAI NAURANG TEHSIL,2,10182,987,11169
LAKKI MARWAT DISTRICT,SARAI NAURANG TEHSIL,3,10742,1066,11808
LAKKI MARWAT DISTRICT,SARAI NAURANG TEHSIL,4,11263,1147,12410
LAKKI MARWAT DISTRICT,SARAI NAURANG TEHSIL,5,10050,940,10990
LAKKI MARWAT DISTRICT,SARAI NAURANG TEHSIL,6,9635,932,10567
LAKKI MARWAT DISTRICT,SARAI NAURANG TEHSIL,7,9790,1026,10816
LAKKI MARWAT DISTRICT,SARAI NAURANG TEHSIL,8,9628,884,10512
LAKKI MARWAT DISTRICT,SARAI NAURANG TEHSIL,9,8911,924,9835
LAKKI MARWAT DISTRICT,SARAI NAURANG TEHSIL,10,8262,775,9037
LAKKI MARWAT DISTRICT,SARAI NAURANG TEHSIL,11,7206,783,7989
LAKKI MARWAT DISTRICT,SARAI NAURANG TEHSIL,12,6669,723,7392
LAKKI MARWAT DISTRICT,SARAI NAURANG TEHSIL,13,6256,754,7010
LAKKI MARWAT DISTRICT,SARAI NAURANG TEHSIL,14,6239,663,6902
LAKKI MARWAT DISTRICT,SARAI NAURANG TEHSIL,15,6090,707,6797
LAKKI MARWAT DISTRICT,SARAI NAURANG TEHSIL,16,5860,610,6470
LAKKI MARWAT DISTRICT,SARAI NAURANG TEHSIL,17,5430,660,6090
LAKKI MARWAT DISTRICT,SARAI NAURANG TEHSIL,18,5209,576,5785
LAKKI MARWAT DISTRICT,SARAI NAURANG TEHSIL,19,4786,603,5389
LAKKI MARWAT DISTRICT,SARAI NAURANG TEHSIL,20,5340,642,5982
LAKKI MARWAT DISTRICT,SARAI NAURANG TEHSIL,21,4258,547,4805
LAKKI MARWAT DISTRICT,SARAI NAURANG TEHSIL,22,4148,550,4698
LAKKI MARWAT DISTRICT,SARAI NAURANG TEHSIL,23,3983,509,4492
LAKKI MARWAT DISTRICT,SARAI NAURANG TEHSIL,24,3713,526,4239
LAKKI MARWAT DISTRICT,SARAI NAURANG TEHSIL,25,4500,527,5027
LAKKI MARWAT DISTRICT,SARAI NAURANG TEHSIL,26,3963,504,4467
LAKKI MARWAT DISTRICT,SARAI NAURANG TEHSIL,27,3607,536,4143
LAKKI MARWAT DISTRICT,SARAI NAURANG TEHSIL,28,3797,468,4265
LAKKI MARWAT DISTRICT,SARAI NAURANG TEHSIL,29,3241,471,3712
LAKKI MARWAT DISTRICT,SARAI NAURANG TEHSIL,30,3921,472,4393
LAKKI MARWAT DISTRICT,SARAI NAURANG TEHSIL,31,2986,371,3357
LAKKI MARWAT DISTRICT,SARAI NAURANG TEHSIL,32,2515,405,2920
LAKKI MARWAT DISTRICT,SARAI NAURANG TEHSIL,33,2580,345,2925
LAKKI MARWAT DISTRICT,SARAI NAURANG TEHSIL,34,2152,288,2440
LAKKI MARWAT DISTRICT,SARAI NAURANG TEHSIL,35,2686,349,3035
LAKKI MARWAT DISTRICT,SARAI NAURANG TEHSIL,36,2078,252,2330
LAKKI MARWAT DISTRICT,SARAI NAURANG TEHSIL,37,1785,285,2070
LAKKI MARWAT DISTRICT,SARAI NAURANG TEHSIL,38,1992,282,2274
LAKKI MARWAT DISTRICT,SARAI NAURANG TEHSIL,39,1966,272,2238
LAKKI MARWAT DISTRICT,SARAI NAURANG TEHSIL,40,2743,295,3038
LAKKI MARWAT DISTRICT,SARAI NAURANG TEHSIL,41,2007,242,2249
LAKKI MARWAT DISTRICT,SARAI NAURANG TEHSIL,42,1685,234,1919
LAKKI MARWAT DISTRICT,SARAI NAURANG TEHSIL,43,1802,221,2023
LAKKI MARWAT DISTRICT,SARAI NAURANG TEHSIL,44,1664,211,1875
LAKKI MARWAT DISTRICT,SARAI NAURANG TEHSIL,45,1984,235,2219
LAKKI MARWAT DISTRICT,SARAI NAURANG TEHSIL,46,1620,147,1767
LAKKI MARWAT DISTRICT,SARAI NAURANG TEHSIL,47,1404,188,1592
LAKKI MARWAT DISTRICT,SARAI NAURANG TEHSIL,48,1506,202,1708
LAKKI MARWAT DISTRICT,SARAI NAURANG TEHSIL,49,1434,158,1592
LAKKI MARWAT DISTRICT,SARAI NAURANG TEHSIL,50,2021,232,2253
LAKKI MARWAT DISTRICT,SARAI NAURANG TEHSIL,51,1320,180,1500
LAKKI MARWAT DISTRICT,SARAI NAURANG TEHSIL,52,1118,191,1309
LAKKI MARWAT DISTRICT,SARAI NAURANG TEHSIL,53,1292,160,1452
LAKKI MARWAT DISTRICT,SARAI NAURANG TEHSIL,54,1114,139,1253
LAKKI MARWAT DISTRICT,SARAI NAURANG TEHSIL,55,1297,151,1448
LAKKI MARWAT DISTRICT,SARAI NAURANG TEHSIL,56,1064,114,1178
LAKKI MARWAT DISTRICT,SARAI NAURANG TEHSIL,57,932,104,1036
LAKKI MARWAT DISTRICT,SARAI NAURANG TEHSIL,58,1147,135,1282
LAKKI MARWAT DISTRICT,SARAI NAURANG TEHSIL,59,1000,111,1111
LAKKI MARWAT DISTRICT,SARAI NAURANG TEHSIL,60,1238,119,1357
LAKKI MARWAT DISTRICT,SARAI NAURANG TEHSIL,61,966,100,1066
LAKKI MARWAT DISTRICT,SARAI NAURANG TEHSIL,62,877,105,982
LAKKI MARWAT DISTRICT,SARAI NAURANG TEHSIL,63,966,95,1061
LAKKI MARWAT DISTRICT,SARAI NAURANG TEHSIL,64,883,119,1002
LAKKI MARWAT DISTRICT,SARAI NAURANG TEHSIL,65,897,82,979
LAKKI MARWAT DISTRICT,SARAI NAURANG TEHSIL,66,664,46,710
LAKKI MARWAT DISTRICT,SARAI NAURANG TEHSIL,67,491,61,552
LAKKI MARWAT DISTRICT,SARAI NAURANG TEHSIL,68,611,54,665
LAKKI MARWAT DISTRICT,SARAI NAURANG TEHSIL,69,562,60,622
LAKKI MARWAT DISTRICT,SARAI NAURANG TEHSIL,70,571,47,618
LAKKI MARWAT DISTRICT,SARAI NAURANG TEHSIL,71,423,46,469
LAKKI MARWAT DISTRICT,SARAI NAURANG TEHSIL,72,328,38,366
LAKKI MARWAT DISTRICT,SARAI NAURANG TEHSIL,73,414,38,452
LAKKI MARWAT DISTRICT,SARAI NAURANG TEHSIL,74,349,35,384
LAKKI MARWAT DISTRICT,SARAI NAURANG TEHSIL,>=75,2753,232,2985
LARKANA DISTRICT,BAKRANI TALUKA,<1,4173,759,4932
LARKANA DISTRICT,BAKRANI TALUKA,1,4755,684,5439
LARKANA DISTRICT,BAKRANI TALUKA,2,6156,907,7063
LARKANA DISTRICT,BAKRANI TALUKA,3,6713,1075,7788
LARKANA DISTRICT,BAKRANI TALUKA,4,7372,1151,8523
LARKANA DISTRICT,BAKRANI TALUKA,5,7286,1070,8356
LARKANA DISTRICT,BAKRANI TALUKA,6,6943,1074,8017
LARKANA DISTRICT,BAKRANI TALUKA,7,6341,954,7295
LARKANA DISTRICT,BAKRANI TALUKA,8,6994,1126,8120
LARKANA DISTRICT,BAKRANI TALUKA,9,5573,895,6468
LARKANA DISTRICT,BAKRANI TALUKA,10,6487,1000,7487
LARKANA DISTRICT,BAKRANI TALUKA,11,4707,751,5458
LARKANA DISTRICT,BAKRANI TALUKA,12,5186,818,6004
LARKANA DISTRICT,BAKRANI TALUKA,13,4489,680,5169
LARKANA DISTRICT,BAKRANI TALUKA,14,4714,788,5502
LARKANA DISTRICT,BAKRANI TALUKA,15,4775,844,5619
LARKANA DISTRICT,BAKRANI TALUKA,16,4621,827,5448
LARKANA DISTRICT,BAKRANI TALUKA,17,4467,738,5205
LARKANA DISTRICT,BAKRANI TALUKA,18,4497,774,5271
LARKANA DISTRICT,BAKRANI TALUKA,19,3811,612,4423
LARKANA DISTRICT,BAKRANI TALUKA,20,4164,719,4883
LARKANA DISTRICT,BAKRANI TALUKA,21,3158,520,3678
LARKANA DISTRICT,BAKRANI TALUKA,22,3118,525,3643
LARKANA DISTRICT,BAKRANI TALUKA,23,2718,430,3148
LARKANA DISTRICT,BAKRANI TALUKA,24,2450,455,2905
LARKANA DISTRICT,BAKRANI TALUKA,25,3121,508,3629
LARKANA DISTRICT,BAKRANI TALUKA,26,2537,420,2957
LARKANA DISTRICT,BAKRANI TALUKA,27,2689,483,3172
LARKANA DISTRICT,BAKRANI TALUKA,28,2800,447,3247
LARKANA DISTRICT,BAKRANI TALUKA,29,2850,491,3341
LARKANA DISTRICT,BAKRANI TALUKA,30,2755,392,3147
LARKANA DISTRICT,BAKRANI TALUKA,31,2694,443,3137
LARKANA DISTRICT,BAKRANI TALUKA,32,2539,483,3022
LARKANA DISTRICT,BAKRANI TALUKA,33,2195,388,2583
LARKANA DISTRICT,BAKRANI TALUKA,34,1850,334,2184
LARKANA DISTRICT,BAKRANI TALUKA,35,2131,373,2504
LARKANA DISTRICT,BAKRANI TALUKA,36,1774,283,2057
LARKANA DISTRICT,BAKRANI TALUKA,37,2437,504,2941
LARKANA DISTRICT,BAKRANI TALUKA,38,1966,284,2250
LARKANA DISTRICT,BAKRANI TALUKA,39,2106,349,2455
LARKANA DISTRICT,BAKRANI TALUKA,40,1892,258,2150
LARKANA DISTRICT,BAKRANI TALUKA,41,1802,242,2044
LARKANA DISTRICT,BAKRANI TALUKA,42,1868,387,2255
LARKANA DISTRICT,BAKRANI TALUKA,43,1451,275,1726
LARKANA DISTRICT,BAKRANI TALUKA,44,1342,199,1541
LARKANA DISTRICT,BAKRANI TALUKA,45,1424,223,1647
LARKANA DISTRICT,BAKRANI TALUKA,46,1262,219,1481
LARKANA DISTRICT,BAKRANI TALUKA,47,1647,345,1992
LARKANA DISTRICT,BAKRANI TALUKA,48,1292,186,1478
LARKANA DISTRICT,BAKRANI TALUKA,49,1447,216,1663
LARKANA DISTRICT,BAKRANI TALUKA,50,1303,169,1472
LARKANA DISTRICT,BAKRANI TALUKA,51,1231,208,1439
LARKANA DISTRICT,BAKRANI TALUKA,52,1317,259,1576
LARKANA DISTRICT,BAKRANI TALUKA,53,1011,146,1157
LARKANA DISTRICT,BAKRANI TALUKA,54,831,162,993
LARKANA DISTRICT,BAKRANI TALUKA,55,888,130,1018
LARKANA DISTRICT,BAKRANI TALUKA,56,764,128,892
LARKANA DISTRICT,BAKRANI TALUKA,57,1006,190,1196
LARKANA DISTRICT,BAKRANI TALUKA,58,697,134,831
LARKANA DISTRICT,BAKRANI TALUKA,59,684,138,822
LARKANA DISTRICT,BAKRANI TALUKA,60,736,119,855
LARKANA DISTRICT,BAKRANI TALUKA,61,718,118,836
LARKANA DISTRICT,BAKRANI TALUKA,62,918,167,1085
LARKANA DISTRICT,BAKRANI TALUKA,63,634,105,739
LARKANA DISTRICT,BAKRANI TALUKA,64,629,117,746
LARKANA DISTRICT,BAKRANI TALUKA,65,532,79,611
LARKANA DISTRICT,BAKRANI TALUKA,66,498,84,582
LARKANA DISTRICT,BAKRANI TALUKA,67,660,108,768
LARKANA DISTRICT,BAKRANI TALUKA,68,416,50,466
LARKANA DISTRICT,BAKRANI TALUKA,69,410,62,472
LARKANA DISTRICT,BAKRANI TALUKA,70,375,75,450
LARKANA DISTRICT,BAKRANI TALUKA,71,354,54,408
LARKANA DISTRICT,BAKRANI TALUKA,72,427,79,506
LARKANA DISTRICT,BAKRANI TALUKA,73,275,52,327
LARKANA DISTRICT,BAKRANI TALUKA,74,209,40,249
LARKANA DISTRICT,BAKRANI TALUKA,>=75,1933,324,2257
LARKANA DISTRICT,DOKRI TALUKA,<1,3510,1237,4747
LARKANA DISTRICT,DOKRI TALUKA,1,3970,1452,5422
LARKANA DISTRICT,DOKRI TALUKA,2,5202,1842,7044
LARKANA DISTRICT,DOKRI TALUKA,3,5640,1905,7545
LARKANA DISTRICT,DOKRI TALUKA,4,6298,2027,8325
LARKANA DISTRICT,DOKRI TALUKA,5,6159,1959,8118
LARKANA DISTRICT,DOKRI TALUKA,6,5759,1909,7668
LARKANA DISTRICT,DOKRI TALUKA,7,5327,1861,7188
LARKANA DISTRICT,DOKRI TALUKA,8,5846,1997,7843
LARKANA DISTRICT,DOKRI TALUKA,9,4920,1527,6447
LARKANA DISTRICT,DOKRI TALUKA,10,5377,1839,7216
LARKANA DISTRICT,DOKRI TALUKA,11,3941,1409,5350
LARKANA DISTRICT,DOKRI TALUKA,12,4442,1575,6017
LARKANA DISTRICT,DOKRI TALUKA,13,3862,1410,5272
LARKANA DISTRICT,DOKRI TALUKA,14,3944,1500,5444
LARKANA DISTRICT,DOKRI TALUKA,15,4059,1599,5658
LARKANA DISTRICT,DOKRI TALUKA,16,3852,1529,5381
LARKANA DISTRICT,DOKRI TALUKA,17,3555,1657,5212
LARKANA DISTRICT,DOKRI TALUKA,18,3839,1517,5356
LARKANA DISTRICT,DOKRI TALUKA,19,3098,1345,4443
LARKANA DISTRICT,DOKRI TALUKA,20,3375,1423,4798
LARKANA DISTRICT,DOKRI TALUKA,21,2472,1128,3600
LARKANA DISTRICT,DOKRI TALUKA,22,2586,1123,3709
LARKANA DISTRICT,DOKRI TALUKA,23,2255,1082,3337
LARKANA DISTRICT,DOKRI TALUKA,24,1935,892,2827
LARKANA DISTRICT,DOKRI TALUKA,25,2516,1014,3530
LARKANA DISTRICT,DOKRI TALUKA,26,1865,722,2587
LARKANA DISTRICT,DOKRI TALUKA,27,2110,923,3033
LARKANA DISTRICT,DOKRI TALUKA,28,2395,919,3314
LARKANA DISTRICT,DOKRI TALUKA,29,2149,822,2971
LARKANA DISTRICT,DOKRI TALUKA,30,2304,949,3253
LARKANA DISTRICT,DOKRI TALUKA,31,2121,838,2959
LARKANA DISTRICT,DOKRI TALUKA,32,2159,844,3003
LARKANA DISTRICT,DOKRI TALUKA,33,1834,769,2603
LARKANA DISTRICT,DOKRI TALUKA,34,1527,609,2136
LARKANA DISTRICT,DOKRI TALUKA,35,1845,777,2622
LARKANA DISTRICT,DOKRI TALUKA,36,1396,592,1988
LARKANA DISTRICT,DOKRI TALUKA,37,2070,799,2869
LARKANA DISTRICT,DOKRI TALUKA,38,1596,684,2280
LARKANA DISTRICT,DOKRI TALUKA,39,1679,634,2313
LARKANA DISTRICT,DOKRI TALUKA,40,1524,633,2157
LARKANA DISTRICT,DOKRI TALUKA,41,1325,551,1876
LARKANA DISTRICT,DOKRI TALUKA,42,1635,656,2291
LARKANA DISTRICT,DOKRI TALUKA,43,1214,484,1698
LARKANA DISTRICT,DOKRI TALUKA,44,1159,451,1610
LARKANA DISTRICT,DOKRI TALUKA,45,1218,507,1725
LARKANA DISTRICT,DOKRI TALUKA,46,1039,390,1429
LARKANA DISTRICT,DOKRI TALUKA,47,1259,539,1798
LARKANA DISTRICT,DOKRI TALUKA,48,1103,479,1582
LARKANA DISTRICT,DOKRI TALUKA,49,1094,472,1566
LARKANA DISTRICT,DOKRI TALUKA,50,1027,475,1502
LARKANA DISTRICT,DOKRI TALUKA,51,954,364,1318
LARKANA DISTRICT,DOKRI TALUKA,52,1088,464,1552
LARKANA DISTRICT,DOKRI TALUKA,53,693,349,1042
LARKANA DISTRICT,DOKRI TALUKA,54,659,291,950
LARKANA DISTRICT,DOKRI TALUKA,55,748,338,1086
LARKANA DISTRICT,DOKRI TALUKA,56,587,276,863
LARKANA DISTRICT,DOKRI TALUKA,57,763,319,1082
LARKANA DISTRICT,DOKRI TALUKA,58,588,258,846
LARKANA DISTRICT,DOKRI TALUKA,59,619,211,830
LARKANA DISTRICT,DOKRI TALUKA,60,652,271,923
LARKANA DISTRICT,DOKRI TALUKA,61,581,231,812
LARKANA DISTRICT,DOKRI TALUKA,62,685,264,949
LARKANA DISTRICT,DOKRI TALUKA,63,505,270,775
LARKANA DISTRICT,DOKRI TALUKA,64,530,195,725
LARKANA DISTRICT,DOKRI TALUKA,65,436,187,623
LARKANA DISTRICT,DOKRI TALUKA,66,395,158,553
LARKANA DISTRICT,DOKRI TALUKA,67,461,175,636
LARKANA DISTRICT,DOKRI TALUKA,68,329,109,438
LARKANA DISTRICT,DOKRI TALUKA,69,318,126,444
LARKANA DISTRICT,DOKRI TALUKA,70,299,117,416
LARKANA DISTRICT,DOKRI TALUKA,71,266,114,380
LARKANA DISTRICT,DOKRI TALUKA,72,308,117,425
LARKANA DISTRICT,DOKRI TALUKA,73,215,94,309
LARKANA DISTRICT,DOKRI TALUKA,74,202,62,264
LARKANA DISTRICT,DOKRI TALUKA,>=75,1490,566,2056
LARKANA DISTRICT,LARKANA TALUKA,<1,5603,10762,16365
LARKANA DISTRICT,LARKANA TALUKA,1,6082,11404,17486
LARKANA DISTRICT,LARKANA TALUKA,2,8008,13336,21344
LARKANA DISTRICT,LARKANA TALUKA,3,8836,15215,24051
LARKANA DISTRICT,LARKANA TALUKA,4,9315,15112,24427
LARKANA DISTRICT,LARKANA TALUKA,5,9088,15800,24888
LARKANA DISTRICT,LARKANA TALUKA,6,8676,13897,22573
LARKANA DISTRICT,LARKANA TALUKA,7,8113,14792,22905
LARKANA DISTRICT,LARKANA TALUKA,8,9125,14114,23239
LARKANA DISTRICT,LARKANA TALUKA,9,6959,12970,19929
LARKANA DISTRICT,LARKANA TALUKA,10,8044,12831,20875
LARKANA DISTRICT,LARKANA TALUKA,11,5670,11473,17143
LARKANA DISTRICT,LARKANA TALUKA,12,6714,11586,18300
LARKANA DISTRICT,LARKANA TALUKA,13,5312,10931,16243
LARKANA DISTRICT,LARKANA TALUKA,14,5821,10934,16755
LARKANA DISTRICT,LARKANA TALUKA,15,6054,11649,17703
LARKANA DISTRICT,LARKANA TALUKA,16,5932,11150,17082
LARKANA DISTRICT,LARKANA TALUKA,17,5618,12014,17632
LARKANA DISTRICT,LARKANA TALUKA,18,6257,12086,18343
LARKANA DISTRICT,LARKANA TALUKA,19,4702,11216,15918
LARKANA DISTRICT,LARKANA TALUKA,20,5474,10846,16320
LARKANA DISTRICT,LARKANA TALUKA,21,3783,9370,13153
LARKANA DISTRICT,LARKANA TALUKA,22,4026,9848,13874
LARKANA DISTRICT,LARKANA TALUKA,23,3417,8647,12064
LARKANA DISTRICT,LARKANA TALUKA,24,3071,7999,11070
LARKANA DISTRICT,LARKANA TALUKA,25,4284,8820,13104
LARKANA DISTRICT,LARKANA TALUKA,26,3246,7744,10990
LARKANA DISTRICT,LARKANA TALUKA,27,3292,7736,11028
LARKANA DISTRICT,LARKANA TALUKA,28,3621,8434,12055
LARKANA DISTRICT,LARKANA TALUKA,29,3315,7292,10607
LARKANA DISTRICT,LARKANA TALUKA,30,3796,8309,12105
LARKANA DISTRICT,LARKANA TALUKA,31,3071,6978,10049
LARKANA DISTRICT,LARKANA TALUKA,32,2986,6654,9640
LARKANA DISTRICT,LARKANA TALUKA,33,2834,6453,9287
LARKANA DISTRICT,LARKANA TALUKA,34,2457,5448,7905
LARKANA DISTRICT,LARKANA TALUKA,35,3088,6501,9589
LARKANA DISTRICT,LARKANA TALUKA,36,2134,4732,6866
LARKANA DISTRICT,LARKANA TALUKA,37,2691,4842,7533
LARKANA DISTRICT,LARKANA TALUKA,38,2579,5733,8312
LARKANA DISTRICT,LARKANA TALUKA,39,2643,5254,7897
LARKANA DISTRICT,LARKANA TALUKA,40,2630,6045,8675
LARKANA DISTRICT,LARKANA TALUKA,41,1904,4358,6262
LARKANA DISTRICT,LARKANA TALUKA,42,2015,4201,6216
LARKANA DISTRICT,LARKANA TALUKA,43,1776,4249,6025
LARKANA DISTRICT,LARKANA TALUKA,44,1700,3697,5397
LARKANA DISTRICT,LARKANA TALUKA,45,2006,4446,6452
LARKANA DISTRICT,LARKANA TALUKA,46,1396,3028,4424
LARKANA DISTRICT,LARKANA TALUKA,47,1759,3259,5018
LARKANA DISTRICT,LARKANA TALUKA,48,1557,3593,5150
LARKANA DISTRICT,LARKANA TALUKA,49,1768,3503,5271
LARKANA DISTRICT,LARKANA TALUKA,50,1800,3941,5741
LARKANA DISTRICT,LARKANA TALUKA,51,1310,2854,4164
LARKANA DISTRICT,LARKANA TALUKA,52,1387,2906,4293
LARKANA DISTRICT,LARKANA TALUKA,53,1148,2674,3822
LARKANA DISTRICT,LARKANA TALUKA,54,1075,2456,3531
LARKANA DISTRICT,LARKANA TALUKA,55,1320,2775,4095
LARKANA DISTRICT,LARKANA TALUKA,56,839,1838,2677
LARKANA DISTRICT,LARKANA TALUKA,57,990,1909,2899
LARKANA DISTRICT,LARKANA TALUKA,58,783,1884,2667
LARKANA DISTRICT,LARKANA TALUKA,59,774,1751,2525
LARKANA DISTRICT,LARKANA TALUKA,60,1033,2075,3108
LARKANA DISTRICT,LARKANA TALUKA,61,827,1568,2395
LARKANA DISTRICT,LARKANA TALUKA,62,995,1805,2800
LARKANA DISTRICT,LARKANA TALUKA,63,741,1595,2336
LARKANA DISTRICT,LARKANA TALUKA,64,704,1487,2191
LARKANA DISTRICT,LARKANA TALUKA,65,777,1450,2227
LARKANA DISTRICT,LARKANA TALUKA,66,548,1041,1589
LARKANA DISTRICT,LARKANA TALUKA,67,656,1001,1657
LARKANA DISTRICT,LARKANA TALUKA,68,440,887,1327
LARKANA DISTRICT,LARKANA TALUKA,69,439,867,1306
LARKANA DISTRICT,LARKANA TALUKA,70,491,931,1422
LARKANA DISTRICT,LARKANA TALUKA,71,405,693,1098
LARKANA DISTRICT,LARKANA TALUKA,72,410,768,1178
LARKANA DISTRICT,LARKANA TALUKA,73,330,662,992
LARKANA DISTRICT,LARKANA TALUKA,74,280,543,823
LARKANA DISTRICT,LARKANA TALUKA,>=75,2454,4354,6808
LARKANA DISTRICT,RATODERO TALUKA,<1,4890,2940,7830
LARKANA DISTRICT,RATODERO TALUKA,1,5790,2792,8582
LARKANA DISTRICT,RATODERO TALUKA,2,7183,3198,10381
LARKANA DISTRICT,RATODERO TALUKA,3,8073,3899,11972
LARKANA DISTRICT,RATODERO TALUKA,4,8307,3827,12134
LARKANA DISTRICT,RATODERO TALUKA,5,8242,4181,12423
LARKANA DISTRICT,RATODERO TALUKA,6,7773,3543,11316
LARKANA DISTRICT,RATODERO TALUKA,7,7354,3761,11115
LARKANA DISTRICT,RATODERO TALUKA,8,8013,3533,11546
LARKANA DISTRICT,RATODERO TALUKA,9,6492,3369,9861
LARKANA DISTRICT,RATODERO TALUKA,10,6673,3135,9808
LARKANA DISTRICT,RATODERO TALUKA,11,5237,2706,7943
LARKANA DISTRICT,RATODERO TALUKA,12,5458,2894,8352
LARKANA DISTRICT,RATODERO TALUKA,13,4891,2597,7488
LARKANA DISTRICT,RATODERO TALUKA,14,4975,2642,7617
LARKANA DISTRICT,RATODERO TALUKA,15,4987,2940,7927
LARKANA DISTRICT,RATODERO TALUKA,16,4888,2705,7593
LARKANA DISTRICT,RATODERO TALUKA,17,4804,2899,7703
LARKANA DISTRICT,RATODERO TALUKA,18,4928,2842,7770
LARKANA DISTRICT,RATODERO TALUKA,19,4162,2463,6625
LARKANA DISTRICT,RATODERO TALUKA,20,4105,2477,6582
LARKANA DISTRICT,RATODERO TALUKA,21,3294,2096,5390
LARKANA DISTRICT,RATODERO TALUKA,22,3044,1952,4996
LARKANA DISTRICT,RATODERO TALUKA,23,2743,1834,4577
LARKANA DISTRICT,RATODERO TALUKA,24,2973,1685,4658
LARKANA DISTRICT,RATODERO TALUKA,25,3175,1979,5154
LARKANA DISTRICT,RATODERO TALUKA,26,2721,1675,4396
LARKANA DISTRICT,RATODERO TALUKA,27,3220,1811,5031
LARKANA DISTRICT,RATODERO TALUKA,28,3044,1861,4905
LARKANA DISTRICT,RATODERO TALUKA,29,3271,1736,5007
LARKANA DISTRICT,RATODERO TALUKA,30,2679,1842,4521
LARKANA DISTRICT,RATODERO TALUKA,31,3148,1732,4880
LARKANA DISTRICT,RATODERO TALUKA,32,2861,1608,4469
LARKANA DISTRICT,RATODERO TALUKA,33,2525,1415,3940
LARKANA DISTRICT,RATODERO TALUKA,34,2532,1366,3898
LARKANA DISTRICT,RATODERO TALUKA,35,2212,1460,3672
LARKANA DISTRICT,RATODERO TALUKA,36,2149,1218,3367
LARKANA DISTRICT,RATODERO TALUKA,37,2702,1294,3996
LARKANA DISTRICT,RATODERO TALUKA,38,2022,1339,3361
LARKANA DISTRICT,RATODERO TALUKA,39,2528,1211,3739
LARKANA DISTRICT,RATODERO TALUKA,40,1699,1262,2961
LARKANA DISTRICT,RATODERO TALUKA,41,1894,1048,2942
LARKANA DISTRICT,RATODERO TALUKA,42,1947,1037,2984
LARKANA DISTRICT,RATODERO TALUKA,43,1530,966,2496
LARKANA DISTRICT,RATODERO TALUKA,44,1547,902,2449
LARKANA DISTRICT,RATODERO TALUKA,45,1420,906,2326
LARKANA DISTRICT,RATODERO TALUKA,46,1524,702,2226
LARKANA DISTRICT,RATODERO TALUKA,47,1722,871,2593
LARKANA DISTRICT,RATODERO TALUKA,48,1395,783,2178
LARKANA DISTRICT,RATODERO TALUKA,49,1491,834,2325
LARKANA DISTRICT,RATODERO TALUKA,50,1109,801,1910
LARKANA DISTRICT,RATODERO TALUKA,51,1307,663,1970
LARKANA DISTRICT,RATODERO TALUKA,52,1378,734,2112
LARKANA DISTRICT,RATODERO TALUKA,53,968,570,1538
LARKANA DISTRICT,RATODERO TALUKA,54,904,573,1477
LARKANA DISTRICT,RATODERO TALUKA,55,840,563,1403
LARKANA DISTRICT,RATODERO TALUKA,56,805,424,1229
LARKANA DISTRICT,RATODERO TALUKA,57,1088,496,1584
LARKANA DISTRICT,RATODERO TALUKA,58,749,416,1165
LARKANA DISTRICT,RATODERO TALUKA,59,749,424,1173
LARKANA DISTRICT,RATODERO TALUKA,60,684,411,1095
LARKANA DISTRICT,RATODERO TALUKA,61,755,383,1138
LARKANA DISTRICT,RATODERO TALUKA,62,975,437,1412
LARKANA DISTRICT,RATODERO TALUKA,63,642,371,1013
LARKANA DISTRICT,RATODERO TALUKA,64,628,345,973
LARKANA DISTRICT,RATODERO TALUKA,65,520,290,810
LARKANA DISTRICT,RATODERO TALUKA,66,566,289,855
LARKANA DISTRICT,RATODERO TALUKA,67,675,292,967
LARKANA DISTRICT,RATODERO TALUKA,68,415,223,638
LARKANA DISTRICT,RATODERO TALUKA,69,416,216,632
LARKANA DISTRICT,RATODERO TALUKA,70,347,213,560
LARKANA DISTRICT,RATODERO TALUKA,71,398,171,569
LARKANA DISTRICT,RATODERO TALUKA,72,429,165,594
LARKANA DISTRICT,RATODERO TALUKA,73,248,125,373
LARKANA DISTRICT,RATODERO TALUKA,74,251,125,376
LARKANA DISTRICT,RATODERO TALUKA,>=75,1849,997,2846
LASBELA DISTRICT,BELA TEHSIL,<1,2080,617,2697
LASBELA DISTRICT,BELA TEHSIL,1,2418,685,3103
LASBELA DISTRICT,BELA TEHSIL,2,2771,696,3467
LASBELA DISTRICT,BELA TEHSIL,3,2634,735,3369
LASBELA DISTRICT,BELA TEHSIL,4,2876,703,3579
LASBELA DISTRICT,BELA TEHSIL,5,2450,670,3120
LASBELA DISTRICT,BELA TEHSIL,6,2856,658,3514
LASBELA DISTRICT,BELA TEHSIL,7,2252,732,2984
LASBELA DISTRICT,BELA TEHSIL,8,2760,638,3398
LASBELA DISTRICT,BELA TEHSIL,9,2235,728,2963
LASBELA DISTRICT,BELA TEHSIL,10,2337,659,2996
LASBELA DISTRICT,BELA TEHSIL,11,1795,642,2437
LASBELA DISTRICT,BELA TEHSIL,12,1970,586,2556
LASBELA DISTRICT,BELA TEHSIL,13,1651,585,2236
LASBELA DISTRICT,BELA TEHSIL,14,1786,527,2313
LASBELA DISTRICT,BELA TEHSIL,15,1490,555,2045
LASBELA DISTRICT,BELA TEHSIL,16,1644,486,2130
LASBELA DISTRICT,BELA TEHSIL,17,1437,513,1950
LASBELA DISTRICT,BELA TEHSIL,18,1518,525,2043
LASBELA DISTRICT,BELA TEHSIL,19,1476,544,2020
LASBELA DISTRICT,BELA TEHSIL,20,1573,442,2015
LASBELA DISTRICT,BELA TEHSIL,21,1479,518,1997
LASBELA DISTRICT,BELA TEHSIL,22,1251,432,1683
LASBELA DISTRICT,BELA TEHSIL,23,1127,414,1541
LASBELA DISTRICT,BELA TEHSIL,24,1210,407,1617
LASBELA DISTRICT,BELA TEHSIL,25,1110,359,1469
LASBELA DISTRICT,BELA TEHSIL,26,1298,452,1750
LASBELA DISTRICT,BELA TEHSIL,27,1187,464,1651
LASBELA DISTRICT,BELA TEHSIL,28,1238,381,1619
LASBELA DISTRICT,BELA TEHSIL,29,1242,474,1716
LASBELA DISTRICT,BELA TEHSIL,30,1120,449,1569
LASBELA DISTRICT,BELA TEHSIL,31,1153,396,1549
LASBELA DISTRICT,BELA TEHSIL,32,1052,358,1410
LASBELA DISTRICT,BELA TEHSIL,33,967,351,1318
LASBELA DISTRICT,BELA TEHSIL,34,1000,262,1262
LASBELA DISTRICT,BELA TEHSIL,35,790,270,1060
LASBELA DISTRICT,BELA TEHSIL,36,928,317,1245
LASBELA DISTRICT,BELA TEHSIL,37,918,306,1224
LASBELA DISTRICT,BELA TEHSIL,38,973,302,1275
LASBELA DISTRICT,BELA TEHSIL,39,893,299,1192
LASBELA DISTRICT,BELA TEHSIL,40,750,255,1005
LASBELA DISTRICT,BELA TEHSIL,41,748,269,1017
LASBELA DISTRICT,BELA TEHSIL,42,693,196,889
LASBELA DISTRICT,BELA TEHSIL,43,629,227,856
LASBELA DISTRICT,BELA TEHSIL,44,707,195,902
LASBELA DISTRICT,BELA TEHSIL,45,543,133,676
LASBELA DISTRICT,BELA TEHSIL,46,632,195,827
LASBELA DISTRICT,BELA TEHSIL,47,594,183,777
LASBELA DISTRICT,BELA TEHSIL,48,606,172,778
LASBELA DISTRICT,BELA TEHSIL,49,665,188,853
LASBELA DISTRICT,BELA TEHSIL,50,540,143,683
LASBELA DISTRICT,BELA TEHSIL,51,596,190,786
LASBELA DISTRICT,BELA TEHSIL,52,483,138,621
LASBELA DISTRICT,BELA TEHSIL,53,449,132,581
LASBELA DISTRICT,BELA TEHSIL,54,358,130,488
LASBELA DISTRICT,BELA TEHSIL,55,290,86,376
LASBELA DISTRICT,BELA TEHSIL,56,337,104,441
LASBELA DISTRICT,BELA TEHSIL,57,297,109,406
LASBELA DISTRICT,BELA TEHSIL,58,372,93,465
LASBELA DISTRICT,BELA TEHSIL,59,305,122,427
LASBELA DISTRICT,BELA TEHSIL,60,312,103,415
LASBELA DISTRICT,BELA TEHSIL,61,339,96,435
LASBELA DISTRICT,BELA TEHSIL,62,293,77,370
LASBELA DISTRICT,BELA TEHSIL,63,282,93,375
LASBELA DISTRICT,BELA TEHSIL,64,254,82,336
LASBELA DISTRICT,BELA TEHSIL,65,229,59,288
LASBELA DISTRICT,BELA TEHSIL,66,368,89,457
LASBELA DISTRICT,BELA TEHSIL,67,158,41,199
LASBELA DISTRICT,BELA TEHSIL,68,240,57,297
LASBELA DISTRICT,BELA TEHSIL,69,190,52,242
LASBELA DISTRICT,BELA TEHSIL,70,223,47,270
LASBELA DISTRICT,BELA TEHSIL,71,297,63,360
LASBELA DISTRICT,BELA TEHSIL,72,134,29,163
LASBELA DISTRICT,BELA TEHSIL,73,160,30,190
LASBELA DISTRICT,BELA TEHSIL,74,102,22,124
LASBELA DISTRICT,BELA TEHSIL,>=75,1004,266,1270
LASBELA DISTRICT,DUREJI TEHSIL,<1,988,452,1440
LASBELA DISTRICT,DUREJI TEHSIL,1,910,326,1236
LASBELA DISTRICT,DUREJI TEHSIL,2,1375,428,1803
LASBELA DISTRICT,DUREJI TEHSIL,3,999,388,1387
LASBELA DISTRICT,DUREJI TEHSIL,4,1449,415,1864
LASBELA DISTRICT,DUREJI TEHSIL,5,997,461,1458
LASBELA DISTRICT,DUREJI TEHSIL,6,1399,434,1833
LASBELA DISTRICT,DUREJI TEHSIL,7,904,322,1226
LASBELA DISTRICT,DUREJI TEHSIL,8,1413,490,1903
LASBELA DISTRICT,DUREJI TEHSIL,9,786,318,1104
LASBELA DISTRICT,DUREJI TEHSIL,10,1167,473,1640
LASBELA DISTRICT,DUREJI TEHSIL,11,617,292,909
LASBELA DISTRICT,DUREJI TEHSIL,12,916,324,1240
LASBELA DISTRICT,DUREJI TEHSIL,13,448,212,660
LASBELA DISTRICT,DUREJI TEHSIL,14,653,263,916
LASBELA DISTRICT,DUREJI TEHSIL,15,559,255,814
LASBELA DISTRICT,DUREJI TEHSIL,16,608,198,806
LASBELA DISTRICT,DUREJI TEHSIL,17,391,164,555
LASBELA DISTRICT,DUREJI TEHSIL,18,718,291,1009
LASBELA DISTRICT,DUREJI TEHSIL,19,460,203,663
LASBELA DISTRICT,DUREJI TEHSIL,20,726,258,984
LASBELA DISTRICT,DUREJI TEHSIL,21,422,167,589
LASBELA DISTRICT,DUREJI TEHSIL,22,481,193,674
LASBELA DISTRICT,DUREJI TEHSIL,23,383,171,554
LASBELA DISTRICT,DUREJI TEHSIL,24,446,169,615
LASBELA DISTRICT,DUREJI TEHSIL,25,552,219,771
LASBELA DISTRICT,DUREJI TEHSIL,26,450,190,640
LASBELA DISTRICT,DUREJI TEHSIL,27,386,141,527
LASBELA DISTRICT,DUREJI TEHSIL,28,475,215,690
LASBELA DISTRICT,DUREJI TEHSIL,29,409,174,583
LASBELA DISTRICT,DUREJI TEHSIL,30,531,252,783
LASBELA DISTRICT,DUREJI TEHSIL,31,466,226,692
LASBELA DISTRICT,DUREJI TEHSIL,32,387,163,550
LASBELA DISTRICT,DUREJI TEHSIL,33,385,148,533
LASBELA DISTRICT,DUREJI TEHSIL,34,339,177,516
LASBELA DISTRICT,DUREJI TEHSIL,35,420,148,568
LASBELA DISTRICT,DUREJI TEHSIL,36,374,191,565
LASBELA DISTRICT,DUREJI TEHSIL,37,306,131,437
LASBELA DISTRICT,DUREJI TEHSIL,38,416,187,603
LASBELA DISTRICT,DUREJI TEHSIL,39,286,128,414
LASBELA DISTRICT,DUREJI TEHSIL,40,429,158,587
LASBELA DISTRICT,DUREJI TEHSIL,41,313,131,444
LASBELA DISTRICT,DUREJI TEHSIL,42,216,77,293
LASBELA DISTRICT,DUREJI TEHSIL,43,218,117,335
LASBELA DISTRICT,DUREJI TEHSIL,44,215,99,314
LASBELA DISTRICT,DUREJI TEHSIL,45,271,101,372
LASBELA DISTRICT,DUREJI TEHSIL,46,262,106,368
LASBELA DISTRICT,DUREJI TEHSIL,47,169,70,239
LASBELA DISTRICT,DUREJI TEHSIL,48,253,159,412
LASBELA DISTRICT,DUREJI TEHSIL,49,245,81,326
LASBELA DISTRICT,DUREJI TEHSIL,50,260,110,370
LASBELA DISTRICT,DUREJI TEHSIL,51,205,81,286
LASBELA DISTRICT,DUREJI TEHSIL,52,134,54,188
LASBELA DISTRICT,DUREJI TEHSIL,53,179,78,257
LASBELA DISTRICT,DUREJI TEHSIL,54,174,76,250
LASBELA DISTRICT,DUREJI TEHSIL,55,138,57,195
LASBELA DISTRICT,DUREJI TEHSIL,56,158,65,223
LASBELA DISTRICT,DUREJI TEHSIL,57,125,51,176
LASBELA DISTRICT,DUREJI TEHSIL,58,151,65,216
LASBELA DISTRICT,DUREJI TEHSIL,59,121,52,173
LASBELA DISTRICT,DUREJI TEHSIL,60,184,74,258
LASBELA DISTRICT,DUREJI TEHSIL,61,128,34,162
LASBELA DISTRICT,DUREJI TEHSIL,62,94,39,133
LASBELA DISTRICT,DUREJI TEHSIL,63,128,46,174
LASBELA DISTRICT,DUREJI TEHSIL,64,115,50,165
LASBELA DISTRICT,DUREJI TEHSIL,65,119,45,164
LASBELA DISTRICT,DUREJI TEHSIL,66,106,51,157
LASBELA DISTRICT,DUREJI TEHSIL,67,90,29,119
LASBELA DISTRICT,DUREJI TEHSIL,68,115,53,168
LASBELA DISTRICT,DUREJI TEHSIL,69,93,27,120
LASBELA DISTRICT,DUREJI TEHSIL,70,96,35,131
LASBELA DISTRICT,DUREJI TEHSIL,71,66,18,84
LASBELA DISTRICT,DUREJI TEHSIL,72,49,20,69
LASBELA DISTRICT,DUREJI TEHSIL,73,68,29,97
LASBELA DISTRICT,DUREJI TEHSIL,74,77,18,95
LASBELA DISTRICT,DUREJI TEHSIL,>=75,525,142,667
LASBELA DISTRICT,GADDANI TEHSIL,<1,419,127,546
LASBELA DISTRICT,GADDANI TEHSIL,1,315,164,479
LASBELA DISTRICT,GADDANI TEHSIL,2,557,202,759
LASBELA DISTRICT,GADDANI TEHSIL,3,364,175,539
LASBELA DISTRICT,GADDANI TEHSIL,4,582,198,780
LASBELA DISTRICT,GADDANI TEHSIL,5,343,198,541
LASBELA DISTRICT,GADDANI TEHSIL,6,434,192,626
LASBELA DISTRICT,GADDANI TEHSIL,7,431,217,648
LASBELA DISTRICT,GADDANI TEHSIL,8,475,213,688
LASBELA DISTRICT,GADDANI TEHSIL,9,437,175,612
LASBELA DISTRICT,GADDANI TEHSIL,10,506,192,698
LASBELA DISTRICT,GADDANI TEHSIL,11,375,198,573
LASBELA DISTRICT,GADDANI TEHSIL,12,380,172,552
LASBELA DISTRICT,GADDANI TEHSIL,13,385,192,577
LASBELA DISTRICT,GADDANI TEHSIL,14,369,151,520
LASBELA DISTRICT,GADDANI TEHSIL,15,394,184,578
LASBELA DISTRICT,GADDANI TEHSIL,16,273,153,426
LASBELA DISTRICT,GADDANI TEHSIL,17,339,160,499
LASBELA DISTRICT,GADDANI TEHSIL,18,308,165,473
LASBELA DISTRICT,GADDANI TEHSIL,19,358,162,520
LASBELA DISTRICT,GADDANI TEHSIL,20,347,154,501
LASBELA DISTRICT,GADDANI TEHSIL,21,305,152,457
LASBELA DISTRICT,GADDANI TEHSIL,22,285,121,406
LASBELA DISTRICT,GADDANI TEHSIL,23,225,127,352
LASBELA DISTRICT,GADDANI TEHSIL,24,307,138,445
LASBELA DISTRICT,GADDANI TEHSIL,25,281,130,411
LASBELA DISTRICT,GADDANI TEHSIL,26,280,171,451
LASBELA DISTRICT,GADDANI TEHSIL,27,314,150,464
LASBELA DISTRICT,GADDANI TEHSIL,28,271,132,403
LASBELA DISTRICT,GADDANI TEHSIL,29,338,140,478
LASBELA DISTRICT,GADDANI TEHSIL,30,202,110,312
LASBELA DISTRICT,GADDANI TEHSIL,31,295,134,429
LASBELA DISTRICT,GADDANI TEHSIL,32,265,109,374
LASBELA DISTRICT,GADDANI TEHSIL,33,210,97,307
LASBELA DISTRICT,GADDANI TEHSIL,34,233,94,327
LASBELA DISTRICT,GADDANI TEHSIL,35,155,68,223
LASBELA DISTRICT,GADDANI TEHSIL,36,184,115,299
LASBELA DISTRICT,GADDANI TEHSIL,37,241,88,329
LASBELA DISTRICT,GADDANI TEHSIL,38,195,97,292
LASBELA DISTRICT,GADDANI TEHSIL,39,238,76,314
LASBELA DISTRICT,GADDANI TEHSIL,40,167,78,245
LASBELA DISTRICT,GADDANI TEHSIL,41,190,83,273
LASBELA DISTRICT,GADDANI TEHSIL,42,163,83,246
LASBELA DISTRICT,GADDANI TEHSIL,43,194,77,271
LASBELA DISTRICT,GADDANI TEHSIL,44,156,69,225
LASBELA DISTRICT,GADDANI TEHSIL,45,131,46,177
LASBELA DISTRICT,GADDANI TEHSIL,46,121,90,211
LASBELA DISTRICT,GADDANI TEHSIL,47,182,63,245
LASBELA DISTRICT,GADDANI TEHSIL,48,143,84,227
LASBELA DISTRICT,GADDANI TEHSIL,49,179,73,252
LASBELA DISTRICT,GADDANI TEHSIL,50,131,55,186
LASBELA DISTRICT,GADDANI TEHSIL,51,136,68,204
LASBELA DISTRICT,GADDANI TEHSIL,52,107,59,166
LASBELA DISTRICT,GADDANI TEHSIL,53,132,45,177
LASBELA DISTRICT,GADDANI TEHSIL,54,86,35,121
LASBELA DISTRICT,GADDANI TEHSIL,55,66,30,96
LASBELA DISTRICT,GADDANI TEHSIL,56,85,46,131
LASBELA DISTRICT,GADDANI TEHSIL,57,83,30,113
LASBELA DISTRICT,GADDANI TEHSIL,58,85,41,126
LASBELA DISTRICT,GADDANI TEHSIL,59,93,55,148
LASBELA DISTRICT,GADDANI TEHSIL,60,87,29,116
LASBELA DISTRICT,GADDANI TEHSIL,61,132,52,184
LASBELA DISTRICT,GADDANI TEHSIL,62,73,35,108
LASBELA DISTRICT,GADDANI TEHSIL,63,73,34,107
LASBELA DISTRICT,GADDANI TEHSIL,64,67,38,105
LASBELA DISTRICT,GADDANI TEHSIL,65,62,21,83
LASBELA DISTRICT,GADDANI TEHSIL,66,66,38,104
LASBELA DISTRICT,GADDANI TEHSIL,67,44,13,57
LASBELA DISTRICT,GADDANI TEHSIL,68,41,26,67
LASBELA DISTRICT,GADDANI TEHSIL,69,48,27,75
LASBELA DISTRICT,GADDANI TEHSIL,70,36,15,51
LASBELA DISTRICT,GADDANI TEHSIL,71,75,23,98
LASBELA DISTRICT,GADDANI TEHSIL,72,13,15,28
LASBELA DISTRICT,GADDANI TEHSIL,73,39,18,57
LASBELA DISTRICT,GADDANI TEHSIL,74,19,8,27
LASBELA DISTRICT,GADDANI TEHSIL,>=75,194,84,278
LASBELA DISTRICT,HUB TEHSIL,<1,755,4749,5504
LASBELA DISTRICT,HUB TEHSIL,1,815,5566,6381
LASBELA DISTRICT,HUB TEHSIL,2,944,5808,6752
LASBELA DISTRICT,HUB TEHSIL,3,966,6176,7142
LASBELA DISTRICT,HUB TEHSIL,4,990,5979,6969
LASBELA DISTRICT,HUB TEHSIL,5,848,5691,6539
LASBELA DISTRICT,HUB TEHSIL,6,923,5559,6482
LASBELA DISTRICT,HUB TEHSIL,7,869,5893,6762
LASBELA DISTRICT,HUB TEHSIL,8,947,5463,6410
LASBELA DISTRICT,HUB TEHSIL,9,770,5250,6020
LASBELA DISTRICT,HUB TEHSIL,10,816,5023,5839
LASBELA DISTRICT,HUB TEHSIL,11,614,4535,5149
LASBELA DISTRICT,HUB TEHSIL,12,673,4407,5080
LASBELA DISTRICT,HUB TEHSIL,13,558,4112,4670
LASBELA DISTRICT,HUB TEHSIL,14,576,3868,4444
LASBELA DISTRICT,HUB TEHSIL,15,498,3870,4368
LASBELA DISTRICT,HUB TEHSIL,16,517,3616,4133
LASBELA DISTRICT,HUB TEHSIL,17,533,3703,4236
LASBELA DISTRICT,HUB TEHSIL,18,541,4011,4552
LASBELA DISTRICT,HUB TEHSIL,19,571,3957,4528
LASBELA DISTRICT,HUB TEHSIL,20,613,3770,4383
LASBELA DISTRICT,HUB TEHSIL,21,539,3656,4195
LASBELA DISTRICT,HUB TEHSIL,22,456,3139,3595
LASBELA DISTRICT,HUB TEHSIL,23,367,2861,3228
LASBELA DISTRICT,HUB TEHSIL,24,428,2810,3238
LASBELA DISTRICT,HUB TEHSIL,25,449,3169,3618
LASBELA DISTRICT,HUB TEHSIL,26,454,2871,3325
LASBELA DISTRICT,HUB TEHSIL,27,416,3024,3440
LASBELA DISTRICT,HUB TEHSIL,28,488,2939,3427
LASBELA DISTRICT,HUB TEHSIL,29,408,2831,3239
LASBELA DISTRICT,HUB TEHSIL,30,408,2743,3151
LASBELA DISTRICT,HUB TEHSIL,31,391,2650,3041
LASBELA DISTRICT,HUB TEHSIL,32,341,2368,2709
LASBELA DISTRICT,HUB TEHSIL,33,358,2189,2547
LASBELA DISTRICT,HUB TEHSIL,34,358,2035,2393
LASBELA DISTRICT,HUB TEHSIL,35,253,2036,2289
LASBELA DISTRICT,HUB TEHSIL,36,344,1842,2186
LASBELA DISTRICT,HUB TEHSIL,37,253,1860,2113
LASBELA DISTRICT,HUB TEHSIL,38,316,1794,2110
LASBELA DISTRICT,HUB TEHSIL,39,262,1826,2088
LASBELA DISTRICT,HUB TEHSIL,40,239,1710,1949
LASBELA DISTRICT,HUB TEHSIL,41,288,1608,1896
LASBELA DISTRICT,HUB TEHSIL,42,237,1369,1606
LASBELA DISTRICT,HUB TEHSIL,43,201,1299,1500
LASBELA DISTRICT,HUB TEHSIL,44,202,1238,1440
LASBELA DISTRICT,HUB TEHSIL,45,175,1245,1420
LASBELA DISTRICT,HUB TEHSIL,46,261,1279,1540
LASBELA DISTRICT,HUB TEHSIL,47,176,1079,1255
LASBELA DISTRICT,HUB TEHSIL,48,244,1069,1313
LASBELA DISTRICT,HUB TEHSIL,49,196,1144,1340
LASBELA DISTRICT,HUB TEHSIL,50,159,1126,1285
LASBELA DISTRICT,HUB TEHSIL,51,187,1071,1258
LASBELA DISTRICT,HUB TEHSIL,52,160,845,1005
LASBELA DISTRICT,HUB TEHSIL,53,169,861,1030
LASBELA DISTRICT,HUB TEHSIL,54,120,753,873
LASBELA DISTRICT,HUB TEHSIL,55,117,710,827
LASBELA DISTRICT,HUB TEHSIL,56,131,713,844
LASBELA DISTRICT,HUB TEHSIL,57,88,650,738
LASBELA DISTRICT,HUB TEHSIL,58,128,621,749
LASBELA DISTRICT,HUB TEHSIL,59,105,625,730
LASBELA DISTRICT,HUB TEHSIL,60,142,624,766
LASBELA DISTRICT,HUB TEHSIL,61,119,569,688
LASBELA DISTRICT,HUB TEHSIL,62,77,556,633
LASBELA DISTRICT,HUB TEHSIL,63,89,553,642
LASBELA DISTRICT,HUB TEHSIL,64,114,480,594
LASBELA DISTRICT,HUB TEHSIL,65,85,439,524
LASBELA DISTRICT,HUB TEHSIL,66,107,361,468
LASBELA DISTRICT,HUB TEHSIL,67,60,316,376
LASBELA DISTRICT,HUB TEHSIL,68,81,352,433
LASBELA DISTRICT,HUB TEHSIL,69,62,294,356
LASBELA DISTRICT,HUB TEHSIL,70,70,235,305
LASBELA DISTRICT,HUB TEHSIL,71,62,251,313
LASBELA DISTRICT,HUB TEHSIL,72,27,221,248
LASBELA DISTRICT,HUB TEHSIL,73,47,226,273
LASBELA DISTRICT,HUB TEHSIL,74,32,154,186
LASBELA DISTRICT,HUB TEHSIL,>=75,281,1528,1809
LASBELA DISTRICT,KANRAJ TEHSIL,<1,266,0,266
LASBELA DISTRICT,KANRAJ TEHSIL,1,390,0,390
LASBELA DISTRICT,KANRAJ TEHSIL,2,398,0,398
LASBELA DISTRICT,KANRAJ TEHSIL,3,414,0,414
LASBELA DISTRICT,KANRAJ TEHSIL,4,465,0,465
LASBELA DISTRICT,KANRAJ TEHSIL,5,376,0,376
LASBELA DISTRICT,KANRAJ TEHSIL,6,467,0,467
LASBELA DISTRICT,KANRAJ TEHSIL,7,323,0,323
LASBELA DISTRICT,KANRAJ TEHSIL,8,440,0,440
LASBELA DISTRICT,KANRAJ TEHSIL,9,283,0,283
LASBELA DISTRICT,KANRAJ TEHSIL,10,416,0,416
LASBELA DISTRICT,KANRAJ TEHSIL,11,277,0,277
LASBELA DISTRICT,KANRAJ TEHSIL,12,273,0,273
LASBELA DISTRICT,KANRAJ TEHSIL,13,151,0,151
LASBELA DISTRICT,KANRAJ TEHSIL,14,197,0,197
LASBELA DISTRICT,KANRAJ TEHSIL,15,145,0,145
LASBELA DISTRICT,KANRAJ TEHSIL,16,185,0,185
LASBELA DISTRICT,KANRAJ TEHSIL,17,137,0,137
LASBELA DISTRICT,KANRAJ TEHSIL,18,161,0,161
LASBELA DISTRICT,KANRAJ TEHSIL,19,158,0,158
LASBELA DISTRICT,KANRAJ TEHSIL,20,238,0,238
LASBELA DISTRICT,KANRAJ TEHSIL,21,175,0,175
LASBELA DISTRICT,KANRAJ TEHSIL,22,171,0,171
LASBELA DISTRICT,KANRAJ TEHSIL,23,135,0,135
LASBELA DISTRICT,KANRAJ TEHSIL,24,124,0,124
LASBELA DISTRICT,KANRAJ TEHSIL,25,203,0,203
LASBELA DISTRICT,KANRAJ TEHSIL,26,163,0,163
LASBELA DISTRICT,KANRAJ TEHSIL,27,162,0,162
LASBELA DISTRICT,KANRAJ TEHSIL,28,254,0,254
LASBELA DISTRICT,KANRAJ TEHSIL,29,193,0,193
LASBELA DISTRICT,KANRAJ TEHSIL,30,234,0,234
LASBELA DISTRICT,KANRAJ TEHSIL,31,214,0,214
LASBELA DISTRICT,KANRAJ TEHSIL,32,173,0,173
LASBELA DISTRICT,KANRAJ TEHSIL,33,163,0,163
LASBELA DISTRICT,KANRAJ TEHSIL,34,159,0,159
LASBELA DISTRICT,KANRAJ TEHSIL,35,139,0,139
LASBELA DISTRICT,KANRAJ TEHSIL,36,217,0,217
LASBELA DISTRICT,KANRAJ TEHSIL,37,181,0,181
LASBELA DISTRICT,KANRAJ TEHSIL,38,213,0,213
LASBELA DISTRICT,KANRAJ TEHSIL,39,145,0,145
LASBELA DISTRICT,KANRAJ TEHSIL,40,211,0,211
LASBELA DISTRICT,KANRAJ TEHSIL,41,135,0,135
LASBELA DISTRICT,KANRAJ TEHSIL,42,149,0,149
LASBELA DISTRICT,KANRAJ TEHSIL,43,139,0,139
LASBELA DISTRICT,KANRAJ TEHSIL,44,133,0,133
LASBELA DISTRICT,KANRAJ TEHSIL,45,103,0,103
LASBELA DISTRICT,KANRAJ TEHSIL,46,105,0,105
LASBELA DISTRICT,KANRAJ TEHSIL,47,97,0,97
LASBELA DISTRICT,KANRAJ TEHSIL,48,98,0,98
LASBELA DISTRICT,KANRAJ TEHSIL,49,74,0,74
LASBELA DISTRICT,KANRAJ TEHSIL,50,96,0,96
LASBELA DISTRICT,KANRAJ TEHSIL,51,60,0,60
LASBELA DISTRICT,KANRAJ TEHSIL,52,74,0,74
LASBELA DISTRICT,KANRAJ TEHSIL,53,83,0,83
LASBELA DISTRICT,KANRAJ TEHSIL,54,77,0,77
LASBELA DISTRICT,KANRAJ TEHSIL,55,65,0,65
LASBELA DISTRICT,KANRAJ TEHSIL,56,52,0,52
LASBELA DISTRICT,KANRAJ TEHSIL,57,45,0,45
LASBELA DISTRICT,KANRAJ TEHSIL,58,44,0,44
LASBELA DISTRICT,KANRAJ TEHSIL,59,44,0,44
LASBELA DISTRICT,KANRAJ TEHSIL,60,79,0,79
LASBELA DISTRICT,KANRAJ TEHSIL,61,50,0,50
LASBELA DISTRICT,KANRAJ TEHSIL,62,65,0,65
LASBELA DISTRICT,KANRAJ TEHSIL,63,79,0,79
LASBELA DISTRICT,KANRAJ TEHSIL,64,61,0,61
LASBELA DISTRICT,KANRAJ TEHSIL,65,49,0,49
LASBELA DISTRICT,KANRAJ TEHSIL,66,57,0,57
LASBELA DISTRICT,KANRAJ TEHSIL,67,40,0,40
LASBELA DISTRICT,KANRAJ TEHSIL,68,66,0,66
LASBELA DISTRICT,KANRAJ TEHSIL,69,44,0,44
LASBELA DISTRICT,KANRAJ TEHSIL,70,32,0,32
LASBELA DISTRICT,KANRAJ TEHSIL,71,20,0,20
LASBELA DISTRICT,KANRAJ TEHSIL,72,19,0,19
LASBELA DISTRICT,KANRAJ TEHSIL,73,32,0,32
LASBELA DISTRICT,KANRAJ TEHSIL,74,30,0,30
LASBELA DISTRICT,KANRAJ TEHSIL,>=75,204,0,204
LASBELA DISTRICT,LAKHRA TEHSIL,<1,940,0,940
LASBELA DISTRICT,LAKHRA TEHSIL,1,991,0,991
LASBELA DISTRICT,LAKHRA TEHSIL,2,1357,0,1357
LASBELA DISTRICT,LAKHRA TEHSIL,3,1234,0,1234
LASBELA DISTRICT,LAKHRA TEHSIL,4,1425,0,1425
LASBELA DISTRICT,LAKHRA TEHSIL,5,1176,0,1176
LASBELA DISTRICT,LAKHRA TEHSIL,6,1380,0,1380
LASBELA DISTRICT,LAKHRA TEHSIL,7,1016,0,1016
LASBELA DISTRICT,LAKHRA TEHSIL,8,1324,0,1324
LASBELA DISTRICT,LAKHRA TEHSIL,9,1005,0,1005
LASBELA DISTRICT,LAKHRA TEHSIL,10,1096,0,1096
LASBELA DISTRICT,LAKHRA TEHSIL,11,803,0,803
LASBELA DISTRICT,LAKHRA TEHSIL,12,903,0,903
LASBELA DISTRICT,LAKHRA TEHSIL,13,732,0,732
LASBELA DISTRICT,LAKHRA TEHSIL,14,712,0,712
LASBELA DISTRICT,LAKHRA TEHSIL,15,685,0,685
LASBELA DISTRICT,LAKHRA TEHSIL,16,612,0,612
LASBELA DISTRICT,LAKHRA TEHSIL,17,598,0,598
LASBELA DISTRICT,LAKHRA TEHSIL,18,683,0,683
LASBELA DISTRICT,LAKHRA TEHSIL,19,654,0,654
LASBELA DISTRICT,LAKHRA TEHSIL,20,700,0,700
LASBELA DISTRICT,LAKHRA TEHSIL,21,582,0,582
LASBELA DISTRICT,LAKHRA TEHSIL,22,488,0,488
LASBELA DISTRICT,LAKHRA TEHSIL,23,421,0,421
LASBELA DISTRICT,LAKHRA TEHSIL,24,449,0,449
LASBELA DISTRICT,LAKHRA TEHSIL,25,483,0,483
LASBELA DISTRICT,LAKHRA TEHSIL,26,394,0,394
LASBELA DISTRICT,LAKHRA TEHSIL,27,505,0,505
LASBELA DISTRICT,LAKHRA TEHSIL,28,477,0,477
LASBELA DISTRICT,LAKHRA TEHSIL,29,527,0,527
LASBELA DISTRICT,LAKHRA TEHSIL,30,500,0,500
LASBELA DISTRICT,LAKHRA TEHSIL,31,502,0,502
LASBELA DISTRICT,LAKHRA TEHSIL,32,445,0,445
LASBELA DISTRICT,LAKHRA TEHSIL,33,410,0,410
LASBELA DISTRICT,LAKHRA TEHSIL,34,418,0,418
LASBELA DISTRICT,LAKHRA TEHSIL,35,411,0,411
LASBELA DISTRICT,LAKHRA TEHSIL,36,379,0,379
LASBELA DISTRICT,LAKHRA TEHSIL,37,524,0,524
LASBELA DISTRICT,LAKHRA TEHSIL,38,361,0,361
LASBELA DISTRICT,LAKHRA TEHSIL,39,420,0,420
LASBELA DISTRICT,LAKHRA TEHSIL,40,328,0,328
LASBELA DISTRICT,LAKHRA TEHSIL,41,334,0,334
LASBELA DISTRICT,LAKHRA TEHSIL,42,333,0,333
LASBELA DISTRICT,LAKHRA TEHSIL,43,319,0,319
LASBELA DISTRICT,LAKHRA TEHSIL,44,274,0,274
LASBELA DISTRICT,LAKHRA TEHSIL,45,286,0,286
LASBELA DISTRICT,LAKHRA TEHSIL,46,271,0,271
LASBELA DISTRICT,LAKHRA TEHSIL,47,262,0,262
LASBELA DISTRICT,LAKHRA TEHSIL,48,215,0,215
LASBELA DISTRICT,LAKHRA TEHSIL,49,250,0,250
LASBELA DISTRICT,LAKHRA TEHSIL,50,205,0,205
LASBELA DISTRICT,LAKHRA TEHSIL,51,314,0,314
LASBELA DISTRICT,LAKHRA TEHSIL,52,175,0,175
LASBELA DISTRICT,LAKHRA TEHSIL,53,192,0,192
LASBELA DISTRICT,LAKHRA TEHSIL,54,125,0,125
LASBELA DISTRICT,LAKHRA TEHSIL,55,124,0,124
LASBELA DISTRICT,LAKHRA TEHSIL,56,128,0,128
LASBELA DISTRICT,LAKHRA TEHSIL,57,135,0,135
LASBELA DISTRICT,LAKHRA TEHSIL,58,133,0,133
LASBELA DISTRICT,LAKHRA TEHSIL,59,142,0,142
LASBELA DISTRICT,LAKHRA TEHSIL,60,150,0,150
LASBELA DISTRICT,LAKHRA TEHSIL,61,177,0,177
LASBELA DISTRICT,LAKHRA TEHSIL,62,132,0,132
LASBELA DISTRICT,LAKHRA TEHSIL,63,133,0,133
LASBELA DISTRICT,LAKHRA TEHSIL,64,133,0,133
LASBELA DISTRICT,LAKHRA TEHSIL,65,114,0,114
LASBELA DISTRICT,LAKHRA TEHSIL,66,139,0,139
LASBELA DISTRICT,LAKHRA TEHSIL,67,84,0,84
LASBELA DISTRICT,LAKHRA TEHSIL,68,114,0,114
LASBELA DISTRICT,LAKHRA TEHSIL,69,127,0,127
LASBELA DISTRICT,LAKHRA TEHSIL,70,100,0,100
LASBELA DISTRICT,LAKHRA TEHSIL,71,125,0,125
LASBELA DISTRICT,LAKHRA TEHSIL,72,56,0,56
LASBELA DISTRICT,LAKHRA TEHSIL,73,63,0,63
LASBELA DISTRICT,LAKHRA TEHSIL,74,64,0,64
LASBELA DISTRICT,LAKHRA TEHSIL,>=75,517,0,517
LASBELA DISTRICT,LIARI TEHSIL,<1,252,0,252
LASBELA DISTRICT,LIARI TEHSIL,1,306,0,306
LASBELA DISTRICT,LIARI TEHSIL,2,418,0,418
LASBELA DISTRICT,LIARI TEHSIL,3,352,0,352
LASBELA DISTRICT,LIARI TEHSIL,4,435,0,435
LASBELA DISTRICT,LIARI TEHSIL,5,329,0,329
LASBELA DISTRICT,LIARI TEHSIL,6,453,0,453
LASBELA DISTRICT,LIARI TEHSIL,7,298,0,298
LASBELA DISTRICT,LIARI TEHSIL,8,470,0,470
LASBELA DISTRICT,LIARI TEHSIL,9,283,0,283
LASBELA DISTRICT,LIARI TEHSIL,10,363,0,363
LASBELA DISTRICT,LIARI TEHSIL,11,245,0,245
LASBELA DISTRICT,LIARI TEHSIL,12,268,0,268
LASBELA DISTRICT,LIARI TEHSIL,13,215,0,215
LASBELA DISTRICT,LIARI TEHSIL,14,244,0,244
LASBELA DISTRICT,LIARI TEHSIL,15,236,0,236
LASBELA DISTRICT,LIARI TEHSIL,16,205,0,205
LASBELA DISTRICT,LIARI TEHSIL,17,212,0,212
LASBELA DISTRICT,LIARI TEHSIL,18,244,0,244
LASBELA DISTRICT,LIARI TEHSIL,19,219,0,219
LASBELA DISTRICT,LIARI TEHSIL,20,221,0,221
LASBELA DISTRICT,LIARI TEHSIL,21,214,0,214
LASBELA DISTRICT,LIARI TEHSIL,22,158,0,158
LASBELA DISTRICT,LIARI TEHSIL,23,154,0,154
LASBELA DISTRICT,LIARI TEHSIL,24,135,0,135
LASBELA DISTRICT,LIARI TEHSIL,25,204,0,204
LASBELA DISTRICT,LIARI TEHSIL,26,148,0,148
LASBELA DISTRICT,LIARI TEHSIL,27,180,0,180
LASBELA DISTRICT,LIARI TEHSIL,28,175,0,175
LASBELA DISTRICT,LIARI TEHSIL,29,220,0,220
LASBELA DISTRICT,LIARI TEHSIL,30,163,0,163
LASBELA DISTRICT,LIARI TEHSIL,31,157,0,157
LASBELA DISTRICT,LIARI TEHSIL,32,156,0,156
LASBELA DISTRICT,LIARI TEHSIL,33,152,0,152
LASBELA DISTRICT,LIARI TEHSIL,34,119,0,119
LASBELA DISTRICT,LIARI TEHSIL,35,130,0,130
LASBELA DISTRICT,LIARI TEHSIL,36,104,0,104
LASBELA DISTRICT,LIARI TEHSIL,37,166,0,166
LASBELA DISTRICT,LIARI TEHSIL,38,103,0,103
LASBELA DISTRICT,LIARI TEHSIL,39,141,0,141
LASBELA DISTRICT,LIARI TEHSIL,40,103,0,103
LASBELA DISTRICT,LIARI TEHSIL,41,109,0,109
LASBELA DISTRICT,LIARI TEHSIL,42,107,0,107
LASBELA DISTRICT,LIARI TEHSIL,43,93,0,93
LASBELA DISTRICT,LIARI TEHSIL,44,102,0,102
LASBELA DISTRICT,LIARI TEHSIL,45,92,0,92
LASBELA DISTRICT,LIARI TEHSIL,46,81,0,81
LASBELA DISTRICT,LIARI TEHSIL,47,117,0,117
LASBELA DISTRICT,LIARI TEHSIL,48,75,0,75
LASBELA DISTRICT,LIARI TEHSIL,49,141,0,141
LASBELA DISTRICT,LIARI TEHSIL,50,65,0,65
LASBELA DISTRICT,LIARI TEHSIL,51,110,0,110
LASBELA DISTRICT,LIARI TEHSIL,52,83,0,83
LASBELA DISTRICT,LIARI TEHSIL,53,100,0,100
LASBELA DISTRICT,LIARI TEHSIL,54,56,0,56
LASBELA DISTRICT,LIARI TEHSIL,55,35,0,35
LASBELA DISTRICT,LIARI TEHSIL,56,28,0,28
LASBELA DISTRICT,LIARI TEHSIL,57,52,0,52
LASBELA DISTRICT,LIARI TEHSIL,58,52,0,52
LASBELA DISTRICT,LIARI TEHSIL,59,59,0,59
LASBELA DISTRICT,LIARI TEHSIL,60,41,0,41
LASBELA DISTRICT,LIARI TEHSIL,61,61,0,61
LASBELA DISTRICT,LIARI TEHSIL,62,49,0,49
LASBELA DISTRICT,LIARI TEHSIL,63,69,0,69
LASBELA DISTRICT,LIARI TEHSIL,64,53,0,53
LASBELA DISTRICT,LIARI TEHSIL,65,47,0,47
LASBELA DISTRICT,LIARI TEHSIL,66,42,0,42
LASBELA DISTRICT,LIARI TEHSIL,67,32,0,32
LASBELA DISTRICT,LIARI TEHSIL,68,43,0,43
LASBELA DISTRICT,LIARI TEHSIL,69,50,0,50
LASBELA DISTRICT,LIARI TEHSIL,70,34,0,34
LASBELA DISTRICT,LIARI TEHSIL,71,29,0,29
LASBELA DISTRICT,LIARI TEHSIL,72,26,0,26
LASBELA DISTRICT,LIARI TEHSIL,73,27,0,27
LASBELA DISTRICT,LIARI TEHSIL,74,25,0,25
LASBELA DISTRICT,LIARI TEHSIL,>=75,195,0,195
LASBELA DISTRICT,SONMIANI/WINDER TEHSIL,<1,755,732,1487
LASBELA DISTRICT,SONMIANI/WINDER TEHSIL,1,962,811,1773
LASBELA DISTRICT,SONMIANI/WINDER TEHSIL,2,1026,976,2002
LASBELA DISTRICT,SONMIANI/WINDER TEHSIL,3,1044,991,2035
LASBELA DISTRICT,SONMIANI/WINDER TEHSIL,4,1090,997,2087
LASBELA DISTRICT,SONMIANI/WINDER TEHSIL,5,923,935,1858
LASBELA DISTRICT,SONMIANI/WINDER TEHSIL,6,1042,976,2018
LASBELA DISTRICT,SONMIANI/WINDER TEHSIL,7,1020,966,1986
LASBELA DISTRICT,SONMIANI/WINDER TEHSIL,8,968,933,1901
LASBELA DISTRICT,SONMIANI/WINDER TEHSIL,9,962,895,1857
LASBELA DISTRICT,SONMIANI/WINDER TEHSIL,10,856,828,1684
LASBELA DISTRICT,SONMIANI/WINDER TEHSIL,11,860,776,1636
LASBELA DISTRICT,SONMIANI/WINDER TEHSIL,12,765,661,1426
LASBELA DISTRICT,SONMIANI/WINDER TEHSIL,13,706,606,1312
LASBELA DISTRICT,SONMIANI/WINDER TEHSIL,14,688,618,1306
LASBELA DISTRICT,SONMIANI/WINDER TEHSIL,15,703,545,1248
LASBELA DISTRICT,SONMIANI/WINDER TEHSIL,16,661,551,1212
LASBELA DISTRICT,SONMIANI/WINDER TEHSIL,17,669,607,1276
LASBELA DISTRICT,SONMIANI/WINDER TEHSIL,18,680,528,1208
LASBELA DISTRICT,SONMIANI/WINDER TEHSIL,19,670,614,1284
LASBELA DISTRICT,SONMIANI/WINDER TEHSIL,20,641,561,1202
LASBELA DISTRICT,SONMIANI/WINDER TEHSIL,21,617,539,1156
LASBELA DISTRICT,SONMIANI/WINDER TEHSIL,22,533,448,981
LASBELA DISTRICT,SONMIANI/WINDER TEHSIL,23,529,461,990
LASBELA DISTRICT,SONMIANI/WINDER TEHSIL,24,549,477,1026
LASBELA DISTRICT,SONMIANI/WINDER TEHSIL,25,491,419,910
LASBELA DISTRICT,SONMIANI/WINDER TEHSIL,26,708,488,1196
LASBELA DISTRICT,SONMIANI/WINDER TEHSIL,27,693,557,1250
LASBELA DISTRICT,SONMIANI/WINDER TEHSIL,28,611,488,1099
LASBELA DISTRICT,SONMIANI/WINDER TEHSIL,29,626,530,1156
LASBELA DISTRICT,SONMIANI/WINDER TEHSIL,30,481,403,884
LASBELA DISTRICT,SONMIANI/WINDER TEHSIL,31,616,505,1121
LASBELA DISTRICT,SONMIANI/WINDER TEHSIL,32,501,389,890
LASBELA DISTRICT,SONMIANI/WINDER TEHSIL,33,460,383,843
LASBELA DISTRICT,SONMIANI/WINDER TEHSIL,34,468,350,818
LASBELA DISTRICT,SONMIANI/WINDER TEHSIL,35,332,290,622
LASBELA DISTRICT,SONMIANI/WINDER TEHSIL,36,486,326,812
LASBELA DISTRICT,SONMIANI/WINDER TEHSIL,37,424,353,777
LASBELA DISTRICT,SONMIANI/WINDER TEHSIL,38,365,342,707
LASBELA DISTRICT,SONMIANI/WINDER TEHSIL,39,361,325,686
LASBELA DISTRICT,SONMIANI/WINDER TEHSIL,40,266,259,525
LASBELA DISTRICT,SONMIANI/WINDER TEHSIL,41,359,269,628
LASBELA DISTRICT,SONMIANI/WINDER TEHSIL,42,324,246,570
LASBELA DISTRICT,SONMIANI/WINDER TEHSIL,43,351,292,643
LASBELA DISTRICT,SONMIANI/WINDER TEHSIL,44,347,243,590
LASBELA DISTRICT,SONMIANI/WINDER TEHSIL,45,215,210,425
LASBELA DISTRICT,SONMIANI/WINDER TEHSIL,46,352,263,615
LASBELA DISTRICT,SONMIANI/WINDER TEHSIL,47,276,226,502
LASBELA DISTRICT,SONMIANI/WINDER TEHSIL,48,283,240,523
LASBELA DISTRICT,SONMIANI/WINDER TEHSIL,49,270,183,453
LASBELA DISTRICT,SONMIANI/WINDER TEHSIL,50,201,183,384
LASBELA DISTRICT,SONMIANI/WINDER TEHSIL,51,277,232,509
LASBELA DISTRICT,SONMIANI/WINDER TEHSIL,52,198,124,322
LASBELA DISTRICT,SONMIANI/WINDER TEHSIL,53,200,165,365
LASBELA DISTRICT,SONMIANI/WINDER TEHSIL,54,191,151,342
LASBELA DISTRICT,SONMIANI/WINDER TEHSIL,55,153,99,252
LASBELA DISTRICT,SONMIANI/WINDER TEHSIL,56,156,107,263
LASBELA DISTRICT,SONMIANI/WINDER TEHSIL,57,116,109,225
LASBELA DISTRICT,SONMIANI/WINDER TEHSIL,58,160,108,268
LASBELA DISTRICT,SONMIANI/WINDER TEHSIL,59,189,108,297
LASBELA DISTRICT,SONMIANI/WINDER TEHSIL,60,161,118,279
LASBELA DISTRICT,SONMIANI/WINDER TEHSIL,61,199,122,321
LASBELA DISTRICT,SONMIANI/WINDER TEHSIL,62,143,110,253
LASBELA DISTRICT,SONMIANI/WINDER TEHSIL,63,158,125,283
LASBELA DISTRICT,SONMIANI/WINDER TEHSIL,64,129,102,231
LASBELA DISTRICT,SONMIANI/WINDER TEHSIL,65,123,68,191
LASBELA DISTRICT,SONMIANI/WINDER TEHSIL,66,132,122,254
LASBELA DISTRICT,SONMIANI/WINDER TEHSIL,67,74,70,144
LASBELA DISTRICT,SONMIANI/WINDER TEHSIL,68,104,86,190
LASBELA DISTRICT,SONMIANI/WINDER TEHSIL,69,102,78,180
LASBELA DISTRICT,SONMIANI/WINDER TEHSIL,70,63,65,128
LASBELA DISTRICT,SONMIANI/WINDER TEHSIL,71,84,58,142
LASBELA DISTRICT,SONMIANI/WINDER TEHSIL,72,53,32,85
LASBELA DISTRICT,SONMIANI/WINDER TEHSIL,73,60,51,111
LASBELA DISTRICT,SONMIANI/WINDER TEHSIL,74,61,42,103
LASBELA DISTRICT,SONMIANI/WINDER TEHSIL,>=75,432,269,701
LASBELA DISTRICT,UTHAL TEHSIL,<1,1078,683,1761
LASBELA DISTRICT,UTHAL TEHSIL,1,1309,693,2002
LASBELA DISTRICT,UTHAL TEHSIL,2,1354,855,2209
LASBELA DISTRICT,UTHAL TEHSIL,3,1474,933,2407
LASBELA DISTRICT,UTHAL TEHSIL,4,1538,868,2406
LASBELA DISTRICT,UTHAL TEHSIL,5,1458,807,2265
LASBELA DISTRICT,UTHAL TEHSIL,6,1484,846,2330
LASBELA DISTRICT,UTHAL TEHSIL,7,1271,780,2051
LASBELA DISTRICT,UTHAL TEHSIL,8,1439,831,2270
LASBELA DISTRICT,UTHAL TEHSIL,9,1233,800,2033
LASBELA DISTRICT,UTHAL TEHSIL,10,1299,781,2080
LASBELA DISTRICT,UTHAL TEHSIL,11,1000,674,1674
LASBELA DISTRICT,UTHAL TEHSIL,12,1026,683,1709
LASBELA DISTRICT,UTHAL TEHSIL,13,829,627,1456
LASBELA DISTRICT,UTHAL TEHSIL,14,820,592,1412
LASBELA DISTRICT,UTHAL TEHSIL,15,796,617,1413
LASBELA DISTRICT,UTHAL TEHSIL,16,751,620,1371
LASBELA DISTRICT,UTHAL TEHSIL,17,729,588,1317
LASBELA DISTRICT,UTHAL TEHSIL,18,902,615,1517
LASBELA DISTRICT,UTHAL TEHSIL,19,930,648,1578
LASBELA DISTRICT,UTHAL TEHSIL,20,744,691,1435
LASBELA DISTRICT,UTHAL TEHSIL,21,771,773,1544
LASBELA DISTRICT,UTHAL TEHSIL,22,585,554,1139
LASBELA DISTRICT,UTHAL TEHSIL,23,548,644,1192
LASBELA DISTRICT,UTHAL TEHSIL,24,572,587,1159
LASBELA DISTRICT,UTHAL TEHSIL,25,529,443,972
LASBELA DISTRICT,UTHAL TEHSIL,26,587,443,1030
LASBELA DISTRICT,UTHAL TEHSIL,27,718,540,1258
LASBELA DISTRICT,UTHAL TEHSIL,28,615,452,1067
LASBELA DISTRICT,UTHAL TEHSIL,29,730,541,1271
LASBELA DISTRICT,UTHAL TEHSIL,30,505,413,918
LASBELA DISTRICT,UTHAL TEHSIL,31,655,457,1112
LASBELA DISTRICT,UTHAL TEHSIL,32,580,461,1041
LASBELA DISTRICT,UTHAL TEHSIL,33,536,417,953
LASBELA DISTRICT,UTHAL TEHSIL,34,517,420,937
LASBELA DISTRICT,UTHAL TEHSIL,35,416,365,781
LASBELA DISTRICT,UTHAL TEHSIL,36,430,316,746
LASBELA DISTRICT,UTHAL TEHSIL,37,634,361,995
LASBELA DISTRICT,UTHAL TEHSIL,38,422,313,735
LASBELA DISTRICT,UTHAL TEHSIL,39,555,382,937
LASBELA DISTRICT,UTHAL TEHSIL,40,341,266,607
LASBELA DISTRICT,UTHAL TEHSIL,41,382,302,684
LASBELA DISTRICT,UTHAL TEHSIL,42,381,226,607
LASBELA DISTRICT,UTHAL TEHSIL,43,372,248,620
LASBELA DISTRICT,UTHAL TEHSIL,44,361,218,579
LASBELA DISTRICT,UTHAL TEHSIL,45,232,216,448
LASBELA DISTRICT,UTHAL TEHSIL,46,290,205,495
LASBELA DISTRICT,UTHAL TEHSIL,47,415,281,696
LASBELA DISTRICT,UTHAL TEHSIL,48,295,208,503
LASBELA DISTRICT,UTHAL TEHSIL,49,349,230,579
LASBELA DISTRICT,UTHAL TEHSIL,50,221,164,385
LASBELA DISTRICT,UTHAL TEHSIL,51,357,222,579
LASBELA DISTRICT,UTHAL TEHSIL,52,256,150,406
LASBELA DISTRICT,UTHAL TEHSIL,53,261,187,448
LASBELA DISTRICT,UTHAL TEHSIL,54,237,150,387
LASBELA DISTRICT,UTHAL TEHSIL,55,167,117,284
LASBELA DISTRICT,UTHAL TEHSIL,56,153,103,256
LASBELA DISTRICT,UTHAL TEHSIL,57,231,121,352
LASBELA DISTRICT,UTHAL TEHSIL,58,161,134,295
LASBELA DISTRICT,UTHAL TEHSIL,59,238,157,395
LASBELA DISTRICT,UTHAL TEHSIL,60,143,98,241
LASBELA DISTRICT,UTHAL TEHSIL,61,242,145,387
LASBELA DISTRICT,UTHAL TEHSIL,62,165,105,270
LASBELA DISTRICT,UTHAL TEHSIL,63,172,104,276
LASBELA DISTRICT,UTHAL TEHSIL,64,202,117,319
LASBELA DISTRICT,UTHAL TEHSIL,65,112,73,185
LASBELA DISTRICT,UTHAL TEHSIL,66,152,75,227
LASBELA DISTRICT,UTHAL TEHSIL,67,140,54,194
LASBELA DISTRICT,UTHAL TEHSIL,68,132,70,202
LASBELA DISTRICT,UTHAL TEHSIL,69,214,73,287
LASBELA DISTRICT,UTHAL TEHSIL,70,103,32,135
LASBELA DISTRICT,UTHAL TEHSIL,71,138,49,187
LASBELA DISTRICT,UTHAL TEHSIL,72,79,42,121
LASBELA DISTRICT,UTHAL TEHSIL,73,101,38,139
LASBELA DISTRICT,UTHAL TEHSIL,74,116,44,160
LASBELA DISTRICT,UTHAL TEHSIL,>=75,587,285,872
LAYYAH DISTRICT,CHOUBARA TEHSIL,<1,5646,1228,6874
LAYYAH DISTRICT,CHOUBARA TEHSIL,1,5940,1342,7282
LAYYAH DISTRICT,CHOUBARA TEHSIL,2,6069,1363,7432
LAYYAH DISTRICT,CHOUBARA TEHSIL,3,6237,1451,7688
LAYYAH DISTRICT,CHOUBARA TEHSIL,4,6474,1476,7950
LAYYAH DISTRICT,CHOUBARA TEHSIL,5,6228,1464,7692
LAYYAH DISTRICT,CHOUBARA TEHSIL,6,6036,1381,7417
LAYYAH DISTRICT,CHOUBARA TEHSIL,7,6359,1497,7856
LAYYAH DISTRICT,CHOUBARA TEHSIL,8,6122,1350,7472
LAYYAH DISTRICT,CHOUBARA TEHSIL,9,6178,1453,7631
LAYYAH DISTRICT,CHOUBARA TEHSIL,10,5405,1196,6601
LAYYAH DISTRICT,CHOUBARA TEHSIL,11,5325,1369,6694
LAYYAH DISTRICT,CHOUBARA TEHSIL,12,4698,1095,5793
LAYYAH DISTRICT,CHOUBARA TEHSIL,13,4353,1071,5424
LAYYAH DISTRICT,CHOUBARA TEHSIL,14,4416,1091,5507
LAYYAH DISTRICT,CHOUBARA TEHSIL,15,4274,1036,5310
LAYYAH DISTRICT,CHOUBARA TEHSIL,16,4214,1047,5261
LAYYAH DISTRICT,CHOUBARA TEHSIL,17,4253,963,5216
LAYYAH DISTRICT,CHOUBARA TEHSIL,18,3932,891,4823
LAYYAH DISTRICT,CHOUBARA TEHSIL,19,3972,1002,4974
LAYYAH DISTRICT,CHOUBARA TEHSIL,20,3736,827,4563
LAYYAH DISTRICT,CHOUBARA TEHSIL,21,3681,921,4602
LAYYAH DISTRICT,CHOUBARA TEHSIL,22,3423,768,4191
LAYYAH DISTRICT,CHOUBARA TEHSIL,23,3364,757,4121
LAYYAH DISTRICT,CHOUBARA TEHSIL,24,3382,838,4220
LAYYAH DISTRICT,CHOUBARA TEHSIL,25,2971,713,3684
LAYYAH DISTRICT,CHOUBARA TEHSIL,26,3199,771,3970
LAYYAH DISTRICT,CHOUBARA TEHSIL,27,3138,834,3972
LAYYAH DISTRICT,CHOUBARA TEHSIL,28,2834,696,3530
LAYYAH DISTRICT,CHOUBARA TEHSIL,29,3083,858,3941
LAYYAH DISTRICT,CHOUBARA TEHSIL,30,2587,528,3115
LAYYAH DISTRICT,CHOUBARA TEHSIL,31,2794,700,3494
LAYYAH DISTRICT,CHOUBARA TEHSIL,32,2427,584,3011
LAYYAH DISTRICT,CHOUBARA TEHSIL,33,2295,556,2851
LAYYAH DISTRICT,CHOUBARA TEHSIL,34,2600,577,3177
LAYYAH DISTRICT,CHOUBARA TEHSIL,35,2298,524,2822
LAYYAH DISTRICT,CHOUBARA TEHSIL,36,2697,659,3356
LAYYAH DISTRICT,CHOUBARA TEHSIL,37,2791,841,3632
LAYYAH DISTRICT,CHOUBARA TEHSIL,38,2163,529,2692
LAYYAH DISTRICT,CHOUBARA TEHSIL,39,2457,665,3122
LAYYAH DISTRICT,CHOUBARA TEHSIL,40,1561,280,1841
LAYYAH DISTRICT,CHOUBARA TEHSIL,41,2128,459,2587
LAYYAH DISTRICT,CHOUBARA TEHSIL,42,1801,499,2300
LAYYAH DISTRICT,CHOUBARA TEHSIL,43,1570,367,1937
LAYYAH DISTRICT,CHOUBARA TEHSIL,44,1614,383,1997
LAYYAH DISTRICT,CHOUBARA TEHSIL,45,1254,241,1495
LAYYAH DISTRICT,CHOUBARA TEHSIL,46,1745,394,2139
LAYYAH DISTRICT,CHOUBARA TEHSIL,47,1743,450,2193
LAYYAH DISTRICT,CHOUBARA TEHSIL,48,1495,353,1848
LAYYAH DISTRICT,CHOUBARA TEHSIL,49,1638,399,2037
LAYYAH DISTRICT,CHOUBARA TEHSIL,50,1132,244,1376
LAYYAH DISTRICT,CHOUBARA TEHSIL,51,1649,371,2020
LAYYAH DISTRICT,CHOUBARA TEHSIL,52,1426,386,1812
LAYYAH DISTRICT,CHOUBARA TEHSIL,53,1286,289,1575
LAYYAH DISTRICT,CHOUBARA TEHSIL,54,1139,304,1443
LAYYAH DISTRICT,CHOUBARA TEHSIL,55,878,234,1112
LAYYAH DISTRICT,CHOUBARA TEHSIL,56,1085,239,1324
LAYYAH DISTRICT,CHOUBARA TEHSIL,57,987,250,1237
LAYYAH DISTRICT,CHOUBARA TEHSIL,58,838,205,1043
LAYYAH DISTRICT,CHOUBARA TEHSIL,59,886,253,1139
LAYYAH DISTRICT,CHOUBARA TEHSIL,60,620,117,737
LAYYAH DISTRICT,CHOUBARA TEHSIL,61,915,212,1127
LAYYAH DISTRICT,CHOUBARA TEHSIL,62,762,206,968
LAYYAH DISTRICT,CHOUBARA TEHSIL,63,703,166,869
LAYYAH DISTRICT,CHOUBARA TEHSIL,64,718,181,899
LAYYAH DISTRICT,CHOUBARA TEHSIL,65,588,119,707
LAYYAH DISTRICT,CHOUBARA TEHSIL,66,726,181,907
LAYYAH DISTRICT,CHOUBARA TEHSIL,67,630,178,808
LAYYAH DISTRICT,CHOUBARA TEHSIL,68,580,109,689
LAYYAH DISTRICT,CHOUBARA TEHSIL,69,540,167,707
LAYYAH DISTRICT,CHOUBARA TEHSIL,70,432,100,532
LAYYAH DISTRICT,CHOUBARA TEHSIL,71,669,134,803
LAYYAH DISTRICT,CHOUBARA TEHSIL,72,446,124,570
LAYYAH DISTRICT,CHOUBARA TEHSIL,73,412,81,493
LAYYAH DISTRICT,CHOUBARA TEHSIL,74,395,91,486
LAYYAH DISTRICT,CHOUBARA TEHSIL,>=75,3127,693,3820
LAYYAH DISTRICT,KAROR LAL ESAN TEHSIL,<1,14063,1941,16004
LAYYAH DISTRICT,KAROR LAL ESAN TEHSIL,1,15060,2012,17072
LAYYAH DISTRICT,KAROR LAL ESAN TEHSIL,2,14857,1939,16796
LAYYAH DISTRICT,KAROR LAL ESAN TEHSIL,3,15880,2096,17976
LAYYAH DISTRICT,KAROR LAL ESAN TEHSIL,4,16198,2059,18257
LAYYAH DISTRICT,KAROR LAL ESAN TEHSIL,5,15734,2087,17821
LAYYAH DISTRICT,KAROR LAL ESAN TEHSIL,6,15124,2005,17129
LAYYAH DISTRICT,KAROR LAL ESAN TEHSIL,7,16341,2161,18502
LAYYAH DISTRICT,KAROR LAL ESAN TEHSIL,8,15163,1981,17144
LAYYAH DISTRICT,KAROR LAL ESAN TEHSIL,9,15368,2169,17537
LAYYAH DISTRICT,KAROR LAL ESAN TEHSIL,10,13766,1713,15479
LAYYAH DISTRICT,KAROR LAL ESAN TEHSIL,11,13817,2227,16044
LAYYAH DISTRICT,KAROR LAL ESAN TEHSIL,12,12466,1715,14181
LAYYAH DISTRICT,KAROR LAL ESAN TEHSIL,13,12077,1998,14075
LAYYAH DISTRICT,KAROR LAL ESAN TEHSIL,14,11615,1769,13384
LAYYAH DISTRICT,KAROR LAL ESAN TEHSIL,15,11275,1703,12978
LAYYAH DISTRICT,KAROR LAL ESAN TEHSIL,16,11014,1816,12830
LAYYAH DISTRICT,KAROR LAL ESAN TEHSIL,17,10925,1849,12774
LAYYAH DISTRICT,KAROR LAL ESAN TEHSIL,18,9960,1534,11494
LAYYAH DISTRICT,KAROR LAL ESAN TEHSIL,19,10300,1880,12180
LAYYAH DISTRICT,KAROR LAL ESAN TEHSIL,20,9353,1317,10670
LAYYAH DISTRICT,KAROR LAL ESAN TEHSIL,21,9810,1669,11479
LAYYAH DISTRICT,KAROR LAL ESAN TEHSIL,22,8686,1331,10017
LAYYAH DISTRICT,KAROR LAL ESAN TEHSIL,23,8656,1493,10149
LAYYAH DISTRICT,KAROR LAL ESAN TEHSIL,24,8156,1408,9564
LAYYAH DISTRICT,KAROR LAL ESAN TEHSIL,25,7405,1156,8561
LAYYAH DISTRICT,KAROR LAL ESAN TEHSIL,26,8276,1374,9650
LAYYAH DISTRICT,KAROR LAL ESAN TEHSIL,27,7793,1344,9137
LAYYAH DISTRICT,KAROR LAL ESAN TEHSIL,28,7207,1164,8371
LAYYAH DISTRICT,KAROR LAL ESAN TEHSIL,29,7909,1387,9296
LAYYAH DISTRICT,KAROR LAL ESAN TEHSIL,30,5926,944,6870
LAYYAH DISTRICT,KAROR LAL ESAN TEHSIL,31,6950,1204,8154
LAYYAH DISTRICT,KAROR LAL ESAN TEHSIL,32,5744,1067,6811
LAYYAH DISTRICT,KAROR LAL ESAN TEHSIL,33,5477,964,6441
LAYYAH DISTRICT,KAROR LAL ESAN TEHSIL,34,6459,1069,7528
LAYYAH DISTRICT,KAROR LAL ESAN TEHSIL,35,5250,755,6005
LAYYAH DISTRICT,KAROR LAL ESAN TEHSIL,36,7483,1143,8626
LAYYAH DISTRICT,KAROR LAL ESAN TEHSIL,37,6448,1084,7532
LAYYAH DISTRICT,KAROR LAL ESAN TEHSIL,38,5183,940,6123
LAYYAH DISTRICT,KAROR LAL ESAN TEHSIL,39,5607,1027,6634
LAYYAH DISTRICT,KAROR LAL ESAN TEHSIL,40,3741,690,4431
LAYYAH DISTRICT,KAROR LAL ESAN TEHSIL,41,5501,922,6423
LAYYAH DISTRICT,KAROR LAL ESAN TEHSIL,42,4446,784,5230
LAYYAH DISTRICT,KAROR LAL ESAN TEHSIL,43,3866,749,4615
LAYYAH DISTRICT,KAROR LAL ESAN TEHSIL,44,4108,744,4852
LAYYAH DISTRICT,KAROR LAL ESAN TEHSIL,45,3245,500,3745
LAYYAH DISTRICT,KAROR LAL ESAN TEHSIL,46,4855,816,5671
LAYYAH DISTRICT,KAROR LAL ESAN TEHSIL,47,4480,706,5186
LAYYAH DISTRICT,KAROR LAL ESAN TEHSIL,48,3953,708,4661
LAYYAH DISTRICT,KAROR LAL ESAN TEHSIL,49,4063,736,4799
LAYYAH DISTRICT,KAROR LAL ESAN TEHSIL,50,3012,516,3528
LAYYAH DISTRICT,KAROR LAL ESAN TEHSIL,51,4370,774,5144
LAYYAH DISTRICT,KAROR LAL ESAN TEHSIL,52,3664,598,4262
LAYYAH DISTRICT,KAROR LAL ESAN TEHSIL,53,3222,568,3790
LAYYAH DISTRICT,KAROR LAL ESAN TEHSIL,54,3041,587,3628
LAYYAH DISTRICT,KAROR LAL ESAN TEHSIL,55,2014,341,2355
LAYYAH DISTRICT,KAROR LAL ESAN TEHSIL,56,2734,543,3277
LAYYAH DISTRICT,KAROR LAL ESAN TEHSIL,57,2244,403,2647
LAYYAH DISTRICT,KAROR LAL ESAN TEHSIL,58,1985,370,2355
LAYYAH DISTRICT,KAROR LAL ESAN TEHSIL,59,2061,362,2423
LAYYAH DISTRICT,KAROR LAL ESAN TEHSIL,60,1643,261,1904
LAYYAH DISTRICT,KAROR LAL ESAN TEHSIL,61,2390,364,2754
LAYYAH DISTRICT,KAROR LAL ESAN TEHSIL,62,1981,361,2342
LAYYAH DISTRICT,KAROR LAL ESAN TEHSIL,63,1837,316,2153
LAYYAH DISTRICT,KAROR LAL ESAN TEHSIL,64,1676,331,2007
LAYYAH DISTRICT,KAROR LAL ESAN TEHSIL,65,1374,196,1570
LAYYAH DISTRICT,KAROR LAL ESAN TEHSIL,66,1828,274,2102
LAYYAH DISTRICT,KAROR LAL ESAN TEHSIL,67,1597,227,1824
LAYYAH DISTRICT,KAROR LAL ESAN TEHSIL,68,1302,183,1485
LAYYAH DISTRICT,KAROR LAL ESAN TEHSIL,69,1302,183,1485
LAYYAH DISTRICT,KAROR LAL ESAN TEHSIL,70,1071,121,1192
LAYYAH DISTRICT,KAROR LAL ESAN TEHSIL,71,1475,183,1658
LAYYAH DISTRICT,KAROR LAL ESAN TEHSIL,72,1271,191,1462
LAYYAH DISTRICT,KAROR LAL ESAN TEHSIL,73,927,148,1075
LAYYAH DISTRICT,KAROR LAL ESAN TEHSIL,74,886,128,1014
LAYYAH DISTRICT,KAROR LAL ESAN TEHSIL,>=75,7094,949,8043
LAYYAH DISTRICT,LAYYAH TEHSIL,<1,22451,4637,27088
LAYYAH DISTRICT,LAYYAH TEHSIL,1,23250,4819,28069
LAYYAH DISTRICT,LAYYAH TEHSIL,2,23740,4745,28485
LAYYAH DISTRICT,LAYYAH TEHSIL,3,24425,5076,29501
LAYYAH DISTRICT,LAYYAH TEHSIL,4,25809,4824,30633
LAYYAH DISTRICT,LAYYAH TEHSIL,5,24384,4959,29343
LAYYAH DISTRICT,LAYYAH TEHSIL,6,23636,4743,28379
LAYYAH DISTRICT,LAYYAH TEHSIL,7,24943,5083,30026
LAYYAH DISTRICT,LAYYAH TEHSIL,8,23344,4643,27987
LAYYAH DISTRICT,LAYYAH TEHSIL,9,24694,5149,29843
LAYYAH DISTRICT,LAYYAH TEHSIL,10,21529,4229,25758
LAYYAH DISTRICT,LAYYAH TEHSIL,11,21738,4914,26652
LAYYAH DISTRICT,LAYYAH TEHSIL,12,19211,4031,23242
LAYYAH DISTRICT,LAYYAH TEHSIL,13,18748,4479,23227
LAYYAH DISTRICT,LAYYAH TEHSIL,14,17777,4158,21935
LAYYAH DISTRICT,LAYYAH TEHSIL,15,17162,4189,21351
LAYYAH DISTRICT,LAYYAH TEHSIL,16,16803,4338,21141
LAYYAH DISTRICT,LAYYAH TEHSIL,17,16381,4462,20843
LAYYAH DISTRICT,LAYYAH TEHSIL,18,15573,3943,19516
LAYYAH DISTRICT,LAYYAH TEHSIL,19,15358,4409,19767
LAYYAH DISTRICT,LAYYAH TEHSIL,20,14353,3634,17987
LAYYAH DISTRICT,LAYYAH TEHSIL,21,14188,4157,18345
LAYYAH DISTRICT,LAYYAH TEHSIL,22,12964,3605,16569
LAYYAH DISTRICT,LAYYAH TEHSIL,23,13362,3719,17081
LAYYAH DISTRICT,LAYYAH TEHSIL,24,12614,3444,16058
LAYYAH DISTRICT,LAYYAH TEHSIL,25,11743,2998,14741
LAYYAH DISTRICT,LAYYAH TEHSIL,26,12437,3356,15793
LAYYAH DISTRICT,LAYYAH TEHSIL,27,11944,3299,15243
LAYYAH DISTRICT,LAYYAH TEHSIL,28,10623,3049,13672
LAYYAH DISTRICT,LAYYAH TEHSIL,29,12005,3203,15208
LAYYAH DISTRICT,LAYYAH TEHSIL,30,9383,2650,12033
LAYYAH DISTRICT,LAYYAH TEHSIL,31,10701,2860,13561
LAYYAH DISTRICT,LAYYAH TEHSIL,32,9385,2922,12307
LAYYAH DISTRICT,LAYYAH TEHSIL,33,8474,2536,11010
LAYYAH DISTRICT,LAYYAH TEHSIL,34,9769,2548,12317
LAYYAH DISTRICT,LAYYAH TEHSIL,35,8481,2316,10797
LAYYAH DISTRICT,LAYYAH TEHSIL,36,10912,2541,13453
LAYYAH DISTRICT,LAYYAH TEHSIL,37,9790,2338,12128
LAYYAH DISTRICT,LAYYAH TEHSIL,38,7766,2456,10222
LAYYAH DISTRICT,LAYYAH TEHSIL,39,8243,2269,10512
LAYYAH DISTRICT,LAYYAH TEHSIL,40,5740,2019,7759
LAYYAH DISTRICT,LAYYAH TEHSIL,41,7758,2127,9885
LAYYAH DISTRICT,LAYYAH TEHSIL,42,6944,1923,8867
LAYYAH DISTRICT,LAYYAH TEHSIL,43,5833,1844,7677
LAYYAH DISTRICT,LAYYAH TEHSIL,44,5997,1777,7774
LAYYAH DISTRICT,LAYYAH TEHSIL,45,4733,1637,6370
LAYYAH DISTRICT,LAYYAH TEHSIL,46,6480,1730,8210
LAYYAH DISTRICT,LAYYAH TEHSIL,47,6323,1636,7959
LAYYAH DISTRICT,LAYYAH TEHSIL,48,5527,1747,7274
LAYYAH DISTRICT,LAYYAH TEHSIL,49,5966,1640,7606
LAYYAH DISTRICT,LAYYAH TEHSIL,50,4613,1546,6159
LAYYAH DISTRICT,LAYYAH TEHSIL,51,5966,1665,7631
LAYYAH DISTRICT,LAYYAH TEHSIL,52,5392,1622,7014
LAYYAH DISTRICT,LAYYAH TEHSIL,53,4952,1422,6374
LAYYAH DISTRICT,LAYYAH TEHSIL,54,4423,1392,5815
LAYYAH DISTRICT,LAYYAH TEHSIL,55,3246,1133,4379
LAYYAH DISTRICT,LAYYAH TEHSIL,56,3755,1133,4888
LAYYAH DISTRICT,LAYYAH TEHSIL,57,3262,940,4202
LAYYAH DISTRICT,LAYYAH TEHSIL,58,2918,928,3846
LAYYAH DISTRICT,LAYYAH TEHSIL,59,3015,974,3989
LAYYAH DISTRICT,LAYYAH TEHSIL,60,2481,763,3244
LAYYAH DISTRICT,LAYYAH TEHSIL,61,3154,892,4046
LAYYAH DISTRICT,LAYYAH TEHSIL,62,2718,745,3463
LAYYAH DISTRICT,LAYYAH TEHSIL,63,2708,862,3570
LAYYAH DISTRICT,LAYYAH TEHSIL,64,2442,709,3151
LAYYAH DISTRICT,LAYYAH TEHSIL,65,2118,617,2735
LAYYAH DISTRICT,LAYYAH TEHSIL,66,2482,562,3044
LAYYAH DISTRICT,LAYYAH TEHSIL,67,2165,481,2646
LAYYAH DISTRICT,LAYYAH TEHSIL,68,1870,525,2395
LAYYAH DISTRICT,LAYYAH TEHSIL,69,1766,440,2206
LAYYAH DISTRICT,LAYYAH TEHSIL,70,1593,448,2041
LAYYAH DISTRICT,LAYYAH TEHSIL,71,1842,446,2288
LAYYAH DISTRICT,LAYYAH TEHSIL,72,1405,350,1755
LAYYAH DISTRICT,LAYYAH TEHSIL,73,1319,400,1719
LAYYAH DISTRICT,LAYYAH TEHSIL,74,1173,314,1487
LAYYAH DISTRICT,LAYYAH TEHSIL,>=75,9440,2357,11797
LODHRAN DISTRICT,DUNYAPUR TEHSIL,<1,11045,1010,12055
LODHRAN DISTRICT,DUNYAPUR TEHSIL,1,12283,1068,13351
LODHRAN DISTRICT,DUNYAPUR TEHSIL,2,12107,1042,13149
LODHRAN DISTRICT,DUNYAPUR TEHSIL,3,12898,1083,13981
LODHRAN DISTRICT,DUNYAPUR TEHSIL,4,13696,1181,14877
LODHRAN DISTRICT,DUNYAPUR TEHSIL,5,13431,1146,14577
LODHRAN DISTRICT,DUNYAPUR TEHSIL,6,12988,1075,14063
LODHRAN DISTRICT,DUNYAPUR TEHSIL,7,13692,1178,14870
LODHRAN DISTRICT,DUNYAPUR TEHSIL,8,13041,1072,14113
LODHRAN DISTRICT,DUNYAPUR TEHSIL,9,13232,1214,14446
LODHRAN DISTRICT,DUNYAPUR TEHSIL,10,12137,1071,13208
LODHRAN DISTRICT,DUNYAPUR TEHSIL,11,11626,1187,12813
LODHRAN DISTRICT,DUNYAPUR TEHSIL,12,10715,933,11648
LODHRAN DISTRICT,DUNYAPUR TEHSIL,13,10217,982,11199
LODHRAN DISTRICT,DUNYAPUR TEHSIL,14,9540,892,10432
LODHRAN DISTRICT,DUNYAPUR TEHSIL,15,9937,917,10854
LODHRAN DISTRICT,DUNYAPUR TEHSIL,16,9289,932,10221
LODHRAN DISTRICT,DUNYAPUR TEHSIL,17,10320,960,11280
LODHRAN DISTRICT,DUNYAPUR TEHSIL,18,8118,687,8805
LODHRAN DISTRICT,DUNYAPUR TEHSIL,19,8273,855,9128
LODHRAN DISTRICT,DUNYAPUR TEHSIL,20,8412,776,9188
LODHRAN DISTRICT,DUNYAPUR TEHSIL,21,8112,870,8982
LODHRAN DISTRICT,DUNYAPUR TEHSIL,22,7725,751,8476
LODHRAN DISTRICT,DUNYAPUR TEHSIL,23,7217,722,7939
LODHRAN DISTRICT,DUNYAPUR TEHSIL,24,6828,703,7531
LODHRAN DISTRICT,DUNYAPUR TEHSIL,25,6742,752,7494
LODHRAN DISTRICT,DUNYAPUR TEHSIL,26,6618,680,7298
LODHRAN DISTRICT,DUNYAPUR TEHSIL,27,6651,717,7368
LODHRAN DISTRICT,DUNYAPUR TEHSIL,28,6741,658,7399
LODHRAN DISTRICT,DUNYAPUR TEHSIL,29,6992,647,7639
LODHRAN DISTRICT,DUNYAPUR TEHSIL,30,6135,602,6737
LODHRAN DISTRICT,DUNYAPUR TEHSIL,31,6450,583,7033
LODHRAN DISTRICT,DUNYAPUR TEHSIL,32,5385,548,5933
LODHRAN DISTRICT,DUNYAPUR TEHSIL,33,5173,543,5716
LODHRAN DISTRICT,DUNYAPUR TEHSIL,34,5893,507,6400
LODHRAN DISTRICT,DUNYAPUR TEHSIL,35,5317,559,5876
LODHRAN DISTRICT,DUNYAPUR TEHSIL,36,6795,585,7380
LODHRAN DISTRICT,DUNYAPUR TEHSIL,37,5657,500,6157
LODHRAN DISTRICT,DUNYAPUR TEHSIL,38,5292,540,5832
LODHRAN DISTRICT,DUNYAPUR TEHSIL,39,5413,537,5950
LODHRAN DISTRICT,DUNYAPUR TEHSIL,40,4105,409,4514
LODHRAN DISTRICT,DUNYAPUR TEHSIL,41,5388,491,5879
LODHRAN DISTRICT,DUNYAPUR TEHSIL,42,4257,391,4648
LODHRAN DISTRICT,DUNYAPUR TEHSIL,43,3845,400,4245
LODHRAN DISTRICT,DUNYAPUR TEHSIL,44,3908,364,4272
LODHRAN DISTRICT,DUNYAPUR TEHSIL,45,3025,308,3333
LODHRAN DISTRICT,DUNYAPUR TEHSIL,46,4531,328,4859
LODHRAN DISTRICT,DUNYAPUR TEHSIL,47,3730,312,4042
LODHRAN DISTRICT,DUNYAPUR TEHSIL,48,3661,303,3964
LODHRAN DISTRICT,DUNYAPUR TEHSIL,49,3685,357,4042
LODHRAN DISTRICT,DUNYAPUR TEHSIL,50,2883,296,3179
LODHRAN DISTRICT,DUNYAPUR TEHSIL,51,4176,328,4504
LODHRAN DISTRICT,DUNYAPUR TEHSIL,52,3316,300,3616
LODHRAN DISTRICT,DUNYAPUR TEHSIL,53,2963,291,3254
LODHRAN DISTRICT,DUNYAPUR TEHSIL,54,2752,245,2997
LODHRAN DISTRICT,DUNYAPUR TEHSIL,55,2162,239,2401
LODHRAN DISTRICT,DUNYAPUR TEHSIL,56,2676,196,2872
LODHRAN DISTRICT,DUNYAPUR TEHSIL,57,2131,154,2285
LODHRAN DISTRICT,DUNYAPUR TEHSIL,58,2025,170,2195
LODHRAN DISTRICT,DUNYAPUR TEHSIL,59,2083,159,2242
LODHRAN DISTRICT,DUNYAPUR TEHSIL,60,1737,177,1914
LODHRAN DISTRICT,DUNYAPUR TEHSIL,61,2331,184,2515
LODHRAN DISTRICT,DUNYAPUR TEHSIL,62,2027,178,2205
LODHRAN DISTRICT,DUNYAPUR TEHSIL,63,1838,152,1990
LODHRAN DISTRICT,DUNYAPUR TEHSIL,64,1818,151,1969
LODHRAN DISTRICT,DUNYAPUR TEHSIL,65,1398,104,1502
LODHRAN DISTRICT,DUNYAPUR TEHSIL,66,1789,128,1917
LODHRAN DISTRICT,DUNYAPUR TEHSIL,67,1470,111,1581
LODHRAN DISTRICT,DUNYAPUR TEHSIL,68,1176,102,1278
LODHRAN DISTRICT,DUNYAPUR TEHSIL,69,1221,92,1313
LODHRAN DISTRICT,DUNYAPUR TEHSIL,70,1030,86,1116
LODHRAN DISTRICT,DUNYAPUR TEHSIL,71,1319,88,1407
LODHRAN DISTRICT,DUNYAPUR TEHSIL,72,1084,94,1178
LODHRAN DISTRICT,DUNYAPUR TEHSIL,73,889,61,950
LODHRAN DISTRICT,DUNYAPUR TEHSIL,74,805,71,876
LODHRAN DISTRICT,DUNYAPUR TEHSIL,>=75,6296,469,6765
LODHRAN DISTRICT,KAHROR PACCA TEHSIL,<1,9399,2371,11770
LODHRAN DISTRICT,KAHROR PACCA TEHSIL,1,10753,2757,13510
LODHRAN DISTRICT,KAHROR PACCA TEHSIL,2,10674,2605,13279
LODHRAN DISTRICT,KAHROR PACCA TEHSIL,3,12059,2805,14864
LODHRAN DISTRICT,KAHROR PACCA TEHSIL,4,12769,2871,15640
LODHRAN DISTRICT,KAHROR PACCA TEHSIL,5,12380,3057,15437
LODHRAN DISTRICT,KAHROR PACCA TEHSIL,6,12165,2815,14980
LODHRAN DISTRICT,KAHROR PACCA TEHSIL,7,12971,3134,16105
LODHRAN DISTRICT,KAHROR PACCA TEHSIL,8,12779,2859,15638
LODHRAN DISTRICT,KAHROR PACCA TEHSIL,9,11985,3058,15043
LODHRAN DISTRICT,KAHROR PACCA TEHSIL,10,11592,2678,14270
LODHRAN DISTRICT,KAHROR PACCA TEHSIL,11,9784,2901,12685
LODHRAN DISTRICT,KAHROR PACCA TEHSIL,12,10029,2631,12660
LODHRAN DISTRICT,KAHROR PACCA TEHSIL,13,8557,2579,11136
LODHRAN DISTRICT,KAHROR PACCA TEHSIL,14,8556,2446,11002
LODHRAN DISTRICT,KAHROR PACCA TEHSIL,15,8043,2295,10338
LODHRAN DISTRICT,KAHROR PACCA TEHSIL,16,7772,2340,10112
LODHRAN DISTRICT,KAHROR PACCA TEHSIL,17,7178,2127,9305
LODHRAN DISTRICT,KAHROR PACCA TEHSIL,18,7903,2164,10067
LODHRAN DISTRICT,KAHROR PACCA TEHSIL,19,6905,2159,9064
LODHRAN DISTRICT,KAHROR PACCA TEHSIL,20,8109,1953,10062
LODHRAN DISTRICT,KAHROR PACCA TEHSIL,21,6347,2089,8436
LODHRAN DISTRICT,KAHROR PACCA TEHSIL,22,6972,1957,8929
LODHRAN DISTRICT,KAHROR PACCA TEHSIL,23,5741,1752,7493
LODHRAN DISTRICT,KAHROR PACCA TEHSIL,24,5390,1777,7167
LODHRAN DISTRICT,KAHROR PACCA TEHSIL,25,6679,1695,8374
LODHRAN DISTRICT,KAHROR PACCA TEHSIL,26,5380,1732,7112
LODHRAN DISTRICT,KAHROR PACCA TEHSIL,27,5230,1611,6841
LODHRAN DISTRICT,KAHROR PACCA TEHSIL,28,5780,1597,7377
LODHRAN DISTRICT,KAHROR PACCA TEHSIL,29,5337,1675,7012
LODHRAN DISTRICT,KAHROR PACCA TEHSIL,30,5762,1557,7319
LODHRAN DISTRICT,KAHROR PACCA TEHSIL,31,5086,1622,6708
LODHRAN DISTRICT,KAHROR PACCA TEHSIL,32,4676,1414,6090
LODHRAN DISTRICT,KAHROR PACCA TEHSIL,33,4565,1451,6016
LODHRAN DISTRICT,KAHROR PACCA TEHSIL,34,4860,1425,6285
LODHRAN DISTRICT,KAHROR PACCA TEHSIL,35,5097,1304,6401
LODHRAN DISTRICT,KAHROR PACCA TEHSIL,36,5745,1504,7249
LODHRAN DISTRICT,KAHROR PACCA TEHSIL,37,4681,1287,5968
LODHRAN DISTRICT,KAHROR PACCA TEHSIL,38,4699,1317,6016
LODHRAN DISTRICT,KAHROR PACCA TEHSIL,39,4493,1277,5770
LODHRAN DISTRICT,KAHROR PACCA TEHSIL,40,4002,1048,5050
LODHRAN DISTRICT,KAHROR PACCA TEHSIL,41,4435,1252,5687
LODHRAN DISTRICT,KAHROR PACCA TEHSIL,42,3564,1049,4613
LODHRAN DISTRICT,KAHROR PACCA TEHSIL,43,3134,934,4068
LODHRAN DISTRICT,KAHROR PACCA TEHSIL,44,3038,946,3984
LODHRAN DISTRICT,KAHROR PACCA TEHSIL,45,3057,832,3889
LODHRAN DISTRICT,KAHROR PACCA TEHSIL,46,3563,867,4430
LODHRAN DISTRICT,KAHROR PACCA TEHSIL,47,2873,816,3689
LODHRAN DISTRICT,KAHROR PACCA TEHSIL,48,2993,893,3886
LODHRAN DISTRICT,KAHROR PACCA TEHSIL,49,2888,893,3781
LODHRAN DISTRICT,KAHROR PACCA TEHSIL,50,2794,727,3521
LODHRAN DISTRICT,KAHROR PACCA TEHSIL,51,3270,917,4187
LODHRAN DISTRICT,KAHROR PACCA TEHSIL,52,2542,791,3333
LODHRAN DISTRICT,KAHROR PACCA TEHSIL,53,2372,707,3079
LODHRAN DISTRICT,KAHROR PACCA TEHSIL,54,2140,578,2718
LODHRAN DISTRICT,KAHROR PACCA TEHSIL,55,2016,555,2571
LODHRAN DISTRICT,KAHROR PACCA TEHSIL,56,2065,596,2661
LODHRAN DISTRICT,KAHROR PACCA TEHSIL,57,1581,448,2029
LODHRAN DISTRICT,KAHROR PACCA TEHSIL,58,1518,449,1967
LODHRAN DISTRICT,KAHROR PACCA TEHSIL,59,1579,429,2008
LODHRAN DISTRICT,KAHROR PACCA TEHSIL,60,1769,381,2150
LODHRAN DISTRICT,KAHROR PACCA TEHSIL,61,1835,487,2322
LODHRAN DISTRICT,KAHROR PACCA TEHSIL,62,1634,432,2066
LODHRAN DISTRICT,KAHROR PACCA TEHSIL,63,1484,417,1901
LODHRAN DISTRICT,KAHROR PACCA TEHSIL,64,1338,401,1739
LODHRAN DISTRICT,KAHROR PACCA TEHSIL,65,1506,325,1831
LODHRAN DISTRICT,KAHROR PACCA TEHSIL,66,1609,354,1963
LODHRAN DISTRICT,KAHROR PACCA TEHSIL,67,1183,303,1486
LODHRAN DISTRICT,KAHROR PACCA TEHSIL,68,1105,264,1369
LODHRAN DISTRICT,KAHROR PACCA TEHSIL,69,973,255,1228
LODHRAN DISTRICT,KAHROR PACCA TEHSIL,70,1070,252,1322
LODHRAN DISTRICT,KAHROR PACCA TEHSIL,71,1072,236,1308
LODHRAN DISTRICT,KAHROR PACCA TEHSIL,72,910,240,1150
LODHRAN DISTRICT,KAHROR PACCA TEHSIL,73,739,173,912
LODHRAN DISTRICT,KAHROR PACCA TEHSIL,74,636,164,800
LODHRAN DISTRICT,KAHROR PACCA TEHSIL,>=75,5509,1226,6735
LODHRAN DISTRICT,LODHRAN TEHSIL,<1,14575,2724,17299
LODHRAN DISTRICT,LODHRAN TEHSIL,1,16979,3289,20268
LODHRAN DISTRICT,LODHRAN TEHSIL,2,16958,2971,19929
LODHRAN DISTRICT,LODHRAN TEHSIL,3,19058,3388,22446
LODHRAN DISTRICT,LODHRAN TEHSIL,4,19789,3318,23107
LODHRAN DISTRICT,LODHRAN TEHSIL,5,19510,3361,22871
LODHRAN DISTRICT,LODHRAN TEHSIL,6,18720,3315,22035
LODHRAN DISTRICT,LODHRAN TEHSIL,7,20244,3522,23766
LODHRAN DISTRICT,LODHRAN TEHSIL,8,19753,3311,23064
LODHRAN DISTRICT,LODHRAN TEHSIL,9,18675,3724,22399
LODHRAN DISTRICT,LODHRAN TEHSIL,10,17253,2931,20184
LODHRAN DISTRICT,LODHRAN TEHSIL,11,15471,3311,18782
LODHRAN DISTRICT,LODHRAN TEHSIL,12,15087,2755,17842
LODHRAN DISTRICT,LODHRAN TEHSIL,13,13531,2947,16478
LODHRAN DISTRICT,LODHRAN TEHSIL,14,13034,2684,15718
LODHRAN DISTRICT,LODHRAN TEHSIL,15,12387,2642,15029
LODHRAN DISTRICT,LODHRAN TEHSIL,16,11746,2476,14222
LODHRAN DISTRICT,LODHRAN TEHSIL,17,12076,3008,15084
LODHRAN DISTRICT,LODHRAN TEHSIL,18,11047,1988,13035
LODHRAN DISTRICT,LODHRAN TEHSIL,19,10566,2430,12996
LODHRAN DISTRICT,LODHRAN TEHSIL,20,10851,2186,13037
LODHRAN DISTRICT,LODHRAN TEHSIL,21,9508,2329,11837
LODHRAN DISTRICT,LODHRAN TEHSIL,22,9716,2143,11859
LODHRAN DISTRICT,LODHRAN TEHSIL,23,8761,1976,10737
LODHRAN DISTRICT,LODHRAN TEHSIL,24,8053,1994,10047
LODHRAN DISTRICT,LODHRAN TEHSIL,25,9096,1854,10950
LODHRAN DISTRICT,LODHRAN TEHSIL,26,7928,1914,9842
LODHRAN DISTRICT,LODHRAN TEHSIL,27,8122,1896,10018
LODHRAN DISTRICT,LODHRAN TEHSIL,28,8474,1815,10289
LODHRAN DISTRICT,LODHRAN TEHSIL,29,8473,1948,10421
LODHRAN DISTRICT,LODHRAN TEHSIL,30,7558,1640,9198
LODHRAN DISTRICT,LODHRAN TEHSIL,31,8095,1800,9895
LODHRAN DISTRICT,LODHRAN TEHSIL,32,6806,1525,8331
LODHRAN DISTRICT,LODHRAN TEHSIL,33,6525,1537,8062
LODHRAN DISTRICT,LODHRAN TEHSIL,34,7288,1528,8816
LODHRAN DISTRICT,LODHRAN TEHSIL,35,6536,1303,7839
LODHRAN DISTRICT,LODHRAN TEHSIL,36,8445,1682,10127
LODHRAN DISTRICT,LODHRAN TEHSIL,37,7165,1371,8536
LODHRAN DISTRICT,LODHRAN TEHSIL,38,6307,1413,7720
LODHRAN DISTRICT,LODHRAN TEHSIL,39,6326,1322,7648
LODHRAN DISTRICT,LODHRAN TEHSIL,40,4970,1177,6147
LODHRAN DISTRICT,LODHRAN TEHSIL,41,6615,1417,8032
LODHRAN DISTRICT,LODHRAN TEHSIL,42,5313,1050,6363
LODHRAN DISTRICT,LODHRAN TEHSIL,43,4393,1048,5441
LODHRAN DISTRICT,LODHRAN TEHSIL,44,4437,976,5413
LODHRAN DISTRICT,LODHRAN TEHSIL,45,3871,918,4789
LODHRAN DISTRICT,LODHRAN TEHSIL,46,5323,1055,6378
LODHRAN DISTRICT,LODHRAN TEHSIL,47,4517,883,5400
LODHRAN DISTRICT,LODHRAN TEHSIL,48,4227,897,5124
LODHRAN DISTRICT,LODHRAN TEHSIL,49,4326,947,5273
LODHRAN DISTRICT,LODHRAN TEHSIL,50,3553,818,4371
LODHRAN DISTRICT,LODHRAN TEHSIL,51,4572,943,5515
LODHRAN DISTRICT,LODHRAN TEHSIL,52,3791,764,4555
LODHRAN DISTRICT,LODHRAN TEHSIL,53,3149,741,3890
LODHRAN DISTRICT,LODHRAN TEHSIL,54,3038,729,3767
LODHRAN DISTRICT,LODHRAN TEHSIL,55,2486,503,2989
LODHRAN DISTRICT,LODHRAN TEHSIL,56,3016,592,3608
LODHRAN DISTRICT,LODHRAN TEHSIL,57,2443,433,2876
LODHRAN DISTRICT,LODHRAN TEHSIL,58,2032,456,2488
LODHRAN DISTRICT,LODHRAN TEHSIL,59,2092,436,2528
LODHRAN DISTRICT,LODHRAN TEHSIL,60,2106,435,2541
LODHRAN DISTRICT,LODHRAN TEHSIL,61,2549,500,3049
LODHRAN DISTRICT,LODHRAN TEHSIL,62,2256,429,2685
LODHRAN DISTRICT,LODHRAN TEHSIL,63,2045,404,2449
LODHRAN DISTRICT,LODHRAN TEHSIL,64,1942,388,2330
LODHRAN DISTRICT,LODHRAN TEHSIL,65,1781,313,2094
LODHRAN DISTRICT,LODHRAN TEHSIL,66,2038,347,2385
LODHRAN DISTRICT,LODHRAN TEHSIL,67,1699,269,1968
LODHRAN DISTRICT,LODHRAN TEHSIL,68,1381,269,1650
LODHRAN DISTRICT,LODHRAN TEHSIL,69,1327,227,1554
LODHRAN DISTRICT,LODHRAN TEHSIL,70,1199,205,1404
LODHRAN DISTRICT,LODHRAN TEHSIL,71,1378,226,1604
LODHRAN DISTRICT,LODHRAN TEHSIL,72,1088,196,1284
LODHRAN DISTRICT,LODHRAN TEHSIL,73,916,180,1096
LODHRAN DISTRICT,LODHRAN TEHSIL,74,796,180,976
LODHRAN DISTRICT,LODHRAN TEHSIL,>=75,6594,1140,7734
LORALAI DISTRICT,DUKI TEHSIL,<1,3619,242,3861
LORALAI DISTRICT,DUKI TEHSIL,1,5390,326,5716
LORALAI DISTRICT,DUKI TEHSIL,2,5912,337,6249
LORALAI DISTRICT,DUKI TEHSIL,3,5774,378,6152
LORALAI DISTRICT,DUKI TEHSIL,4,5716,343,6059
LORALAI DISTRICT,DUKI TEHSIL,5,5584,373,5957
LORALAI DISTRICT,DUKI TEHSIL,6,5494,304,5798
LORALAI DISTRICT,DUKI TEHSIL,7,5316,366,5682
LORALAI DISTRICT,DUKI TEHSIL,8,5382,328,5710
LORALAI DISTRICT,DUKI TEHSIL,9,4747,324,5071
LORALAI DISTRICT,DUKI TEHSIL,10,4548,275,4823
LORALAI DISTRICT,DUKI TEHSIL,11,3725,246,3971
LORALAI DISTRICT,DUKI TEHSIL,12,3393,202,3595
LORALAI DISTRICT,DUKI TEHSIL,13,3212,217,3429
LORALAI DISTRICT,DUKI TEHSIL,14,2921,188,3109
LORALAI DISTRICT,DUKI TEHSIL,15,3037,172,3209
LORALAI DISTRICT,DUKI TEHSIL,16,2540,191,2731
LORALAI DISTRICT,DUKI TEHSIL,17,2336,151,2487
LORALAI DISTRICT,DUKI TEHSIL,18,2828,183,3011
LORALAI DISTRICT,DUKI TEHSIL,19,2599,183,2782
LORALAI DISTRICT,DUKI TEHSIL,20,2674,172,2846
LORALAI DISTRICT,DUKI TEHSIL,21,2415,166,2581
LORALAI DISTRICT,DUKI TEHSIL,22,2096,130,2226
LORALAI DISTRICT,DUKI TEHSIL,23,2137,163,2300
LORALAI DISTRICT,DUKI TEHSIL,24,1921,162,2083
LORALAI DISTRICT,DUKI TEHSIL,25,2596,174,2770
LORALAI DISTRICT,DUKI TEHSIL,26,1835,197,2032
LORALAI DISTRICT,DUKI TEHSIL,27,2466,255,2721
LORALAI DISTRICT,DUKI TEHSIL,28,1948,204,2152
LORALAI DISTRICT,DUKI TEHSIL,29,2224,234,2458
LORALAI DISTRICT,DUKI TEHSIL,30,1933,140,2073
LORALAI DISTRICT,DUKI TEHSIL,31,1886,180,2066
LORALAI DISTRICT,DUKI TEHSIL,32,1792,145,1937
LORALAI DISTRICT,DUKI TEHSIL,33,1459,125,1584
LORALAI DISTRICT,DUKI TEHSIL,34,1228,108,1336
LORALAI DISTRICT,DUKI TEHSIL,35,1501,111,1612
LORALAI DISTRICT,DUKI TEHSIL,36,983,113,1096
LORALAI DISTRICT,DUKI TEHSIL,37,1846,128,1974
LORALAI DISTRICT,DUKI TEHSIL,38,1243,119,1362
LORALAI DISTRICT,DUKI TEHSIL,39,1367,119,1486
LORALAI DISTRICT,DUKI TEHSIL,40,1190,82,1272
LORALAI DISTRICT,DUKI TEHSIL,41,968,113,1081
LORALAI DISTRICT,DUKI TEHSIL,42,1030,75,1105
LORALAI DISTRICT,DUKI TEHSIL,43,860,68,928
LORALAI DISTRICT,DUKI TEHSIL,44,684,59,743
LORALAI DISTRICT,DUKI TEHSIL,45,856,73,929
LORALAI DISTRICT,DUKI TEHSIL,46,614,51,665
LORALAI DISTRICT,DUKI TEHSIL,47,1065,78,1143
LORALAI DISTRICT,DUKI TEHSIL,48,716,69,785
LORALAI DISTRICT,DUKI TEHSIL,49,850,58,908
LORALAI DISTRICT,DUKI TEHSIL,50,754,62,816
LORALAI DISTRICT,DUKI TEHSIL,51,732,66,798
LORALAI DISTRICT,DUKI TEHSIL,52,704,56,760
LORALAI DISTRICT,DUKI TEHSIL,53,531,48,579
LORALAI DISTRICT,DUKI TEHSIL,54,570,38,608
LORALAI DISTRICT,DUKI TEHSIL,55,500,27,527
LORALAI DISTRICT,DUKI TEHSIL,56,430,24,454
LORALAI DISTRICT,DUKI TEHSIL,57,670,32,702
LORALAI DISTRICT,DUKI TEHSIL,58,401,33,434
LORALAI DISTRICT,DUKI TEHSIL,59,592,44,636
LORALAI DISTRICT,DUKI TEHSIL,60,512,30,542
LORALAI DISTRICT,DUKI TEHSIL,61,482,34,516
LORALAI DISTRICT,DUKI TEHSIL,62,485,27,512
LORALAI DISTRICT,DUKI TEHSIL,63,393,34,427
LORALAI DISTRICT,DUKI TEHSIL,64,439,26,465
LORALAI DISTRICT,DUKI TEHSIL,65,371,17,388
LORALAI DISTRICT,DUKI TEHSIL,66,317,27,344
LORALAI DISTRICT,DUKI TEHSIL,67,389,27,416
LORALAI DISTRICT,DUKI TEHSIL,68,276,19,295
LORALAI DISTRICT,DUKI TEHSIL,69,339,24,363
LORALAI DISTRICT,DUKI TEHSIL,70,290,11,301
LORALAI DISTRICT,DUKI TEHSIL,71,283,20,303
LORALAI DISTRICT,DUKI TEHSIL,72,255,14,269
LORALAI DISTRICT,DUKI TEHSIL,73,195,8,203
LORALAI DISTRICT,DUKI TEHSIL,74,236,9,245
LORALAI DISTRICT,DUKI TEHSIL,>=75,1333,85,1418
LORALAI DISTRICT,LORALAI\BORI TEHSIL,<1,3797,1420,5217
LORALAI DISTRICT,LORALAI\BORI TEHSIL,1,5803,1617,7420
LORALAI DISTRICT,LORALAI\BORI TEHSIL,2,5917,1687,7604
LORALAI DISTRICT,LORALAI\BORI TEHSIL,3,5965,1724,7689
LORALAI DISTRICT,LORALAI\BORI TEHSIL,4,5796,1668,7464
LORALAI DISTRICT,LORALAI\BORI TEHSIL,5,5911,1705,7616
LORALAI DISTRICT,LORALAI\BORI TEHSIL,6,5638,1697,7335
LORALAI DISTRICT,LORALAI\BORI TEHSIL,7,5543,1704,7247
LORALAI DISTRICT,LORALAI\BORI TEHSIL,8,5360,1498,6858
LORALAI DISTRICT,LORALAI\BORI TEHSIL,9,5113,1693,6806
LORALAI DISTRICT,LORALAI\BORI TEHSIL,10,4485,1371,5856
LORALAI DISTRICT,LORALAI\BORI TEHSIL,11,4215,1429,5644
LORALAI DISTRICT,LORALAI\BORI TEHSIL,12,3683,1273,4956
LORALAI DISTRICT,LORALAI\BORI TEHSIL,13,3653,1392,5045
LORALAI DISTRICT,LORALAI\BORI TEHSIL,14,3281,1181,4462
LORALAI DISTRICT,LORALAI\BORI TEHSIL,15,3437,1174,4611
LORALAI DISTRICT,LORALAI\BORI TEHSIL,16,2974,1167,4141
LORALAI DISTRICT,LORALAI\BORI TEHSIL,17,2766,1133,3899
LORALAI DISTRICT,LORALAI\BORI TEHSIL,18,3003,1308,4311
LORALAI DISTRICT,LORALAI\BORI TEHSIL,19,2784,1711,4495
LORALAI DISTRICT,LORALAI\BORI TEHSIL,20,2824,1372,4196
LORALAI DISTRICT,LORALAI\BORI TEHSIL,21,2399,1532,3931
LORALAI DISTRICT,LORALAI\BORI TEHSIL,22,2134,1295,3429
LORALAI DISTRICT,LORALAI\BORI TEHSIL,23,2083,1176,3259
LORALAI DISTRICT,LORALAI\BORI TEHSIL,24,1805,890,2695
LORALAI DISTRICT,LORALAI\BORI TEHSIL,25,2522,896,3418
LORALAI DISTRICT,LORALAI\BORI TEHSIL,26,1826,853,2679
LORALAI DISTRICT,LORALAI\BORI TEHSIL,27,2192,924,3116
LORALAI DISTRICT,LORALAI\BORI TEHSIL,28,1812,855,2667
LORALAI DISTRICT,LORALAI\BORI TEHSIL,29,2091,913,3004
LORALAI DISTRICT,LORALAI\BORI TEHSIL,30,1929,722,2651
LORALAI DISTRICT,LORALAI\BORI TEHSIL,31,1964,813,2777
LORALAI DISTRICT,LORALAI\BORI TEHSIL,32,1580,749,2329
LORALAI DISTRICT,LORALAI\BORI TEHSIL,33,1665,641,2306
LORALAI DISTRICT,LORALAI\BORI TEHSIL,34,1262,618,1880
LORALAI DISTRICT,LORALAI\BORI TEHSIL,35,1592,538,2130
LORALAI DISTRICT,LORALAI\BORI TEHSIL,36,1084,484,1568
LORALAI DISTRICT,LORALAI\BORI TEHSIL,37,1548,610,2158
LORALAI DISTRICT,LORALAI\BORI TEHSIL,38,1324,556,1880
LORALAI DISTRICT,LORALAI\BORI TEHSIL,39,1413,552,1965
LORALAI DISTRICT,LORALAI\BORI TEHSIL,40,1294,452,1746
LORALAI DISTRICT,LORALAI\BORI TEHSIL,41,1089,465,1554
LORALAI DISTRICT,LORALAI\BORI TEHSIL,42,953,399,1352
LORALAI DISTRICT,LORALAI\BORI TEHSIL,43,874,408,1282
LORALAI DISTRICT,LORALAI\BORI TEHSIL,44,772,355,1127
LORALAI DISTRICT,LORALAI\BORI TEHSIL,45,1050,342,1392
LORALAI DISTRICT,LORALAI\BORI TEHSIL,46,827,318,1145
LORALAI DISTRICT,LORALAI\BORI TEHSIL,47,1110,361,1471
LORALAI DISTRICT,LORALAI\BORI TEHSIL,48,724,338,1062
LORALAI DISTRICT,LORALAI\BORI TEHSIL,49,887,352,1239
LORALAI DISTRICT,LORALAI\BORI TEHSIL,50,856,285,1141
LORALAI DISTRICT,LORALAI\BORI TEHSIL,51,777,344,1121
LORALAI DISTRICT,LORALAI\BORI TEHSIL,52,710,257,967
LORALAI DISTRICT,LORALAI\BORI TEHSIL,53,653,262,915
LORALAI DISTRICT,LORALAI\BORI TEHSIL,54,503,244,747
LORALAI DISTRICT,LORALAI\BORI TEHSIL,55,571,202,773
LORALAI DISTRICT,LORALAI\BORI TEHSIL,56,483,189,672
LORALAI DISTRICT,LORALAI\BORI TEHSIL,57,589,218,807
LORALAI DISTRICT,LORALAI\BORI TEHSIL,58,467,162,629
LORALAI DISTRICT,LORALAI\BORI TEHSIL,59,524,217,741
LORALAI DISTRICT,LORALAI\BORI TEHSIL,60,536,141,677
LORALAI DISTRICT,LORALAI\BORI TEHSIL,61,466,188,654
LORALAI DISTRICT,LORALAI\BORI TEHSIL,62,404,158,562
LORALAI DISTRICT,LORALAI\BORI TEHSIL,63,436,154,590
LORALAI DISTRICT,LORALAI\BORI TEHSIL,64,428,138,566
LORALAI DISTRICT,LORALAI\BORI TEHSIL,65,391,106,497
LORALAI DISTRICT,LORALAI\BORI TEHSIL,66,363,139,502
LORALAI DISTRICT,LORALAI\BORI TEHSIL,67,427,117,544
LORALAI DISTRICT,LORALAI\BORI TEHSIL,68,325,83,408
LORALAI DISTRICT,LORALAI\BORI TEHSIL,69,378,115,493
LORALAI DISTRICT,LORALAI\BORI TEHSIL,70,244,75,319
LORALAI DISTRICT,LORALAI\BORI TEHSIL,71,288,88,376
LORALAI DISTRICT,LORALAI\BORI TEHSIL,72,219,69,288
LORALAI DISTRICT,LORALAI\BORI TEHSIL,73,203,71,274
LORALAI DISTRICT,LORALAI\BORI TEHSIL,74,232,65,297
LORALAI DISTRICT,LORALAI\BORI TEHSIL,>=75,1504,431,1935
LORALAI DISTRICT,MEKHTAR SUB-TEHSIL,<1,1250,0,1250
LORALAI DISTRICT,MEKHTAR SUB-TEHSIL,1,1557,0,1557
LORALAI DISTRICT,MEKHTAR SUB-TEHSIL,2,1813,0,1813
LORALAI DISTRICT,MEKHTAR SUB-TEHSIL,3,1709,0,1709
LORALAI DISTRICT,MEKHTAR SUB-TEHSIL,4,1865,0,1865
LORALAI DISTRICT,MEKHTAR SUB-TEHSIL,5,1781,0,1781
LORALAI DISTRICT,MEKHTAR SUB-TEHSIL,6,1757,0,1757
LORALAI DISTRICT,MEKHTAR SUB-TEHSIL,7,1734,0,1734
LORALAI DISTRICT,MEKHTAR SUB-TEHSIL,8,1670,0,1670
LORALAI DISTRICT,MEKHTAR SUB-TEHSIL,9,1400,0,1400
LORALAI DISTRICT,MEKHTAR SUB-TEHSIL,10,1348,0,1348
LORALAI DISTRICT,MEKHTAR SUB-TEHSIL,11,981,0,981
LORALAI DISTRICT,MEKHTAR SUB-TEHSIL,12,979,0,979
LORALAI DISTRICT,MEKHTAR SUB-TEHSIL,13,817,0,817
LORALAI DISTRICT,MEKHTAR SUB-TEHSIL,14,771,0,771
LORALAI DISTRICT,MEKHTAR SUB-TEHSIL,15,776,0,776
LORALAI DISTRICT,MEKHTAR SUB-TEHSIL,16,641,0,641
LORALAI DISTRICT,MEKHTAR SUB-TEHSIL,17,696,0,696
LORALAI DISTRICT,MEKHTAR SUB-TEHSIL,18,674,0,674
LORALAI DISTRICT,MEKHTAR SUB-TEHSIL,19,602,0,602
LORALAI DISTRICT,MEKHTAR SUB-TEHSIL,20,742,0,742
LORALAI DISTRICT,MEKHTAR SUB-TEHSIL,21,564,0,564
LORALAI DISTRICT,MEKHTAR SUB-TEHSIL,22,471,0,471
LORALAI DISTRICT,MEKHTAR SUB-TEHSIL,23,442,0,442
LORALAI DISTRICT,MEKHTAR SUB-TEHSIL,24,432,0,432
LORALAI DISTRICT,MEKHTAR SUB-TEHSIL,25,666,0,666
LORALAI DISTRICT,MEKHTAR SUB-TEHSIL,26,506,0,506
LORALAI DISTRICT,MEKHTAR SUB-TEHSIL,27,639,0,639
LORALAI DISTRICT,MEKHTAR SUB-TEHSIL,28,537,0,537
LORALAI DISTRICT,MEKHTAR SUB-TEHSIL,29,528,0,528
LORALAI DISTRICT,MEKHTAR SUB-TEHSIL,30,564,0,564
LORALAI DISTRICT,MEKHTAR SUB-TEHSIL,31,708,0,708
LORALAI DISTRICT,MEKHTAR SUB-TEHSIL,32,482,0,482
LORALAI DISTRICT,MEKHTAR SUB-TEHSIL,33,414,0,414
LORALAI DISTRICT,MEKHTAR SUB-TEHSIL,34,328,0,328
LORALAI DISTRICT,MEKHTAR SUB-TEHSIL,35,356,0,356
LORALAI DISTRICT,MEKHTAR SUB-TEHSIL,36,342,0,342
LORALAI DISTRICT,MEKHTAR SUB-TEHSIL,37,506,0,506
LORALAI DISTRICT,MEKHTAR SUB-TEHSIL,38,312,0,312
LORALAI DISTRICT,MEKHTAR SUB-TEHSIL,39,372,0,372
LORALAI DISTRICT,MEKHTAR SUB-TEHSIL,40,262,0,262
LORALAI DISTRICT,MEKHTAR SUB-TEHSIL,41,334,0,334
LORALAI DISTRICT,MEKHTAR SUB-TEHSIL,42,268,0,268
LORALAI DISTRICT,MEKHTAR SUB-TEHSIL,43,238,0,238
LORALAI DISTRICT,MEKHTAR SUB-TEHSIL,44,220,0,220
LORALAI DISTRICT,MEKHTAR SUB-TEHSIL,45,249,0,249
LORALAI DISTRICT,MEKHTAR SUB-TEHSIL,46,254,0,254
LORALAI DISTRICT,MEKHTAR SUB-TEHSIL,47,365,0,365
LORALAI DISTRICT,MEKHTAR SUB-TEHSIL,48,189,0,189
LORALAI DISTRICT,MEKHTAR SUB-TEHSIL,49,262,0,262
LORALAI DISTRICT,MEKHTAR SUB-TEHSIL,50,177,0,177
LORALAI DISTRICT,MEKHTAR SUB-TEHSIL,51,187,0,187
LORALAI DISTRICT,MEKHTAR SUB-TEHSIL,52,205,0,205
LORALAI DISTRICT,MEKHTAR SUB-TEHSIL,53,161,0,161
LORALAI DISTRICT,MEKHTAR SUB-TEHSIL,54,123,0,123
LORALAI DISTRICT,MEKHTAR SUB-TEHSIL,55,109,0,109
LORALAI DISTRICT,MEKHTAR SUB-TEHSIL,56,140,0,140
LORALAI DISTRICT,MEKHTAR SUB-TEHSIL,57,194,0,194
LORALAI DISTRICT,MEKHTAR SUB-TEHSIL,58,145,0,145
LORALAI DISTRICT,MEKHTAR SUB-TEHSIL,59,202,0,202
LORALAI DISTRICT,MEKHTAR SUB-TEHSIL,60,88,0,88
LORALAI DISTRICT,MEKHTAR SUB-TEHSIL,61,152,0,152
LORALAI DISTRICT,MEKHTAR SUB-TEHSIL,62,92,0,92
LORALAI DISTRICT,MEKHTAR SUB-TEHSIL,63,94,0,94
LORALAI DISTRICT,MEKHTAR SUB-TEHSIL,64,154,0,154
LORALAI DISTRICT,MEKHTAR SUB-TEHSIL,65,80,0,80
LORALAI DISTRICT,MEKHTAR SUB-TEHSIL,66,96,0,96
LORALAI DISTRICT,MEKHTAR SUB-TEHSIL,67,128,0,128
LORALAI DISTRICT,MEKHTAR SUB-TEHSIL,68,82,0,82
LORALAI DISTRICT,MEKHTAR SUB-TEHSIL,69,127,0,127
LORALAI DISTRICT,MEKHTAR SUB-TEHSIL,70,57,0,57
LORALAI DISTRICT,MEKHTAR SUB-TEHSIL,71,90,0,90
LORALAI DISTRICT,MEKHTAR SUB-TEHSIL,72,54,0,54
LORALAI DISTRICT,MEKHTAR SUB-TEHSIL,73,53,0,53
LORALAI DISTRICT,MEKHTAR SUB-TEHSIL,74,70,0,70
LORALAI DISTRICT,MEKHTAR SUB-TEHSIL,>=75,434,0,434
LOWER DIR DISTRICT,ADENZAI SUB-DIVISION,<1,8806,0,8806
LOWER DIR DISTRICT,ADENZAI SUB-DIVISION,1,9771,0,9771
LOWER DIR DISTRICT,ADENZAI SUB-DIVISION,2,10569,0,10569
LOWER DIR DISTRICT,ADENZAI SUB-DIVISION,3,10989,0,10989
LOWER DIR DISTRICT,ADENZAI SUB-DIVISION,4,11215,0,11215
LOWER DIR DISTRICT,ADENZAI SUB-DIVISION,5,10199,0,10199
LOWER DIR DISTRICT,ADENZAI SUB-DIVISION,6,10014,0,10014
LOWER DIR DISTRICT,ADENZAI SUB-DIVISION,7,10523,0,10523
LOWER DIR DISTRICT,ADENZAI SUB-DIVISION,8,10137,0,10137
LOWER DIR DISTRICT,ADENZAI SUB-DIVISION,9,10364,0,10364
LOWER DIR DISTRICT,ADENZAI SUB-DIVISION,10,9067,0,9067
LOWER DIR DISTRICT,ADENZAI SUB-DIVISION,11,9319,0,9319
LOWER DIR DISTRICT,ADENZAI SUB-DIVISION,12,8085,0,8085
LOWER DIR DISTRICT,ADENZAI SUB-DIVISION,13,8555,0,8555
LOWER DIR DISTRICT,ADENZAI SUB-DIVISION,14,7964,0,7964
LOWER DIR DISTRICT,ADENZAI SUB-DIVISION,15,7877,0,7877
LOWER DIR DISTRICT,ADENZAI SUB-DIVISION,16,7044,0,7044
LOWER DIR DISTRICT,ADENZAI SUB-DIVISION,17,7004,0,7004
LOWER DIR DISTRICT,ADENZAI SUB-DIVISION,18,6531,0,6531
LOWER DIR DISTRICT,ADENZAI SUB-DIVISION,19,6353,0,6353
LOWER DIR DISTRICT,ADENZAI SUB-DIVISION,20,6499,0,6499
LOWER DIR DISTRICT,ADENZAI SUB-DIVISION,21,5677,0,5677
LOWER DIR DISTRICT,ADENZAI SUB-DIVISION,22,5531,0,5531
LOWER DIR DISTRICT,ADENZAI SUB-DIVISION,23,5374,0,5374
LOWER DIR DISTRICT,ADENZAI SUB-DIVISION,24,4772,0,4772
LOWER DIR DISTRICT,ADENZAI SUB-DIVISION,25,5347,0,5347
LOWER DIR DISTRICT,ADENZAI SUB-DIVISION,26,4785,0,4785
LOWER DIR DISTRICT,ADENZAI SUB-DIVISION,27,4681,0,4681
LOWER DIR DISTRICT,ADENZAI SUB-DIVISION,28,4692,0,4692
LOWER DIR DISTRICT,ADENZAI SUB-DIVISION,29,4493,0,4493
LOWER DIR DISTRICT,ADENZAI SUB-DIVISION,30,4427,0,4427
LOWER DIR DISTRICT,ADENZAI SUB-DIVISION,31,4115,0,4115
LOWER DIR DISTRICT,ADENZAI SUB-DIVISION,32,3830,0,3830
LOWER DIR DISTRICT,ADENZAI SUB-DIVISION,33,3746,0,3746
LOWER DIR DISTRICT,ADENZAI SUB-DIVISION,34,3138,0,3138
LOWER DIR DISTRICT,ADENZAI SUB-DIVISION,35,3325,0,3325
LOWER DIR DISTRICT,ADENZAI SUB-DIVISION,36,2841,0,2841
LOWER DIR DISTRICT,ADENZAI SUB-DIVISION,37,3125,0,3125
LOWER DIR DISTRICT,ADENZAI SUB-DIVISION,38,2963,0,2963
LOWER DIR DISTRICT,ADENZAI SUB-DIVISION,39,2869,0,2869
LOWER DIR DISTRICT,ADENZAI SUB-DIVISION,40,2805,0,2805
LOWER DIR DISTRICT,ADENZAI SUB-DIVISION,41,2490,0,2490
LOWER DIR DISTRICT,ADENZAI SUB-DIVISION,42,2283,0,2283
LOWER DIR DISTRICT,ADENZAI SUB-DIVISION,43,2346,0,2346
LOWER DIR DISTRICT,ADENZAI SUB-DIVISION,44,1975,0,1975
LOWER DIR DISTRICT,ADENZAI SUB-DIVISION,45,2114,0,2114
LOWER DIR DISTRICT,ADENZAI SUB-DIVISION,46,1794,0,1794
LOWER DIR DISTRICT,ADENZAI SUB-DIVISION,47,1991,0,1991
LOWER DIR DISTRICT,ADENZAI SUB-DIVISION,48,1785,0,1785
LOWER DIR DISTRICT,ADENZAI SUB-DIVISION,49,1743,0,1743
LOWER DIR DISTRICT,ADENZAI SUB-DIVISION,50,1989,0,1989
LOWER DIR DISTRICT,ADENZAI SUB-DIVISION,51,1614,0,1614
LOWER DIR DISTRICT,ADENZAI SUB-DIVISION,52,1428,0,1428
LOWER DIR DISTRICT,ADENZAI SUB-DIVISION,53,1421,0,1421
LOWER DIR DISTRICT,ADENZAI SUB-DIVISION,54,1321,0,1321
LOWER DIR DISTRICT,ADENZAI SUB-DIVISION,55,1471,0,1471
LOWER DIR DISTRICT,ADENZAI SUB-DIVISION,56,1180,0,1180
LOWER DIR DISTRICT,ADENZAI SUB-DIVISION,57,1199,0,1199
LOWER DIR DISTRICT,ADENZAI SUB-DIVISION,58,1305,0,1305
LOWER DIR DISTRICT,ADENZAI SUB-DIVISION,59,1266,0,1266
LOWER DIR DISTRICT,ADENZAI SUB-DIVISION,60,1358,0,1358
LOWER DIR DISTRICT,ADENZAI SUB-DIVISION,61,1217,0,1217
LOWER DIR DISTRICT,ADENZAI SUB-DIVISION,62,1048,0,1048
LOWER DIR DISTRICT,ADENZAI SUB-DIVISION,63,979,0,979
LOWER DIR DISTRICT,ADENZAI SUB-DIVISION,64,927,0,927
LOWER DIR DISTRICT,ADENZAI SUB-DIVISION,65,901,0,901
LOWER DIR DISTRICT,ADENZAI SUB-DIVISION,66,787,0,787
LOWER DIR DISTRICT,ADENZAI SUB-DIVISION,67,755,0,755
LOWER DIR DISTRICT,ADENZAI SUB-DIVISION,68,621,0,621
LOWER DIR DISTRICT,ADENZAI SUB-DIVISION,69,669,0,669
LOWER DIR DISTRICT,ADENZAI SUB-DIVISION,70,734,0,734
LOWER DIR DISTRICT,ADENZAI SUB-DIVISION,71,669,0,669
LOWER DIR DISTRICT,ADENZAI SUB-DIVISION,72,504,0,504
LOWER DIR DISTRICT,ADENZAI SUB-DIVISION,73,416,0,416
LOWER DIR DISTRICT,ADENZAI SUB-DIVISION,74,418,0,418
LOWER DIR DISTRICT,ADENZAI SUB-DIVISION,>=75,3387,0,3387
LOWER DIR DISTRICT,LAL QILA SUB-DIVISION,<1,6133,0,6133
LOWER DIR DISTRICT,LAL QILA SUB-DIVISION,1,7154,0,7154
LOWER DIR DISTRICT,LAL QILA SUB-DIVISION,2,7784,0,7784
LOWER DIR DISTRICT,LAL QILA SUB-DIVISION,3,8479,0,8479
LOWER DIR DISTRICT,LAL QILA SUB-DIVISION,4,9007,0,9007
LOWER DIR DISTRICT,LAL QILA SUB-DIVISION,5,7983,0,7983
LOWER DIR DISTRICT,LAL QILA SUB-DIVISION,6,7471,0,7471
LOWER DIR DISTRICT,LAL QILA SUB-DIVISION,7,7422,0,7422
LOWER DIR DISTRICT,LAL QILA SUB-DIVISION,8,7803,0,7803
LOWER DIR DISTRICT,LAL QILA SUB-DIVISION,9,8008,0,8008
LOWER DIR DISTRICT,LAL QILA SUB-DIVISION,10,6738,0,6738
LOWER DIR DISTRICT,LAL QILA SUB-DIVISION,11,6483,0,6483
LOWER DIR DISTRICT,LAL QILA SUB-DIVISION,12,5984,0,5984
LOWER DIR DISTRICT,LAL QILA SUB-DIVISION,13,5849,0,5849
LOWER DIR DISTRICT,LAL QILA SUB-DIVISION,14,5644,0,5644
LOWER DIR DISTRICT,LAL QILA SUB-DIVISION,15,5623,0,5623
LOWER DIR DISTRICT,LAL QILA SUB-DIVISION,16,5086,0,5086
LOWER DIR DISTRICT,LAL QILA SUB-DIVISION,17,4556,0,4556
LOWER DIR DISTRICT,LAL QILA SUB-DIVISION,18,4496,0,4496
LOWER DIR DISTRICT,LAL QILA SUB-DIVISION,19,4012,0,4012
LOWER DIR DISTRICT,LAL QILA SUB-DIVISION,20,4301,0,4301
LOWER DIR DISTRICT,LAL QILA SUB-DIVISION,21,3332,0,3332
LOWER DIR DISTRICT,LAL QILA SUB-DIVISION,22,3895,0,3895
LOWER DIR DISTRICT,LAL QILA SUB-DIVISION,23,3269,0,3269
LOWER DIR DISTRICT,LAL QILA SUB-DIVISION,24,3091,0,3091
LOWER DIR DISTRICT,LAL QILA SUB-DIVISION,25,3404,0,3404
LOWER DIR DISTRICT,LAL QILA SUB-DIVISION,26,3016,0,3016
LOWER DIR DISTRICT,LAL QILA SUB-DIVISION,27,2876,0,2876
LOWER DIR DISTRICT,LAL QILA SUB-DIVISION,28,2708,0,2708
LOWER DIR DISTRICT,LAL QILA SUB-DIVISION,29,2797,0,2797
LOWER DIR DISTRICT,LAL QILA SUB-DIVISION,30,2548,0,2548
LOWER DIR DISTRICT,LAL QILA SUB-DIVISION,31,2465,0,2465
LOWER DIR DISTRICT,LAL QILA SUB-DIVISION,32,2167,0,2167
LOWER DIR DISTRICT,LAL QILA SUB-DIVISION,33,2264,0,2264
LOWER DIR DISTRICT,LAL QILA SUB-DIVISION,34,1825,0,1825
LOWER DIR DISTRICT,LAL QILA SUB-DIVISION,35,1801,0,1801
LOWER DIR DISTRICT,LAL QILA SUB-DIVISION,36,1758,0,1758
LOWER DIR DISTRICT,LAL QILA SUB-DIVISION,37,2048,0,2048
LOWER DIR DISTRICT,LAL QILA SUB-DIVISION,38,1720,0,1720
LOWER DIR DISTRICT,LAL QILA SUB-DIVISION,39,1723,0,1723
LOWER DIR DISTRICT,LAL QILA SUB-DIVISION,40,1708,0,1708
LOWER DIR DISTRICT,LAL QILA SUB-DIVISION,41,1665,0,1665
LOWER DIR DISTRICT,LAL QILA SUB-DIVISION,42,1650,0,1650
LOWER DIR DISTRICT,LAL QILA SUB-DIVISION,43,1336,0,1336
LOWER DIR DISTRICT,LAL QILA SUB-DIVISION,44,1292,0,1292
LOWER DIR DISTRICT,LAL QILA SUB-DIVISION,45,1142,0,1142
LOWER DIR DISTRICT,LAL QILA SUB-DIVISION,46,1124,0,1124
LOWER DIR DISTRICT,LAL QILA SUB-DIVISION,47,1345,0,1345
LOWER DIR DISTRICT,LAL QILA SUB-DIVISION,48,1114,0,1114
LOWER DIR DISTRICT,LAL QILA SUB-DIVISION,49,1059,0,1059
LOWER DIR DISTRICT,LAL QILA SUB-DIVISION,50,1151,0,1151
LOWER DIR DISTRICT,LAL QILA SUB-DIVISION,51,1025,0,1025
LOWER DIR DISTRICT,LAL QILA SUB-DIVISION,52,917,0,917
LOWER DIR DISTRICT,LAL QILA SUB-DIVISION,53,806,0,806
LOWER DIR DISTRICT,LAL QILA SUB-DIVISION,54,791,0,791
LOWER DIR DISTRICT,LAL QILA SUB-DIVISION,55,896,0,896
LOWER DIR DISTRICT,LAL QILA SUB-DIVISION,56,752,0,752
LOWER DIR DISTRICT,LAL QILA SUB-DIVISION,57,868,0,868
LOWER DIR DISTRICT,LAL QILA SUB-DIVISION,58,754,0,754
LOWER DIR DISTRICT,LAL QILA SUB-DIVISION,59,939,0,939
LOWER DIR DISTRICT,LAL QILA SUB-DIVISION,60,995,0,995
LOWER DIR DISTRICT,LAL QILA SUB-DIVISION,61,908,0,908
LOWER DIR DISTRICT,LAL QILA SUB-DIVISION,62,827,0,827
LOWER DIR DISTRICT,LAL QILA SUB-DIVISION,63,758,0,758
LOWER DIR DISTRICT,LAL QILA SUB-DIVISION,64,750,0,750
LOWER DIR DISTRICT,LAL QILA SUB-DIVISION,65,643,0,643
LOWER DIR DISTRICT,LAL QILA SUB-DIVISION,66,700,0,700
LOWER DIR DISTRICT,LAL QILA SUB-DIVISION,67,765,0,765
LOWER DIR DISTRICT,LAL QILA SUB-DIVISION,68,505,0,505
LOWER DIR DISTRICT,LAL QILA SUB-DIVISION,69,579,0,579
LOWER DIR DISTRICT,LAL QILA SUB-DIVISION,70,538,0,538
LOWER DIR DISTRICT,LAL QILA SUB-DIVISION,71,522,0,522
LOWER DIR DISTRICT,LAL QILA SUB-DIVISION,72,430,0,430
LOWER DIR DISTRICT,LAL QILA SUB-DIVISION,73,320,0,320
LOWER DIR DISTRICT,LAL QILA SUB-DIVISION,74,379,0,379
LOWER DIR DISTRICT,LAL QILA SUB-DIVISION,>=75,2891,0,2891
LOWER DIR DISTRICT,SAMARBAGH SUB-DIVISION,<1,10856,0,10856
LOWER DIR DISTRICT,SAMARBAGH SUB-DIVISION,1,11369,0,11369
LOWER DIR DISTRICT,SAMARBAGH SUB-DIVISION,2,13126,0,13126
LOWER DIR DISTRICT,SAMARBAGH SUB-DIVISION,3,13296,0,13296
LOWER DIR DISTRICT,SAMARBAGH SUB-DIVISION,4,14424,0,14424
LOWER DIR DISTRICT,SAMARBAGH SUB-DIVISION,5,12923,0,12923
LOWER DIR DISTRICT,SAMARBAGH SUB-DIVISION,6,13281,0,13281
LOWER DIR DISTRICT,SAMARBAGH SUB-DIVISION,7,13088,0,13088
LOWER DIR DISTRICT,SAMARBAGH SUB-DIVISION,8,13314,0,13314
LOWER DIR DISTRICT,SAMARBAGH SUB-DIVISION,9,12829,0,12829
LOWER DIR DISTRICT,SAMARBAGH SUB-DIVISION,10,11527,0,11527
LOWER DIR DISTRICT,SAMARBAGH SUB-DIVISION,11,10700,0,10700
LOWER DIR DISTRICT,SAMARBAGH SUB-DIVISION,12,10066,0,10066
LOWER DIR DISTRICT,SAMARBAGH SUB-DIVISION,13,9428,0,9428
LOWER DIR DISTRICT,SAMARBAGH SUB-DIVISION,14,9243,0,9243
LOWER DIR DISTRICT,SAMARBAGH SUB-DIVISION,15,8922,0,8922
LOWER DIR DISTRICT,SAMARBAGH SUB-DIVISION,16,8067,0,8067
LOWER DIR DISTRICT,SAMARBAGH SUB-DIVISION,17,7487,0,7487
LOWER DIR DISTRICT,SAMARBAGH SUB-DIVISION,18,7720,0,7720
LOWER DIR DISTRICT,SAMARBAGH SUB-DIVISION,19,6676,0,6676
LOWER DIR DISTRICT,SAMARBAGH SUB-DIVISION,20,7500,0,7500
LOWER DIR DISTRICT,SAMARBAGH SUB-DIVISION,21,6297,0,6297
LOWER DIR DISTRICT,SAMARBAGH SUB-DIVISION,22,6460,0,6460
LOWER DIR DISTRICT,SAMARBAGH SUB-DIVISION,23,6570,0,6570
LOWER DIR DISTRICT,SAMARBAGH SUB-DIVISION,24,5809,0,5809
LOWER DIR DISTRICT,SAMARBAGH SUB-DIVISION,25,6111,0,6111
LOWER DIR DISTRICT,SAMARBAGH SUB-DIVISION,26,5376,0,5376
LOWER DIR DISTRICT,SAMARBAGH SUB-DIVISION,27,5519,0,5519
LOWER DIR DISTRICT,SAMARBAGH SUB-DIVISION,28,5371,0,5371
LOWER DIR DISTRICT,SAMARBAGH SUB-DIVISION,29,5426,0,5426
LOWER DIR DISTRICT,SAMARBAGH SUB-DIVISION,30,5267,0,5267
LOWER DIR DISTRICT,SAMARBAGH SUB-DIVISION,31,4951,0,4951
LOWER DIR DISTRICT,SAMARBAGH SUB-DIVISION,32,4154,0,4154
LOWER DIR DISTRICT,SAMARBAGH SUB-DIVISION,33,4169,0,4169
LOWER DIR DISTRICT,SAMARBAGH SUB-DIVISION,34,3652,0,3652
LOWER DIR DISTRICT,SAMARBAGH SUB-DIVISION,35,3644,0,3644
LOWER DIR DISTRICT,SAMARBAGH SUB-DIVISION,36,3390,0,3390
LOWER DIR DISTRICT,SAMARBAGH SUB-DIVISION,37,3611,0,3611
LOWER DIR DISTRICT,SAMARBAGH SUB-DIVISION,38,3300,0,3300
LOWER DIR DISTRICT,SAMARBAGH SUB-DIVISION,39,3101,0,3101
LOWER DIR DISTRICT,SAMARBAGH SUB-DIVISION,40,3413,0,3413
LOWER DIR DISTRICT,SAMARBAGH SUB-DIVISION,41,3192,0,3192
LOWER DIR DISTRICT,SAMARBAGH SUB-DIVISION,42,2900,0,2900
LOWER DIR DISTRICT,SAMARBAGH SUB-DIVISION,43,2801,0,2801
LOWER DIR DISTRICT,SAMARBAGH SUB-DIVISION,44,2646,0,2646
LOWER DIR DISTRICT,SAMARBAGH SUB-DIVISION,45,2429,0,2429
LOWER DIR DISTRICT,SAMARBAGH SUB-DIVISION,46,2203,0,2203
LOWER DIR DISTRICT,SAMARBAGH SUB-DIVISION,47,2348,0,2348
LOWER DIR DISTRICT,SAMARBAGH SUB-DIVISION,48,2165,0,2165
LOWER DIR DISTRICT,SAMARBAGH SUB-DIVISION,49,2027,0,2027
LOWER DIR DISTRICT,SAMARBAGH SUB-DIVISION,50,2089,0,2089
LOWER DIR DISTRICT,SAMARBAGH SUB-DIVISION,51,1883,0,1883
LOWER DIR DISTRICT,SAMARBAGH SUB-DIVISION,52,1545,0,1545
LOWER DIR DISTRICT,SAMARBAGH SUB-DIVISION,53,1587,0,1587
LOWER DIR DISTRICT,SAMARBAGH SUB-DIVISION,54,1483,0,1483
LOWER DIR DISTRICT,SAMARBAGH SUB-DIVISION,55,1556,0,1556
LOWER DIR DISTRICT,SAMARBAGH SUB-DIVISION,56,1325,0,1325
LOWER DIR DISTRICT,SAMARBAGH SUB-DIVISION,57,1343,0,1343
LOWER DIR DISTRICT,SAMARBAGH SUB-DIVISION,58,1470,0,1470
LOWER DIR DISTRICT,SAMARBAGH SUB-DIVISION,59,1450,0,1450
LOWER DIR DISTRICT,SAMARBAGH SUB-DIVISION,60,1399,0,1399
LOWER DIR DISTRICT,SAMARBAGH SUB-DIVISION,61,1304,0,1304
LOWER DIR DISTRICT,SAMARBAGH SUB-DIVISION,62,1163,0,1163
LOWER DIR DISTRICT,SAMARBAGH SUB-DIVISION,63,1224,0,1224
LOWER DIR DISTRICT,SAMARBAGH SUB-DIVISION,64,1131,0,1131
LOWER DIR DISTRICT,SAMARBAGH SUB-DIVISION,65,1031,0,1031
LOWER DIR DISTRICT,SAMARBAGH SUB-DIVISION,66,1009,0,1009
LOWER DIR DISTRICT,SAMARBAGH SUB-DIVISION,67,790,0,790
LOWER DIR DISTRICT,SAMARBAGH SUB-DIVISION,68,856,0,856
LOWER DIR DISTRICT,SAMARBAGH SUB-DIVISION,69,823,0,823
LOWER DIR DISTRICT,SAMARBAGH SUB-DIVISION,70,839,0,839
LOWER DIR DISTRICT,SAMARBAGH SUB-DIVISION,71,806,0,806
LOWER DIR DISTRICT,SAMARBAGH SUB-DIVISION,72,553,0,553
LOWER DIR DISTRICT,SAMARBAGH SUB-DIVISION,73,560,0,560
LOWER DIR DISTRICT,SAMARBAGH SUB-DIVISION,74,542,0,542
LOWER DIR DISTRICT,SAMARBAGH SUB-DIVISION,>=75,4099,0,4099
LOWER DIR DISTRICT,TEMERGARA SUB-DIVISION,<1,13516,1035,14551
LOWER DIR DISTRICT,TEMERGARA SUB-DIVISION,1,14965,1187,16152
LOWER DIR DISTRICT,TEMERGARA SUB-DIVISION,2,16353,1242,17595
LOWER DIR DISTRICT,TEMERGARA SUB-DIVISION,3,17555,1296,18851
LOWER DIR DISTRICT,TEMERGARA SUB-DIVISION,4,17799,1318,19117
LOWER DIR DISTRICT,TEMERGARA SUB-DIVISION,5,16035,1309,17344
LOWER DIR DISTRICT,TEMERGARA SUB-DIVISION,6,15644,1213,16857
LOWER DIR DISTRICT,TEMERGARA SUB-DIVISION,7,15667,1175,16842
LOWER DIR DISTRICT,TEMERGARA SUB-DIVISION,8,15546,1203,16749
LOWER DIR DISTRICT,TEMERGARA SUB-DIVISION,9,16238,1240,17478
LOWER DIR DISTRICT,TEMERGARA SUB-DIVISION,10,14069,1100,15169
LOWER DIR DISTRICT,TEMERGARA SUB-DIVISION,11,14439,1131,15570
LOWER DIR DISTRICT,TEMERGARA SUB-DIVISION,12,12386,1073,13459
LOWER DIR DISTRICT,TEMERGARA SUB-DIVISION,13,13286,1021,14307
LOWER DIR DISTRICT,TEMERGARA SUB-DIVISION,14,12247,1004,13251
LOWER DIR DISTRICT,TEMERGARA SUB-DIVISION,15,12487,1004,13491
LOWER DIR DISTRICT,TEMERGARA SUB-DIVISION,16,11438,938,12376
LOWER DIR DISTRICT,TEMERGARA SUB-DIVISION,17,10698,919,11617
LOWER DIR DISTRICT,TEMERGARA SUB-DIVISION,18,10449,896,11345
LOWER DIR DISTRICT,TEMERGARA SUB-DIVISION,19,9912,832,10744
LOWER DIR DISTRICT,TEMERGARA SUB-DIVISION,20,9839,802,10641
LOWER DIR DISTRICT,TEMERGARA SUB-DIVISION,21,8632,804,9436
LOWER DIR DISTRICT,TEMERGARA SUB-DIVISION,22,8474,799,9273
LOWER DIR DISTRICT,TEMERGARA SUB-DIVISION,23,8413,782,9195
LOWER DIR DISTRICT,TEMERGARA SUB-DIVISION,24,7412,671,8083
LOWER DIR DISTRICT,TEMERGARA SUB-DIVISION,25,7986,747,8733
LOWER DIR DISTRICT,TEMERGARA SUB-DIVISION,26,7166,673,7839
LOWER DIR DISTRICT,TEMERGARA SUB-DIVISION,27,6784,652,7436
LOWER DIR DISTRICT,TEMERGARA SUB-DIVISION,28,6307,626,6933
LOWER DIR DISTRICT,TEMERGARA SUB-DIVISION,29,6381,617,6998
LOWER DIR DISTRICT,TEMERGARA SUB-DIVISION,30,6093,587,6680
LOWER DIR DISTRICT,TEMERGARA SUB-DIVISION,31,5603,567,6170
LOWER DIR DISTRICT,TEMERGARA SUB-DIVISION,32,4811,436,5247
LOWER DIR DISTRICT,TEMERGARA SUB-DIVISION,33,4958,450,5408
LOWER DIR DISTRICT,TEMERGARA SUB-DIVISION,34,4282,440,4722
LOWER DIR DISTRICT,TEMERGARA SUB-DIVISION,35,4447,493,4940
LOWER DIR DISTRICT,TEMERGARA SUB-DIVISION,36,4239,384,4623
LOWER DIR DISTRICT,TEMERGARA SUB-DIVISION,37,4054,340,4394
LOWER DIR DISTRICT,TEMERGARA SUB-DIVISION,38,4238,401,4639
LOWER DIR DISTRICT,TEMERGARA SUB-DIVISION,39,3888,394,4282
LOWER DIR DISTRICT,TEMERGARA SUB-DIVISION,40,4057,397,4454
LOWER DIR DISTRICT,TEMERGARA SUB-DIVISION,41,3737,341,4078
LOWER DIR DISTRICT,TEMERGARA SUB-DIVISION,42,3232,309,3541
LOWER DIR DISTRICT,TEMERGARA SUB-DIVISION,43,3115,288,3403
LOWER DIR DISTRICT,TEMERGARA SUB-DIVISION,44,2846,282,3128
LOWER DIR DISTRICT,TEMERGARA SUB-DIVISION,45,2955,304,3259
LOWER DIR DISTRICT,TEMERGARA SUB-DIVISION,46,2830,245,3075
LOWER DIR DISTRICT,TEMERGARA SUB-DIVISION,47,2669,243,2912
LOWER DIR DISTRICT,TEMERGARA SUB-DIVISION,48,2640,256,2896
LOWER DIR DISTRICT,TEMERGARA SUB-DIVISION,49,2582,214,2796
LOWER DIR DISTRICT,TEMERGARA SUB-DIVISION,50,2742,276,3018
LOWER DIR DISTRICT,TEMERGARA SUB-DIVISION,51,2367,197,2564
LOWER DIR DISTRICT,TEMERGARA SUB-DIVISION,52,2055,193,2248
LOWER DIR DISTRICT,TEMERGARA SUB-DIVISION,53,2085,192,2277
LOWER DIR DISTRICT,TEMERGARA SUB-DIVISION,54,1902,187,2089
LOWER DIR DISTRICT,TEMERGARA SUB-DIVISION,55,2078,217,2295
LOWER DIR DISTRICT,TEMERGARA SUB-DIVISION,56,1771,150,1921
LOWER DIR DISTRICT,TEMERGARA SUB-DIVISION,57,1645,145,1790
LOWER DIR DISTRICT,TEMERGARA SUB-DIVISION,58,1960,151,2111
LOWER DIR DISTRICT,TEMERGARA SUB-DIVISION,59,1882,156,2038
LOWER DIR DISTRICT,TEMERGARA SUB-DIVISION,60,2036,177,2213
LOWER DIR DISTRICT,TEMERGARA SUB-DIVISION,61,1909,162,2071
LOWER DIR DISTRICT,TEMERGARA SUB-DIVISION,62,1538,140,1678
LOWER DIR DISTRICT,TEMERGARA SUB-DIVISION,63,1660,131,1791
LOWER DIR DISTRICT,TEMERGARA SUB-DIVISION,64,1537,105,1642
LOWER DIR DISTRICT,TEMERGARA SUB-DIVISION,65,1427,118,1545
LOWER DIR DISTRICT,TEMERGARA SUB-DIVISION,66,1262,92,1354
LOWER DIR DISTRICT,TEMERGARA SUB-DIVISION,67,1186,107,1293
LOWER DIR DISTRICT,TEMERGARA SUB-DIVISION,68,1073,61,1134
LOWER DIR DISTRICT,TEMERGARA SUB-DIVISION,69,1004,63,1067
LOWER DIR DISTRICT,TEMERGARA SUB-DIVISION,70,1109,73,1182
LOWER DIR DISTRICT,TEMERGARA SUB-DIVISION,71,1026,65,1091
LOWER DIR DISTRICT,TEMERGARA SUB-DIVISION,72,837,52,889
LOWER DIR DISTRICT,TEMERGARA SUB-DIVISION,73,766,45,811
LOWER DIR DISTRICT,TEMERGARA SUB-DIVISION,74,707,42,749
LOWER DIR DISTRICT,TEMERGARA SUB-DIVISION,>=75,5708,337,6045
MALAKAND PROTECTED AREA,SAM RANI ZAI SUB-DIVISION,<1,8125,0,8125
MALAKAND PROTECTED AREA,SAM RANI ZAI SUB-DIVISION,1,8658,0,8658
MALAKAND PROTECTED AREA,SAM RANI ZAI SUB-DIVISION,2,8981,0,8981
MALAKAND PROTECTED AREA,SAM RANI ZAI SUB-DIVISION,3,9491,0,9491
MALAKAND PROTECTED AREA,SAM RANI ZAI SUB-DIVISION,4,9368,0,9368
MALAKAND PROTECTED AREA,SAM RANI ZAI SUB-DIVISION,5,9638,0,9638
MALAKAND PROTECTED AREA,SAM RANI ZAI SUB-DIVISION,6,9385,0,9385
MALAKAND PROTECTED AREA,SAM RANI ZAI SUB-DIVISION,7,9592,0,9592
MALAKAND PROTECTED AREA,SAM RANI ZAI SUB-DIVISION,8,9107,0,9107
MALAKAND PROTECTED AREA,SAM RANI ZAI SUB-DIVISION,9,9714,0,9714
MALAKAND PROTECTED AREA,SAM RANI ZAI SUB-DIVISION,10,8043,0,8043
MALAKAND PROTECTED AREA,SAM RANI ZAI SUB-DIVISION,11,8310,0,8310
MALAKAND PROTECTED AREA,SAM RANI ZAI SUB-DIVISION,12,7213,0,7213
MALAKAND PROTECTED AREA,SAM RANI ZAI SUB-DIVISION,13,7918,0,7918
MALAKAND PROTECTED AREA,SAM RANI ZAI SUB-DIVISION,14,7176,0,7176
MALAKAND PROTECTED AREA,SAM RANI ZAI SUB-DIVISION,15,7431,0,7431
MALAKAND PROTECTED AREA,SAM RANI ZAI SUB-DIVISION,16,6917,0,6917
MALAKAND PROTECTED AREA,SAM RANI ZAI SUB-DIVISION,17,6534,0,6534
MALAKAND PROTECTED AREA,SAM RANI ZAI SUB-DIVISION,18,6214,0,6214
MALAKAND PROTECTED AREA,SAM RANI ZAI SUB-DIVISION,19,5902,0,5902
MALAKAND PROTECTED AREA,SAM RANI ZAI SUB-DIVISION,20,6155,0,6155
MALAKAND PROTECTED AREA,SAM RANI ZAI SUB-DIVISION,21,5451,0,5451
MALAKAND PROTECTED AREA,SAM RANI ZAI SUB-DIVISION,22,5449,0,5449
MALAKAND PROTECTED AREA,SAM RANI ZAI SUB-DIVISION,23,5185,0,5185
MALAKAND PROTECTED AREA,SAM RANI ZAI SUB-DIVISION,24,4665,0,4665
MALAKAND PROTECTED AREA,SAM RANI ZAI SUB-DIVISION,25,5399,0,5399
MALAKAND PROTECTED AREA,SAM RANI ZAI SUB-DIVISION,26,4633,0,4633
MALAKAND PROTECTED AREA,SAM RANI ZAI SUB-DIVISION,27,4683,0,4683
MALAKAND PROTECTED AREA,SAM RANI ZAI SUB-DIVISION,28,4576,0,4576
MALAKAND PROTECTED AREA,SAM RANI ZAI SUB-DIVISION,29,4509,0,4509
MALAKAND PROTECTED AREA,SAM RANI ZAI SUB-DIVISION,30,4870,0,4870
MALAKAND PROTECTED AREA,SAM RANI ZAI SUB-DIVISION,31,4249,0,4249
MALAKAND PROTECTED AREA,SAM RANI ZAI SUB-DIVISION,32,3483,0,3483
MALAKAND PROTECTED AREA,SAM RANI ZAI SUB-DIVISION,33,3684,0,3684
MALAKAND PROTECTED AREA,SAM RANI ZAI SUB-DIVISION,34,3034,0,3034
MALAKAND PROTECTED AREA,SAM RANI ZAI SUB-DIVISION,35,3440,0,3440
MALAKAND PROTECTED AREA,SAM RANI ZAI SUB-DIVISION,36,2918,0,2918
MALAKAND PROTECTED AREA,SAM RANI ZAI SUB-DIVISION,37,2725,0,2725
MALAKAND PROTECTED AREA,SAM RANI ZAI SUB-DIVISION,38,2894,0,2894
MALAKAND PROTECTED AREA,SAM RANI ZAI SUB-DIVISION,39,2779,0,2779
MALAKAND PROTECTED AREA,SAM RANI ZAI SUB-DIVISION,40,3553,0,3553
MALAKAND PROTECTED AREA,SAM RANI ZAI SUB-DIVISION,41,2724,0,2724
MALAKAND PROTECTED AREA,SAM RANI ZAI SUB-DIVISION,42,2287,0,2287
MALAKAND PROTECTED AREA,SAM RANI ZAI SUB-DIVISION,43,2418,0,2418
MALAKAND PROTECTED AREA,SAM RANI ZAI SUB-DIVISION,44,2242,0,2242
MALAKAND PROTECTED AREA,SAM RANI ZAI SUB-DIVISION,45,2286,0,2286
MALAKAND PROTECTED AREA,SAM RANI ZAI SUB-DIVISION,46,2060,0,2060
MALAKAND PROTECTED AREA,SAM RANI ZAI SUB-DIVISION,47,1958,0,1958
MALAKAND PROTECTED AREA,SAM RANI ZAI SUB-DIVISION,48,1888,0,1888
MALAKAND PROTECTED AREA,SAM RANI ZAI SUB-DIVISION,49,1937,0,1937
MALAKAND PROTECTED AREA,SAM RANI ZAI SUB-DIVISION,50,2486,0,2486
MALAKAND PROTECTED AREA,SAM RANI ZAI SUB-DIVISION,51,1942,0,1942
MALAKAND PROTECTED AREA,SAM RANI ZAI SUB-DIVISION,52,1507,0,1507
MALAKAND PROTECTED AREA,SAM RANI ZAI SUB-DIVISION,53,1753,0,1753
MALAKAND PROTECTED AREA,SAM RANI ZAI SUB-DIVISION,54,1442,0,1442
MALAKAND PROTECTED AREA,SAM RANI ZAI SUB-DIVISION,55,1577,0,1577
MALAKAND PROTECTED AREA,SAM RANI ZAI SUB-DIVISION,56,1218,0,1218
MALAKAND PROTECTED AREA,SAM RANI ZAI SUB-DIVISION,57,1064,0,1064
MALAKAND PROTECTED AREA,SAM RANI ZAI SUB-DIVISION,58,1343,0,1343
MALAKAND PROTECTED AREA,SAM RANI ZAI SUB-DIVISION,59,1370,0,1370
MALAKAND PROTECTED AREA,SAM RANI ZAI SUB-DIVISION,60,1537,0,1537
MALAKAND PROTECTED AREA,SAM RANI ZAI SUB-DIVISION,61,1329,0,1329
MALAKAND PROTECTED AREA,SAM RANI ZAI SUB-DIVISION,62,995,0,995
MALAKAND PROTECTED AREA,SAM RANI ZAI SUB-DIVISION,63,1132,0,1132
MALAKAND PROTECTED AREA,SAM RANI ZAI SUB-DIVISION,64,1108,0,1108
MALAKAND PROTECTED AREA,SAM RANI ZAI SUB-DIVISION,65,919,0,919
MALAKAND PROTECTED AREA,SAM RANI ZAI SUB-DIVISION,66,818,0,818
MALAKAND PROTECTED AREA,SAM RANI ZAI SUB-DIVISION,67,629,0,629
MALAKAND PROTECTED AREA,SAM RANI ZAI SUB-DIVISION,68,696,0,696
MALAKAND PROTECTED AREA,SAM RANI ZAI SUB-DIVISION,69,748,0,748
MALAKAND PROTECTED AREA,SAM RANI ZAI SUB-DIVISION,70,726,0,726
MALAKAND PROTECTED AREA,SAM RANI ZAI SUB-DIVISION,71,595,0,595
MALAKAND PROTECTED AREA,SAM RANI ZAI SUB-DIVISION,72,438,0,438
MALAKAND PROTECTED AREA,SAM RANI ZAI SUB-DIVISION,73,488,0,488
MALAKAND PROTECTED AREA,SAM RANI ZAI SUB-DIVISION,74,497,0,497
MALAKAND PROTECTED AREA,SAM RANI ZAI SUB-DIVISION,>=75,3436,0,3436
MALAKAND PROTECTED AREA,SWAT RANI ZAI SUB-DIVISION,<1,9869,1667,11536
MALAKAND PROTECTED AREA,SWAT RANI ZAI SUB-DIVISION,1,10318,2029,12347
MALAKAND PROTECTED AREA,SWAT RANI ZAI SUB-DIVISION,2,11150,2106,13256
MALAKAND PROTECTED AREA,SWAT RANI ZAI SUB-DIVISION,3,11764,2231,13995
MALAKAND PROTECTED AREA,SWAT RANI ZAI SUB-DIVISION,4,11431,2028,13459
MALAKAND PROTECTED AREA,SWAT RANI ZAI SUB-DIVISION,5,11371,2079,13450
MALAKAND PROTECTED AREA,SWAT RANI ZAI SUB-DIVISION,6,10037,2089,12126
MALAKAND PROTECTED AREA,SWAT RANI ZAI SUB-DIVISION,7,11226,2159,13385
MALAKAND PROTECTED AREA,SWAT RANI ZAI SUB-DIVISION,8,10525,1986,12511
MALAKAND PROTECTED AREA,SWAT RANI ZAI SUB-DIVISION,9,11011,2045,13056
MALAKAND PROTECTED AREA,SWAT RANI ZAI SUB-DIVISION,10,9319,1731,11050
MALAKAND PROTECTED AREA,SWAT RANI ZAI SUB-DIVISION,11,9610,1824,11434
MALAKAND PROTECTED AREA,SWAT RANI ZAI SUB-DIVISION,12,8355,1627,9982
MALAKAND PROTECTED AREA,SWAT RANI ZAI SUB-DIVISION,13,9120,1772,10892
MALAKAND PROTECTED AREA,SWAT RANI ZAI SUB-DIVISION,14,7945,1607,9552
MALAKAND PROTECTED AREA,SWAT RANI ZAI SUB-DIVISION,15,8504,1629,10133
MALAKAND PROTECTED AREA,SWAT RANI ZAI SUB-DIVISION,16,7675,1480,9155
MALAKAND PROTECTED AREA,SWAT RANI ZAI SUB-DIVISION,17,7886,1441,9327
MALAKAND PROTECTED AREA,SWAT RANI ZAI SUB-DIVISION,18,7128,1426,8554
MALAKAND PROTECTED AREA,SWAT RANI ZAI SUB-DIVISION,19,7010,1361,8371
MALAKAND PROTECTED AREA,SWAT RANI ZAI SUB-DIVISION,20,6814,1297,8111
MALAKAND PROTECTED AREA,SWAT RANI ZAI SUB-DIVISION,21,6092,1220,7312
MALAKAND PROTECTED AREA,SWAT RANI ZAI SUB-DIVISION,22,5954,1171,7125
MALAKAND PROTECTED AREA,SWAT RANI ZAI SUB-DIVISION,23,5892,1142,7034
MALAKAND PROTECTED AREA,SWAT RANI ZAI SUB-DIVISION,24,5309,1059,6368
MALAKAND PROTECTED AREA,SWAT RANI ZAI SUB-DIVISION,25,6113,1230,7343
MALAKAND PROTECTED AREA,SWAT RANI ZAI SUB-DIVISION,26,5354,1059,6413
MALAKAND PROTECTED AREA,SWAT RANI ZAI SUB-DIVISION,27,5262,1129,6391
MALAKAND PROTECTED AREA,SWAT RANI ZAI SUB-DIVISION,28,4934,1071,6005
MALAKAND PROTECTED AREA,SWAT RANI ZAI SUB-DIVISION,29,4964,1044,6008
MALAKAND PROTECTED AREA,SWAT RANI ZAI SUB-DIVISION,30,5008,1114,6122
MALAKAND PROTECTED AREA,SWAT RANI ZAI SUB-DIVISION,31,4540,961,5501
MALAKAND PROTECTED AREA,SWAT RANI ZAI SUB-DIVISION,32,4047,889,4936
MALAKAND PROTECTED AREA,SWAT RANI ZAI SUB-DIVISION,33,4010,845,4855
MALAKAND PROTECTED AREA,SWAT RANI ZAI SUB-DIVISION,34,3488,772,4260
MALAKAND PROTECTED AREA,SWAT RANI ZAI SUB-DIVISION,35,3729,828,4557
MALAKAND PROTECTED AREA,SWAT RANI ZAI SUB-DIVISION,36,3133,623,3756
MALAKAND PROTECTED AREA,SWAT RANI ZAI SUB-DIVISION,37,2939,680,3619
MALAKAND PROTECTED AREA,SWAT RANI ZAI SUB-DIVISION,38,3397,713,4110
MALAKAND PROTECTED AREA,SWAT RANI ZAI SUB-DIVISION,39,3067,641,3708
MALAKAND PROTECTED AREA,SWAT RANI ZAI SUB-DIVISION,40,3527,810,4337
MALAKAND PROTECTED AREA,SWAT RANI ZAI SUB-DIVISION,41,2778,561,3339
MALAKAND PROTECTED AREA,SWAT RANI ZAI SUB-DIVISION,42,2522,543,3065
MALAKAND PROTECTED AREA,SWAT RANI ZAI SUB-DIVISION,43,2738,535,3273
MALAKAND PROTECTED AREA,SWAT RANI ZAI SUB-DIVISION,44,2421,468,2889
MALAKAND PROTECTED AREA,SWAT RANI ZAI SUB-DIVISION,45,2516,533,3049
MALAKAND PROTECTED AREA,SWAT RANI ZAI SUB-DIVISION,46,2284,452,2736
MALAKAND PROTECTED AREA,SWAT RANI ZAI SUB-DIVISION,47,2081,435,2516
MALAKAND PROTECTED AREA,SWAT RANI ZAI SUB-DIVISION,48,2167,473,2640
MALAKAND PROTECTED AREA,SWAT RANI ZAI SUB-DIVISION,49,2199,429,2628
MALAKAND PROTECTED AREA,SWAT RANI ZAI SUB-DIVISION,50,2622,510,3132
MALAKAND PROTECTED AREA,SWAT RANI ZAI SUB-DIVISION,51,2075,404,2479
MALAKAND PROTECTED AREA,SWAT RANI ZAI SUB-DIVISION,52,1717,360,2077
MALAKAND PROTECTED AREA,SWAT RANI ZAI SUB-DIVISION,53,2009,345,2354
MALAKAND PROTECTED AREA,SWAT RANI ZAI SUB-DIVISION,54,1767,324,2091
MALAKAND PROTECTED AREA,SWAT RANI ZAI SUB-DIVISION,55,1862,376,2238
MALAKAND PROTECTED AREA,SWAT RANI ZAI SUB-DIVISION,56,1426,271,1697
MALAKAND PROTECTED AREA,SWAT RANI ZAI SUB-DIVISION,57,1297,213,1510
MALAKAND PROTECTED AREA,SWAT RANI ZAI SUB-DIVISION,58,1527,258,1785
MALAKAND PROTECTED AREA,SWAT RANI ZAI SUB-DIVISION,59,1448,268,1716
MALAKAND PROTECTED AREA,SWAT RANI ZAI SUB-DIVISION,60,1599,350,1949
MALAKAND PROTECTED AREA,SWAT RANI ZAI SUB-DIVISION,61,1395,258,1653
MALAKAND PROTECTED AREA,SWAT RANI ZAI SUB-DIVISION,62,1171,244,1415
MALAKAND PROTECTED AREA,SWAT RANI ZAI SUB-DIVISION,63,1317,259,1576
MALAKAND PROTECTED AREA,SWAT RANI ZAI SUB-DIVISION,64,1104,229,1333
MALAKAND PROTECTED AREA,SWAT RANI ZAI SUB-DIVISION,65,1052,189,1241
MALAKAND PROTECTED AREA,SWAT RANI ZAI SUB-DIVISION,66,949,171,1120
MALAKAND PROTECTED AREA,SWAT RANI ZAI SUB-DIVISION,67,786,163,949
MALAKAND PROTECTED AREA,SWAT RANI ZAI SUB-DIVISION,68,830,115,945
MALAKAND PROTECTED AREA,SWAT RANI ZAI SUB-DIVISION,69,765,115,880
MALAKAND PROTECTED AREA,SWAT RANI ZAI SUB-DIVISION,70,843,135,978
MALAKAND PROTECTED AREA,SWAT RANI ZAI SUB-DIVISION,71,759,135,894
MALAKAND PROTECTED AREA,SWAT RANI ZAI SUB-DIVISION,72,608,120,728
MALAKAND PROTECTED AREA,SWAT RANI ZAI SUB-DIVISION,73,561,111,672
MALAKAND PROTECTED AREA,SWAT RANI ZAI SUB-DIVISION,74,510,79,589
MALAKAND PROTECTED AREA,SWAT RANI ZAI SUB-DIVISION,>=75,3944,640,4584
MALIR DISTRICT,AIRPORT SUB-DIVISION,<1,0,4102,4102
MALIR DISTRICT,AIRPORT SUB-DIVISION,1,0,4570,4570
MALIR DISTRICT,AIRPORT SUB-DIVISION,2,0,4648,4648
MALIR DISTRICT,AIRPORT SUB-DIVISION,3,0,4949,4949
MALIR DISTRICT,AIRPORT SUB-DIVISION,4,0,4522,4522
MALIR DISTRICT,AIRPORT SUB-DIVISION,5,0,4753,4753
MALIR DISTRICT,AIRPORT SUB-DIVISION,6,0,4555,4555
MALIR DISTRICT,AIRPORT SUB-DIVISION,7,0,4817,4817
MALIR DISTRICT,AIRPORT SUB-DIVISION,8,0,4182,4182
MALIR DISTRICT,AIRPORT SUB-DIVISION,9,0,4752,4752
MALIR DISTRICT,AIRPORT SUB-DIVISION,10,0,3918,3918
MALIR DISTRICT,AIRPORT SUB-DIVISION,11,0,4435,4435
MALIR DISTRICT,AIRPORT SUB-DIVISION,12,0,3826,3826
MALIR DISTRICT,AIRPORT SUB-DIVISION,13,0,3996,3996
MALIR DISTRICT,AIRPORT SUB-DIVISION,14,0,3672,3672
MALIR DISTRICT,AIRPORT SUB-DIVISION,15,0,3572,3572
MALIR DISTRICT,AIRPORT SUB-DIVISION,16,0,3725,3725
MALIR DISTRICT,AIRPORT SUB-DIVISION,17,0,4001,4001
MALIR DISTRICT,AIRPORT SUB-DIVISION,18,0,3546,3546
MALIR DISTRICT,AIRPORT SUB-DIVISION,19,0,4053,4053
MALIR DISTRICT,AIRPORT SUB-DIVISION,20,0,3601,3601
MALIR DISTRICT,AIRPORT SUB-DIVISION,21,0,4217,4217
MALIR DISTRICT,AIRPORT SUB-DIVISION,22,0,3856,3856
MALIR DISTRICT,AIRPORT SUB-DIVISION,23,0,3907,3907
MALIR DISTRICT,AIRPORT SUB-DIVISION,24,0,3964,3964
MALIR DISTRICT,AIRPORT SUB-DIVISION,25,0,3419,3419
MALIR DISTRICT,AIRPORT SUB-DIVISION,26,0,3956,3956
MALIR DISTRICT,AIRPORT SUB-DIVISION,27,0,3858,3858
MALIR DISTRICT,AIRPORT SUB-DIVISION,28,0,3708,3708
MALIR DISTRICT,AIRPORT SUB-DIVISION,29,0,3855,3855
MALIR DISTRICT,AIRPORT SUB-DIVISION,30,0,3439,3439
MALIR DISTRICT,AIRPORT SUB-DIVISION,31,0,3699,3699
MALIR DISTRICT,AIRPORT SUB-DIVISION,32,0,3327,3327
MALIR DISTRICT,AIRPORT SUB-DIVISION,33,0,3391,3391
MALIR DISTRICT,AIRPORT SUB-DIVISION,34,0,3049,3049
MALIR DISTRICT,AIRPORT SUB-DIVISION,35,0,2727,2727
MALIR DISTRICT,AIRPORT SUB-DIVISION,36,0,2888,2888
MALIR DISTRICT,AIRPORT SUB-DIVISION,37,0,2495,2495
MALIR DISTRICT,AIRPORT SUB-DIVISION,38,0,2752,2752
MALIR DISTRICT,AIRPORT SUB-DIVISION,39,0,2460,2460
MALIR DISTRICT,AIRPORT SUB-DIVISION,40,0,2524,2524
MALIR DISTRICT,AIRPORT SUB-DIVISION,41,0,2301,2301
MALIR DISTRICT,AIRPORT SUB-DIVISION,42,0,2198,2198
MALIR DISTRICT,AIRPORT SUB-DIVISION,43,0,2129,2129
MALIR DISTRICT,AIRPORT SUB-DIVISION,44,0,1916,1916
MALIR DISTRICT,AIRPORT SUB-DIVISION,45,0,1731,1731
MALIR DISTRICT,AIRPORT SUB-DIVISION,46,0,1697,1697
MALIR DISTRICT,AIRPORT SUB-DIVISION,47,0,1551,1551
MALIR DISTRICT,AIRPORT SUB-DIVISION,48,0,1682,1682
MALIR DISTRICT,AIRPORT SUB-DIVISION,49,0,1572,1572
MALIR DISTRICT,AIRPORT SUB-DIVISION,50,0,1613,1613
MALIR DISTRICT,AIRPORT SUB-DIVISION,51,0,1492,1492
MALIR DISTRICT,AIRPORT SUB-DIVISION,52,0,1491,1491
MALIR DISTRICT,AIRPORT SUB-DIVISION,53,0,1484,1484
MALIR DISTRICT,AIRPORT SUB-DIVISION,54,0,1339,1339
MALIR DISTRICT,AIRPORT SUB-DIVISION,55,0,1183,1183
MALIR DISTRICT,AIRPORT SUB-DIVISION,56,0,1103,1103
MALIR DISTRICT,AIRPORT SUB-DIVISION,57,0,933,933
MALIR DISTRICT,AIRPORT SUB-DIVISION,58,0,1043,1043
MALIR DISTRICT,AIRPORT SUB-DIVISION,59,0,951,951
MALIR DISTRICT,AIRPORT SUB-DIVISION,60,0,924,924
MALIR DISTRICT,AIRPORT SUB-DIVISION,61,0,849,849
MALIR DISTRICT,AIRPORT SUB-DIVISION,62,0,890,890
MALIR DISTRICT,AIRPORT SUB-DIVISION,63,0,820,820
MALIR DISTRICT,AIRPORT SUB-DIVISION,64,0,752,752
MALIR DISTRICT,AIRPORT SUB-DIVISION,65,0,561,561
MALIR DISTRICT,AIRPORT SUB-DIVISION,66,0,487,487
MALIR DISTRICT,AIRPORT SUB-DIVISION,67,0,448,448
MALIR DISTRICT,AIRPORT SUB-DIVISION,68,0,513,513
MALIR DISTRICT,AIRPORT SUB-DIVISION,69,0,416,416
MALIR DISTRICT,AIRPORT SUB-DIVISION,70,0,368,368
MALIR DISTRICT,AIRPORT SUB-DIVISION,71,0,346,346
MALIR DISTRICT,AIRPORT SUB-DIVISION,72,0,332,332
MALIR DISTRICT,AIRPORT SUB-DIVISION,73,0,304,304
MALIR DISTRICT,AIRPORT SUB-DIVISION,74,0,290,290
MALIR DISTRICT,AIRPORT SUB-DIVISION,>=75,0,1748,1748
MALIR DISTRICT,BIN QASIM SUB-DIVISION,<1,5926,0,5926
MALIR DISTRICT,BIN QASIM SUB-DIVISION,1,6346,0,6346
MALIR DISTRICT,BIN QASIM SUB-DIVISION,2,6393,0,6393
MALIR DISTRICT,BIN QASIM SUB-DIVISION,3,7233,0,7233
MALIR DISTRICT,BIN QASIM SUB-DIVISION,4,6689,0,6689
MALIR DISTRICT,BIN QASIM SUB-DIVISION,5,6816,0,6816
MALIR DISTRICT,BIN QASIM SUB-DIVISION,6,6396,0,6396
MALIR DISTRICT,BIN QASIM SUB-DIVISION,7,6914,0,6914
MALIR DISTRICT,BIN QASIM SUB-DIVISION,8,6110,0,6110
MALIR DISTRICT,BIN QASIM SUB-DIVISION,9,6299,0,6299
MALIR DISTRICT,BIN QASIM SUB-DIVISION,10,5343,0,5343
MALIR DISTRICT,BIN QASIM SUB-DIVISION,11,5571,0,5571
MALIR DISTRICT,BIN QASIM SUB-DIVISION,12,4842,0,4842
MALIR DISTRICT,BIN QASIM SUB-DIVISION,13,5197,0,5197
MALIR DISTRICT,BIN QASIM SUB-DIVISION,14,4607,0,4607
MALIR DISTRICT,BIN QASIM SUB-DIVISION,15,4719,0,4719
MALIR DISTRICT,BIN QASIM SUB-DIVISION,16,4915,0,4915
MALIR DISTRICT,BIN QASIM SUB-DIVISION,17,5167,0,5167
MALIR DISTRICT,BIN QASIM SUB-DIVISION,18,4858,0,4858
MALIR DISTRICT,BIN QASIM SUB-DIVISION,19,5620,0,5620
MALIR DISTRICT,BIN QASIM SUB-DIVISION,20,4875,0,4875
MALIR DISTRICT,BIN QASIM SUB-DIVISION,21,5556,0,5556
MALIR DISTRICT,BIN QASIM SUB-DIVISION,22,5054,0,5054
MALIR DISTRICT,BIN QASIM SUB-DIVISION,23,5160,0,5160
MALIR DISTRICT,BIN QASIM SUB-DIVISION,24,4859,0,4859
MALIR DISTRICT,BIN QASIM SUB-DIVISION,25,4513,0,4513
MALIR DISTRICT,BIN QASIM SUB-DIVISION,26,5049,0,5049
MALIR DISTRICT,BIN QASIM SUB-DIVISION,27,5090,0,5090
MALIR DISTRICT,BIN QASIM SUB-DIVISION,28,4743,0,4743
MALIR DISTRICT,BIN QASIM SUB-DIVISION,29,4941,0,4941
MALIR DISTRICT,BIN QASIM SUB-DIVISION,30,4150,0,4150
MALIR DISTRICT,BIN QASIM SUB-DIVISION,31,4617,0,4617
MALIR DISTRICT,BIN QASIM SUB-DIVISION,32,3864,0,3864
MALIR DISTRICT,BIN QASIM SUB-DIVISION,33,3778,0,3778
MALIR DISTRICT,BIN QASIM SUB-DIVISION,34,3666,0,3666
MALIR DISTRICT,BIN QASIM SUB-DIVISION,35,3056,0,3056
MALIR DISTRICT,BIN QASIM SUB-DIVISION,36,3212,0,3212
MALIR DISTRICT,BIN QASIM SUB-DIVISION,37,2910,0,2910
MALIR DISTRICT,BIN QASIM SUB-DIVISION,38,2925,0,2925
MALIR DISTRICT,BIN QASIM SUB-DIVISION,39,2857,0,2857
MALIR DISTRICT,BIN QASIM SUB-DIVISION,40,2422,0,2422
MALIR DISTRICT,BIN QASIM SUB-DIVISION,41,2458,0,2458
MALIR DISTRICT,BIN QASIM SUB-DIVISION,42,2143,0,2143
MALIR DISTRICT,BIN QASIM SUB-DIVISION,43,2100,0,2100
MALIR DISTRICT,BIN QASIM SUB-DIVISION,44,2033,0,2033
MALIR DISTRICT,BIN QASIM SUB-DIVISION,45,1852,0,1852
MALIR DISTRICT,BIN QASIM SUB-DIVISION,46,1967,0,1967
MALIR DISTRICT,BIN QASIM SUB-DIVISION,47,1785,0,1785
MALIR DISTRICT,BIN QASIM SUB-DIVISION,48,1807,0,1807
MALIR DISTRICT,BIN QASIM SUB-DIVISION,49,1878,0,1878
MALIR DISTRICT,BIN QASIM SUB-DIVISION,50,1627,0,1627
MALIR DISTRICT,BIN QASIM SUB-DIVISION,51,1766,0,1766
MALIR DISTRICT,BIN QASIM SUB-DIVISION,52,1654,0,1654
MALIR DISTRICT,BIN QASIM SUB-DIVISION,53,1715,0,1715
MALIR DISTRICT,BIN QASIM SUB-DIVISION,54,1652,0,1652
MALIR DISTRICT,BIN QASIM SUB-DIVISION,55,1344,0,1344
MALIR DISTRICT,BIN QASIM SUB-DIVISION,56,1516,0,1516
MALIR DISTRICT,BIN QASIM SUB-DIVISION,57,1436,0,1436
MALIR DISTRICT,BIN QASIM SUB-DIVISION,58,1409,0,1409
MALIR DISTRICT,BIN QASIM SUB-DIVISION,59,1311,0,1311
MALIR DISTRICT,BIN QASIM SUB-DIVISION,60,993,0,993
MALIR DISTRICT,BIN QASIM SUB-DIVISION,61,1073,0,1073
MALIR DISTRICT,BIN QASIM SUB-DIVISION,62,1018,0,1018
MALIR DISTRICT,BIN QASIM SUB-DIVISION,63,990,0,990
MALIR DISTRICT,BIN QASIM SUB-DIVISION,64,842,0,842
MALIR DISTRICT,BIN QASIM SUB-DIVISION,65,608,0,608
MALIR DISTRICT,BIN QASIM SUB-DIVISION,66,614,0,614
MALIR DISTRICT,BIN QASIM SUB-DIVISION,67,536,0,536
MALIR DISTRICT,BIN QASIM SUB-DIVISION,68,511,0,511
MALIR DISTRICT,BIN QASIM SUB-DIVISION,69,448,0,448
MALIR DISTRICT,BIN QASIM SUB-DIVISION,70,296,0,296
MALIR DISTRICT,BIN QASIM SUB-DIVISION,71,352,0,352
MALIR DISTRICT,BIN QASIM SUB-DIVISION,72,292,0,292
MALIR DISTRICT,BIN QASIM SUB-DIVISION,73,303,0,303
MALIR DISTRICT,BIN QASIM SUB-DIVISION,74,264,0,264
MALIR DISTRICT,BIN QASIM SUB-DIVISION,>=75,2247,0,2247
MALIR DISTRICT,GADAP SUB-DIVISION,<1,1432,0,1432
MALIR DISTRICT,GADAP SUB-DIVISION,1,1540,0,1540
MALIR DISTRICT,GADAP SUB-DIVISION,2,1685,0,1685
MALIR DISTRICT,GADAP SUB-DIVISION,3,1785,0,1785
MALIR DISTRICT,GADAP SUB-DIVISION,4,1743,0,1743
MALIR DISTRICT,GADAP SUB-DIVISION,5,1715,0,1715
MALIR DISTRICT,GADAP SUB-DIVISION,6,1686,0,1686
MALIR DISTRICT,GADAP SUB-DIVISION,7,1746,0,1746
MALIR DISTRICT,GADAP SUB-DIVISION,8,1665,0,1665
MALIR DISTRICT,GADAP SUB-DIVISION,9,1684,0,1684
MALIR DISTRICT,GADAP SUB-DIVISION,10,1465,0,1465
MALIR DISTRICT,GADAP SUB-DIVISION,11,1495,0,1495
MALIR DISTRICT,GADAP SUB-DIVISION,12,1413,0,1413
MALIR DISTRICT,GADAP SUB-DIVISION,13,1270,0,1270
MALIR DISTRICT,GADAP SUB-DIVISION,14,1292,0,1292
MALIR DISTRICT,GADAP SUB-DIVISION,15,1273,0,1273
MALIR DISTRICT,GADAP SUB-DIVISION,16,1274,0,1274
MALIR DISTRICT,GADAP SUB-DIVISION,17,1210,0,1210
MALIR DISTRICT,GADAP SUB-DIVISION,18,1335,0,1335
MALIR DISTRICT,GADAP SUB-DIVISION,19,1476,0,1476
MALIR DISTRICT,GADAP SUB-DIVISION,20,1300,0,1300
MALIR DISTRICT,GADAP SUB-DIVISION,21,1373,0,1373
MALIR DISTRICT,GADAP SUB-DIVISION,22,1244,0,1244
MALIR DISTRICT,GADAP SUB-DIVISION,23,1134,0,1134
MALIR DISTRICT,GADAP SUB-DIVISION,24,1148,0,1148
MALIR DISTRICT,GADAP SUB-DIVISION,25,966,0,966
MALIR DISTRICT,GADAP SUB-DIVISION,26,1183,0,1183
MALIR DISTRICT,GADAP SUB-DIVISION,27,1210,0,1210
MALIR DISTRICT,GADAP SUB-DIVISION,28,1115,0,1115
MALIR DISTRICT,GADAP SUB-DIVISION,29,1279,0,1279
MALIR DISTRICT,GADAP SUB-DIVISION,30,1076,0,1076
MALIR DISTRICT,GADAP SUB-DIVISION,31,1168,0,1168
MALIR DISTRICT,GADAP SUB-DIVISION,32,1064,0,1064
MALIR DISTRICT,GADAP SUB-DIVISION,33,990,0,990
MALIR DISTRICT,GADAP SUB-DIVISION,34,991,0,991
MALIR DISTRICT,GADAP SUB-DIVISION,35,860,0,860
MALIR DISTRICT,GADAP SUB-DIVISION,36,882,0,882
MALIR DISTRICT,GADAP SUB-DIVISION,37,1066,0,1066
MALIR DISTRICT,GADAP SUB-DIVISION,38,833,0,833
MALIR DISTRICT,GADAP SUB-DIVISION,39,876,0,876
MALIR DISTRICT,GADAP SUB-DIVISION,40,572,0,572
MALIR DISTRICT,GADAP SUB-DIVISION,41,710,0,710
MALIR DISTRICT,GADAP SUB-DIVISION,42,604,0,604
MALIR DISTRICT,GADAP SUB-DIVISION,43,510,0,510
MALIR DISTRICT,GADAP SUB-DIVISION,44,536,0,536
MALIR DISTRICT,GADAP SUB-DIVISION,45,412,0,412
MALIR DISTRICT,GADAP SUB-DIVISION,46,550,0,550
MALIR DISTRICT,GADAP SUB-DIVISION,47,566,0,566
MALIR DISTRICT,GADAP SUB-DIVISION,48,557,0,557
MALIR DISTRICT,GADAP SUB-DIVISION,49,572,0,572
MALIR DISTRICT,GADAP SUB-DIVISION,50,363,0,363
MALIR DISTRICT,GADAP SUB-DIVISION,51,431,0,431
MALIR DISTRICT,GADAP SUB-DIVISION,52,390,0,390
MALIR DISTRICT,GADAP SUB-DIVISION,53,349,0,349
MALIR DISTRICT,GADAP SUB-DIVISION,54,346,0,346
MALIR DISTRICT,GADAP SUB-DIVISION,55,250,0,250
MALIR DISTRICT,GADAP SUB-DIVISION,56,267,0,267
MALIR DISTRICT,GADAP SUB-DIVISION,57,309,0,309
MALIR DISTRICT,GADAP SUB-DIVISION,58,279,0,279
MALIR DISTRICT,GADAP SUB-DIVISION,59,248,0,248
MALIR DISTRICT,GADAP SUB-DIVISION,60,213,0,213
MALIR DISTRICT,GADAP SUB-DIVISION,61,259,0,259
MALIR DISTRICT,GADAP SUB-DIVISION,62,241,0,241
MALIR DISTRICT,GADAP SUB-DIVISION,63,229,0,229
MALIR DISTRICT,GADAP SUB-DIVISION,64,246,0,246
MALIR DISTRICT,GADAP SUB-DIVISION,65,152,0,152
MALIR DISTRICT,GADAP SUB-DIVISION,66,170,0,170
MALIR DISTRICT,GADAP SUB-DIVISION,67,181,0,181
MALIR DISTRICT,GADAP SUB-DIVISION,68,197,0,197
MALIR DISTRICT,GADAP SUB-DIVISION,69,171,0,171
MALIR DISTRICT,GADAP SUB-DIVISION,70,95,0,95
MALIR DISTRICT,GADAP SUB-DIVISION,71,130,0,130
MALIR DISTRICT,GADAP SUB-DIVISION,72,130,0,130
MALIR DISTRICT,GADAP SUB-DIVISION,73,117,0,117
MALIR DISTRICT,GADAP SUB-DIVISION,74,113,0,113
MALIR DISTRICT,GADAP SUB-DIVISION,>=75,746,0,746
MALIR DISTRICT,IBRAHIM HYDRI SUB-DIVISION,<1,9830,16322,26152
MALIR DISTRICT,IBRAHIM HYDRI SUB-DIVISION,1,10673,17020,27693
MALIR DISTRICT,IBRAHIM HYDRI SUB-DIVISION,2,10849,18097,28946
MALIR DISTRICT,IBRAHIM HYDRI SUB-DIVISION,3,12013,19417,31430
MALIR DISTRICT,IBRAHIM HYDRI SUB-DIVISION,4,11058,17836,28894
MALIR DISTRICT,IBRAHIM HYDRI SUB-DIVISION,5,11357,18374,29731
MALIR DISTRICT,IBRAHIM HYDRI SUB-DIVISION,6,10686,17417,28103
MALIR DISTRICT,IBRAHIM HYDRI SUB-DIVISION,7,11553,18526,30079
MALIR DISTRICT,IBRAHIM HYDRI SUB-DIVISION,8,10435,16557,26992
MALIR DISTRICT,IBRAHIM HYDRI SUB-DIVISION,9,10823,17982,28805
MALIR DISTRICT,IBRAHIM HYDRI SUB-DIVISION,10,9411,15057,24468
MALIR DISTRICT,IBRAHIM HYDRI SUB-DIVISION,11,9754,16663,26417
MALIR DISTRICT,IBRAHIM HYDRI SUB-DIVISION,12,8557,14097,22654
MALIR DISTRICT,IBRAHIM HYDRI SUB-DIVISION,13,8600,14727,23327
MALIR DISTRICT,IBRAHIM HYDRI SUB-DIVISION,14,7897,13262,21159
MALIR DISTRICT,IBRAHIM HYDRI SUB-DIVISION,15,8074,13779,21853
MALIR DISTRICT,IBRAHIM HYDRI SUB-DIVISION,16,7828,13661,21489
MALIR DISTRICT,IBRAHIM HYDRI SUB-DIVISION,17,8065,14865,22930
MALIR DISTRICT,IBRAHIM HYDRI SUB-DIVISION,18,8170,14334,22504
MALIR DISTRICT,IBRAHIM HYDRI SUB-DIVISION,19,8587,16586,25173
MALIR DISTRICT,IBRAHIM HYDRI SUB-DIVISION,20,7794,14557,22351
MALIR DISTRICT,IBRAHIM HYDRI SUB-DIVISION,21,8293,15589,23882
MALIR DISTRICT,IBRAHIM HYDRI SUB-DIVISION,22,7638,14370,22008
MALIR DISTRICT,IBRAHIM HYDRI SUB-DIVISION,23,7309,13959,21268
MALIR DISTRICT,IBRAHIM HYDRI SUB-DIVISION,24,7005,13365,20370
MALIR DISTRICT,IBRAHIM HYDRI SUB-DIVISION,25,7053,12376,19429
MALIR DISTRICT,IBRAHIM HYDRI SUB-DIVISION,26,6895,12935,19830
MALIR DISTRICT,IBRAHIM HYDRI SUB-DIVISION,27,6869,12927,19796
MALIR DISTRICT,IBRAHIM HYDRI SUB-DIVISION,28,6642,12297,18939
MALIR DISTRICT,IBRAHIM HYDRI SUB-DIVISION,29,6789,12253,19042
MALIR DISTRICT,IBRAHIM HYDRI SUB-DIVISION,30,6356,11624,17980
MALIR DISTRICT,IBRAHIM HYDRI SUB-DIVISION,31,6299,11569,17868
MALIR DISTRICT,IBRAHIM HYDRI SUB-DIVISION,32,5521,10378,15899
MALIR DISTRICT,IBRAHIM HYDRI SUB-DIVISION,33,5538,10476,16014
MALIR DISTRICT,IBRAHIM HYDRI SUB-DIVISION,34,5390,9531,14921
MALIR DISTRICT,IBRAHIM HYDRI SUB-DIVISION,35,4869,8964,13833
MALIR DISTRICT,IBRAHIM HYDRI SUB-DIVISION,36,4754,8239,12993
MALIR DISTRICT,IBRAHIM HYDRI SUB-DIVISION,37,4655,8015,12670
MALIR DISTRICT,IBRAHIM HYDRI SUB-DIVISION,38,4294,8162,12456
MALIR DISTRICT,IBRAHIM HYDRI SUB-DIVISION,39,4410,7975,12385
MALIR DISTRICT,IBRAHIM HYDRI SUB-DIVISION,40,3856,7620,11476
MALIR DISTRICT,IBRAHIM HYDRI SUB-DIVISION,41,3819,6826,10645
MALIR DISTRICT,IBRAHIM HYDRI SUB-DIVISION,42,3126,5971,9097
MALIR DISTRICT,IBRAHIM HYDRI SUB-DIVISION,43,3321,6157,9478
MALIR DISTRICT,IBRAHIM HYDRI SUB-DIVISION,44,3122,5172,8294
MALIR DISTRICT,IBRAHIM HYDRI SUB-DIVISION,45,2984,5226,8210
MALIR DISTRICT,IBRAHIM HYDRI SUB-DIVISION,46,2954,4695,7649
MALIR DISTRICT,IBRAHIM HYDRI SUB-DIVISION,47,2932,4565,7497
MALIR DISTRICT,IBRAHIM HYDRI SUB-DIVISION,48,2726,4558,7284
MALIR DISTRICT,IBRAHIM HYDRI SUB-DIVISION,49,2754,4738,7492
MALIR DISTRICT,IBRAHIM HYDRI SUB-DIVISION,50,2570,4397,6967
MALIR DISTRICT,IBRAHIM HYDRI SUB-DIVISION,51,2668,4092,6760
MALIR DISTRICT,IBRAHIM HYDRI SUB-DIVISION,52,2228,3741,5969
MALIR DISTRICT,IBRAHIM HYDRI SUB-DIVISION,53,2065,3640,5705
MALIR DISTRICT,IBRAHIM HYDRI SUB-DIVISION,54,1785,3399,5184
MALIR DISTRICT,IBRAHIM HYDRI SUB-DIVISION,55,1663,3023,4686
MALIR DISTRICT,IBRAHIM HYDRI SUB-DIVISION,56,1599,2760,4359
MALIR DISTRICT,IBRAHIM HYDRI SUB-DIVISION,57,1706,2616,4322
MALIR DISTRICT,IBRAHIM HYDRI SUB-DIVISION,58,1409,2578,3987
MALIR DISTRICT,IBRAHIM HYDRI SUB-DIVISION,59,1452,2569,4021
MALIR DISTRICT,IBRAHIM HYDRI SUB-DIVISION,60,1284,2523,3807
MALIR DISTRICT,IBRAHIM HYDRI SUB-DIVISION,61,1565,2581,4146
MALIR DISTRICT,IBRAHIM HYDRI SUB-DIVISION,62,1448,2256,3704
MALIR DISTRICT,IBRAHIM HYDRI SUB-DIVISION,63,1446,2386,3832
MALIR DISTRICT,IBRAHIM HYDRI SUB-DIVISION,64,1109,2014,3123
MALIR DISTRICT,IBRAHIM HYDRI SUB-DIVISION,65,881,1605,2486
MALIR DISTRICT,IBRAHIM HYDRI SUB-DIVISION,66,871,1405,2276
MALIR DISTRICT,IBRAHIM HYDRI SUB-DIVISION,67,853,1349,2202
MALIR DISTRICT,IBRAHIM HYDRI SUB-DIVISION,68,861,1369,2230
MALIR DISTRICT,IBRAHIM HYDRI SUB-DIVISION,69,635,1200,1835
MALIR DISTRICT,IBRAHIM HYDRI SUB-DIVISION,70,529,927,1456
MALIR DISTRICT,IBRAHIM HYDRI SUB-DIVISION,71,572,889,1461
MALIR DISTRICT,IBRAHIM HYDRI SUB-DIVISION,72,535,766,1301
MALIR DISTRICT,IBRAHIM HYDRI SUB-DIVISION,73,570,917,1487
MALIR DISTRICT,IBRAHIM HYDRI SUB-DIVISION,74,358,636,994
MALIR DISTRICT,IBRAHIM HYDRI SUB-DIVISION,>=75,2927,4698,7625
MALIR DISTRICT,MURAD MEMON SUB-DIVISION,<1,2990,4411,7401
MALIR DISTRICT,MURAD MEMON SUB-DIVISION,1,3387,4369,7756
MALIR DISTRICT,MURAD MEMON SUB-DIVISION,2,3403,4662,8065
MALIR DISTRICT,MURAD MEMON SUB-DIVISION,3,3883,5077,8960
MALIR DISTRICT,MURAD MEMON SUB-DIVISION,4,3529,4663,8192
MALIR DISTRICT,MURAD MEMON SUB-DIVISION,5,3659,4658,8317
MALIR DISTRICT,MURAD MEMON SUB-DIVISION,6,3499,4733,8232
MALIR DISTRICT,MURAD MEMON SUB-DIVISION,7,3776,4768,8544
MALIR DISTRICT,MURAD MEMON SUB-DIVISION,8,3491,4328,7819
MALIR DISTRICT,MURAD MEMON SUB-DIVISION,9,3331,4704,8035
MALIR DISTRICT,MURAD MEMON SUB-DIVISION,10,3107,3821,6928
MALIR DISTRICT,MURAD MEMON SUB-DIVISION,11,3036,4539,7575
MALIR DISTRICT,MURAD MEMON SUB-DIVISION,12,2800,3764,6564
MALIR DISTRICT,MURAD MEMON SUB-DIVISION,13,2854,4095,6949
MALIR DISTRICT,MURAD MEMON SUB-DIVISION,14,2641,3630,6271
MALIR DISTRICT,MURAD MEMON SUB-DIVISION,15,2674,3791,6465
MALIR DISTRICT,MURAD MEMON SUB-DIVISION,16,2714,4093,6807
MALIR DISTRICT,MURAD MEMON SUB-DIVISION,17,2931,4314,7245
MALIR DISTRICT,MURAD MEMON SUB-DIVISION,18,2723,3794,6517
MALIR DISTRICT,MURAD MEMON SUB-DIVISION,19,2956,4319,7275
MALIR DISTRICT,MURAD MEMON SUB-DIVISION,20,2689,3746,6435
MALIR DISTRICT,MURAD MEMON SUB-DIVISION,21,2856,4234,7090
MALIR DISTRICT,MURAD MEMON SUB-DIVISION,22,2554,3909,6463
MALIR DISTRICT,MURAD MEMON SUB-DIVISION,23,2365,3964,6329
MALIR DISTRICT,MURAD MEMON SUB-DIVISION,24,2348,4015,6363
MALIR DISTRICT,MURAD MEMON SUB-DIVISION,25,2225,3538,5763
MALIR DISTRICT,MURAD MEMON SUB-DIVISION,26,2226,3986,6212
MALIR DISTRICT,MURAD MEMON SUB-DIVISION,27,2312,3793,6105
MALIR DISTRICT,MURAD MEMON SUB-DIVISION,28,2159,3894,6053
MALIR DISTRICT,MURAD MEMON SUB-DIVISION,29,2423,3820,6243
MALIR DISTRICT,MURAD MEMON SUB-DIVISION,30,2127,3607,5734
MALIR DISTRICT,MURAD MEMON SUB-DIVISION,31,2289,3837,6126
MALIR DISTRICT,MURAD MEMON SUB-DIVISION,32,1896,3586,5482
MALIR DISTRICT,MURAD MEMON SUB-DIVISION,33,2051,3420,5471
MALIR DISTRICT,MURAD MEMON SUB-DIVISION,34,1915,3246,5161
MALIR DISTRICT,MURAD MEMON SUB-DIVISION,35,1626,2829,4455
MALIR DISTRICT,MURAD MEMON SUB-DIVISION,36,1695,3064,4759
MALIR DISTRICT,MURAD MEMON SUB-DIVISION,37,1640,2791,4431
MALIR DISTRICT,MURAD MEMON SUB-DIVISION,38,1515,2903,4418
MALIR DISTRICT,MURAD MEMON SUB-DIVISION,39,1647,2765,4412
MALIR DISTRICT,MURAD MEMON SUB-DIVISION,40,1301,2404,3705
MALIR DISTRICT,MURAD MEMON SUB-DIVISION,41,1490,2464,3954
MALIR DISTRICT,MURAD MEMON SUB-DIVISION,42,1182,2155,3337
MALIR DISTRICT,MURAD MEMON SUB-DIVISION,43,1287,2223,3510
MALIR DISTRICT,MURAD MEMON SUB-DIVISION,44,1168,1976,3144
MALIR DISTRICT,MURAD MEMON SUB-DIVISION,45,902,1717,2619
MALIR DISTRICT,MURAD MEMON SUB-DIVISION,46,1124,1724,2848
MALIR DISTRICT,MURAD MEMON SUB-DIVISION,47,979,1637,2616
MALIR DISTRICT,MURAD MEMON SUB-DIVISION,48,1033,1817,2850
MALIR DISTRICT,MURAD MEMON SUB-DIVISION,49,1012,1822,2834
MALIR DISTRICT,MURAD MEMON SUB-DIVISION,50,786,1642,2428
MALIR DISTRICT,MURAD MEMON SUB-DIVISION,51,920,1739,2659
MALIR DISTRICT,MURAD MEMON SUB-DIVISION,52,767,1437,2204
MALIR DISTRICT,MURAD MEMON SUB-DIVISION,53,732,1567,2299
MALIR DISTRICT,MURAD MEMON SUB-DIVISION,54,629,1342,1971
MALIR DISTRICT,MURAD MEMON SUB-DIVISION,55,532,1221,1753
MALIR DISTRICT,MURAD MEMON SUB-DIVISION,56,602,1188,1790
MALIR DISTRICT,MURAD MEMON SUB-DIVISION,57,536,1087,1623
MALIR DISTRICT,MURAD MEMON SUB-DIVISION,58,547,1051,1598
MALIR DISTRICT,MURAD MEMON SUB-DIVISION,59,552,1053,1605
MALIR DISTRICT,MURAD MEMON SUB-DIVISION,60,486,852,1338
MALIR DISTRICT,MURAD MEMON SUB-DIVISION,61,568,1007,1575
MALIR DISTRICT,MURAD MEMON SUB-DIVISION,62,488,900,1388
MALIR DISTRICT,MURAD MEMON SUB-DIVISION,63,542,900,1442
MALIR DISTRICT,MURAD MEMON SUB-DIVISION,64,388,776,1164
MALIR DISTRICT,MURAD MEMON SUB-DIVISION,65,302,592,894
MALIR DISTRICT,MURAD MEMON SUB-DIVISION,66,292,576,868
MALIR DISTRICT,MURAD MEMON SUB-DIVISION,67,290,476,766
MALIR DISTRICT,MURAD MEMON SUB-DIVISION,68,288,542,830
MALIR DISTRICT,MURAD MEMON SUB-DIVISION,69,256,497,753
MALIR DISTRICT,MURAD MEMON SUB-DIVISION,70,181,390,571
MALIR DISTRICT,MURAD MEMON SUB-DIVISION,71,201,394,595
MALIR DISTRICT,MURAD MEMON SUB-DIVISION,72,185,340,525
MALIR DISTRICT,MURAD MEMON SUB-DIVISION,73,184,383,567
MALIR DISTRICT,MURAD MEMON SUB-DIVISION,74,134,264,398
MALIR DISTRICT,MURAD MEMON SUB-DIVISION,>=75,953,1930,2883
MALIR DISTRICT,SHAH MUREED SUB-DIVISION,<1,711,0,711
MALIR DISTRICT,SHAH MUREED SUB-DIVISION,1,780,0,780
MALIR DISTRICT,SHAH MUREED SUB-DIVISION,2,810,0,810
MALIR DISTRICT,SHAH MUREED SUB-DIVISION,3,908,0,908
MALIR DISTRICT,SHAH MUREED SUB-DIVISION,4,918,0,918
MALIR DISTRICT,SHAH MUREED SUB-DIVISION,5,902,0,902
MALIR DISTRICT,SHAH MUREED SUB-DIVISION,6,882,0,882
MALIR DISTRICT,SHAH MUREED SUB-DIVISION,7,902,0,902
MALIR DISTRICT,SHAH MUREED SUB-DIVISION,8,893,0,893
MALIR DISTRICT,SHAH MUREED SUB-DIVISION,9,843,0,843
MALIR DISTRICT,SHAH MUREED SUB-DIVISION,10,838,0,838
MALIR DISTRICT,SHAH MUREED SUB-DIVISION,11,792,0,792
MALIR DISTRICT,SHAH MUREED SUB-DIVISION,12,761,0,761
MALIR DISTRICT,SHAH MUREED SUB-DIVISION,13,612,0,612
MALIR DISTRICT,SHAH MUREED SUB-DIVISION,14,666,0,666
MALIR DISTRICT,SHAH MUREED SUB-DIVISION,15,589,0,589
MALIR DISTRICT,SHAH MUREED SUB-DIVISION,16,599,0,599
MALIR DISTRICT,SHAH MUREED SUB-DIVISION,17,609,0,609
MALIR DISTRICT,SHAH MUREED SUB-DIVISION,18,569,0,569
MALIR DISTRICT,SHAH MUREED SUB-DIVISION,19,681,0,681
MALIR DISTRICT,SHAH MUREED SUB-DIVISION,20,558,0,558
MALIR DISTRICT,SHAH MUREED SUB-DIVISION,21,565,0,565
MALIR DISTRICT,SHAH MUREED SUB-DIVISION,22,523,0,523
MALIR DISTRICT,SHAH MUREED SUB-DIVISION,23,495,0,495
MALIR DISTRICT,SHAH MUREED SUB-DIVISION,24,415,0,415
MALIR DISTRICT,SHAH MUREED SUB-DIVISION,25,450,0,450
MALIR DISTRICT,SHAH MUREED SUB-DIVISION,26,412,0,412
MALIR DISTRICT,SHAH MUREED SUB-DIVISION,27,550,0,550
MALIR DISTRICT,SHAH MUREED SUB-DIVISION,28,442,0,442
MALIR DISTRICT,SHAH MUREED SUB-DIVISION,29,554,0,554
MALIR DISTRICT,SHAH MUREED SUB-DIVISION,30,392,0,392
MALIR DISTRICT,SHAH MUREED SUB-DIVISION,31,482,0,482
MALIR DISTRICT,SHAH MUREED SUB-DIVISION,32,427,0,427
MALIR DISTRICT,SHAH MUREED SUB-DIVISION,33,381,0,381
MALIR DISTRICT,SHAH MUREED SUB-DIVISION,34,449,0,449
MALIR DISTRICT,SHAH MUREED SUB-DIVISION,35,384,0,384
MALIR DISTRICT,SHAH MUREED SUB-DIVISION,36,335,0,335
MALIR DISTRICT,SHAH MUREED SUB-DIVISION,37,492,0,492
MALIR DISTRICT,SHAH MUREED SUB-DIVISION,38,350,0,350
MALIR DISTRICT,SHAH MUREED SUB-DIVISION,39,382,0,382
MALIR DISTRICT,SHAH MUREED SUB-DIVISION,40,238,0,238
MALIR DISTRICT,SHAH MUREED SUB-DIVISION,41,318,0,318
MALIR DISTRICT,SHAH MUREED SUB-DIVISION,42,265,0,265
MALIR DISTRICT,SHAH MUREED SUB-DIVISION,43,236,0,236
MALIR DISTRICT,SHAH MUREED SUB-DIVISION,44,261,0,261
MALIR DISTRICT,SHAH MUREED SUB-DIVISION,45,224,0,224
MALIR DISTRICT,SHAH MUREED SUB-DIVISION,46,248,0,248
MALIR DISTRICT,SHAH MUREED SUB-DIVISION,47,294,0,294
MALIR DISTRICT,SHAH MUREED SUB-DIVISION,48,214,0,214
MALIR DISTRICT,SHAH MUREED SUB-DIVISION,49,225,0,225
MALIR DISTRICT,SHAH MUREED SUB-DIVISION,50,136,0,136
MALIR DISTRICT,SHAH MUREED SUB-DIVISION,51,204,0,204
MALIR DISTRICT,SHAH MUREED SUB-DIVISION,52,183,0,183
MALIR DISTRICT,SHAH MUREED SUB-DIVISION,53,166,0,166
MALIR DISTRICT,SHAH MUREED SUB-DIVISION,54,143,0,143
MALIR DISTRICT,SHAH MUREED SUB-DIVISION,55,108,0,108
MALIR DISTRICT,SHAH MUREED SUB-DIVISION,56,124,0,124
MALIR DISTRICT,SHAH MUREED SUB-DIVISION,57,162,0,162
MALIR DISTRICT,SHAH MUREED SUB-DIVISION,58,121,0,121
MALIR DISTRICT,SHAH MUREED SUB-DIVISION,59,132,0,132
MALIR DISTRICT,SHAH MUREED SUB-DIVISION,60,83,0,83
MALIR DISTRICT,SHAH MUREED SUB-DIVISION,61,131,0,131
MALIR DISTRICT,SHAH MUREED SUB-DIVISION,62,116,0,116
MALIR DISTRICT,SHAH MUREED SUB-DIVISION,63,113,0,113
MALIR DISTRICT,SHAH MUREED SUB-DIVISION,64,113,0,113
MALIR DISTRICT,SHAH MUREED SUB-DIVISION,65,56,0,56
MALIR DISTRICT,SHAH MUREED SUB-DIVISION,66,75,0,75
MALIR DISTRICT,SHAH MUREED SUB-DIVISION,67,93,0,93
MALIR DISTRICT,SHAH MUREED SUB-DIVISION,68,76,0,76
MALIR DISTRICT,SHAH MUREED SUB-DIVISION,69,74,0,74
MALIR DISTRICT,SHAH MUREED SUB-DIVISION,70,45,0,45
MALIR DISTRICT,SHAH MUREED SUB-DIVISION,71,52,0,52
MALIR DISTRICT,SHAH MUREED SUB-DIVISION,72,70,0,70
MALIR DISTRICT,SHAH MUREED SUB-DIVISION,73,53,0,53
MALIR DISTRICT,SHAH MUREED SUB-DIVISION,74,45,0,45
MALIR DISTRICT,SHAH MUREED SUB-DIVISION,>=75,346,0,346
MANDI BAHAUDDIN DISTRICT,MALAKWAL TEHSIL,<1,7244,944,8188
MANDI BAHAUDDIN DISTRICT,MALAKWAL TEHSIL,1,7644,932,8576
MANDI BAHAUDDIN DISTRICT,MALAKWAL TEHSIL,2,8029,1029,9058
MANDI BAHAUDDIN DISTRICT,MALAKWAL TEHSIL,3,8654,1004,9658
MANDI BAHAUDDIN DISTRICT,MALAKWAL TEHSIL,4,8729,938,9667
MANDI BAHAUDDIN DISTRICT,MALAKWAL TEHSIL,5,8504,959,9463
MANDI BAHAUDDIN DISTRICT,MALAKWAL TEHSIL,6,8391,945,9336
MANDI BAHAUDDIN DISTRICT,MALAKWAL TEHSIL,7,8454,1028,9482
MANDI BAHAUDDIN DISTRICT,MALAKWAL TEHSIL,8,8176,901,9077
MANDI BAHAUDDIN DISTRICT,MALAKWAL TEHSIL,9,8149,1026,9175
MANDI BAHAUDDIN DISTRICT,MALAKWAL TEHSIL,10,7975,882,8857
MANDI BAHAUDDIN DISTRICT,MALAKWAL TEHSIL,11,8049,1052,9101
MANDI BAHAUDDIN DISTRICT,MALAKWAL TEHSIL,12,7485,896,8381
MANDI BAHAUDDIN DISTRICT,MALAKWAL TEHSIL,13,7249,985,8234
MANDI BAHAUDDIN DISTRICT,MALAKWAL TEHSIL,14,7209,907,8116
MANDI BAHAUDDIN DISTRICT,MALAKWAL TEHSIL,15,7168,847,8015
MANDI BAHAUDDIN DISTRICT,MALAKWAL TEHSIL,16,7244,856,8100
MANDI BAHAUDDIN DISTRICT,MALAKWAL TEHSIL,17,7142,906,8048
MANDI BAHAUDDIN DISTRICT,MALAKWAL TEHSIL,18,6303,779,7082
MANDI BAHAUDDIN DISTRICT,MALAKWAL TEHSIL,19,6614,911,7525
MANDI BAHAUDDIN DISTRICT,MALAKWAL TEHSIL,20,6294,758,7052
MANDI BAHAUDDIN DISTRICT,MALAKWAL TEHSIL,21,6045,893,6938
MANDI BAHAUDDIN DISTRICT,MALAKWAL TEHSIL,22,5934,810,6744
MANDI BAHAUDDIN DISTRICT,MALAKWAL TEHSIL,23,5458,804,6262
MANDI BAHAUDDIN DISTRICT,MALAKWAL TEHSIL,24,5256,843,6099
MANDI BAHAUDDIN DISTRICT,MALAKWAL TEHSIL,25,5390,719,6109
MANDI BAHAUDDIN DISTRICT,MALAKWAL TEHSIL,26,4912,759,5671
MANDI BAHAUDDIN DISTRICT,MALAKWAL TEHSIL,27,4650,804,5454
MANDI BAHAUDDIN DISTRICT,MALAKWAL TEHSIL,28,4807,742,5549
MANDI BAHAUDDIN DISTRICT,MALAKWAL TEHSIL,29,4521,733,5254
MANDI BAHAUDDIN DISTRICT,MALAKWAL TEHSIL,30,5281,627,5908
MANDI BAHAUDDIN DISTRICT,MALAKWAL TEHSIL,31,4061,649,4710
MANDI BAHAUDDIN DISTRICT,MALAKWAL TEHSIL,32,4057,677,4734
MANDI BAHAUDDIN DISTRICT,MALAKWAL TEHSIL,33,3818,648,4466
MANDI BAHAUDDIN DISTRICT,MALAKWAL TEHSIL,34,3466,569,4035
MANDI BAHAUDDIN DISTRICT,MALAKWAL TEHSIL,35,4524,574,5098
MANDI BAHAUDDIN DISTRICT,MALAKWAL TEHSIL,36,3673,526,4199
MANDI BAHAUDDIN DISTRICT,MALAKWAL TEHSIL,37,3167,525,3692
MANDI BAHAUDDIN DISTRICT,MALAKWAL TEHSIL,38,3860,574,4434
MANDI BAHAUDDIN DISTRICT,MALAKWAL TEHSIL,39,3355,529,3884
MANDI BAHAUDDIN DISTRICT,MALAKWAL TEHSIL,40,4245,566,4811
MANDI BAHAUDDIN DISTRICT,MALAKWAL TEHSIL,41,2959,430,3389
MANDI BAHAUDDIN DISTRICT,MALAKWAL TEHSIL,42,3132,447,3579
MANDI BAHAUDDIN DISTRICT,MALAKWAL TEHSIL,43,2816,423,3239
MANDI BAHAUDDIN DISTRICT,MALAKWAL TEHSIL,44,2630,398,3028
MANDI BAHAUDDIN DISTRICT,MALAKWAL TEHSIL,45,3456,443,3899
MANDI BAHAUDDIN DISTRICT,MALAKWAL TEHSIL,46,2613,367,2980
MANDI BAHAUDDIN DISTRICT,MALAKWAL TEHSIL,47,2507,374,2881
MANDI BAHAUDDIN DISTRICT,MALAKWAL TEHSIL,48,3269,435,3704
MANDI BAHAUDDIN DISTRICT,MALAKWAL TEHSIL,49,2847,437,3284
MANDI BAHAUDDIN DISTRICT,MALAKWAL TEHSIL,50,3452,441,3893
MANDI BAHAUDDIN DISTRICT,MALAKWAL TEHSIL,51,2592,416,3008
MANDI BAHAUDDIN DISTRICT,MALAKWAL TEHSIL,52,2647,371,3018
MANDI BAHAUDDIN DISTRICT,MALAKWAL TEHSIL,53,2603,360,2963
MANDI BAHAUDDIN DISTRICT,MALAKWAL TEHSIL,54,2442,326,2768
MANDI BAHAUDDIN DISTRICT,MALAKWAL TEHSIL,55,2782,370,3152
MANDI BAHAUDDIN DISTRICT,MALAKWAL TEHSIL,56,1920,251,2171
MANDI BAHAUDDIN DISTRICT,MALAKWAL TEHSIL,57,1587,235,1822
MANDI BAHAUDDIN DISTRICT,MALAKWAL TEHSIL,58,1821,250,2071
MANDI BAHAUDDIN DISTRICT,MALAKWAL TEHSIL,59,1778,259,2037
MANDI BAHAUDDIN DISTRICT,MALAKWAL TEHSIL,60,2341,247,2588
MANDI BAHAUDDIN DISTRICT,MALAKWAL TEHSIL,61,1748,288,2036
MANDI BAHAUDDIN DISTRICT,MALAKWAL TEHSIL,62,1723,218,1941
MANDI BAHAUDDIN DISTRICT,MALAKWAL TEHSIL,63,1544,215,1759
MANDI BAHAUDDIN DISTRICT,MALAKWAL TEHSIL,64,1296,233,1529
MANDI BAHAUDDIN DISTRICT,MALAKWAL TEHSIL,65,1848,191,2039
MANDI BAHAUDDIN DISTRICT,MALAKWAL TEHSIL,66,1262,147,1409
MANDI BAHAUDDIN DISTRICT,MALAKWAL TEHSIL,67,1004,115,1119
MANDI BAHAUDDIN DISTRICT,MALAKWAL TEHSIL,68,1148,148,1296
MANDI BAHAUDDIN DISTRICT,MALAKWAL TEHSIL,69,1007,110,1117
MANDI BAHAUDDIN DISTRICT,MALAKWAL TEHSIL,70,1492,141,1633
MANDI BAHAUDDIN DISTRICT,MALAKWAL TEHSIL,71,1112,128,1240
MANDI BAHAUDDIN DISTRICT,MALAKWAL TEHSIL,72,1017,114,1131
MANDI BAHAUDDIN DISTRICT,MALAKWAL TEHSIL,73,894,135,1029
MANDI BAHAUDDIN DISTRICT,MALAKWAL TEHSIL,74,756,79,835
MANDI BAHAUDDIN DISTRICT,MALAKWAL TEHSIL,>=75,7517,825,8342
MANDI BAHAUDDIN DISTRICT,MANDI BAHAUDDIN TEHSIL,<1,10275,5000,15275
MANDI BAHAUDDIN DISTRICT,MANDI BAHAUDDIN TEHSIL,1,11171,5063,16234
MANDI BAHAUDDIN DISTRICT,MANDI BAHAUDDIN TEHSIL,2,11177,5195,16372
MANDI BAHAUDDIN DISTRICT,MANDI BAHAUDDIN TEHSIL,3,11857,5550,17407
MANDI BAHAUDDIN DISTRICT,MANDI BAHAUDDIN TEHSIL,4,11489,5205,16694
MANDI BAHAUDDIN DISTRICT,MANDI BAHAUDDIN TEHSIL,5,11666,5301,16967
MANDI BAHAUDDIN DISTRICT,MANDI BAHAUDDIN TEHSIL,6,11624,5251,16875
MANDI BAHAUDDIN DISTRICT,MANDI BAHAUDDIN TEHSIL,7,11633,5666,17299
MANDI BAHAUDDIN DISTRICT,MANDI BAHAUDDIN TEHSIL,8,10532,4920,15452
MANDI BAHAUDDIN DISTRICT,MANDI BAHAUDDIN TEHSIL,9,11431,5342,16773
MANDI BAHAUDDIN DISTRICT,MANDI BAHAUDDIN TEHSIL,10,9761,4458,14219
MANDI BAHAUDDIN DISTRICT,MANDI BAHAUDDIN TEHSIL,11,11315,5593,16908
MANDI BAHAUDDIN DISTRICT,MANDI BAHAUDDIN TEHSIL,12,9800,4416,14216
MANDI BAHAUDDIN DISTRICT,MANDI BAHAUDDIN TEHSIL,13,10366,4892,15258
MANDI BAHAUDDIN DISTRICT,MANDI BAHAUDDIN TEHSIL,14,9758,4568,14326
MANDI BAHAUDDIN DISTRICT,MANDI BAHAUDDIN TEHSIL,15,10018,4574,14592
MANDI BAHAUDDIN DISTRICT,MANDI BAHAUDDIN TEHSIL,16,9852,4657,14509
MANDI BAHAUDDIN DISTRICT,MANDI BAHAUDDIN TEHSIL,17,10047,4826,14873
MANDI BAHAUDDIN DISTRICT,MANDI BAHAUDDIN TEHSIL,18,8591,3954,12545
MANDI BAHAUDDIN DISTRICT,MANDI BAHAUDDIN TEHSIL,19,9786,4711,14497
MANDI BAHAUDDIN DISTRICT,MANDI BAHAUDDIN TEHSIL,20,7896,3788,11684
MANDI BAHAUDDIN DISTRICT,MANDI BAHAUDDIN TEHSIL,21,9245,4787,14032
MANDI BAHAUDDIN DISTRICT,MANDI BAHAUDDIN TEHSIL,22,8009,4053,12062
MANDI BAHAUDDIN DISTRICT,MANDI BAHAUDDIN TEHSIL,23,8045,4181,12226
MANDI BAHAUDDIN DISTRICT,MANDI BAHAUDDIN TEHSIL,24,7442,4073,11515
MANDI BAHAUDDIN DISTRICT,MANDI BAHAUDDIN TEHSIL,25,6909,3361,10270
MANDI BAHAUDDIN DISTRICT,MANDI BAHAUDDIN TEHSIL,26,7102,3882,10984
MANDI BAHAUDDIN DISTRICT,MANDI BAHAUDDIN TEHSIL,27,6975,3815,10790
MANDI BAHAUDDIN DISTRICT,MANDI BAHAUDDIN TEHSIL,28,6435,3539,9974
MANDI BAHAUDDIN DISTRICT,MANDI BAHAUDDIN TEHSIL,29,6815,3675,10490
MANDI BAHAUDDIN DISTRICT,MANDI BAHAUDDIN TEHSIL,30,6466,3145,9611
MANDI BAHAUDDIN DISTRICT,MANDI BAHAUDDIN TEHSIL,31,6163,3500,9663
MANDI BAHAUDDIN DISTRICT,MANDI BAHAUDDIN TEHSIL,32,5731,3295,9026
MANDI BAHAUDDIN DISTRICT,MANDI BAHAUDDIN TEHSIL,33,5392,3167,8559
MANDI BAHAUDDIN DISTRICT,MANDI BAHAUDDIN TEHSIL,34,5057,2836,7893
MANDI BAHAUDDIN DISTRICT,MANDI BAHAUDDIN TEHSIL,35,5416,2723,8139
MANDI BAHAUDDIN DISTRICT,MANDI BAHAUDDIN TEHSIL,36,5300,2756,8056
MANDI BAHAUDDIN DISTRICT,MANDI BAHAUDDIN TEHSIL,37,5134,2587,7721
MANDI BAHAUDDIN DISTRICT,MANDI BAHAUDDIN TEHSIL,38,4959,2725,7684
MANDI BAHAUDDIN DISTRICT,MANDI BAHAUDDIN TEHSIL,39,4933,2495,7428
MANDI BAHAUDDIN DISTRICT,MANDI BAHAUDDIN TEHSIL,40,4595,2524,7119
MANDI BAHAUDDIN DISTRICT,MANDI BAHAUDDIN TEHSIL,41,4308,2414,6722
MANDI BAHAUDDIN DISTRICT,MANDI BAHAUDDIN TEHSIL,42,4041,2283,6324
MANDI BAHAUDDIN DISTRICT,MANDI BAHAUDDIN TEHSIL,43,3896,2168,6064
MANDI BAHAUDDIN DISTRICT,MANDI BAHAUDDIN TEHSIL,44,3658,1923,5581
MANDI BAHAUDDIN DISTRICT,MANDI BAHAUDDIN TEHSIL,45,3959,1963,5922
MANDI BAHAUDDIN DISTRICT,MANDI BAHAUDDIN TEHSIL,46,3794,1751,5545
MANDI BAHAUDDIN DISTRICT,MANDI BAHAUDDIN TEHSIL,47,3814,1863,5677
MANDI BAHAUDDIN DISTRICT,MANDI BAHAUDDIN TEHSIL,48,4054,1987,6041
MANDI BAHAUDDIN DISTRICT,MANDI BAHAUDDIN TEHSIL,49,4066,1899,5965
MANDI BAHAUDDIN DISTRICT,MANDI BAHAUDDIN TEHSIL,50,3949,1976,5925
MANDI BAHAUDDIN DISTRICT,MANDI BAHAUDDIN TEHSIL,51,3952,1797,5749
MANDI BAHAUDDIN DISTRICT,MANDI BAHAUDDIN TEHSIL,52,3640,1747,5387
MANDI BAHAUDDIN DISTRICT,MANDI BAHAUDDIN TEHSIL,53,3522,1687,5209
MANDI BAHAUDDIN DISTRICT,MANDI BAHAUDDIN TEHSIL,54,3181,1602,4783
MANDI BAHAUDDIN DISTRICT,MANDI BAHAUDDIN TEHSIL,55,3184,1435,4619
MANDI BAHAUDDIN DISTRICT,MANDI BAHAUDDIN TEHSIL,56,2725,1240,3965
MANDI BAHAUDDIN DISTRICT,MANDI BAHAUDDIN TEHSIL,57,2481,1081,3562
MANDI BAHAUDDIN DISTRICT,MANDI BAHAUDDIN TEHSIL,58,2439,1130,3569
MANDI BAHAUDDIN DISTRICT,MANDI BAHAUDDIN TEHSIL,59,2680,1125,3805
MANDI BAHAUDDIN DISTRICT,MANDI BAHAUDDIN TEHSIL,60,2793,1205,3998
MANDI BAHAUDDIN DISTRICT,MANDI BAHAUDDIN TEHSIL,61,2747,1177,3924
MANDI BAHAUDDIN DISTRICT,MANDI BAHAUDDIN TEHSIL,62,2537,1153,3690
MANDI BAHAUDDIN DISTRICT,MANDI BAHAUDDIN TEHSIL,63,2365,1068,3433
MANDI BAHAUDDIN DISTRICT,MANDI BAHAUDDIN TEHSIL,64,1960,853,2813
MANDI BAHAUDDIN DISTRICT,MANDI BAHAUDDIN TEHSIL,65,2089,729,2818
MANDI BAHAUDDIN DISTRICT,MANDI BAHAUDDIN TEHSIL,66,1917,588,2505
MANDI BAHAUDDIN DISTRICT,MANDI BAHAUDDIN TEHSIL,67,1689,602,2291
MANDI BAHAUDDIN DISTRICT,MANDI BAHAUDDIN TEHSIL,68,1396,556,1952
MANDI BAHAUDDIN DISTRICT,MANDI BAHAUDDIN TEHSIL,69,1324,515,1839
MANDI BAHAUDDIN DISTRICT,MANDI BAHAUDDIN TEHSIL,70,1656,616,2272
MANDI BAHAUDDIN DISTRICT,MANDI BAHAUDDIN TEHSIL,71,1617,551,2168
MANDI BAHAUDDIN DISTRICT,MANDI BAHAUDDIN TEHSIL,72,1317,518,1835
MANDI BAHAUDDIN DISTRICT,MANDI BAHAUDDIN TEHSIL,73,1148,413,1561
MANDI BAHAUDDIN DISTRICT,MANDI BAHAUDDIN TEHSIL,74,930,316,1246
MANDI BAHAUDDIN DISTRICT,MANDI BAHAUDDIN TEHSIL,>=75,10310,3252,13562
MANDI BAHAUDDIN DISTRICT,PHALIA TEHSIL,<1,11376,1533,12909
MANDI BAHAUDDIN DISTRICT,PHALIA TEHSIL,1,11685,1586,13271
MANDI BAHAUDDIN DISTRICT,PHALIA TEHSIL,2,12078,1632,13710
MANDI BAHAUDDIN DISTRICT,PHALIA TEHSIL,3,13110,1730,14840
MANDI BAHAUDDIN DISTRICT,PHALIA TEHSIL,4,12562,1588,14150
MANDI BAHAUDDIN DISTRICT,PHALIA TEHSIL,5,12651,1634,14285
MANDI BAHAUDDIN DISTRICT,PHALIA TEHSIL,6,12843,1721,14564
MANDI BAHAUDDIN DISTRICT,PHALIA TEHSIL,7,12715,1649,14364
MANDI BAHAUDDIN DISTRICT,PHALIA TEHSIL,8,12010,1501,13511
MANDI BAHAUDDIN DISTRICT,PHALIA TEHSIL,9,12287,1616,13903
MANDI BAHAUDDIN DISTRICT,PHALIA TEHSIL,10,11131,1330,12461
MANDI BAHAUDDIN DISTRICT,PHALIA TEHSIL,11,11833,1715,13548
MANDI BAHAUDDIN DISTRICT,PHALIA TEHSIL,12,10791,1406,12197
MANDI BAHAUDDIN DISTRICT,PHALIA TEHSIL,13,11083,1523,12606
MANDI BAHAUDDIN DISTRICT,PHALIA TEHSIL,14,10636,1419,12055
MANDI BAHAUDDIN DISTRICT,PHALIA TEHSIL,15,10392,1480,11872
MANDI BAHAUDDIN DISTRICT,PHALIA TEHSIL,16,10842,1517,12359
MANDI BAHAUDDIN DISTRICT,PHALIA TEHSIL,17,9997,1483,11480
MANDI BAHAUDDIN DISTRICT,PHALIA TEHSIL,18,9441,1159,10600
MANDI BAHAUDDIN DISTRICT,PHALIA TEHSIL,19,10086,1388,11474
MANDI BAHAUDDIN DISTRICT,PHALIA TEHSIL,20,8704,1116,9820
MANDI BAHAUDDIN DISTRICT,PHALIA TEHSIL,21,9627,1385,11012
MANDI BAHAUDDIN DISTRICT,PHALIA TEHSIL,22,8758,1175,9933
MANDI BAHAUDDIN DISTRICT,PHALIA TEHSIL,23,8389,1195,9584
MANDI BAHAUDDIN DISTRICT,PHALIA TEHSIL,24,7978,1233,9211
MANDI BAHAUDDIN DISTRICT,PHALIA TEHSIL,25,7506,983,8489
MANDI BAHAUDDIN DISTRICT,PHALIA TEHSIL,26,7568,1140,8708
MANDI BAHAUDDIN DISTRICT,PHALIA TEHSIL,27,7203,1098,8301
MANDI BAHAUDDIN DISTRICT,PHALIA TEHSIL,28,7126,1084,8210
MANDI BAHAUDDIN DISTRICT,PHALIA TEHSIL,29,7089,1102,8191
MANDI BAHAUDDIN DISTRICT,PHALIA TEHSIL,30,7092,857,7949
MANDI BAHAUDDIN DISTRICT,PHALIA TEHSIL,31,6572,980,7552
MANDI BAHAUDDIN DISTRICT,PHALIA TEHSIL,32,6172,897,7069
MANDI BAHAUDDIN DISTRICT,PHALIA TEHSIL,33,5735,932,6667
MANDI BAHAUDDIN DISTRICT,PHALIA TEHSIL,34,5359,860,6219
MANDI BAHAUDDIN DISTRICT,PHALIA TEHSIL,35,5762,679,6441
MANDI BAHAUDDIN DISTRICT,PHALIA TEHSIL,36,5686,807,6493
MANDI BAHAUDDIN DISTRICT,PHALIA TEHSIL,37,5558,887,6445
MANDI BAHAUDDIN DISTRICT,PHALIA TEHSIL,38,5374,749,6123
MANDI BAHAUDDIN DISTRICT,PHALIA TEHSIL,39,5221,786,6007
MANDI BAHAUDDIN DISTRICT,PHALIA TEHSIL,40,5117,637,5754
MANDI BAHAUDDIN DISTRICT,PHALIA TEHSIL,41,4722,678,5400
MANDI BAHAUDDIN DISTRICT,PHALIA TEHSIL,42,4431,687,5118
MANDI BAHAUDDIN DISTRICT,PHALIA TEHSIL,43,4189,638,4827
MANDI BAHAUDDIN DISTRICT,PHALIA TEHSIL,44,4146,649,4795
MANDI BAHAUDDIN DISTRICT,PHALIA TEHSIL,45,4168,517,4685
MANDI BAHAUDDIN DISTRICT,PHALIA TEHSIL,46,4202,607,4809
MANDI BAHAUDDIN DISTRICT,PHALIA TEHSIL,47,4095,585,4680
MANDI BAHAUDDIN DISTRICT,PHALIA TEHSIL,48,4382,628,5010
MANDI BAHAUDDIN DISTRICT,PHALIA TEHSIL,49,4396,612,5008
MANDI BAHAUDDIN DISTRICT,PHALIA TEHSIL,50,4547,516,5063
MANDI BAHAUDDIN DISTRICT,PHALIA TEHSIL,51,4121,538,4659
MANDI BAHAUDDIN DISTRICT,PHALIA TEHSIL,52,3908,603,4511
MANDI BAHAUDDIN DISTRICT,PHALIA TEHSIL,53,3709,512,4221
MANDI BAHAUDDIN DISTRICT,PHALIA TEHSIL,54,3437,506,3943
MANDI BAHAUDDIN DISTRICT,PHALIA TEHSIL,55,3297,401,3698
MANDI BAHAUDDIN DISTRICT,PHALIA TEHSIL,56,2937,422,3359
MANDI BAHAUDDIN DISTRICT,PHALIA TEHSIL,57,2630,360,2990
MANDI BAHAUDDIN DISTRICT,PHALIA TEHSIL,58,2626,360,2986
MANDI BAHAUDDIN DISTRICT,PHALIA TEHSIL,59,2869,358,3227
MANDI BAHAUDDIN DISTRICT,PHALIA TEHSIL,60,3088,295,3383
MANDI BAHAUDDIN DISTRICT,PHALIA TEHSIL,61,2869,351,3220
MANDI BAHAUDDIN DISTRICT,PHALIA TEHSIL,62,2580,339,2919
MANDI BAHAUDDIN DISTRICT,PHALIA TEHSIL,63,2357,287,2644
MANDI BAHAUDDIN DISTRICT,PHALIA TEHSIL,64,2265,276,2541
MANDI BAHAUDDIN DISTRICT,PHALIA TEHSIL,65,2350,218,2568
MANDI BAHAUDDIN DISTRICT,PHALIA TEHSIL,66,2117,211,2328
MANDI BAHAUDDIN DISTRICT,PHALIA TEHSIL,67,1854,228,2082
MANDI BAHAUDDIN DISTRICT,PHALIA TEHSIL,68,1562,183,1745
MANDI BAHAUDDIN DISTRICT,PHALIA TEHSIL,69,1643,158,1801
MANDI BAHAUDDIN DISTRICT,PHALIA TEHSIL,70,1987,155,2142
MANDI BAHAUDDIN DISTRICT,PHALIA TEHSIL,71,1771,172,1943
MANDI BAHAUDDIN DISTRICT,PHALIA TEHSIL,72,1585,152,1737
MANDI BAHAUDDIN DISTRICT,PHALIA TEHSIL,73,1199,144,1343
MANDI BAHAUDDIN DISTRICT,PHALIA TEHSIL,74,1069,109,1178
MANDI BAHAUDDIN DISTRICT,PHALIA TEHSIL,>=75,11374,1056,12430
MANSEHRA DISTRICT,BALA KOT TEHSIL,<1,7641,0,7641
MANSEHRA DISTRICT,BALA KOT TEHSIL,1,7901,0,7901
MANSEHRA DISTRICT,BALA KOT TEHSIL,2,7546,0,7546
MANSEHRA DISTRICT,BALA KOT TEHSIL,3,8199,0,8199
MANSEHRA DISTRICT,BALA KOT TEHSIL,4,8047,0,8047
MANSEHRA DISTRICT,BALA KOT TEHSIL,5,8223,0,8223
MANSEHRA DISTRICT,BALA KOT TEHSIL,6,8167,0,8167
MANSEHRA DISTRICT,BALA KOT TEHSIL,7,8984,0,8984
MANSEHRA DISTRICT,BALA KOT TEHSIL,8,8008,0,8008
MANSEHRA DISTRICT,BALA KOT TEHSIL,9,8790,0,8790
MANSEHRA DISTRICT,BALA KOT TEHSIL,10,7087,0,7087
MANSEHRA DISTRICT,BALA KOT TEHSIL,11,7808,0,7808
MANSEHRA DISTRICT,BALA KOT TEHSIL,12,5980,0,5980
MANSEHRA DISTRICT,BALA KOT TEHSIL,13,6554,0,6554
MANSEHRA DISTRICT,BALA KOT TEHSIL,14,5751,0,5751
MANSEHRA DISTRICT,BALA KOT TEHSIL,15,5802,0,5802
MANSEHRA DISTRICT,BALA KOT TEHSIL,16,5470,0,5470
MANSEHRA DISTRICT,BALA KOT TEHSIL,17,5646,0,5646
MANSEHRA DISTRICT,BALA KOT TEHSIL,18,5201,0,5201
MANSEHRA DISTRICT,BALA KOT TEHSIL,19,5759,0,5759
MANSEHRA DISTRICT,BALA KOT TEHSIL,20,4549,0,4549
MANSEHRA DISTRICT,BALA KOT TEHSIL,21,5194,0,5194
MANSEHRA DISTRICT,BALA KOT TEHSIL,22,4615,0,4615
MANSEHRA DISTRICT,BALA KOT TEHSIL,23,4787,0,4787
MANSEHRA DISTRICT,BALA KOT TEHSIL,24,4630,0,4630
MANSEHRA DISTRICT,BALA KOT TEHSIL,25,3641,0,3641
MANSEHRA DISTRICT,BALA KOT TEHSIL,26,4305,0,4305
MANSEHRA DISTRICT,BALA KOT TEHSIL,27,4135,0,4135
MANSEHRA DISTRICT,BALA KOT TEHSIL,28,3861,0,3861
MANSEHRA DISTRICT,BALA KOT TEHSIL,29,4482,0,4482
MANSEHRA DISTRICT,BALA KOT TEHSIL,30,3232,0,3232
MANSEHRA DISTRICT,BALA KOT TEHSIL,31,4198,0,4198
MANSEHRA DISTRICT,BALA KOT TEHSIL,32,3576,0,3576
MANSEHRA DISTRICT,BALA KOT TEHSIL,33,3479,0,3479
MANSEHRA DISTRICT,BALA KOT TEHSIL,34,3480,0,3480
MANSEHRA DISTRICT,BALA KOT TEHSIL,35,2452,0,2452
MANSEHRA DISTRICT,BALA KOT TEHSIL,36,3369,0,3369
MANSEHRA DISTRICT,BALA KOT TEHSIL,37,2836,0,2836
MANSEHRA DISTRICT,BALA KOT TEHSIL,38,2689,0,2689
MANSEHRA DISTRICT,BALA KOT TEHSIL,39,2704,0,2704
MANSEHRA DISTRICT,BALA KOT TEHSIL,40,2000,0,2000
MANSEHRA DISTRICT,BALA KOT TEHSIL,41,2616,0,2616
MANSEHRA DISTRICT,BALA KOT TEHSIL,42,2133,0,2133
MANSEHRA DISTRICT,BALA KOT TEHSIL,43,2260,0,2260
MANSEHRA DISTRICT,BALA KOT TEHSIL,44,2324,0,2324
MANSEHRA DISTRICT,BALA KOT TEHSIL,45,1666,0,1666
MANSEHRA DISTRICT,BALA KOT TEHSIL,46,2337,0,2337
MANSEHRA DISTRICT,BALA KOT TEHSIL,47,2108,0,2108
MANSEHRA DISTRICT,BALA KOT TEHSIL,48,1998,0,1998
MANSEHRA DISTRICT,BALA KOT TEHSIL,49,2061,0,2061
MANSEHRA DISTRICT,BALA KOT TEHSIL,50,1572,0,1572
MANSEHRA DISTRICT,BALA KOT TEHSIL,51,2236,0,2236
MANSEHRA DISTRICT,BALA KOT TEHSIL,52,1784,0,1784
MANSEHRA DISTRICT,BALA KOT TEHSIL,53,1778,0,1778
MANSEHRA DISTRICT,BALA KOT TEHSIL,54,1634,0,1634
MANSEHRA DISTRICT,BALA KOT TEHSIL,55,1208,0,1208
MANSEHRA DISTRICT,BALA KOT TEHSIL,56,1361,0,1361
MANSEHRA DISTRICT,BALA KOT TEHSIL,57,1173,0,1173
MANSEHRA DISTRICT,BALA KOT TEHSIL,58,1242,0,1242
MANSEHRA DISTRICT,BALA KOT TEHSIL,59,1080,0,1080
MANSEHRA DISTRICT,BALA KOT TEHSIL,60,919,0,919
MANSEHRA DISTRICT,BALA KOT TEHSIL,61,1397,0,1397
MANSEHRA DISTRICT,BALA KOT TEHSIL,62,1264,0,1264
MANSEHRA DISTRICT,BALA KOT TEHSIL,63,1182,0,1182
MANSEHRA DISTRICT,BALA KOT TEHSIL,64,1110,0,1110
MANSEHRA DISTRICT,BALA KOT TEHSIL,65,803,0,803
MANSEHRA DISTRICT,BALA KOT TEHSIL,66,1020,0,1020
MANSEHRA DISTRICT,BALA KOT TEHSIL,67,999,0,999
MANSEHRA DISTRICT,BALA KOT TEHSIL,68,948,0,948
MANSEHRA DISTRICT,BALA KOT TEHSIL,69,828,0,828
MANSEHRA DISTRICT,BALA KOT TEHSIL,70,549,0,549
MANSEHRA DISTRICT,BALA KOT TEHSIL,71,827,0,827
MANSEHRA DISTRICT,BALA KOT TEHSIL,72,803,0,803
MANSEHRA DISTRICT,BALA KOT TEHSIL,73,702,0,702
MANSEHRA DISTRICT,BALA KOT TEHSIL,74,555,0,555
MANSEHRA DISTRICT,BALA KOT TEHSIL,>=75,4002,0,4002
MANSEHRA DISTRICT,MANSEHRA TEHSIL,<1,24358,3564,27922
MANSEHRA DISTRICT,MANSEHRA TEHSIL,1,24112,3366,27478
MANSEHRA DISTRICT,MANSEHRA TEHSIL,2,24333,3355,27688
MANSEHRA DISTRICT,MANSEHRA TEHSIL,3,26038,4004,30042
MANSEHRA DISTRICT,MANSEHRA TEHSIL,4,24766,3516,28282
MANSEHRA DISTRICT,MANSEHRA TEHSIL,5,26011,3740,29751
MANSEHRA DISTRICT,MANSEHRA TEHSIL,6,24735,3553,28288
MANSEHRA DISTRICT,MANSEHRA TEHSIL,7,26839,4020,30859
MANSEHRA DISTRICT,MANSEHRA TEHSIL,8,24650,3516,28166
MANSEHRA DISTRICT,MANSEHRA TEHSIL,9,25970,3820,29790
MANSEHRA DISTRICT,MANSEHRA TEHSIL,10,22169,3168,25337
MANSEHRA DISTRICT,MANSEHRA TEHSIL,11,24030,3833,27863
MANSEHRA DISTRICT,MANSEHRA TEHSIL,12,21489,3271,24760
MANSEHRA DISTRICT,MANSEHRA TEHSIL,13,21735,3382,25117
MANSEHRA DISTRICT,MANSEHRA TEHSIL,14,20032,3073,23105
MANSEHRA DISTRICT,MANSEHRA TEHSIL,15,19536,3132,22668
MANSEHRA DISTRICT,MANSEHRA TEHSIL,16,18989,3150,22139
MANSEHRA DISTRICT,MANSEHRA TEHSIL,17,18813,3282,22095
MANSEHRA DISTRICT,MANSEHRA TEHSIL,18,17924,2853,20777
MANSEHRA DISTRICT,MANSEHRA TEHSIL,19,18385,3099,21484
MANSEHRA DISTRICT,MANSEHRA TEHSIL,20,16134,2565,18699
MANSEHRA DISTRICT,MANSEHRA TEHSIL,21,16553,2939,19492
MANSEHRA DISTRICT,MANSEHRA TEHSIL,22,15370,2735,18105
MANSEHRA DISTRICT,MANSEHRA TEHSIL,23,14881,2713,17594
MANSEHRA DISTRICT,MANSEHRA TEHSIL,24,14351,2871,17222
MANSEHRA DISTRICT,MANSEHRA TEHSIL,25,13358,2301,15659
MANSEHRA DISTRICT,MANSEHRA TEHSIL,26,13671,2545,16216
MANSEHRA DISTRICT,MANSEHRA TEHSIL,27,12884,2442,15326
MANSEHRA DISTRICT,MANSEHRA TEHSIL,28,12506,2380,14886
MANSEHRA DISTRICT,MANSEHRA TEHSIL,29,12827,2271,15098
MANSEHRA DISTRICT,MANSEHRA TEHSIL,30,11868,2097,13965
MANSEHRA DISTRICT,MANSEHRA TEHSIL,31,12388,2123,14511
MANSEHRA DISTRICT,MANSEHRA TEHSIL,32,11007,2119,13126
MANSEHRA DISTRICT,MANSEHRA TEHSIL,33,10578,2122,12700
MANSEHRA DISTRICT,MANSEHRA TEHSIL,34,10135,1879,12014
MANSEHRA DISTRICT,MANSEHRA TEHSIL,35,9072,1754,10826
MANSEHRA DISTRICT,MANSEHRA TEHSIL,36,10079,1769,11848
MANSEHRA DISTRICT,MANSEHRA TEHSIL,37,8427,1566,9993
MANSEHRA DISTRICT,MANSEHRA TEHSIL,38,9016,1955,10971
MANSEHRA DISTRICT,MANSEHRA TEHSIL,39,8463,1644,10107
MANSEHRA DISTRICT,MANSEHRA TEHSIL,40,7831,1721,9552
MANSEHRA DISTRICT,MANSEHRA TEHSIL,41,8186,1478,9664
MANSEHRA DISTRICT,MANSEHRA TEHSIL,42,7152,1426,8578
MANSEHRA DISTRICT,MANSEHRA TEHSIL,43,7280,1458,8738
MANSEHRA DISTRICT,MANSEHRA TEHSIL,44,6939,1261,8200
MANSEHRA DISTRICT,MANSEHRA TEHSIL,45,6221,1264,7485
MANSEHRA DISTRICT,MANSEHRA TEHSIL,46,7096,1221,8317
MANSEHRA DISTRICT,MANSEHRA TEHSIL,47,6120,1007,7127
MANSEHRA DISTRICT,MANSEHRA TEHSIL,48,6617,1224,7841
MANSEHRA DISTRICT,MANSEHRA TEHSIL,49,6526,1142,7668
MANSEHRA DISTRICT,MANSEHRA TEHSIL,50,6218,1276,7494
MANSEHRA DISTRICT,MANSEHRA TEHSIL,51,6543,1091,7634
MANSEHRA DISTRICT,MANSEHRA TEHSIL,52,5464,1084,6548
MANSEHRA DISTRICT,MANSEHRA TEHSIL,53,5569,1105,6674
MANSEHRA DISTRICT,MANSEHRA TEHSIL,54,5245,973,6218
MANSEHRA DISTRICT,MANSEHRA TEHSIL,55,4365,984,5349
MANSEHRA DISTRICT,MANSEHRA TEHSIL,56,4292,837,5129
MANSEHRA DISTRICT,MANSEHRA TEHSIL,57,3525,586,4111
MANSEHRA DISTRICT,MANSEHRA TEHSIL,58,3771,818,4589
MANSEHRA DISTRICT,MANSEHRA TEHSIL,59,3402,656,4058
MANSEHRA DISTRICT,MANSEHRA TEHSIL,60,3745,726,4471
MANSEHRA DISTRICT,MANSEHRA TEHSIL,61,4201,713,4914
MANSEHRA DISTRICT,MANSEHRA TEHSIL,62,3749,673,4422
MANSEHRA DISTRICT,MANSEHRA TEHSIL,63,3598,681,4279
MANSEHRA DISTRICT,MANSEHRA TEHSIL,64,3311,544,3855
MANSEHRA DISTRICT,MANSEHRA TEHSIL,65,2769,550,3319
MANSEHRA DISTRICT,MANSEHRA TEHSIL,66,2974,455,3429
MANSEHRA DISTRICT,MANSEHRA TEHSIL,67,2879,350,3229
MANSEHRA DISTRICT,MANSEHRA TEHSIL,68,2743,402,3145
MANSEHRA DISTRICT,MANSEHRA TEHSIL,69,2304,353,2657
MANSEHRA DISTRICT,MANSEHRA TEHSIL,70,2179,355,2534
MANSEHRA DISTRICT,MANSEHRA TEHSIL,71,2563,307,2870
MANSEHRA DISTRICT,MANSEHRA TEHSIL,72,2276,293,2569
MANSEHRA DISTRICT,MANSEHRA TEHSIL,73,2068,274,2342
MANSEHRA DISTRICT,MANSEHRA TEHSIL,74,1486,205,1691
MANSEHRA DISTRICT,MANSEHRA TEHSIL,>=75,12934,1918,14852
MANSEHRA DISTRICT,OGHI TEHSIL,<1,7311,0,7311
MANSEHRA DISTRICT,OGHI TEHSIL,1,6829,0,6829
MANSEHRA DISTRICT,OGHI TEHSIL,2,7398,0,7398
MANSEHRA DISTRICT,OGHI TEHSIL,3,7730,0,7730
MANSEHRA DISTRICT,OGHI TEHSIL,4,7919,0,7919
MANSEHRA DISTRICT,OGHI TEHSIL,5,7992,0,7992
MANSEHRA DISTRICT,OGHI TEHSIL,6,7594,0,7594
MANSEHRA DISTRICT,OGHI TEHSIL,7,8182,0,8182
MANSEHRA DISTRICT,OGHI TEHSIL,8,7940,0,7940
MANSEHRA DISTRICT,OGHI TEHSIL,9,8244,0,8244
MANSEHRA DISTRICT,OGHI TEHSIL,10,7085,0,7085
MANSEHRA DISTRICT,OGHI TEHSIL,11,7379,0,7379
MANSEHRA DISTRICT,OGHI TEHSIL,12,6766,0,6766
MANSEHRA DISTRICT,OGHI TEHSIL,13,6892,0,6892
MANSEHRA DISTRICT,OGHI TEHSIL,14,6255,0,6255
MANSEHRA DISTRICT,OGHI TEHSIL,15,6323,0,6323
MANSEHRA DISTRICT,OGHI TEHSIL,16,6183,0,6183
MANSEHRA DISTRICT,OGHI TEHSIL,17,5937,0,5937
MANSEHRA DISTRICT,OGHI TEHSIL,18,5585,0,5585
MANSEHRA DISTRICT,OGHI TEHSIL,19,5534,0,5534
MANSEHRA DISTRICT,OGHI TEHSIL,20,4632,0,4632
MANSEHRA DISTRICT,OGHI TEHSIL,21,4698,0,4698
MANSEHRA DISTRICT,OGHI TEHSIL,22,4382,0,4382
MANSEHRA DISTRICT,OGHI TEHSIL,23,4356,0,4356
MANSEHRA DISTRICT,OGHI TEHSIL,24,4114,0,4114
MANSEHRA DISTRICT,OGHI TEHSIL,25,3634,0,3634
MANSEHRA DISTRICT,OGHI TEHSIL,26,4188,0,4188
MANSEHRA DISTRICT,OGHI TEHSIL,27,3744,0,3744
MANSEHRA DISTRICT,OGHI TEHSIL,28,3632,0,3632
MANSEHRA DISTRICT,OGHI TEHSIL,29,3551,0,3551
MANSEHRA DISTRICT,OGHI TEHSIL,30,3350,0,3350
MANSEHRA DISTRICT,OGHI TEHSIL,31,3652,0,3652
MANSEHRA DISTRICT,OGHI TEHSIL,32,3199,0,3199
MANSEHRA DISTRICT,OGHI TEHSIL,33,2933,0,2933
MANSEHRA DISTRICT,OGHI TEHSIL,34,2908,0,2908
MANSEHRA DISTRICT,OGHI TEHSIL,35,2445,0,2445
MANSEHRA DISTRICT,OGHI TEHSIL,36,3030,0,3030
MANSEHRA DISTRICT,OGHI TEHSIL,37,2567,0,2567
MANSEHRA DISTRICT,OGHI TEHSIL,38,2677,0,2677
MANSEHRA DISTRICT,OGHI TEHSIL,39,2599,0,2599
MANSEHRA DISTRICT,OGHI TEHSIL,40,2147,0,2147
MANSEHRA DISTRICT,OGHI TEHSIL,41,2483,0,2483
MANSEHRA DISTRICT,OGHI TEHSIL,42,2140,0,2140
MANSEHRA DISTRICT,OGHI TEHSIL,43,2137,0,2137
MANSEHRA DISTRICT,OGHI TEHSIL,44,2002,0,2002
MANSEHRA DISTRICT,OGHI TEHSIL,45,1688,0,1688
MANSEHRA DISTRICT,OGHI TEHSIL,46,2258,0,2258
MANSEHRA DISTRICT,OGHI TEHSIL,47,1843,0,1843
MANSEHRA DISTRICT,OGHI TEHSIL,48,2046,0,2046
MANSEHRA DISTRICT,OGHI TEHSIL,49,1976,0,1976
MANSEHRA DISTRICT,OGHI TEHSIL,50,1643,0,1643
MANSEHRA DISTRICT,OGHI TEHSIL,51,1949,0,1949
MANSEHRA DISTRICT,OGHI TEHSIL,52,1697,0,1697
MANSEHRA DISTRICT,OGHI TEHSIL,53,1629,0,1629
MANSEHRA DISTRICT,OGHI TEHSIL,54,1503,0,1503
MANSEHRA DISTRICT,OGHI TEHSIL,55,1255,0,1255
MANSEHRA DISTRICT,OGHI TEHSIL,56,1388,0,1388
MANSEHRA DISTRICT,OGHI TEHSIL,57,1139,0,1139
MANSEHRA DISTRICT,OGHI TEHSIL,58,1274,0,1274
MANSEHRA DISTRICT,OGHI TEHSIL,59,1072,0,1072
MANSEHRA DISTRICT,OGHI TEHSIL,60,1131,0,1131
MANSEHRA DISTRICT,OGHI TEHSIL,61,1271,0,1271
MANSEHRA DISTRICT,OGHI TEHSIL,62,1179,0,1179
MANSEHRA DISTRICT,OGHI TEHSIL,63,1181,0,1181
MANSEHRA DISTRICT,OGHI TEHSIL,64,1030,0,1030
MANSEHRA DISTRICT,OGHI TEHSIL,65,898,0,898
MANSEHRA DISTRICT,OGHI TEHSIL,66,1064,0,1064
MANSEHRA DISTRICT,OGHI TEHSIL,67,928,0,928
MANSEHRA DISTRICT,OGHI TEHSIL,68,997,0,997
MANSEHRA DISTRICT,OGHI TEHSIL,69,773,0,773
MANSEHRA DISTRICT,OGHI TEHSIL,70,649,0,649
MANSEHRA DISTRICT,OGHI TEHSIL,71,824,0,824
MANSEHRA DISTRICT,OGHI TEHSIL,72,729,0,729
MANSEHRA DISTRICT,OGHI TEHSIL,73,692,0,692
MANSEHRA DISTRICT,OGHI TEHSIL,74,530,0,530
MANSEHRA DISTRICT,OGHI TEHSIL,>=75,4450,0,4450
MARDAN DISTRICT,KATLANG TEHSIL,<1,9436,0,9436
MARDAN DISTRICT,KATLANG TEHSIL,1,9837,0,9837
MARDAN DISTRICT,KATLANG TEHSIL,2,10423,0,10423
MARDAN DISTRICT,KATLANG TEHSIL,3,10904,0,10904
MARDAN DISTRICT,KATLANG TEHSIL,4,11329,0,11329
MARDAN DISTRICT,KATLANG TEHSIL,5,10452,0,10452
MARDAN DISTRICT,KATLANG TEHSIL,6,10229,0,10229
MARDAN DISTRICT,KATLANG TEHSIL,7,10495,0,10495
MARDAN DISTRICT,KATLANG TEHSIL,8,10338,0,10338
MARDAN DISTRICT,KATLANG TEHSIL,9,10574,0,10574
MARDAN DISTRICT,KATLANG TEHSIL,10,9277,0,9277
MARDAN DISTRICT,KATLANG TEHSIL,11,9688,0,9688
MARDAN DISTRICT,KATLANG TEHSIL,12,8584,0,8584
MARDAN DISTRICT,KATLANG TEHSIL,13,9183,0,9183
MARDAN DISTRICT,KATLANG TEHSIL,14,8405,0,8405
MARDAN DISTRICT,KATLANG TEHSIL,15,8219,0,8219
MARDAN DISTRICT,KATLANG TEHSIL,16,7715,0,7715
MARDAN DISTRICT,KATLANG TEHSIL,17,7728,0,7728
MARDAN DISTRICT,KATLANG TEHSIL,18,6943,0,6943
MARDAN DISTRICT,KATLANG TEHSIL,19,6981,0,6981
MARDAN DISTRICT,KATLANG TEHSIL,20,7002,0,7002
MARDAN DISTRICT,KATLANG TEHSIL,21,6344,0,6344
MARDAN DISTRICT,KATLANG TEHSIL,22,6027,0,6027
MARDAN DISTRICT,KATLANG TEHSIL,23,5555,0,5555
MARDAN DISTRICT,KATLANG TEHSIL,24,5149,0,5149
MARDAN DISTRICT,KATLANG TEHSIL,25,5664,0,5664
MARDAN DISTRICT,KATLANG TEHSIL,26,5158,0,5158
MARDAN DISTRICT,KATLANG TEHSIL,27,5004,0,5004
MARDAN DISTRICT,KATLANG TEHSIL,28,4795,0,4795
MARDAN DISTRICT,KATLANG TEHSIL,29,4855,0,4855
MARDAN DISTRICT,KATLANG TEHSIL,30,4882,0,4882
MARDAN DISTRICT,KATLANG TEHSIL,31,4541,0,4541
MARDAN DISTRICT,KATLANG TEHSIL,32,3890,0,3890
MARDAN DISTRICT,KATLANG TEHSIL,33,3756,0,3756
MARDAN DISTRICT,KATLANG TEHSIL,34,3617,0,3617
MARDAN DISTRICT,KATLANG TEHSIL,35,3498,0,3498
MARDAN DISTRICT,KATLANG TEHSIL,36,3388,0,3388
MARDAN DISTRICT,KATLANG TEHSIL,37,3047,0,3047
MARDAN DISTRICT,KATLANG TEHSIL,38,3086,0,3086
MARDAN DISTRICT,KATLANG TEHSIL,39,3113,0,3113
MARDAN DISTRICT,KATLANG TEHSIL,40,3254,0,3254
MARDAN DISTRICT,KATLANG TEHSIL,41,3019,0,3019
MARDAN DISTRICT,KATLANG TEHSIL,42,2583,0,2583
MARDAN DISTRICT,KATLANG TEHSIL,43,2735,0,2735
MARDAN DISTRICT,KATLANG TEHSIL,44,2550,0,2550
MARDAN DISTRICT,KATLANG TEHSIL,45,2417,0,2417
MARDAN DISTRICT,KATLANG TEHSIL,46,2569,0,2569
MARDAN DISTRICT,KATLANG TEHSIL,47,2267,0,2267
MARDAN DISTRICT,KATLANG TEHSIL,48,2219,0,2219
MARDAN DISTRICT,KATLANG TEHSIL,49,2319,0,2319
MARDAN DISTRICT,KATLANG TEHSIL,50,2417,0,2417
MARDAN DISTRICT,KATLANG TEHSIL,51,2171,0,2171
MARDAN DISTRICT,KATLANG TEHSIL,52,1873,0,1873
MARDAN DISTRICT,KATLANG TEHSIL,53,1970,0,1970
MARDAN DISTRICT,KATLANG TEHSIL,54,1789,0,1789
MARDAN DISTRICT,KATLANG TEHSIL,55,1727,0,1727
MARDAN DISTRICT,KATLANG TEHSIL,56,1521,0,1521
MARDAN DISTRICT,KATLANG TEHSIL,57,1401,0,1401
MARDAN DISTRICT,KATLANG TEHSIL,58,1540,0,1540
MARDAN DISTRICT,KATLANG TEHSIL,59,1636,0,1636
MARDAN DISTRICT,KATLANG TEHSIL,60,1675,0,1675
MARDAN DISTRICT,KATLANG TEHSIL,61,1618,0,1618
MARDAN DISTRICT,KATLANG TEHSIL,62,1359,0,1359
MARDAN DISTRICT,KATLANG TEHSIL,63,1288,0,1288
MARDAN DISTRICT,KATLANG TEHSIL,64,1228,0,1228
MARDAN DISTRICT,KATLANG TEHSIL,65,1094,0,1094
MARDAN DISTRICT,KATLANG TEHSIL,66,1153,0,1153
MARDAN DISTRICT,KATLANG TEHSIL,67,859,0,859
MARDAN DISTRICT,KATLANG TEHSIL,68,797,0,797
MARDAN DISTRICT,KATLANG TEHSIL,69,847,0,847
MARDAN DISTRICT,KATLANG TEHSIL,70,928,0,928
MARDAN DISTRICT,KATLANG TEHSIL,71,902,0,902
MARDAN DISTRICT,KATLANG TEHSIL,72,663,0,663
MARDAN DISTRICT,KATLANG TEHSIL,73,665,0,665
MARDAN DISTRICT,KATLANG TEHSIL,74,550,0,550
MARDAN DISTRICT,KATLANG TEHSIL,>=75,4511,0,4511
MARDAN DISTRICT,MARDAN TEHSIL,<1,27972,9014,36986
MARDAN DISTRICT,MARDAN TEHSIL,1,28193,9614,37807
MARDAN DISTRICT,MARDAN TEHSIL,2,31080,10000,41080
MARDAN DISTRICT,MARDAN TEHSIL,3,32361,10602,42963
MARDAN DISTRICT,MARDAN TEHSIL,4,33317,9968,43285
MARDAN DISTRICT,MARDAN TEHSIL,5,31451,10125,41576
MARDAN DISTRICT,MARDAN TEHSIL,6,31188,9678,40866
MARDAN DISTRICT,MARDAN TEHSIL,7,31624,10159,41783
MARDAN DISTRICT,MARDAN TEHSIL,8,31073,9151,40224
MARDAN DISTRICT,MARDAN TEHSIL,9,30727,9885,40612
MARDAN DISTRICT,MARDAN TEHSIL,10,28852,8487,37339
MARDAN DISTRICT,MARDAN TEHSIL,11,27806,9151,36957
MARDAN DISTRICT,MARDAN TEHSIL,12,26194,8069,34263
MARDAN DISTRICT,MARDAN TEHSIL,13,27219,8914,36133
MARDAN DISTRICT,MARDAN TEHSIL,14,25578,7975,33553
MARDAN DISTRICT,MARDAN TEHSIL,15,25319,8315,33634
MARDAN DISTRICT,MARDAN TEHSIL,16,23405,7974,31379
MARDAN DISTRICT,MARDAN TEHSIL,17,23855,8345,32200
MARDAN DISTRICT,MARDAN TEHSIL,18,21654,7562,29216
MARDAN DISTRICT,MARDAN TEHSIL,19,21946,8353,30299
MARDAN DISTRICT,MARDAN TEHSIL,20,21616,7220,28836
MARDAN DISTRICT,MARDAN TEHSIL,21,20005,8029,28034
MARDAN DISTRICT,MARDAN TEHSIL,22,18145,7028,25173
MARDAN DISTRICT,MARDAN TEHSIL,23,17359,6575,23934
MARDAN DISTRICT,MARDAN TEHSIL,24,16361,6287,22648
MARDAN DISTRICT,MARDAN TEHSIL,25,16942,5966,22908
MARDAN DISTRICT,MARDAN TEHSIL,26,16726,6054,22780
MARDAN DISTRICT,MARDAN TEHSIL,27,16709,6169,22878
MARDAN DISTRICT,MARDAN TEHSIL,28,14689,5630,20319
MARDAN DISTRICT,MARDAN TEHSIL,29,15828,5743,21571
MARDAN DISTRICT,MARDAN TEHSIL,30,14560,5376,19936
MARDAN DISTRICT,MARDAN TEHSIL,31,14386,5345,19731
MARDAN DISTRICT,MARDAN TEHSIL,32,11910,4914,16824
MARDAN DISTRICT,MARDAN TEHSIL,33,12274,4783,17057
MARDAN DISTRICT,MARDAN TEHSIL,34,10896,4262,15158
MARDAN DISTRICT,MARDAN TEHSIL,35,10149,3964,14113
MARDAN DISTRICT,MARDAN TEHSIL,36,10122,3831,13953
MARDAN DISTRICT,MARDAN TEHSIL,37,10193,3854,14047
MARDAN DISTRICT,MARDAN TEHSIL,38,9272,3960,13232
MARDAN DISTRICT,MARDAN TEHSIL,39,9913,4012,13925
MARDAN DISTRICT,MARDAN TEHSIL,40,9362,3805,13167
MARDAN DISTRICT,MARDAN TEHSIL,41,9462,3466,12928
MARDAN DISTRICT,MARDAN TEHSIL,42,8648,3339,11987
MARDAN DISTRICT,MARDAN TEHSIL,43,8614,3382,11996
MARDAN DISTRICT,MARDAN TEHSIL,44,8227,3069,11296
MARDAN DISTRICT,MARDAN TEHSIL,45,6882,2643,9525
MARDAN DISTRICT,MARDAN TEHSIL,46,7958,2814,10772
MARDAN DISTRICT,MARDAN TEHSIL,47,7794,2704,10498
MARDAN DISTRICT,MARDAN TEHSIL,48,7074,2690,9764
MARDAN DISTRICT,MARDAN TEHSIL,49,7371,2658,10029
MARDAN DISTRICT,MARDAN TEHSIL,50,6593,2469,9062
MARDAN DISTRICT,MARDAN TEHSIL,51,7181,2433,9614
MARDAN DISTRICT,MARDAN TEHSIL,52,6108,2262,8370
MARDAN DISTRICT,MARDAN TEHSIL,53,6014,2163,8177
MARDAN DISTRICT,MARDAN TEHSIL,54,5240,1939,7179
MARDAN DISTRICT,MARDAN TEHSIL,55,4651,1826,6477
MARDAN DISTRICT,MARDAN TEHSIL,56,4829,1629,6458
MARDAN DISTRICT,MARDAN TEHSIL,57,4695,1557,6252
MARDAN DISTRICT,MARDAN TEHSIL,58,4646,1527,6173
MARDAN DISTRICT,MARDAN TEHSIL,59,4916,1650,6566
MARDAN DISTRICT,MARDAN TEHSIL,60,4378,1525,5903
MARDAN DISTRICT,MARDAN TEHSIL,61,4926,1607,6533
MARDAN DISTRICT,MARDAN TEHSIL,62,4270,1572,5842
MARDAN DISTRICT,MARDAN TEHSIL,63,4293,1537,5830
MARDAN DISTRICT,MARDAN TEHSIL,64,3997,1187,5184
MARDAN DISTRICT,MARDAN TEHSIL,65,2986,1014,4000
MARDAN DISTRICT,MARDAN TEHSIL,66,3352,941,4293
MARDAN DISTRICT,MARDAN TEHSIL,67,2938,1026,3964
MARDAN DISTRICT,MARDAN TEHSIL,68,2696,941,3637
MARDAN DISTRICT,MARDAN TEHSIL,69,2757,744,3501
MARDAN DISTRICT,MARDAN TEHSIL,70,2497,648,3145
MARDAN DISTRICT,MARDAN TEHSIL,71,2429,673,3102
MARDAN DISTRICT,MARDAN TEHSIL,72,2008,646,2654
MARDAN DISTRICT,MARDAN TEHSIL,73,1871,684,2555
MARDAN DISTRICT,MARDAN TEHSIL,74,1613,470,2083
MARDAN DISTRICT,MARDAN TEHSIL,>=75,11833,3441,15274
MARDAN DISTRICT,TAKHT BHAI TEHSIL,<1,14643,1994,16637
MARDAN DISTRICT,TAKHT BHAI TEHSIL,1,14734,2141,16875
MARDAN DISTRICT,TAKHT BHAI TEHSIL,2,16600,2464,19064
MARDAN DISTRICT,TAKHT BHAI TEHSIL,3,17130,2441,19571
MARDAN DISTRICT,TAKHT BHAI TEHSIL,4,18298,2470,20768
MARDAN DISTRICT,TAKHT BHAI TEHSIL,5,16277,2462,18739
MARDAN DISTRICT,TAKHT BHAI TEHSIL,6,16586,2288,18874
MARDAN DISTRICT,TAKHT BHAI TEHSIL,7,16567,2401,18968
MARDAN DISTRICT,TAKHT BHAI TEHSIL,8,16583,2261,18844
MARDAN DISTRICT,TAKHT BHAI TEHSIL,9,16382,2282,18664
MARDAN DISTRICT,TAKHT BHAI TEHSIL,10,15057,2265,17322
MARDAN DISTRICT,TAKHT BHAI TEHSIL,11,14520,2114,16634
MARDAN DISTRICT,TAKHT BHAI TEHSIL,12,13434,2073,15507
MARDAN DISTRICT,TAKHT BHAI TEHSIL,13,14190,2111,16301
MARDAN DISTRICT,TAKHT BHAI TEHSIL,14,13222,2038,15260
MARDAN DISTRICT,TAKHT BHAI TEHSIL,15,13370,1912,15282
MARDAN DISTRICT,TAKHT BHAI TEHSIL,16,12005,1776,13781
MARDAN DISTRICT,TAKHT BHAI TEHSIL,17,11396,1911,13307
MARDAN DISTRICT,TAKHT BHAI TEHSIL,18,11077,1741,12818
MARDAN DISTRICT,TAKHT BHAI TEHSIL,19,10615,1648,12263
MARDAN DISTRICT,TAKHT BHAI TEHSIL,20,11614,1787,13401
MARDAN DISTRICT,TAKHT BHAI TEHSIL,21,9926,1499,11425
MARDAN DISTRICT,TAKHT BHAI TEHSIL,22,10152,1589,11741
MARDAN DISTRICT,TAKHT BHAI TEHSIL,23,9448,1504,10952
MARDAN DISTRICT,TAKHT BHAI TEHSIL,24,8796,1313,10109
MARDAN DISTRICT,TAKHT BHAI TEHSIL,25,9983,1512,11495
MARDAN DISTRICT,TAKHT BHAI TEHSIL,26,8669,1340,10009
MARDAN DISTRICT,TAKHT BHAI TEHSIL,27,8379,1251,9630
MARDAN DISTRICT,TAKHT BHAI TEHSIL,28,8000,1294,9294
MARDAN DISTRICT,TAKHT BHAI TEHSIL,29,7853,1170,9023
MARDAN DISTRICT,TAKHT BHAI TEHSIL,30,8790,1415,10205
MARDAN DISTRICT,TAKHT BHAI TEHSIL,31,7621,1065,8686
MARDAN DISTRICT,TAKHT BHAI TEHSIL,32,6608,993,7601
MARDAN DISTRICT,TAKHT BHAI TEHSIL,33,6557,1017,7574
MARDAN DISTRICT,TAKHT BHAI TEHSIL,34,5511,836,6347
MARDAN DISTRICT,TAKHT BHAI TEHSIL,35,6207,967,7174
MARDAN DISTRICT,TAKHT BHAI TEHSIL,36,5422,834,6256
MARDAN DISTRICT,TAKHT BHAI TEHSIL,37,5329,787,6116
MARDAN DISTRICT,TAKHT BHAI TEHSIL,38,5302,844,6146
MARDAN DISTRICT,TAKHT BHAI TEHSIL,39,5016,759,5775
MARDAN DISTRICT,TAKHT BHAI TEHSIL,40,5789,950,6739
MARDAN DISTRICT,TAKHT BHAI TEHSIL,41,4767,688,5455
MARDAN DISTRICT,TAKHT BHAI TEHSIL,42,4120,645,4765
MARDAN DISTRICT,TAKHT BHAI TEHSIL,43,4286,649,4935
MARDAN DISTRICT,TAKHT BHAI TEHSIL,44,3805,612,4417
MARDAN DISTRICT,TAKHT BHAI TEHSIL,45,4126,669,4795
MARDAN DISTRICT,TAKHT BHAI TEHSIL,46,3487,494,3981
MARDAN DISTRICT,TAKHT BHAI TEHSIL,47,3496,521,4017
MARDAN DISTRICT,TAKHT BHAI TEHSIL,48,3410,553,3963
MARDAN DISTRICT,TAKHT BHAI TEHSIL,49,3404,521,3925
MARDAN DISTRICT,TAKHT BHAI TEHSIL,50,4092,695,4787
MARDAN DISTRICT,TAKHT BHAI TEHSIL,51,3244,489,3733
MARDAN DISTRICT,TAKHT BHAI TEHSIL,52,2876,462,3338
MARDAN DISTRICT,TAKHT BHAI TEHSIL,53,2800,481,3281
MARDAN DISTRICT,TAKHT BHAI TEHSIL,54,2659,434,3093
MARDAN DISTRICT,TAKHT BHAI TEHSIL,55,2904,487,3391
MARDAN DISTRICT,TAKHT BHAI TEHSIL,56,2241,326,2567
MARDAN DISTRICT,TAKHT BHAI TEHSIL,57,2112,270,2382
MARDAN DISTRICT,TAKHT BHAI TEHSIL,58,2260,313,2573
MARDAN DISTRICT,TAKHT BHAI TEHSIL,59,2317,340,2657
MARDAN DISTRICT,TAKHT BHAI TEHSIL,60,2802,417,3219
MARDAN DISTRICT,TAKHT BHAI TEHSIL,61,2399,317,2716
MARDAN DISTRICT,TAKHT BHAI TEHSIL,62,2005,321,2326
MARDAN DISTRICT,TAKHT BHAI TEHSIL,63,2140,311,2451
MARDAN DISTRICT,TAKHT BHAI TEHSIL,64,1932,261,2193
MARDAN DISTRICT,TAKHT BHAI TEHSIL,65,1816,264,2080
MARDAN DISTRICT,TAKHT BHAI TEHSIL,66,1541,188,1729
MARDAN DISTRICT,TAKHT BHAI TEHSIL,67,1326,185,1511
MARDAN DISTRICT,TAKHT BHAI TEHSIL,68,1262,163,1425
MARDAN DISTRICT,TAKHT BHAI TEHSIL,69,1267,162,1429
MARDAN DISTRICT,TAKHT BHAI TEHSIL,70,1391,180,1571
MARDAN DISTRICT,TAKHT BHAI TEHSIL,71,1184,149,1333
MARDAN DISTRICT,TAKHT BHAI TEHSIL,72,968,124,1092
MARDAN DISTRICT,TAKHT BHAI TEHSIL,73,884,128,1012
MARDAN DISTRICT,TAKHT BHAI TEHSIL,74,799,100,899
MARDAN DISTRICT,TAKHT BHAI TEHSIL,>=75,6194,760,6954
MASTUNG DISTRICT,DASHT TEHSIL,<1,1766,0,1766
MASTUNG DISTRICT,DASHT TEHSIL,1,2275,0,2275
MASTUNG DISTRICT,DASHT TEHSIL,2,2639,0,2639
MASTUNG DISTRICT,DASHT TEHSIL,3,2547,0,2547
MASTUNG DISTRICT,DASHT TEHSIL,4,2614,0,2614
MASTUNG DISTRICT,DASHT TEHSIL,5,2407,0,2407
MASTUNG DISTRICT,DASHT TEHSIL,6,2493,0,2493
MASTUNG DISTRICT,DASHT TEHSIL,7,2501,0,2501
MASTUNG DISTRICT,DASHT TEHSIL,8,2542,0,2542
MASTUNG DISTRICT,DASHT TEHSIL,9,2190,0,2190
MASTUNG DISTRICT,DASHT TEHSIL,10,2272,0,2272
MASTUNG DISTRICT,DASHT TEHSIL,11,1518,0,1518
MASTUNG DISTRICT,DASHT TEHSIL,12,1761,0,1761
MASTUNG DISTRICT,DASHT TEHSIL,13,1285,0,1285
MASTUNG DISTRICT,DASHT TEHSIL,14,1514,0,1514
MASTUNG DISTRICT,DASHT TEHSIL,15,1357,0,1357
MASTUNG DISTRICT,DASHT TEHSIL,16,1343,0,1343
MASTUNG DISTRICT,DASHT TEHSIL,17,1108,0,1108
MASTUNG DISTRICT,DASHT TEHSIL,18,1456,0,1456
MASTUNG DISTRICT,DASHT TEHSIL,19,1039,0,1039
MASTUNG DISTRICT,DASHT TEHSIL,20,1378,0,1378
MASTUNG DISTRICT,DASHT TEHSIL,21,914,0,914
MASTUNG DISTRICT,DASHT TEHSIL,22,946,0,946
MASTUNG DISTRICT,DASHT TEHSIL,23,764,0,764
MASTUNG DISTRICT,DASHT TEHSIL,24,614,0,614
MASTUNG DISTRICT,DASHT TEHSIL,25,1192,0,1192
MASTUNG DISTRICT,DASHT TEHSIL,26,645,0,645
MASTUNG DISTRICT,DASHT TEHSIL,27,821,0,821
MASTUNG DISTRICT,DASHT TEHSIL,28,823,0,823
MASTUNG DISTRICT,DASHT TEHSIL,29,852,0,852
MASTUNG DISTRICT,DASHT TEHSIL,30,1162,0,1162
MASTUNG DISTRICT,DASHT TEHSIL,31,760,0,760
MASTUNG DISTRICT,DASHT TEHSIL,32,696,0,696
MASTUNG DISTRICT,DASHT TEHSIL,33,707,0,707
MASTUNG DISTRICT,DASHT TEHSIL,34,568,0,568
MASTUNG DISTRICT,DASHT TEHSIL,35,880,0,880
MASTUNG DISTRICT,DASHT TEHSIL,36,487,0,487
MASTUNG DISTRICT,DASHT TEHSIL,37,708,0,708
MASTUNG DISTRICT,DASHT TEHSIL,38,564,0,564
MASTUNG DISTRICT,DASHT TEHSIL,39,616,0,616
MASTUNG DISTRICT,DASHT TEHSIL,40,744,0,744
MASTUNG DISTRICT,DASHT TEHSIL,41,423,0,423
MASTUNG DISTRICT,DASHT TEHSIL,42,418,0,418
MASTUNG DISTRICT,DASHT TEHSIL,43,421,0,421
MASTUNG DISTRICT,DASHT TEHSIL,44,327,0,327
MASTUNG DISTRICT,DASHT TEHSIL,45,495,0,495
MASTUNG DISTRICT,DASHT TEHSIL,46,247,0,247
MASTUNG DISTRICT,DASHT TEHSIL,47,424,0,424
MASTUNG DISTRICT,DASHT TEHSIL,48,293,0,293
MASTUNG DISTRICT,DASHT TEHSIL,49,345,0,345
MASTUNG DISTRICT,DASHT TEHSIL,50,503,0,503
MASTUNG DISTRICT,DASHT TEHSIL,51,286,0,286
MASTUNG DISTRICT,DASHT TEHSIL,52,236,0,236
MASTUNG DISTRICT,DASHT TEHSIL,53,307,0,307
MASTUNG DISTRICT,DASHT TEHSIL,54,243,0,243
MASTUNG DISTRICT,DASHT TEHSIL,55,321,0,321
MASTUNG DISTRICT,DASHT TEHSIL,56,168,0,168
MASTUNG DISTRICT,DASHT TEHSIL,57,240,0,240
MASTUNG DISTRICT,DASHT TEHSIL,58,175,0,175
MASTUNG DISTRICT,DASHT TEHSIL,59,223,0,223
MASTUNG DISTRICT,DASHT TEHSIL,60,331,0,331
MASTUNG DISTRICT,DASHT TEHSIL,61,212,0,212
MASTUNG DISTRICT,DASHT TEHSIL,62,215,0,215
MASTUNG DISTRICT,DASHT TEHSIL,63,217,0,217
MASTUNG DISTRICT,DASHT TEHSIL,64,187,0,187
MASTUNG DISTRICT,DASHT TEHSIL,65,197,0,197
MASTUNG DISTRICT,DASHT TEHSIL,66,147,0,147
MASTUNG DISTRICT,DASHT TEHSIL,67,166,0,166
MASTUNG DISTRICT,DASHT TEHSIL,68,114,0,114
MASTUNG DISTRICT,DASHT TEHSIL,69,142,0,142
MASTUNG DISTRICT,DASHT TEHSIL,70,159,0,159
MASTUNG DISTRICT,DASHT TEHSIL,71,126,0,126
MASTUNG DISTRICT,DASHT TEHSIL,72,100,0,100
MASTUNG DISTRICT,DASHT TEHSIL,73,86,0,86
MASTUNG DISTRICT,DASHT TEHSIL,74,75,0,75
MASTUNG DISTRICT,DASHT TEHSIL,>=75,728,0,728
MASTUNG DISTRICT,KHAD KOCHA SUB-TEHSIL,<1,1305,0,1305
MASTUNG DISTRICT,KHAD KOCHA SUB-TEHSIL,1,1423,0,1423
MASTUNG DISTRICT,KHAD KOCHA SUB-TEHSIL,2,1818,0,1818
MASTUNG DISTRICT,KHAD KOCHA SUB-TEHSIL,3,1630,0,1630
MASTUNG DISTRICT,KHAD KOCHA SUB-TEHSIL,4,1647,0,1647
MASTUNG DISTRICT,KHAD KOCHA SUB-TEHSIL,5,1475,0,1475
MASTUNG DISTRICT,KHAD KOCHA SUB-TEHSIL,6,1582,0,1582
MASTUNG DISTRICT,KHAD KOCHA SUB-TEHSIL,7,1481,0,1481
MASTUNG DISTRICT,KHAD KOCHA SUB-TEHSIL,8,1548,0,1548
MASTUNG DISTRICT,KHAD KOCHA SUB-TEHSIL,9,1256,0,1256
MASTUNG DISTRICT,KHAD KOCHA SUB-TEHSIL,10,1407,0,1407
MASTUNG DISTRICT,KHAD KOCHA SUB-TEHSIL,11,939,0,939
MASTUNG DISTRICT,KHAD KOCHA SUB-TEHSIL,12,1025,0,1025
MASTUNG DISTRICT,KHAD KOCHA SUB-TEHSIL,13,829,0,829
MASTUNG DISTRICT,KHAD KOCHA SUB-TEHSIL,14,927,0,927
MASTUNG DISTRICT,KHAD KOCHA SUB-TEHSIL,15,787,0,787
MASTUNG DISTRICT,KHAD KOCHA SUB-TEHSIL,16,780,0,780
MASTUNG DISTRICT,KHAD KOCHA SUB-TEHSIL,17,618,0,618
MASTUNG DISTRICT,KHAD KOCHA SUB-TEHSIL,18,816,0,816
MASTUNG DISTRICT,KHAD KOCHA SUB-TEHSIL,19,621,0,621
MASTUNG DISTRICT,KHAD KOCHA SUB-TEHSIL,20,755,0,755
MASTUNG DISTRICT,KHAD KOCHA SUB-TEHSIL,21,562,0,562
MASTUNG DISTRICT,KHAD KOCHA SUB-TEHSIL,22,543,0,543
MASTUNG DISTRICT,KHAD KOCHA SUB-TEHSIL,23,465,0,465
MASTUNG DISTRICT,KHAD KOCHA SUB-TEHSIL,24,379,0,379
MASTUNG DISTRICT,KHAD KOCHA SUB-TEHSIL,25,633,0,633
MASTUNG DISTRICT,KHAD KOCHA SUB-TEHSIL,26,405,0,405
MASTUNG DISTRICT,KHAD KOCHA SUB-TEHSIL,27,531,0,531
MASTUNG DISTRICT,KHAD KOCHA SUB-TEHSIL,28,511,0,511
MASTUNG DISTRICT,KHAD KOCHA SUB-TEHSIL,29,526,0,526
MASTUNG DISTRICT,KHAD KOCHA SUB-TEHSIL,30,633,0,633
MASTUNG DISTRICT,KHAD KOCHA SUB-TEHSIL,31,501,0,501
MASTUNG DISTRICT,KHAD KOCHA SUB-TEHSIL,32,414,0,414
MASTUNG DISTRICT,KHAD KOCHA SUB-TEHSIL,33,429,0,429
MASTUNG DISTRICT,KHAD KOCHA SUB-TEHSIL,34,338,0,338
MASTUNG DISTRICT,KHAD KOCHA SUB-TEHSIL,35,449,0,449
MASTUNG DISTRICT,KHAD KOCHA SUB-TEHSIL,36,316,0,316
MASTUNG DISTRICT,KHAD KOCHA SUB-TEHSIL,37,410,0,410
MASTUNG DISTRICT,KHAD KOCHA SUB-TEHSIL,38,293,0,293
MASTUNG DISTRICT,KHAD KOCHA SUB-TEHSIL,39,320,0,320
MASTUNG DISTRICT,KHAD KOCHA SUB-TEHSIL,40,394,0,394
MASTUNG DISTRICT,KHAD KOCHA SUB-TEHSIL,41,242,0,242
MASTUNG DISTRICT,KHAD KOCHA SUB-TEHSIL,42,242,0,242
MASTUNG DISTRICT,KHAD KOCHA SUB-TEHSIL,43,193,0,193
MASTUNG DISTRICT,KHAD KOCHA SUB-TEHSIL,44,209,0,209
MASTUNG DISTRICT,KHAD KOCHA SUB-TEHSIL,45,256,0,256
MASTUNG DISTRICT,KHAD KOCHA SUB-TEHSIL,46,172,0,172
MASTUNG DISTRICT,KHAD KOCHA SUB-TEHSIL,47,275,0,275
MASTUNG DISTRICT,KHAD KOCHA SUB-TEHSIL,48,178,0,178
MASTUNG DISTRICT,KHAD KOCHA SUB-TEHSIL,49,205,0,205
MASTUNG DISTRICT,KHAD KOCHA SUB-TEHSIL,50,249,0,249
MASTUNG DISTRICT,KHAD KOCHA SUB-TEHSIL,51,184,0,184
MASTUNG DISTRICT,KHAD KOCHA SUB-TEHSIL,52,139,0,139
MASTUNG DISTRICT,KHAD KOCHA SUB-TEHSIL,53,136,0,136
MASTUNG DISTRICT,KHAD KOCHA SUB-TEHSIL,54,130,0,130
MASTUNG DISTRICT,KHAD KOCHA SUB-TEHSIL,55,142,0,142
MASTUNG DISTRICT,KHAD KOCHA SUB-TEHSIL,56,93,0,93
MASTUNG DISTRICT,KHAD KOCHA SUB-TEHSIL,57,165,0,165
MASTUNG DISTRICT,KHAD KOCHA SUB-TEHSIL,58,82,0,82
MASTUNG DISTRICT,KHAD KOCHA SUB-TEHSIL,59,133,0,133
MASTUNG DISTRICT,KHAD KOCHA SUB-TEHSIL,60,194,0,194
MASTUNG DISTRICT,KHAD KOCHA SUB-TEHSIL,61,115,0,115
MASTUNG DISTRICT,KHAD KOCHA SUB-TEHSIL,62,110,0,110
MASTUNG DISTRICT,KHAD KOCHA SUB-TEHSIL,63,84,0,84
MASTUNG DISTRICT,KHAD KOCHA SUB-TEHSIL,64,100,0,100
MASTUNG DISTRICT,KHAD KOCHA SUB-TEHSIL,65,85,0,85
MASTUNG DISTRICT,KHAD KOCHA SUB-TEHSIL,66,96,0,96
MASTUNG DISTRICT,KHAD KOCHA SUB-TEHSIL,67,104,0,104
MASTUNG DISTRICT,KHAD KOCHA SUB-TEHSIL,68,57,0,57
MASTUNG DISTRICT,KHAD KOCHA SUB-TEHSIL,69,68,0,68
MASTUNG DISTRICT,KHAD KOCHA SUB-TEHSIL,70,81,0,81
MASTUNG DISTRICT,KHAD KOCHA SUB-TEHSIL,71,76,0,76
MASTUNG DISTRICT,KHAD KOCHA SUB-TEHSIL,72,58,0,58
MASTUNG DISTRICT,KHAD KOCHA SUB-TEHSIL,73,45,0,45
MASTUNG DISTRICT,KHAD KOCHA SUB-TEHSIL,74,44,0,44
MASTUNG DISTRICT,KHAD KOCHA SUB-TEHSIL,>=75,397,0,397
MASTUNG DISTRICT,KIRDGAP SUB-TEHSIL,<1,846,0,846
MASTUNG DISTRICT,KIRDGAP SUB-TEHSIL,1,903,0,903
MASTUNG DISTRICT,KIRDGAP SUB-TEHSIL,2,1168,0,1168
MASTUNG DISTRICT,KIRDGAP SUB-TEHSIL,3,1078,0,1078
MASTUNG DISTRICT,KIRDGAP SUB-TEHSIL,4,1169,0,1169
MASTUNG DISTRICT,KIRDGAP SUB-TEHSIL,5,959,0,959
MASTUNG DISTRICT,KIRDGAP SUB-TEHSIL,6,1076,0,1076
MASTUNG DISTRICT,KIRDGAP SUB-TEHSIL,7,1020,0,1020
MASTUNG DISTRICT,KIRDGAP SUB-TEHSIL,8,1039,0,1039
MASTUNG DISTRICT,KIRDGAP SUB-TEHSIL,9,897,0,897
MASTUNG DISTRICT,KIRDGAP SUB-TEHSIL,10,984,0,984
MASTUNG DISTRICT,KIRDGAP SUB-TEHSIL,11,724,0,724
MASTUNG DISTRICT,KIRDGAP SUB-TEHSIL,12,783,0,783
MASTUNG DISTRICT,KIRDGAP SUB-TEHSIL,13,632,0,632
MASTUNG DISTRICT,KIRDGAP SUB-TEHSIL,14,717,0,717
MASTUNG DISTRICT,KIRDGAP SUB-TEHSIL,15,622,0,622
MASTUNG DISTRICT,KIRDGAP SUB-TEHSIL,16,627,0,627
MASTUNG DISTRICT,KIRDGAP SUB-TEHSIL,17,590,0,590
MASTUNG DISTRICT,KIRDGAP SUB-TEHSIL,18,585,0,585
MASTUNG DISTRICT,KIRDGAP SUB-TEHSIL,19,489,0,489
MASTUNG DISTRICT,KIRDGAP SUB-TEHSIL,20,514,0,514
MASTUNG DISTRICT,KIRDGAP SUB-TEHSIL,21,458,0,458
MASTUNG DISTRICT,KIRDGAP SUB-TEHSIL,22,395,0,395
MASTUNG DISTRICT,KIRDGAP SUB-TEHSIL,23,384,0,384
MASTUNG DISTRICT,KIRDGAP SUB-TEHSIL,24,357,0,357
MASTUNG DISTRICT,KIRDGAP SUB-TEHSIL,25,455,0,455
MASTUNG DISTRICT,KIRDGAP SUB-TEHSIL,26,338,0,338
MASTUNG DISTRICT,KIRDGAP SUB-TEHSIL,27,495,0,495
MASTUNG DISTRICT,KIRDGAP SUB-TEHSIL,28,398,0,398
MASTUNG DISTRICT,KIRDGAP SUB-TEHSIL,29,450,0,450
MASTUNG DISTRICT,KIRDGAP SUB-TEHSIL,30,410,0,410
MASTUNG DISTRICT,KIRDGAP SUB-TEHSIL,31,380,0,380
MASTUNG DISTRICT,KIRDGAP SUB-TEHSIL,32,358,0,358
MASTUNG DISTRICT,KIRDGAP SUB-TEHSIL,33,362,0,362
MASTUNG DISTRICT,KIRDGAP SUB-TEHSIL,34,289,0,289
MASTUNG DISTRICT,KIRDGAP SUB-TEHSIL,35,333,0,333
MASTUNG DISTRICT,KIRDGAP SUB-TEHSIL,36,226,0,226
MASTUNG DISTRICT,KIRDGAP SUB-TEHSIL,37,326,0,326
MASTUNG DISTRICT,KIRDGAP SUB-TEHSIL,38,270,0,270
MASTUNG DISTRICT,KIRDGAP SUB-TEHSIL,39,286,0,286
MASTUNG DISTRICT,KIRDGAP SUB-TEHSIL,40,285,0,285
MASTUNG DISTRICT,KIRDGAP SUB-TEHSIL,41,190,0,190
MASTUNG DISTRICT,KIRDGAP SUB-TEHSIL,42,217,0,217
MASTUNG DISTRICT,KIRDGAP SUB-TEHSIL,43,210,0,210
MASTUNG DISTRICT,KIRDGAP SUB-TEHSIL,44,165,0,165
MASTUNG DISTRICT,KIRDGAP SUB-TEHSIL,45,171,0,171
MASTUNG DISTRICT,KIRDGAP SUB-TEHSIL,46,130,0,130
MASTUNG DISTRICT,KIRDGAP SUB-TEHSIL,47,196,0,196
MASTUNG DISTRICT,KIRDGAP SUB-TEHSIL,48,140,0,140
MASTUNG DISTRICT,KIRDGAP SUB-TEHSIL,49,182,0,182
MASTUNG DISTRICT,KIRDGAP SUB-TEHSIL,50,185,0,185
MASTUNG DISTRICT,KIRDGAP SUB-TEHSIL,51,144,0,144
MASTUNG DISTRICT,KIRDGAP SUB-TEHSIL,52,134,0,134
MASTUNG DISTRICT,KIRDGAP SUB-TEHSIL,53,117,0,117
MASTUNG DISTRICT,KIRDGAP SUB-TEHSIL,54,99,0,99
MASTUNG DISTRICT,KIRDGAP SUB-TEHSIL,55,125,0,125
MASTUNG DISTRICT,KIRDGAP SUB-TEHSIL,56,77,0,77
MASTUNG DISTRICT,KIRDGAP SUB-TEHSIL,57,109,0,109
MASTUNG DISTRICT,KIRDGAP SUB-TEHSIL,58,80,0,80
MASTUNG DISTRICT,KIRDGAP SUB-TEHSIL,59,106,0,106
MASTUNG DISTRICT,KIRDGAP SUB-TEHSIL,60,99,0,99
MASTUNG DISTRICT,KIRDGAP SUB-TEHSIL,61,66,0,66
MASTUNG DISTRICT,KIRDGAP SUB-TEHSIL,62,81,0,81
MASTUNG DISTRICT,KIRDGAP SUB-TEHSIL,63,87,0,87
MASTUNG DISTRICT,KIRDGAP SUB-TEHSIL,64,63,0,63
MASTUNG DISTRICT,KIRDGAP SUB-TEHSIL,65,74,0,74
MASTUNG DISTRICT,KIRDGAP SUB-TEHSIL,66,55,0,55
MASTUNG DISTRICT,KIRDGAP SUB-TEHSIL,67,94,0,94
MASTUNG DISTRICT,KIRDGAP SUB-TEHSIL,68,40,0,40
MASTUNG DISTRICT,KIRDGAP SUB-TEHSIL,69,43,0,43
MASTUNG DISTRICT,KIRDGAP SUB-TEHSIL,70,44,0,44
MASTUNG DISTRICT,KIRDGAP SUB-TEHSIL,71,43,0,43
MASTUNG DISTRICT,KIRDGAP SUB-TEHSIL,72,41,0,41
MASTUNG DISTRICT,KIRDGAP SUB-TEHSIL,73,32,0,32
MASTUNG DISTRICT,KIRDGAP SUB-TEHSIL,74,35,0,35
MASTUNG DISTRICT,KIRDGAP SUB-TEHSIL,>=75,273,0,273
MASTUNG DISTRICT,MASTUNG TEHSIL,<1,2575,820,3395
MASTUNG DISTRICT,MASTUNG TEHSIL,1,3234,976,4210
MASTUNG DISTRICT,MASTUNG TEHSIL,2,3859,1165,5024
MASTUNG DISTRICT,MASTUNG TEHSIL,3,3643,1101,4744
MASTUNG DISTRICT,MASTUNG TEHSIL,4,3587,1044,4631
MASTUNG DISTRICT,MASTUNG TEHSIL,5,3313,1106,4419
MASTUNG DISTRICT,MASTUNG TEHSIL,6,3315,1020,4335
MASTUNG DISTRICT,MASTUNG TEHSIL,7,3419,1119,4538
MASTUNG DISTRICT,MASTUNG TEHSIL,8,3423,1029,4452
MASTUNG DISTRICT,MASTUNG TEHSIL,9,2870,985,3855
MASTUNG DISTRICT,MASTUNG TEHSIL,10,3079,941,4020
MASTUNG DISTRICT,MASTUNG TEHSIL,11,2396,895,3291
MASTUNG DISTRICT,MASTUNG TEHSIL,12,2505,892,3397
MASTUNG DISTRICT,MASTUNG TEHSIL,13,2198,834,3032
MASTUNG DISTRICT,MASTUNG TEHSIL,14,2322,844,3166
MASTUNG DISTRICT,MASTUNG TEHSIL,15,2164,848,3012
MASTUNG DISTRICT,MASTUNG TEHSIL,16,2208,788,2996
MASTUNG DISTRICT,MASTUNG TEHSIL,17,1958,773,2731
MASTUNG DISTRICT,MASTUNG TEHSIL,18,2125,812,2937
MASTUNG DISTRICT,MASTUNG TEHSIL,19,1937,756,2693
MASTUNG DISTRICT,MASTUNG TEHSIL,20,1880,647,2527
MASTUNG DISTRICT,MASTUNG TEHSIL,21,1652,663,2315
MASTUNG DISTRICT,MASTUNG TEHSIL,22,1505,572,2077
MASTUNG DISTRICT,MASTUNG TEHSIL,23,1376,581,1957
MASTUNG DISTRICT,MASTUNG TEHSIL,24,1324,528,1852
MASTUNG DISTRICT,MASTUNG TEHSIL,25,1737,598,2335
MASTUNG DISTRICT,MASTUNG TEHSIL,26,1335,546,1881
MASTUNG DISTRICT,MASTUNG TEHSIL,27,1599,598,2197
MASTUNG DISTRICT,MASTUNG TEHSIL,28,1573,610,2183
MASTUNG DISTRICT,MASTUNG TEHSIL,29,1472,537,2009
MASTUNG DISTRICT,MASTUNG TEHSIL,30,1456,556,2012
MASTUNG DISTRICT,MASTUNG TEHSIL,31,1369,522,1891
MASTUNG DISTRICT,MASTUNG TEHSIL,32,1162,403,1565
MASTUNG DISTRICT,MASTUNG TEHSIL,33,1185,455,1640
MASTUNG DISTRICT,MASTUNG TEHSIL,34,969,377,1346
MASTUNG DISTRICT,MASTUNG TEHSIL,35,1087,437,1524
MASTUNG DISTRICT,MASTUNG TEHSIL,36,875,322,1197
MASTUNG DISTRICT,MASTUNG TEHSIL,37,1105,420,1525
MASTUNG DISTRICT,MASTUNG TEHSIL,38,878,376,1254
MASTUNG DISTRICT,MASTUNG TEHSIL,39,901,385,1286
MASTUNG DISTRICT,MASTUNG TEHSIL,40,949,325,1274
MASTUNG DISTRICT,MASTUNG TEHSIL,41,797,291,1088
MASTUNG DISTRICT,MASTUNG TEHSIL,42,688,314,1002
MASTUNG DISTRICT,MASTUNG TEHSIL,43,629,256,885
MASTUNG DISTRICT,MASTUNG TEHSIL,44,578,242,820
MASTUNG DISTRICT,MASTUNG TEHSIL,45,650,254,904
MASTUNG DISTRICT,MASTUNG TEHSIL,46,644,203,847
MASTUNG DISTRICT,MASTUNG TEHSIL,47,735,319,1054
MASTUNG DISTRICT,MASTUNG TEHSIL,48,540,214,754
MASTUNG DISTRICT,MASTUNG TEHSIL,49,597,245,842
MASTUNG DISTRICT,MASTUNG TEHSIL,50,648,231,879
MASTUNG DISTRICT,MASTUNG TEHSIL,51,516,220,736
MASTUNG DISTRICT,MASTUNG TEHSIL,52,461,202,663
MASTUNG DISTRICT,MASTUNG TEHSIL,53,468,180,648
MASTUNG DISTRICT,MASTUNG TEHSIL,54,395,192,587
MASTUNG DISTRICT,MASTUNG TEHSIL,55,399,171,570
MASTUNG DISTRICT,MASTUNG TEHSIL,56,338,143,481
MASTUNG DISTRICT,MASTUNG TEHSIL,57,463,172,635
MASTUNG DISTRICT,MASTUNG TEHSIL,58,349,134,483
MASTUNG DISTRICT,MASTUNG TEHSIL,59,336,151,487
MASTUNG DISTRICT,MASTUNG TEHSIL,60,377,133,510
MASTUNG DISTRICT,MASTUNG TEHSIL,61,380,134,514
MASTUNG DISTRICT,MASTUNG TEHSIL,62,276,125,401
MASTUNG DISTRICT,MASTUNG TEHSIL,63,315,110,425
MASTUNG DISTRICT,MASTUNG TEHSIL,64,251,106,357
MASTUNG DISTRICT,MASTUNG TEHSIL,65,213,90,303
MASTUNG DISTRICT,MASTUNG TEHSIL,66,297,93,390
MASTUNG DISTRICT,MASTUNG TEHSIL,67,288,112,400
MASTUNG DISTRICT,MASTUNG TEHSIL,68,193,66,259
MASTUNG DISTRICT,MASTUNG TEHSIL,69,213,80,293
MASTUNG DISTRICT,MASTUNG TEHSIL,70,190,57,247
MASTUNG DISTRICT,MASTUNG TEHSIL,71,210,62,272
MASTUNG DISTRICT,MASTUNG TEHSIL,72,171,59,230
MASTUNG DISTRICT,MASTUNG TEHSIL,73,122,51,173
MASTUNG DISTRICT,MASTUNG TEHSIL,74,114,35,149
MASTUNG DISTRICT,MASTUNG TEHSIL,>=75,1070,344,1414
MATIARI DISTRICT,HALA TALUKA,<1,2885,2240,5125
MATIARI DISTRICT,HALA TALUKA,1,3688,2820,6508
MATIARI DISTRICT,HALA TALUKA,2,4233,3064,7297
MATIARI DISTRICT,HALA TALUKA,3,5021,3570,8591
MATIARI DISTRICT,HALA TALUKA,4,5083,3380,8463
MATIARI DISTRICT,HALA TALUKA,5,5181,3792,8973
MATIARI DISTRICT,HALA TALUKA,6,4766,3289,8055
MATIARI DISTRICT,HALA TALUKA,7,4512,3319,7831
MATIARI DISTRICT,HALA TALUKA,8,4968,3429,8397
MATIARI DISTRICT,HALA TALUKA,9,3837,2991,6828
MATIARI DISTRICT,HALA TALUKA,10,4371,3130,7501
MATIARI DISTRICT,HALA TALUKA,11,3158,2755,5913
MATIARI DISTRICT,HALA TALUKA,12,3648,2841,6489
MATIARI DISTRICT,HALA TALUKA,13,2814,2686,5500
MATIARI DISTRICT,HALA TALUKA,14,3131,2540,5671
MATIARI DISTRICT,HALA TALUKA,15,3334,2881,6215
MATIARI DISTRICT,HALA TALUKA,16,3226,2609,5835
MATIARI DISTRICT,HALA TALUKA,17,3020,2652,5672
MATIARI DISTRICT,HALA TALUKA,18,3293,2735,6028
MATIARI DISTRICT,HALA TALUKA,19,2552,2331,4883
MATIARI DISTRICT,HALA TALUKA,20,3263,2612,5875
MATIARI DISTRICT,HALA TALUKA,21,2317,2158,4475
MATIARI DISTRICT,HALA TALUKA,22,2415,2112,4527
MATIARI DISTRICT,HALA TALUKA,23,2028,1987,4015
MATIARI DISTRICT,HALA TALUKA,24,2033,1747,3780
MATIARI DISTRICT,HALA TALUKA,25,2519,2042,4561
MATIARI DISTRICT,HALA TALUKA,26,2040,1882,3922
MATIARI DISTRICT,HALA TALUKA,27,2249,1937,4186
MATIARI DISTRICT,HALA TALUKA,28,1996,1815,3811
MATIARI DISTRICT,HALA TALUKA,29,2040,1866,3906
MATIARI DISTRICT,HALA TALUKA,30,2105,1950,4055
MATIARI DISTRICT,HALA TALUKA,31,1919,1771,3690
MATIARI DISTRICT,HALA TALUKA,32,1892,1735,3627
MATIARI DISTRICT,HALA TALUKA,33,1586,1538,3124
MATIARI DISTRICT,HALA TALUKA,34,1648,1465,3113
MATIARI DISTRICT,HALA TALUKA,35,1757,1556,3313
MATIARI DISTRICT,HALA TALUKA,36,1718,1434,3152
MATIARI DISTRICT,HALA TALUKA,37,2192,1661,3853
MATIARI DISTRICT,HALA TALUKA,38,1710,1461,3171
MATIARI DISTRICT,HALA TALUKA,39,1643,1461,3104
MATIARI DISTRICT,HALA TALUKA,40,1537,1453,2990
MATIARI DISTRICT,HALA TALUKA,41,1522,1260,2782
MATIARI DISTRICT,HALA TALUKA,42,1393,1217,2610
MATIARI DISTRICT,HALA TALUKA,43,1222,1159,2381
MATIARI DISTRICT,HALA TALUKA,44,1143,1050,2193
MATIARI DISTRICT,HALA TALUKA,45,1161,965,2126
MATIARI DISTRICT,HALA TALUKA,46,1190,939,2129
MATIARI DISTRICT,HALA TALUKA,47,1155,1023,2178
MATIARI DISTRICT,HALA TALUKA,48,1020,863,1883
MATIARI DISTRICT,HALA TALUKA,49,1047,939,1986
MATIARI DISTRICT,HALA TALUKA,50,1046,897,1943
MATIARI DISTRICT,HALA TALUKA,51,925,852,1777
MATIARI DISTRICT,HALA TALUKA,52,861,787,1648
MATIARI DISTRICT,HALA TALUKA,53,702,698,1400
MATIARI DISTRICT,HALA TALUKA,54,649,585,1234
MATIARI DISTRICT,HALA TALUKA,55,568,545,1113
MATIARI DISTRICT,HALA TALUKA,56,526,534,1060
MATIARI DISTRICT,HALA TALUKA,57,623,584,1207
MATIARI DISTRICT,HALA TALUKA,58,505,490,995
MATIARI DISTRICT,HALA TALUKA,59,508,518,1026
MATIARI DISTRICT,HALA TALUKA,60,576,454,1030
MATIARI DISTRICT,HALA TALUKA,61,581,499,1080
MATIARI DISTRICT,HALA TALUKA,62,518,488,1006
MATIARI DISTRICT,HALA TALUKA,63,510,462,972
MATIARI DISTRICT,HALA TALUKA,64,487,401,888
MATIARI DISTRICT,HALA TALUKA,65,459,328,787
MATIARI DISTRICT,HALA TALUKA,66,365,323,688
MATIARI DISTRICT,HALA TALUKA,67,317,296,613
MATIARI DISTRICT,HALA TALUKA,68,320,278,598
MATIARI DISTRICT,HALA TALUKA,69,334,256,590
MATIARI DISTRICT,HALA TALUKA,70,314,259,573
MATIARI DISTRICT,HALA TALUKA,71,265,220,485
MATIARI DISTRICT,HALA TALUKA,72,190,187,377
MATIARI DISTRICT,HALA TALUKA,73,239,152,391
MATIARI DISTRICT,HALA TALUKA,74,214,160,374
MATIARI DISTRICT,HALA TALUKA,>=75,1384,1107,2491
MATIARI DISTRICT,MATIARI TALUKA,<1,6636,857,7493
MATIARI DISTRICT,MATIARI TALUKA,1,7808,1071,8879
MATIARI DISTRICT,MATIARI TALUKA,2,9111,1224,10335
MATIARI DISTRICT,MATIARI TALUKA,3,10186,1333,11519
MATIARI DISTRICT,MATIARI TALUKA,4,10280,1291,11571
MATIARI DISTRICT,MATIARI TALUKA,5,10271,1342,11613
MATIARI DISTRICT,MATIARI TALUKA,6,9700,1200,10900
MATIARI DISTRICT,MATIARI TALUKA,7,9012,1219,10231
MATIARI DISTRICT,MATIARI TALUKA,8,10535,1219,11754
MATIARI DISTRICT,MATIARI TALUKA,9,7837,1040,8877
MATIARI DISTRICT,MATIARI TALUKA,10,9782,1089,10871
MATIARI DISTRICT,MATIARI TALUKA,11,6764,924,7688
MATIARI DISTRICT,MATIARI TALUKA,12,7855,963,8818
MATIARI DISTRICT,MATIARI TALUKA,13,6057,869,6926
MATIARI DISTRICT,MATIARI TALUKA,14,6303,905,7208
MATIARI DISTRICT,MATIARI TALUKA,15,6795,935,7730
MATIARI DISTRICT,MATIARI TALUKA,16,6105,843,6948
MATIARI DISTRICT,MATIARI TALUKA,17,5355,848,6203
MATIARI DISTRICT,MATIARI TALUKA,18,6810,915,7725
MATIARI DISTRICT,MATIARI TALUKA,19,5461,881,6342
MATIARI DISTRICT,MATIARI TALUKA,20,6827,903,7730
MATIARI DISTRICT,MATIARI TALUKA,21,4730,805,5535
MATIARI DISTRICT,MATIARI TALUKA,22,5141,772,5913
MATIARI DISTRICT,MATIARI TALUKA,23,4311,727,5038
MATIARI DISTRICT,MATIARI TALUKA,24,4191,730,4921
MATIARI DISTRICT,MATIARI TALUKA,25,5252,725,5977
MATIARI DISTRICT,MATIARI TALUKA,26,4266,681,4947
MATIARI DISTRICT,MATIARI TALUKA,27,4274,738,5012
MATIARI DISTRICT,MATIARI TALUKA,28,4646,772,5418
MATIARI DISTRICT,MATIARI TALUKA,29,4232,726,4958
MATIARI DISTRICT,MATIARI TALUKA,30,4583,620,5203
MATIARI DISTRICT,MATIARI TALUKA,31,4108,672,4780
MATIARI DISTRICT,MATIARI TALUKA,32,4187,716,4903
MATIARI DISTRICT,MATIARI TALUKA,33,3986,678,4664
MATIARI DISTRICT,MATIARI TALUKA,34,3862,622,4484
MATIARI DISTRICT,MATIARI TALUKA,35,3694,543,4237
MATIARI DISTRICT,MATIARI TALUKA,36,3531,555,4086
MATIARI DISTRICT,MATIARI TALUKA,37,4244,628,4872
MATIARI DISTRICT,MATIARI TALUKA,38,3605,557,4162
MATIARI DISTRICT,MATIARI TALUKA,39,3398,597,3995
MATIARI DISTRICT,MATIARI TALUKA,40,3076,419,3495
MATIARI DISTRICT,MATIARI TALUKA,41,2903,456,3359
MATIARI DISTRICT,MATIARI TALUKA,42,2803,431,3234
MATIARI DISTRICT,MATIARI TALUKA,43,2510,477,2987
MATIARI DISTRICT,MATIARI TALUKA,44,2524,401,2925
MATIARI DISTRICT,MATIARI TALUKA,45,2319,312,2631
MATIARI DISTRICT,MATIARI TALUKA,46,2234,382,2616
MATIARI DISTRICT,MATIARI TALUKA,47,2480,404,2884
MATIARI DISTRICT,MATIARI TALUKA,48,2104,358,2462
MATIARI DISTRICT,MATIARI TALUKA,49,2045,362,2407
MATIARI DISTRICT,MATIARI TALUKA,50,1912,275,2187
MATIARI DISTRICT,MATIARI TALUKA,51,1719,292,2011
MATIARI DISTRICT,MATIARI TALUKA,52,1542,272,1814
MATIARI DISTRICT,MATIARI TALUKA,53,1268,236,1504
MATIARI DISTRICT,MATIARI TALUKA,54,1221,231,1452
MATIARI DISTRICT,MATIARI TALUKA,55,1210,205,1415
MATIARI DISTRICT,MATIARI TALUKA,56,1114,164,1278
MATIARI DISTRICT,MATIARI TALUKA,57,1317,229,1546
MATIARI DISTRICT,MATIARI TALUKA,58,1041,202,1243
MATIARI DISTRICT,MATIARI TALUKA,59,1177,238,1415
MATIARI DISTRICT,MATIARI TALUKA,60,1206,172,1378
MATIARI DISTRICT,MATIARI TALUKA,61,957,180,1137
MATIARI DISTRICT,MATIARI TALUKA,62,1073,187,1260
MATIARI DISTRICT,MATIARI TALUKA,63,967,146,1113
MATIARI DISTRICT,MATIARI TALUKA,64,970,160,1130
MATIARI DISTRICT,MATIARI TALUKA,65,903,124,1027
MATIARI DISTRICT,MATIARI TALUKA,66,787,110,897
MATIARI DISTRICT,MATIARI TALUKA,67,652,132,784
MATIARI DISTRICT,MATIARI TALUKA,68,667,93,760
MATIARI DISTRICT,MATIARI TALUKA,69,604,116,720
MATIARI DISTRICT,MATIARI TALUKA,70,529,63,592
MATIARI DISTRICT,MATIARI TALUKA,71,519,70,589
MATIARI DISTRICT,MATIARI TALUKA,72,424,63,487
MATIARI DISTRICT,MATIARI TALUKA,73,391,43,434
MATIARI DISTRICT,MATIARI TALUKA,74,368,46,414
MATIARI DISTRICT,MATIARI TALUKA,>=75,2683,374,3057
MATIARI DISTRICT,SAEEDABAD TALUKA,<1,3152,440,3592
MATIARI DISTRICT,SAEEDABAD TALUKA,1,3846,572,4418
MATIARI DISTRICT,SAEEDABAD TALUKA,2,4542,585,5127
MATIARI DISTRICT,SAEEDABAD TALUKA,3,4747,629,5376
MATIARI DISTRICT,SAEEDABAD TALUKA,4,5037,657,5694
MATIARI DISTRICT,SAEEDABAD TALUKA,5,4920,673,5593
MATIARI DISTRICT,SAEEDABAD TALUKA,6,4781,619,5400
MATIARI DISTRICT,SAEEDABAD TALUKA,7,4375,623,4998
MATIARI DISTRICT,SAEEDABAD TALUKA,8,4919,610,5529
MATIARI DISTRICT,SAEEDABAD TALUKA,9,3903,576,4479
MATIARI DISTRICT,SAEEDABAD TALUKA,10,4470,551,5021
MATIARI DISTRICT,SAEEDABAD TALUKA,11,3235,464,3699
MATIARI DISTRICT,SAEEDABAD TALUKA,12,3611,509,4120
MATIARI DISTRICT,SAEEDABAD TALUKA,13,2963,485,3448
MATIARI DISTRICT,SAEEDABAD TALUKA,14,3217,469,3686
MATIARI DISTRICT,SAEEDABAD TALUKA,15,3163,492,3655
MATIARI DISTRICT,SAEEDABAD TALUKA,16,3082,454,3536
MATIARI DISTRICT,SAEEDABAD TALUKA,17,2852,503,3355
MATIARI DISTRICT,SAEEDABAD TALUKA,18,3186,463,3649
MATIARI DISTRICT,SAEEDABAD TALUKA,19,2829,485,3314
MATIARI DISTRICT,SAEEDABAD TALUKA,20,3105,421,3526
MATIARI DISTRICT,SAEEDABAD TALUKA,21,2334,413,2747
MATIARI DISTRICT,SAEEDABAD TALUKA,22,2447,401,2848
MATIARI DISTRICT,SAEEDABAD TALUKA,23,2206,350,2556
MATIARI DISTRICT,SAEEDABAD TALUKA,24,2072,370,2442
MATIARI DISTRICT,SAEEDABAD TALUKA,25,2367,346,2713
MATIARI DISTRICT,SAEEDABAD TALUKA,26,2208,302,2510
MATIARI DISTRICT,SAEEDABAD TALUKA,27,2112,311,2423
MATIARI DISTRICT,SAEEDABAD TALUKA,28,2298,339,2637
MATIARI DISTRICT,SAEEDABAD TALUKA,29,2170,312,2482
MATIARI DISTRICT,SAEEDABAD TALUKA,30,2122,347,2469
MATIARI DISTRICT,SAEEDABAD TALUKA,31,1997,309,2306
MATIARI DISTRICT,SAEEDABAD TALUKA,32,2018,296,2314
MATIARI DISTRICT,SAEEDABAD TALUKA,33,1916,270,2186
MATIARI DISTRICT,SAEEDABAD TALUKA,34,1720,255,1975
MATIARI DISTRICT,SAEEDABAD TALUKA,35,1761,278,2039
MATIARI DISTRICT,SAEEDABAD TALUKA,36,1852,268,2120
MATIARI DISTRICT,SAEEDABAD TALUKA,37,2097,265,2362
MATIARI DISTRICT,SAEEDABAD TALUKA,38,1737,264,2001
MATIARI DISTRICT,SAEEDABAD TALUKA,39,1601,267,1868
MATIARI DISTRICT,SAEEDABAD TALUKA,40,1456,266,1722
MATIARI DISTRICT,SAEEDABAD TALUKA,41,1445,226,1671
MATIARI DISTRICT,SAEEDABAD TALUKA,42,1359,183,1542
MATIARI DISTRICT,SAEEDABAD TALUKA,43,1212,196,1408
MATIARI DISTRICT,SAEEDABAD TALUKA,44,1089,174,1263
MATIARI DISTRICT,SAEEDABAD TALUKA,45,1105,182,1287
MATIARI DISTRICT,SAEEDABAD TALUKA,46,1219,163,1382
MATIARI DISTRICT,SAEEDABAD TALUKA,47,1195,164,1359
MATIARI DISTRICT,SAEEDABAD TALUKA,48,1010,147,1157
MATIARI DISTRICT,SAEEDABAD TALUKA,49,1075,136,1211
MATIARI DISTRICT,SAEEDABAD TALUKA,50,960,160,1120
MATIARI DISTRICT,SAEEDABAD TALUKA,51,994,145,1139
MATIARI DISTRICT,SAEEDABAD TALUKA,52,870,101,971
MATIARI DISTRICT,SAEEDABAD TALUKA,53,720,107,827
MATIARI DISTRICT,SAEEDABAD TALUKA,54,616,95,711
MATIARI DISTRICT,SAEEDABAD TALUKA,55,580,89,669
MATIARI DISTRICT,SAEEDABAD TALUKA,56,545,76,621
MATIARI DISTRICT,SAEEDABAD TALUKA,57,646,54,700
MATIARI DISTRICT,SAEEDABAD TALUKA,58,565,65,630
MATIARI DISTRICT,SAEEDABAD TALUKA,59,577,86,663
MATIARI DISTRICT,SAEEDABAD TALUKA,60,561,86,647
MATIARI DISTRICT,SAEEDABAD TALUKA,61,548,70,618
MATIARI DISTRICT,SAEEDABAD TALUKA,62,619,69,688
MATIARI DISTRICT,SAEEDABAD TALUKA,63,510,81,591
MATIARI DISTRICT,SAEEDABAD TALUKA,64,474,65,539
MATIARI DISTRICT,SAEEDABAD TALUKA,65,416,44,460
MATIARI DISTRICT,SAEEDABAD TALUKA,66,450,60,510
MATIARI DISTRICT,SAEEDABAD TALUKA,67,337,34,371
MATIARI DISTRICT,SAEEDABAD TALUKA,68,300,43,343
MATIARI DISTRICT,SAEEDABAD TALUKA,69,323,43,366
MATIARI DISTRICT,SAEEDABAD TALUKA,70,316,47,363
MATIARI DISTRICT,SAEEDABAD TALUKA,71,278,39,317
MATIARI DISTRICT,SAEEDABAD TALUKA,72,214,31,245
MATIARI DISTRICT,SAEEDABAD TALUKA,73,199,43,242
MATIARI DISTRICT,SAEEDABAD TALUKA,74,182,24,206
MATIARI DISTRICT,SAEEDABAD TALUKA,>=75,1319,200,1519
MIANWALI DISTRICT,ISAKHEL TEHSIL,<1,7648,1965,9613
MIANWALI DISTRICT,ISAKHEL TEHSIL,1,8033,1829,9862
MIANWALI DISTRICT,ISAKHEL TEHSIL,2,8200,2121,10321
MIANWALI DISTRICT,ISAKHEL TEHSIL,3,8466,2215,10681
MIANWALI DISTRICT,ISAKHEL TEHSIL,4,8351,2174,10525
MIANWALI DISTRICT,ISAKHEL TEHSIL,5,8353,2088,10441
MIANWALI DISTRICT,ISAKHEL TEHSIL,6,7781,2044,9825
MIANWALI DISTRICT,ISAKHEL TEHSIL,7,8261,2144,10405
MIANWALI DISTRICT,ISAKHEL TEHSIL,8,7482,1904,9386
MIANWALI DISTRICT,ISAKHEL TEHSIL,9,8147,2225,10372
MIANWALI DISTRICT,ISAKHEL TEHSIL,10,6801,1767,8568
MIANWALI DISTRICT,ISAKHEL TEHSIL,11,7710,1956,9666
MIANWALI DISTRICT,ISAKHEL TEHSIL,12,6623,1722,8345
MIANWALI DISTRICT,ISAKHEL TEHSIL,13,6877,1734,8611
MIANWALI DISTRICT,ISAKHEL TEHSIL,14,6276,1787,8063
MIANWALI DISTRICT,ISAKHEL TEHSIL,15,6389,1722,8111
MIANWALI DISTRICT,ISAKHEL TEHSIL,16,6345,1783,8128
MIANWALI DISTRICT,ISAKHEL TEHSIL,17,6521,1952,8473
MIANWALI DISTRICT,ISAKHEL TEHSIL,18,5664,1581,7245
MIANWALI DISTRICT,ISAKHEL TEHSIL,19,6321,1712,8033
MIANWALI DISTRICT,ISAKHEL TEHSIL,20,5175,1434,6609
MIANWALI DISTRICT,ISAKHEL TEHSIL,21,5777,1656,7433
MIANWALI DISTRICT,ISAKHEL TEHSIL,22,4867,1401,6268
MIANWALI DISTRICT,ISAKHEL TEHSIL,23,5010,1568,6578
MIANWALI DISTRICT,ISAKHEL TEHSIL,24,4647,1354,6001
MIANWALI DISTRICT,ISAKHEL TEHSIL,25,4226,1260,5486
MIANWALI DISTRICT,ISAKHEL TEHSIL,26,4537,1406,5943
MIANWALI DISTRICT,ISAKHEL TEHSIL,27,4710,1482,6192
MIANWALI DISTRICT,ISAKHEL TEHSIL,28,4067,1304,5371
MIANWALI DISTRICT,ISAKHEL TEHSIL,29,4972,1500,6472
MIANWALI DISTRICT,ISAKHEL TEHSIL,30,3451,1147,4598
MIANWALI DISTRICT,ISAKHEL TEHSIL,31,4207,1328,5535
MIANWALI DISTRICT,ISAKHEL TEHSIL,32,3755,1234,4989
MIANWALI DISTRICT,ISAKHEL TEHSIL,33,3682,1157,4839
MIANWALI DISTRICT,ISAKHEL TEHSIL,34,3700,1101,4801
MIANWALI DISTRICT,ISAKHEL TEHSIL,35,2712,916,3628
MIANWALI DISTRICT,ISAKHEL TEHSIL,36,3095,1030,4125
MIANWALI DISTRICT,ISAKHEL TEHSIL,37,3201,1092,4293
MIANWALI DISTRICT,ISAKHEL TEHSIL,38,2730,1004,3734
MIANWALI DISTRICT,ISAKHEL TEHSIL,39,3106,1003,4109
MIANWALI DISTRICT,ISAKHEL TEHSIL,40,2165,809,2974
MIANWALI DISTRICT,ISAKHEL TEHSIL,41,2662,920,3582
MIANWALI DISTRICT,ISAKHEL TEHSIL,42,2476,858,3334
MIANWALI DISTRICT,ISAKHEL TEHSIL,43,2438,840,3278
MIANWALI DISTRICT,ISAKHEL TEHSIL,44,2345,837,3182
MIANWALI DISTRICT,ISAKHEL TEHSIL,45,1829,678,2507
MIANWALI DISTRICT,ISAKHEL TEHSIL,46,2295,698,2993
MIANWALI DISTRICT,ISAKHEL TEHSIL,47,2259,765,3024
MIANWALI DISTRICT,ISAKHEL TEHSIL,48,2321,757,3078
MIANWALI DISTRICT,ISAKHEL TEHSIL,49,2396,795,3191
MIANWALI DISTRICT,ISAKHEL TEHSIL,50,1813,628,2441
MIANWALI DISTRICT,ISAKHEL TEHSIL,51,2461,854,3315
MIANWALI DISTRICT,ISAKHEL TEHSIL,52,2355,705,3060
MIANWALI DISTRICT,ISAKHEL TEHSIL,53,2354,743,3097
MIANWALI DISTRICT,ISAKHEL TEHSIL,54,2144,647,2791
MIANWALI DISTRICT,ISAKHEL TEHSIL,55,1544,546,2090
MIANWALI DISTRICT,ISAKHEL TEHSIL,56,1756,544,2300
MIANWALI DISTRICT,ISAKHEL TEHSIL,57,1492,559,2051
MIANWALI DISTRICT,ISAKHEL TEHSIL,58,1437,510,1947
MIANWALI DISTRICT,ISAKHEL TEHSIL,59,1393,484,1877
MIANWALI DISTRICT,ISAKHEL TEHSIL,60,956,347,1303
MIANWALI DISTRICT,ISAKHEL TEHSIL,61,1481,511,1992
MIANWALI DISTRICT,ISAKHEL TEHSIL,62,1471,529,2000
MIANWALI DISTRICT,ISAKHEL TEHSIL,63,1378,485,1863
MIANWALI DISTRICT,ISAKHEL TEHSIL,64,1234,411,1645
MIANWALI DISTRICT,ISAKHEL TEHSIL,65,903,323,1226
MIANWALI DISTRICT,ISAKHEL TEHSIL,66,1010,313,1323
MIANWALI DISTRICT,ISAKHEL TEHSIL,67,1165,364,1529
MIANWALI DISTRICT,ISAKHEL TEHSIL,68,1170,379,1549
MIANWALI DISTRICT,ISAKHEL TEHSIL,69,928,313,1241
MIANWALI DISTRICT,ISAKHEL TEHSIL,70,592,210,802
MIANWALI DISTRICT,ISAKHEL TEHSIL,71,869,256,1125
MIANWALI DISTRICT,ISAKHEL TEHSIL,72,848,275,1123
MIANWALI DISTRICT,ISAKHEL TEHSIL,73,873,286,1159
MIANWALI DISTRICT,ISAKHEL TEHSIL,74,500,203,703
MIANWALI DISTRICT,ISAKHEL TEHSIL,>=75,4444,1377,5821
MIANWALI DISTRICT,MIANWALI TEHSIL,<1,13833,2997,16830
MIANWALI DISTRICT,MIANWALI TEHSIL,1,15040,2977,18017
MIANWALI DISTRICT,MIANWALI TEHSIL,2,15627,3307,18934
MIANWALI DISTRICT,MIANWALI TEHSIL,3,17004,3571,20575
MIANWALI DISTRICT,MIANWALI TEHSIL,4,16495,3450,19945
MIANWALI DISTRICT,MIANWALI TEHSIL,5,16801,3500,20301
MIANWALI DISTRICT,MIANWALI TEHSIL,6,15546,3214,18760
MIANWALI DISTRICT,MIANWALI TEHSIL,7,16141,3450,19591
MIANWALI DISTRICT,MIANWALI TEHSIL,8,15253,2975,18228
MIANWALI DISTRICT,MIANWALI TEHSIL,9,16643,3451,20094
MIANWALI DISTRICT,MIANWALI TEHSIL,10,13881,2739,16620
MIANWALI DISTRICT,MIANWALI TEHSIL,11,15598,3287,18885
MIANWALI DISTRICT,MIANWALI TEHSIL,12,13145,2679,15824
MIANWALI DISTRICT,MIANWALI TEHSIL,13,14336,3147,17483
MIANWALI DISTRICT,MIANWALI TEHSIL,14,13349,2718,16067
MIANWALI DISTRICT,MIANWALI TEHSIL,15,13551,2864,16415
MIANWALI DISTRICT,MIANWALI TEHSIL,16,13341,2885,16226
MIANWALI DISTRICT,MIANWALI TEHSIL,17,15092,3150,18242
MIANWALI DISTRICT,MIANWALI TEHSIL,18,11399,2631,14030
MIANWALI DISTRICT,MIANWALI TEHSIL,19,12934,3069,16003
MIANWALI DISTRICT,MIANWALI TEHSIL,20,11161,2678,13839
MIANWALI DISTRICT,MIANWALI TEHSIL,21,12502,3259,15761
MIANWALI DISTRICT,MIANWALI TEHSIL,22,10587,2730,13317
MIANWALI DISTRICT,MIANWALI TEHSIL,23,11417,3122,14539
MIANWALI DISTRICT,MIANWALI TEHSIL,24,10454,2835,13289
MIANWALI DISTRICT,MIANWALI TEHSIL,25,9213,2450,11663
MIANWALI DISTRICT,MIANWALI TEHSIL,26,10236,2812,13048
MIANWALI DISTRICT,MIANWALI TEHSIL,27,9860,2811,12671
MIANWALI DISTRICT,MIANWALI TEHSIL,28,9664,2558,12222
MIANWALI DISTRICT,MIANWALI TEHSIL,29,9567,2755,12322
MIANWALI DISTRICT,MIANWALI TEHSIL,30,8531,2360,10891
MIANWALI DISTRICT,MIANWALI TEHSIL,31,8864,2530,11394
MIANWALI DISTRICT,MIANWALI TEHSIL,32,8377,2443,10820
MIANWALI DISTRICT,MIANWALI TEHSIL,33,8065,2338,10403
MIANWALI DISTRICT,MIANWALI TEHSIL,34,7824,2244,10068
MIANWALI DISTRICT,MIANWALI TEHSIL,35,6960,1900,8860
MIANWALI DISTRICT,MIANWALI TEHSIL,36,7251,2028,9279
MIANWALI DISTRICT,MIANWALI TEHSIL,37,6318,1901,8219
MIANWALI DISTRICT,MIANWALI TEHSIL,38,7223,2125,9348
MIANWALI DISTRICT,MIANWALI TEHSIL,39,6588,1923,8511
MIANWALI DISTRICT,MIANWALI TEHSIL,40,6274,1664,7938
MIANWALI DISTRICT,MIANWALI TEHSIL,41,6049,1677,7726
MIANWALI DISTRICT,MIANWALI TEHSIL,42,5586,1640,7226
MIANWALI DISTRICT,MIANWALI TEHSIL,43,5612,1545,7157
MIANWALI DISTRICT,MIANWALI TEHSIL,44,5327,1432,6759
MIANWALI DISTRICT,MIANWALI TEHSIL,45,5102,1281,6383
MIANWALI DISTRICT,MIANWALI TEHSIL,46,5123,1322,6445
MIANWALI DISTRICT,MIANWALI TEHSIL,47,4641,1233,5874
MIANWALI DISTRICT,MIANWALI TEHSIL,48,5565,1475,7040
MIANWALI DISTRICT,MIANWALI TEHSIL,49,5257,1391,6648
MIANWALI DISTRICT,MIANWALI TEHSIL,50,5075,1198,6273
MIANWALI DISTRICT,MIANWALI TEHSIL,51,5183,1259,6442
MIANWALI DISTRICT,MIANWALI TEHSIL,52,4825,1197,6022
MIANWALI DISTRICT,MIANWALI TEHSIL,53,5054,1270,6324
MIANWALI DISTRICT,MIANWALI TEHSIL,54,4538,1128,5666
MIANWALI DISTRICT,MIANWALI TEHSIL,55,4042,1002,5044
MIANWALI DISTRICT,MIANWALI TEHSIL,56,3936,920,4856
MIANWALI DISTRICT,MIANWALI TEHSIL,57,3422,864,4286
MIANWALI DISTRICT,MIANWALI TEHSIL,58,3717,936,4653
MIANWALI DISTRICT,MIANWALI TEHSIL,59,3290,856,4146
MIANWALI DISTRICT,MIANWALI TEHSIL,60,3093,726,3819
MIANWALI DISTRICT,MIANWALI TEHSIL,61,3270,856,4126
MIANWALI DISTRICT,MIANWALI TEHSIL,62,3068,833,3901
MIANWALI DISTRICT,MIANWALI TEHSIL,63,3186,857,4043
MIANWALI DISTRICT,MIANWALI TEHSIL,64,2837,700,3537
MIANWALI DISTRICT,MIANWALI TEHSIL,65,2547,590,3137
MIANWALI DISTRICT,MIANWALI TEHSIL,66,2268,547,2815
MIANWALI DISTRICT,MIANWALI TEHSIL,67,2115,478,2593
MIANWALI DISTRICT,MIANWALI TEHSIL,68,2390,553,2943
MIANWALI DISTRICT,MIANWALI TEHSIL,69,2129,490,2619
MIANWALI DISTRICT,MIANWALI TEHSIL,70,1856,376,2232
MIANWALI DISTRICT,MIANWALI TEHSIL,71,1815,368,2183
MIANWALI DISTRICT,MIANWALI TEHSIL,72,1555,340,1895
MIANWALI DISTRICT,MIANWALI TEHSIL,73,1615,350,1965
MIANWALI DISTRICT,MIANWALI TEHSIL,74,1376,271,1647
MIANWALI DISTRICT,MIANWALI TEHSIL,>=75,10537,1923,12460
MIANWALI DISTRICT,PIPLAN TEHSIL,<1,7109,2100,9209
MIANWALI DISTRICT,PIPLAN TEHSIL,1,7733,2279,10012
MIANWALI DISTRICT,PIPLAN TEHSIL,2,7889,2380,10269
MIANWALI DISTRICT,PIPLAN TEHSIL,3,8557,2421,10978
MIANWALI DISTRICT,PIPLAN TEHSIL,4,8610,2404,11014
MIANWALI DISTRICT,PIPLAN TEHSIL,5,8379,2295,10674
MIANWALI DISTRICT,PIPLAN TEHSIL,6,7793,2192,9985
MIANWALI DISTRICT,PIPLAN TEHSIL,7,8681,2316,10997
MIANWALI DISTRICT,PIPLAN TEHSIL,8,8049,2113,10162
MIANWALI DISTRICT,PIPLAN TEHSIL,9,8439,2435,10874
MIANWALI DISTRICT,PIPLAN TEHSIL,10,7336,1870,9206
MIANWALI DISTRICT,PIPLAN TEHSIL,11,7782,2304,10086
MIANWALI DISTRICT,PIPLAN TEHSIL,12,6753,1844,8597
MIANWALI DISTRICT,PIPLAN TEHSIL,13,6989,2172,9161
MIANWALI DISTRICT,PIPLAN TEHSIL,14,6680,1907,8587
MIANWALI DISTRICT,PIPLAN TEHSIL,15,6823,1947,8770
MIANWALI DISTRICT,PIPLAN TEHSIL,16,6732,1981,8713
MIANWALI DISTRICT,PIPLAN TEHSIL,17,7391,2466,9857
MIANWALI DISTRICT,PIPLAN TEHSIL,18,5617,1676,7293
MIANWALI DISTRICT,PIPLAN TEHSIL,19,6508,2017,8525
MIANWALI DISTRICT,PIPLAN TEHSIL,20,5989,1720,7709
MIANWALI DISTRICT,PIPLAN TEHSIL,21,5913,2024,7937
MIANWALI DISTRICT,PIPLAN TEHSIL,22,5678,1820,7498
MIANWALI DISTRICT,PIPLAN TEHSIL,23,5555,1953,7508
MIANWALI DISTRICT,PIPLAN TEHSIL,24,5124,1748,6872
MIANWALI DISTRICT,PIPLAN TEHSIL,25,4869,1478,6347
MIANWALI DISTRICT,PIPLAN TEHSIL,26,4785,1746,6531
MIANWALI DISTRICT,PIPLAN TEHSIL,27,4766,1689,6455
MIANWALI DISTRICT,PIPLAN TEHSIL,28,4589,1571,6160
MIANWALI DISTRICT,PIPLAN TEHSIL,29,4490,1564,6054
MIANWALI DISTRICT,PIPLAN TEHSIL,30,4479,1416,5895
MIANWALI DISTRICT,PIPLAN TEHSIL,31,4045,1474,5519
MIANWALI DISTRICT,PIPLAN TEHSIL,32,4218,1468,5686
MIANWALI DISTRICT,PIPLAN TEHSIL,33,3832,1413,5245
MIANWALI DISTRICT,PIPLAN TEHSIL,34,3883,1347,5230
MIANWALI DISTRICT,PIPLAN TEHSIL,35,3843,1228,5071
MIANWALI DISTRICT,PIPLAN TEHSIL,36,3518,1212,4730
MIANWALI DISTRICT,PIPLAN TEHSIL,37,3325,1087,4412
MIANWALI DISTRICT,PIPLAN TEHSIL,38,3666,1256,4922
MIANWALI DISTRICT,PIPLAN TEHSIL,39,3333,1129,4462
MIANWALI DISTRICT,PIPLAN TEHSIL,40,3464,1052,4516
MIANWALI DISTRICT,PIPLAN TEHSIL,41,2832,949,3781
MIANWALI DISTRICT,PIPLAN TEHSIL,42,2782,867,3649
MIANWALI DISTRICT,PIPLAN TEHSIL,43,2808,934,3742
MIANWALI DISTRICT,PIPLAN TEHSIL,44,2606,922,3528
MIANWALI DISTRICT,PIPLAN TEHSIL,45,2711,820,3531
MIANWALI DISTRICT,PIPLAN TEHSIL,46,2414,834,3248
MIANWALI DISTRICT,PIPLAN TEHSIL,47,2221,697,2918
MIANWALI DISTRICT,PIPLAN TEHSIL,48,2543,855,3398
MIANWALI DISTRICT,PIPLAN TEHSIL,49,2441,863,3304
MIANWALI DISTRICT,PIPLAN TEHSIL,50,2646,853,3499
MIANWALI DISTRICT,PIPLAN TEHSIL,51,2178,768,2946
MIANWALI DISTRICT,PIPLAN TEHSIL,52,2296,777,3073
MIANWALI DISTRICT,PIPLAN TEHSIL,53,2383,814,3197
MIANWALI DISTRICT,PIPLAN TEHSIL,54,2153,757,2910
MIANWALI DISTRICT,PIPLAN TEHSIL,55,2015,633,2648
MIANWALI DISTRICT,PIPLAN TEHSIL,56,1799,634,2433
MIANWALI DISTRICT,PIPLAN TEHSIL,57,1549,497,2046
MIANWALI DISTRICT,PIPLAN TEHSIL,58,1534,520,2054
MIANWALI DISTRICT,PIPLAN TEHSIL,59,1381,505,1886
MIANWALI DISTRICT,PIPLAN TEHSIL,60,1592,470,2062
MIANWALI DISTRICT,PIPLAN TEHSIL,61,1344,515,1859
MIANWALI DISTRICT,PIPLAN TEHSIL,62,1313,523,1836
MIANWALI DISTRICT,PIPLAN TEHSIL,63,1279,530,1809
MIANWALI DISTRICT,PIPLAN TEHSIL,64,1200,419,1619
MIANWALI DISTRICT,PIPLAN TEHSIL,65,1230,407,1637
MIANWALI DISTRICT,PIPLAN TEHSIL,66,914,379,1293
MIANWALI DISTRICT,PIPLAN TEHSIL,67,921,304,1225
MIANWALI DISTRICT,PIPLAN TEHSIL,68,973,357,1330
MIANWALI DISTRICT,PIPLAN TEHSIL,69,842,333,1175
MIANWALI DISTRICT,PIPLAN TEHSIL,70,970,273,1243
MIANWALI DISTRICT,PIPLAN TEHSIL,71,794,257,1051
MIANWALI DISTRICT,PIPLAN TEHSIL,72,693,264,957
MIANWALI DISTRICT,PIPLAN TEHSIL,73,727,243,970
MIANWALI DISTRICT,PIPLAN TEHSIL,74,535,172,707
MIANWALI DISTRICT,PIPLAN TEHSIL,>=75,4377,1381,5758
MIRPUR KHAS DISTRICT,DIGRI TALUKA,<1,3543,1526,5069
MIRPUR KHAS DISTRICT,DIGRI TALUKA,1,4101,1743,5844
MIRPUR KHAS DISTRICT,DIGRI TALUKA,2,4567,1884,6451
MIRPUR KHAS DISTRICT,DIGRI TALUKA,3,5050,2249,7299
MIRPUR KHAS DISTRICT,DIGRI TALUKA,4,5162,1991,7153
MIRPUR KHAS DISTRICT,DIGRI TALUKA,5,5118,2271,7389
MIRPUR KHAS DISTRICT,DIGRI TALUKA,6,4998,2003,7001
MIRPUR KHAS DISTRICT,DIGRI TALUKA,7,4462,2101,6563
MIRPUR KHAS DISTRICT,DIGRI TALUKA,8,5287,2036,7323
MIRPUR KHAS DISTRICT,DIGRI TALUKA,9,3734,1880,5614
MIRPUR KHAS DISTRICT,DIGRI TALUKA,10,4581,1827,6408
MIRPUR KHAS DISTRICT,DIGRI TALUKA,11,2983,1709,4692
MIRPUR KHAS DISTRICT,DIGRI TALUKA,12,3611,1640,5251
MIRPUR KHAS DISTRICT,DIGRI TALUKA,13,2634,1589,4223
MIRPUR KHAS DISTRICT,DIGRI TALUKA,14,2640,1439,4079
MIRPUR KHAS DISTRICT,DIGRI TALUKA,15,2924,1674,4598
MIRPUR KHAS DISTRICT,DIGRI TALUKA,16,2804,1459,4263
MIRPUR KHAS DISTRICT,DIGRI TALUKA,17,2545,1559,4104
MIRPUR KHAS DISTRICT,DIGRI TALUKA,18,2997,1496,4493
MIRPUR KHAS DISTRICT,DIGRI TALUKA,19,2251,1443,3694
MIRPUR KHAS DISTRICT,DIGRI TALUKA,20,3089,1508,4597
MIRPUR KHAS DISTRICT,DIGRI TALUKA,21,2061,1280,3341
MIRPUR KHAS DISTRICT,DIGRI TALUKA,22,2328,1267,3595
MIRPUR KHAS DISTRICT,DIGRI TALUKA,23,1955,1243,3198
MIRPUR KHAS DISTRICT,DIGRI TALUKA,24,1768,1202,2970
MIRPUR KHAS DISTRICT,DIGRI TALUKA,25,2395,1214,3609
MIRPUR KHAS DISTRICT,DIGRI TALUKA,26,1957,1228,3185
MIRPUR KHAS DISTRICT,DIGRI TALUKA,27,2040,1162,3202
MIRPUR KHAS DISTRICT,DIGRI TALUKA,28,2088,1130,3218
MIRPUR KHAS DISTRICT,DIGRI TALUKA,29,2130,1193,3323
MIRPUR KHAS DISTRICT,DIGRI TALUKA,30,2097,1064,3161
MIRPUR KHAS DISTRICT,DIGRI TALUKA,31,2031,1106,3137
MIRPUR KHAS DISTRICT,DIGRI TALUKA,32,1993,1164,3157
MIRPUR KHAS DISTRICT,DIGRI TALUKA,33,1814,1077,2891
MIRPUR KHAS DISTRICT,DIGRI TALUKA,34,1599,983,2582
MIRPUR KHAS DISTRICT,DIGRI TALUKA,35,1778,887,2665
MIRPUR KHAS DISTRICT,DIGRI TALUKA,36,1574,870,2444
MIRPUR KHAS DISTRICT,DIGRI TALUKA,37,2063,1149,3212
MIRPUR KHAS DISTRICT,DIGRI TALUKA,38,1456,834,2290
MIRPUR KHAS DISTRICT,DIGRI TALUKA,39,1696,954,2650
MIRPUR KHAS DISTRICT,DIGRI TALUKA,40,1297,760,2057
MIRPUR KHAS DISTRICT,DIGRI TALUKA,41,1290,773,2063
MIRPUR KHAS DISTRICT,DIGRI TALUKA,42,1242,789,2031
MIRPUR KHAS DISTRICT,DIGRI TALUKA,43,1043,761,1804
MIRPUR KHAS DISTRICT,DIGRI TALUKA,44,1049,712,1761
MIRPUR KHAS DISTRICT,DIGRI TALUKA,45,1001,592,1593
MIRPUR KHAS DISTRICT,DIGRI TALUKA,46,970,566,1536
MIRPUR KHAS DISTRICT,DIGRI TALUKA,47,1091,736,1827
MIRPUR KHAS DISTRICT,DIGRI TALUKA,48,918,581,1499
MIRPUR KHAS DISTRICT,DIGRI TALUKA,49,940,654,1594
MIRPUR KHAS DISTRICT,DIGRI TALUKA,50,836,475,1311
MIRPUR KHAS DISTRICT,DIGRI TALUKA,51,770,580,1350
MIRPUR KHAS DISTRICT,DIGRI TALUKA,52,748,559,1307
MIRPUR KHAS DISTRICT,DIGRI TALUKA,53,695,493,1188
MIRPUR KHAS DISTRICT,DIGRI TALUKA,54,615,440,1055
MIRPUR KHAS DISTRICT,DIGRI TALUKA,55,596,356,952
MIRPUR KHAS DISTRICT,DIGRI TALUKA,56,485,362,847
MIRPUR KHAS DISTRICT,DIGRI TALUKA,57,666,436,1102
MIRPUR KHAS DISTRICT,DIGRI TALUKA,58,535,356,891
MIRPUR KHAS DISTRICT,DIGRI TALUKA,59,658,399,1057
MIRPUR KHAS DISTRICT,DIGRI TALUKA,60,543,294,837
MIRPUR KHAS DISTRICT,DIGRI TALUKA,61,526,371,897
MIRPUR KHAS DISTRICT,DIGRI TALUKA,62,518,374,892
MIRPUR KHAS DISTRICT,DIGRI TALUKA,63,512,294,806
MIRPUR KHAS DISTRICT,DIGRI TALUKA,64,558,303,861
MIRPUR KHAS DISTRICT,DIGRI TALUKA,65,405,218,623
MIRPUR KHAS DISTRICT,DIGRI TALUKA,66,308,212,520
MIRPUR KHAS DISTRICT,DIGRI TALUKA,67,323,216,539
MIRPUR KHAS DISTRICT,DIGRI TALUKA,68,288,209,497
MIRPUR KHAS DISTRICT,DIGRI TALUKA,69,382,222,604
MIRPUR KHAS DISTRICT,DIGRI TALUKA,70,320,161,481
MIRPUR KHAS DISTRICT,DIGRI TALUKA,71,237,168,405
MIRPUR KHAS DISTRICT,DIGRI TALUKA,72,205,139,344
MIRPUR KHAS DISTRICT,DIGRI TALUKA,73,212,117,329
MIRPUR KHAS DISTRICT,DIGRI TALUKA,74,210,93,303
MIRPUR KHAS DISTRICT,DIGRI TALUKA,>=75,1408,908,2316
MIRPUR KHAS DISTRICT,HUSSAIN BUX MARI TALUKA,<1,3740,0,3740
MIRPUR KHAS DISTRICT,HUSSAIN BUX MARI TALUKA,1,4150,0,4150
MIRPUR KHAS DISTRICT,HUSSAIN BUX MARI TALUKA,2,4978,0,4978
MIRPUR KHAS DISTRICT,HUSSAIN BUX MARI TALUKA,3,5243,0,5243
MIRPUR KHAS DISTRICT,HUSSAIN BUX MARI TALUKA,4,5579,0,5579
MIRPUR KHAS DISTRICT,HUSSAIN BUX MARI TALUKA,5,5200,0,5200
MIRPUR KHAS DISTRICT,HUSSAIN BUX MARI TALUKA,6,5462,0,5462
MIRPUR KHAS DISTRICT,HUSSAIN BUX MARI TALUKA,7,4833,0,4833
MIRPUR KHAS DISTRICT,HUSSAIN BUX MARI TALUKA,8,5766,0,5766
MIRPUR KHAS DISTRICT,HUSSAIN BUX MARI TALUKA,9,4291,0,4291
MIRPUR KHAS DISTRICT,HUSSAIN BUX MARI TALUKA,10,5023,0,5023
MIRPUR KHAS DISTRICT,HUSSAIN BUX MARI TALUKA,11,3441,0,3441
MIRPUR KHAS DISTRICT,HUSSAIN BUX MARI TALUKA,12,3992,0,3992
MIRPUR KHAS DISTRICT,HUSSAIN BUX MARI TALUKA,13,3138,0,3138
MIRPUR KHAS DISTRICT,HUSSAIN BUX MARI TALUKA,14,3031,0,3031
MIRPUR KHAS DISTRICT,HUSSAIN BUX MARI TALUKA,15,3321,0,3321
MIRPUR KHAS DISTRICT,HUSSAIN BUX MARI TALUKA,16,2735,0,2735
MIRPUR KHAS DISTRICT,HUSSAIN BUX MARI TALUKA,17,2687,0,2687
MIRPUR KHAS DISTRICT,HUSSAIN BUX MARI TALUKA,18,3237,0,3237
MIRPUR KHAS DISTRICT,HUSSAIN BUX MARI TALUKA,19,2630,0,2630
MIRPUR KHAS DISTRICT,HUSSAIN BUX MARI TALUKA,20,3167,0,3167
MIRPUR KHAS DISTRICT,HUSSAIN BUX MARI TALUKA,21,2255,0,2255
MIRPUR KHAS DISTRICT,HUSSAIN BUX MARI TALUKA,22,2308,0,2308
MIRPUR KHAS DISTRICT,HUSSAIN BUX MARI TALUKA,23,1964,0,1964
MIRPUR KHAS DISTRICT,HUSSAIN BUX MARI TALUKA,24,1796,0,1796
MIRPUR KHAS DISTRICT,HUSSAIN BUX MARI TALUKA,25,2487,0,2487
MIRPUR KHAS DISTRICT,HUSSAIN BUX MARI TALUKA,26,1910,0,1910
MIRPUR KHAS DISTRICT,HUSSAIN BUX MARI TALUKA,27,2230,0,2230
MIRPUR KHAS DISTRICT,HUSSAIN BUX MARI TALUKA,28,2181,0,2181
MIRPUR KHAS DISTRICT,HUSSAIN BUX MARI TALUKA,29,2313,0,2313
MIRPUR KHAS DISTRICT,HUSSAIN BUX MARI TALUKA,30,2246,0,2246
MIRPUR KHAS DISTRICT,HUSSAIN BUX MARI TALUKA,31,2275,0,2275
MIRPUR KHAS DISTRICT,HUSSAIN BUX MARI TALUKA,32,2049,0,2049
MIRPUR KHAS DISTRICT,HUSSAIN BUX MARI TALUKA,33,1971,0,1971
MIRPUR KHAS DISTRICT,HUSSAIN BUX MARI TALUKA,34,1727,0,1727
MIRPUR KHAS DISTRICT,HUSSAIN BUX MARI TALUKA,35,1891,0,1891
MIRPUR KHAS DISTRICT,HUSSAIN BUX MARI TALUKA,36,1613,0,1613
MIRPUR KHAS DISTRICT,HUSSAIN BUX MARI TALUKA,37,2268,0,2268
MIRPUR KHAS DISTRICT,HUSSAIN BUX MARI TALUKA,38,1585,0,1585
MIRPUR KHAS DISTRICT,HUSSAIN BUX MARI TALUKA,39,1820,0,1820
MIRPUR KHAS DISTRICT,HUSSAIN BUX MARI TALUKA,40,1410,0,1410
MIRPUR KHAS DISTRICT,HUSSAIN BUX MARI TALUKA,41,1379,0,1379
MIRPUR KHAS DISTRICT,HUSSAIN BUX MARI TALUKA,42,1432,0,1432
MIRPUR KHAS DISTRICT,HUSSAIN BUX MARI TALUKA,43,1194,0,1194
MIRPUR KHAS DISTRICT,HUSSAIN BUX MARI TALUKA,44,1109,0,1109
MIRPUR KHAS DISTRICT,HUSSAIN BUX MARI TALUKA,45,1093,0,1093
MIRPUR KHAS DISTRICT,HUSSAIN BUX MARI TALUKA,46,1024,0,1024
MIRPUR KHAS DISTRICT,HUSSAIN BUX MARI TALUKA,47,1337,0,1337
MIRPUR KHAS DISTRICT,HUSSAIN BUX MARI TALUKA,48,994,0,994
MIRPUR KHAS DISTRICT,HUSSAIN BUX MARI TALUKA,49,1129,0,1129
MIRPUR KHAS DISTRICT,HUSSAIN BUX MARI TALUKA,50,899,0,899
MIRPUR KHAS DISTRICT,HUSSAIN BUX MARI TALUKA,51,897,0,897
MIRPUR KHAS DISTRICT,HUSSAIN BUX MARI TALUKA,52,871,0,871
MIRPUR KHAS DISTRICT,HUSSAIN BUX MARI TALUKA,53,715,0,715
MIRPUR KHAS DISTRICT,HUSSAIN BUX MARI TALUKA,54,688,0,688
MIRPUR KHAS DISTRICT,HUSSAIN BUX MARI TALUKA,55,636,0,636
MIRPUR KHAS DISTRICT,HUSSAIN BUX MARI TALUKA,56,482,0,482
MIRPUR KHAS DISTRICT,HUSSAIN BUX MARI TALUKA,57,693,0,693
MIRPUR KHAS DISTRICT,HUSSAIN BUX MARI TALUKA,58,457,0,457
MIRPUR KHAS DISTRICT,HUSSAIN BUX MARI TALUKA,59,545,0,545
MIRPUR KHAS DISTRICT,HUSSAIN BUX MARI TALUKA,60,529,0,529
MIRPUR KHAS DISTRICT,HUSSAIN BUX MARI TALUKA,61,490,0,490
MIRPUR KHAS DISTRICT,HUSSAIN BUX MARI TALUKA,62,538,0,538
MIRPUR KHAS DISTRICT,HUSSAIN BUX MARI TALUKA,63,461,0,461
MIRPUR KHAS DISTRICT,HUSSAIN BUX MARI TALUKA,64,489,0,489
MIRPUR KHAS DISTRICT,HUSSAIN BUX MARI TALUKA,65,376,0,376
MIRPUR KHAS DISTRICT,HUSSAIN BUX MARI TALUKA,66,310,0,310
MIRPUR KHAS DISTRICT,HUSSAIN BUX MARI TALUKA,67,396,0,396
MIRPUR KHAS DISTRICT,HUSSAIN BUX MARI TALUKA,68,328,0,328
MIRPUR KHAS DISTRICT,HUSSAIN BUX MARI TALUKA,69,340,0,340
MIRPUR KHAS DISTRICT,HUSSAIN BUX MARI TALUKA,70,284,0,284
MIRPUR KHAS DISTRICT,HUSSAIN BUX MARI TALUKA,71,256,0,256
MIRPUR KHAS DISTRICT,HUSSAIN BUX MARI TALUKA,72,210,0,210
MIRPUR KHAS DISTRICT,HUSSAIN BUX MARI TALUKA,73,228,0,228
MIRPUR KHAS DISTRICT,HUSSAIN BUX MARI TALUKA,74,169,0,169
MIRPUR KHAS DISTRICT,HUSSAIN BUX MARI TALUKA,>=75,1305,0,1305
MIRPUR KHAS DISTRICT,JHUDO TALUKA,<1,3845,1379,5224
MIRPUR KHAS DISTRICT,JHUDO TALUKA,1,4623,1448,6071
MIRPUR KHAS DISTRICT,JHUDO TALUKA,2,5294,1574,6868
MIRPUR KHAS DISTRICT,JHUDO TALUKA,3,5681,1793,7474
MIRPUR KHAS DISTRICT,JHUDO TALUKA,4,5439,1644,7083
MIRPUR KHAS DISTRICT,JHUDO TALUKA,5,5688,1809,7497
MIRPUR KHAS DISTRICT,JHUDO TALUKA,6,5473,1718,7191
MIRPUR KHAS DISTRICT,JHUDO TALUKA,7,4940,1652,6592
MIRPUR KHAS DISTRICT,JHUDO TALUKA,8,5656,1732,7388
MIRPUR KHAS DISTRICT,JHUDO TALUKA,9,4028,1566,5594
MIRPUR KHAS DISTRICT,JHUDO TALUKA,10,4639,1536,6175
MIRPUR KHAS DISTRICT,JHUDO TALUKA,11,3157,1341,4498
MIRPUR KHAS DISTRICT,JHUDO TALUKA,12,3706,1376,5082
MIRPUR KHAS DISTRICT,JHUDO TALUKA,13,2613,1247,3860
MIRPUR KHAS DISTRICT,JHUDO TALUKA,14,2615,1207,3822
MIRPUR KHAS DISTRICT,JHUDO TALUKA,15,2730,1239,3969
MIRPUR KHAS DISTRICT,JHUDO TALUKA,16,2508,1245,3753
MIRPUR KHAS DISTRICT,JHUDO TALUKA,17,2096,1269,3365
MIRPUR KHAS DISTRICT,JHUDO TALUKA,18,3225,1212,4437
MIRPUR KHAS DISTRICT,JHUDO TALUKA,19,2432,1144,3576
MIRPUR KHAS DISTRICT,JHUDO TALUKA,20,3052,1169,4221
MIRPUR KHAS DISTRICT,JHUDO TALUKA,21,2077,1127,3204
MIRPUR KHAS DISTRICT,JHUDO TALUKA,22,2203,1005,3208
MIRPUR KHAS DISTRICT,JHUDO TALUKA,23,1843,1000,2843
MIRPUR KHAS DISTRICT,JHUDO TALUKA,24,1736,885,2621
MIRPUR KHAS DISTRICT,JHUDO TALUKA,25,2361,1004,3365
MIRPUR KHAS DISTRICT,JHUDO TALUKA,26,1943,966,2909
MIRPUR KHAS DISTRICT,JHUDO TALUKA,27,2157,1062,3219
MIRPUR KHAS DISTRICT,JHUDO TALUKA,28,2135,948,3083
MIRPUR KHAS DISTRICT,JHUDO TALUKA,29,2288,964,3252
MIRPUR KHAS DISTRICT,JHUDO TALUKA,30,2125,870,2995
MIRPUR KHAS DISTRICT,JHUDO TALUKA,31,2133,996,3129
MIRPUR KHAS DISTRICT,JHUDO TALUKA,32,2080,974,3054
MIRPUR KHAS DISTRICT,JHUDO TALUKA,33,1759,931,2690
MIRPUR KHAS DISTRICT,JHUDO TALUKA,34,1485,764,2249
MIRPUR KHAS DISTRICT,JHUDO TALUKA,35,1641,715,2356
MIRPUR KHAS DISTRICT,JHUDO TALUKA,36,1456,672,2128
MIRPUR KHAS DISTRICT,JHUDO TALUKA,37,2122,835,2957
MIRPUR KHAS DISTRICT,JHUDO TALUKA,38,1272,699,1971
MIRPUR KHAS DISTRICT,JHUDO TALUKA,39,1661,785,2446
MIRPUR KHAS DISTRICT,JHUDO TALUKA,40,1223,570,1793
MIRPUR KHAS DISTRICT,JHUDO TALUKA,41,1226,584,1810
MIRPUR KHAS DISTRICT,JHUDO TALUKA,42,1211,587,1798
MIRPUR KHAS DISTRICT,JHUDO TALUKA,43,1095,541,1636
MIRPUR KHAS DISTRICT,JHUDO TALUKA,44,900,520,1420
MIRPUR KHAS DISTRICT,JHUDO TALUKA,45,926,451,1377
MIRPUR KHAS DISTRICT,JHUDO TALUKA,46,830,433,1263
MIRPUR KHAS DISTRICT,JHUDO TALUKA,47,1266,580,1846
MIRPUR KHAS DISTRICT,JHUDO TALUKA,48,791,442,1233
MIRPUR KHAS DISTRICT,JHUDO TALUKA,49,862,551,1413
MIRPUR KHAS DISTRICT,JHUDO TALUKA,50,815,377,1192
MIRPUR KHAS DISTRICT,JHUDO TALUKA,51,721,447,1168
MIRPUR KHAS DISTRICT,JHUDO TALUKA,52,755,420,1175
MIRPUR KHAS DISTRICT,JHUDO TALUKA,53,566,376,942
MIRPUR KHAS DISTRICT,JHUDO TALUKA,54,503,330,833
MIRPUR KHAS DISTRICT,JHUDO TALUKA,55,527,254,781
MIRPUR KHAS DISTRICT,JHUDO TALUKA,56,398,244,642
MIRPUR KHAS DISTRICT,JHUDO TALUKA,57,583,335,918
MIRPUR KHAS DISTRICT,JHUDO TALUKA,58,406,278,684
MIRPUR KHAS DISTRICT,JHUDO TALUKA,59,481,278,759
MIRPUR KHAS DISTRICT,JHUDO TALUKA,60,527,255,782
MIRPUR KHAS DISTRICT,JHUDO TALUKA,61,402,256,658
MIRPUR KHAS DISTRICT,JHUDO TALUKA,62,482,255,737
MIRPUR KHAS DISTRICT,JHUDO TALUKA,63,431,238,669
MIRPUR KHAS DISTRICT,JHUDO TALUKA,64,482,242,724
MIRPUR KHAS DISTRICT,JHUDO TALUKA,65,460,175,635
MIRPUR KHAS DISTRICT,JHUDO TALUKA,66,287,176,463
MIRPUR KHAS DISTRICT,JHUDO TALUKA,67,301,163,464
MIRPUR KHAS DISTRICT,JHUDO TALUKA,68,257,154,411
MIRPUR KHAS DISTRICT,JHUDO TALUKA,69,379,169,548
MIRPUR KHAS DISTRICT,JHUDO TALUKA,70,269,130,399
MIRPUR KHAS DISTRICT,JHUDO TALUKA,71,218,143,361
MIRPUR KHAS DISTRICT,JHUDO TALUKA,72,190,122,312
MIRPUR KHAS DISTRICT,JHUDO TALUKA,73,176,90,266
MIRPUR KHAS DISTRICT,JHUDO TALUKA,74,226,117,343
MIRPUR KHAS DISTRICT,JHUDO TALUKA,>=75,1373,603,1976
MIRPUR KHAS DISTRICT,KOT GHULAM MUHAMMAD TALUKA,<1,6249,683,6932
MIRPUR KHAS DISTRICT,KOT GHULAM MUHAMMAD TALUKA,1,7488,688,8176
MIRPUR KHAS DISTRICT,KOT GHULAM MUHAMMAD TALUKA,2,8347,745,9092
MIRPUR KHAS DISTRICT,KOT GHULAM MUHAMMAD TALUKA,3,9045,810,9855
MIRPUR KHAS DISTRICT,KOT GHULAM MUHAMMAD TALUKA,4,8927,787,9714
MIRPUR KHAS DISTRICT,KOT GHULAM MUHAMMAD TALUKA,5,9179,834,10013
MIRPUR KHAS DISTRICT,KOT GHULAM MUHAMMAD TALUKA,6,9135,754,9889
MIRPUR KHAS DISTRICT,KOT GHULAM MUHAMMAD TALUKA,7,8251,835,9086
MIRPUR KHAS DISTRICT,KOT GHULAM MUHAMMAD TALUKA,8,9209,765,9974
MIRPUR KHAS DISTRICT,KOT GHULAM MUHAMMAD TALUKA,9,6881,752,7633
MIRPUR KHAS DISTRICT,KOT GHULAM MUHAMMAD TALUKA,10,8059,690,8749
MIRPUR KHAS DISTRICT,KOT GHULAM MUHAMMAD TALUKA,11,5792,717,6509
MIRPUR KHAS DISTRICT,KOT GHULAM MUHAMMAD TALUKA,12,6620,615,7235
MIRPUR KHAS DISTRICT,KOT GHULAM MUHAMMAD TALUKA,13,4868,654,5522
MIRPUR KHAS DISTRICT,KOT GHULAM MUHAMMAD TALUKA,14,4967,625,5592
MIRPUR KHAS DISTRICT,KOT GHULAM MUHAMMAD TALUKA,15,5130,611,5741
MIRPUR KHAS DISTRICT,KOT GHULAM MUHAMMAD TALUKA,16,4772,609,5381
MIRPUR KHAS DISTRICT,KOT GHULAM MUHAMMAD TALUKA,17,4036,551,4587
MIRPUR KHAS DISTRICT,KOT GHULAM MUHAMMAD TALUKA,18,5244,558,5802
MIRPUR KHAS DISTRICT,KOT GHULAM MUHAMMAD TALUKA,19,4216,573,4789
MIRPUR KHAS DISTRICT,KOT GHULAM MUHAMMAD TALUKA,20,4939,550,5489
MIRPUR KHAS DISTRICT,KOT GHULAM MUHAMMAD TALUKA,21,3768,598,4366
MIRPUR KHAS DISTRICT,KOT GHULAM MUHAMMAD TALUKA,22,3942,478,4420
MIRPUR KHAS DISTRICT,KOT GHULAM MUHAMMAD TALUKA,23,3475,529,4004
MIRPUR KHAS DISTRICT,KOT GHULAM MUHAMMAD TALUKA,24,3259,473,3732
MIRPUR KHAS DISTRICT,KOT GHULAM MUHAMMAD TALUKA,25,3676,480,4156
MIRPUR KHAS DISTRICT,KOT GHULAM MUHAMMAD TALUKA,26,3602,467,4069
MIRPUR KHAS DISTRICT,KOT GHULAM MUHAMMAD TALUKA,27,4540,599,5139
MIRPUR KHAS DISTRICT,KOT GHULAM MUHAMMAD TALUKA,28,3101,469,3570
MIRPUR KHAS DISTRICT,KOT GHULAM MUHAMMAD TALUKA,29,3709,476,4185
MIRPUR KHAS DISTRICT,KOT GHULAM MUHAMMAD TALUKA,30,2869,434,3303
MIRPUR KHAS DISTRICT,KOT GHULAM MUHAMMAD TALUKA,31,3628,457,4085
MIRPUR KHAS DISTRICT,KOT GHULAM MUHAMMAD TALUKA,32,3742,492,4234
MIRPUR KHAS DISTRICT,KOT GHULAM MUHAMMAD TALUKA,33,2714,403,3117
MIRPUR KHAS DISTRICT,KOT GHULAM MUHAMMAD TALUKA,34,2647,401,3048
MIRPUR KHAS DISTRICT,KOT GHULAM MUHAMMAD TALUKA,35,2429,304,2733
MIRPUR KHAS DISTRICT,KOT GHULAM MUHAMMAD TALUKA,36,2677,389,3066
MIRPUR KHAS DISTRICT,KOT GHULAM MUHAMMAD TALUKA,37,4201,448,4649
MIRPUR KHAS DISTRICT,KOT GHULAM MUHAMMAD TALUKA,38,1973,339,2312
MIRPUR KHAS DISTRICT,KOT GHULAM MUHAMMAD TALUKA,39,2737,364,3101
MIRPUR KHAS DISTRICT,KOT GHULAM MUHAMMAD TALUKA,40,1741,276,2017
MIRPUR KHAS DISTRICT,KOT GHULAM MUHAMMAD TALUKA,41,2111,295,2406
MIRPUR KHAS DISTRICT,KOT GHULAM MUHAMMAD TALUKA,42,2370,320,2690
MIRPUR KHAS DISTRICT,KOT GHULAM MUHAMMAD TALUKA,43,1793,299,2092
MIRPUR KHAS DISTRICT,KOT GHULAM MUHAMMAD TALUKA,44,1750,289,2039
MIRPUR KHAS DISTRICT,KOT GHULAM MUHAMMAD TALUKA,45,1445,234,1679
MIRPUR KHAS DISTRICT,KOT GHULAM MUHAMMAD TALUKA,46,1688,259,1947
MIRPUR KHAS DISTRICT,KOT GHULAM MUHAMMAD TALUKA,47,2321,306,2627
MIRPUR KHAS DISTRICT,KOT GHULAM MUHAMMAD TALUKA,48,1416,252,1668
MIRPUR KHAS DISTRICT,KOT GHULAM MUHAMMAD TALUKA,49,1624,280,1904
MIRPUR KHAS DISTRICT,KOT GHULAM MUHAMMAD TALUKA,50,1142,184,1326
MIRPUR KHAS DISTRICT,KOT GHULAM MUHAMMAD TALUKA,51,1443,239,1682
MIRPUR KHAS DISTRICT,KOT GHULAM MUHAMMAD TALUKA,52,1340,202,1542
MIRPUR KHAS DISTRICT,KOT GHULAM MUHAMMAD TALUKA,53,1053,207,1260
MIRPUR KHAS DISTRICT,KOT GHULAM MUHAMMAD TALUKA,54,924,154,1078
MIRPUR KHAS DISTRICT,KOT GHULAM MUHAMMAD TALUKA,55,738,143,881
MIRPUR KHAS DISTRICT,KOT GHULAM MUHAMMAD TALUKA,56,792,133,925
MIRPUR KHAS DISTRICT,KOT GHULAM MUHAMMAD TALUKA,57,1177,150,1327
MIRPUR KHAS DISTRICT,KOT GHULAM MUHAMMAD TALUKA,58,921,112,1033
MIRPUR KHAS DISTRICT,KOT GHULAM MUHAMMAD TALUKA,59,1008,153,1161
MIRPUR KHAS DISTRICT,KOT GHULAM MUHAMMAD TALUKA,60,761,96,857
MIRPUR KHAS DISTRICT,KOT GHULAM MUHAMMAD TALUKA,61,851,142,993
MIRPUR KHAS DISTRICT,KOT GHULAM MUHAMMAD TALUKA,62,827,125,952
MIRPUR KHAS DISTRICT,KOT GHULAM MUHAMMAD TALUKA,63,762,121,883
MIRPUR KHAS DISTRICT,KOT GHULAM MUHAMMAD TALUKA,64,821,111,932
MIRPUR KHAS DISTRICT,KOT GHULAM MUHAMMAD TALUKA,65,604,78,682
MIRPUR KHAS DISTRICT,KOT GHULAM MUHAMMAD TALUKA,66,611,74,685
MIRPUR KHAS DISTRICT,KOT GHULAM MUHAMMAD TALUKA,67,683,83,766
MIRPUR KHAS DISTRICT,KOT GHULAM MUHAMMAD TALUKA,68,459,81,540
MIRPUR KHAS DISTRICT,KOT GHULAM MUHAMMAD TALUKA,69,596,75,671
MIRPUR KHAS DISTRICT,KOT GHULAM MUHAMMAD TALUKA,70,432,47,479
MIRPUR KHAS DISTRICT,KOT GHULAM MUHAMMAD TALUKA,71,433,51,484
MIRPUR KHAS DISTRICT,KOT GHULAM MUHAMMAD TALUKA,72,362,53,415
MIRPUR KHAS DISTRICT,KOT GHULAM MUHAMMAD TALUKA,73,358,56,414
MIRPUR KHAS DISTRICT,KOT GHULAM MUHAMMAD TALUKA,74,357,48,405
MIRPUR KHAS DISTRICT,KOT GHULAM MUHAMMAD TALUKA,>=75,2333,308,2641
MIRPUR KHAS DISTRICT,MIRPUR KHAS TALUKA,<1,588,4568,5156
MIRPUR KHAS DISTRICT,MIRPUR KHAS TALUKA,1,725,5232,5957
MIRPUR KHAS DISTRICT,MIRPUR KHAS TALUKA,2,730,5350,6080
MIRPUR KHAS DISTRICT,MIRPUR KHAS TALUKA,3,835,5786,6621
MIRPUR KHAS DISTRICT,MIRPUR KHAS TALUKA,4,836,5533,6369
MIRPUR KHAS DISTRICT,MIRPUR KHAS TALUKA,5,834,5644,6478
MIRPUR KHAS DISTRICT,MIRPUR KHAS TALUKA,6,826,5445,6271
MIRPUR KHAS DISTRICT,MIRPUR KHAS TALUKA,7,875,5662,6537
MIRPUR KHAS DISTRICT,MIRPUR KHAS TALUKA,8,828,5269,6097
MIRPUR KHAS DISTRICT,MIRPUR KHAS TALUKA,9,700,5556,6256
MIRPUR KHAS DISTRICT,MIRPUR KHAS TALUKA,10,723,4893,5616
MIRPUR KHAS DISTRICT,MIRPUR KHAS TALUKA,11,701,5395,6096
MIRPUR KHAS DISTRICT,MIRPUR KHAS TALUKA,12,687,4776,5463
MIRPUR KHAS DISTRICT,MIRPUR KHAS TALUKA,13,582,5124,5706
MIRPUR KHAS DISTRICT,MIRPUR KHAS TALUKA,14,564,4719,5283
MIRPUR KHAS DISTRICT,MIRPUR KHAS TALUKA,15,570,5153,5723
MIRPUR KHAS DISTRICT,MIRPUR KHAS TALUKA,16,594,5071,5665
MIRPUR KHAS DISTRICT,MIRPUR KHAS TALUKA,17,597,5393,5990
MIRPUR KHAS DISTRICT,MIRPUR KHAS TALUKA,18,581,4657,5238
MIRPUR KHAS DISTRICT,MIRPUR KHAS TALUKA,19,551,5043,5594
MIRPUR KHAS DISTRICT,MIRPUR KHAS TALUKA,20,562,4478,5040
MIRPUR KHAS DISTRICT,MIRPUR KHAS TALUKA,21,473,4976,5449
MIRPUR KHAS DISTRICT,MIRPUR KHAS TALUKA,22,446,4456,4902
MIRPUR KHAS DISTRICT,MIRPUR KHAS TALUKA,23,433,4415,4848
MIRPUR KHAS DISTRICT,MIRPUR KHAS TALUKA,24,358,4410,4768
MIRPUR KHAS DISTRICT,MIRPUR KHAS TALUKA,25,449,3741,4190
MIRPUR KHAS DISTRICT,MIRPUR KHAS TALUKA,26,372,4263,4635
MIRPUR KHAS DISTRICT,MIRPUR KHAS TALUKA,27,410,4240,4650
MIRPUR KHAS DISTRICT,MIRPUR KHAS TALUKA,28,404,3983,4387
MIRPUR KHAS DISTRICT,MIRPUR KHAS TALUKA,29,399,4346,4745
MIRPUR KHAS DISTRICT,MIRPUR KHAS TALUKA,30,375,3630,4005
MIRPUR KHAS DISTRICT,MIRPUR KHAS TALUKA,31,381,4115,4496
MIRPUR KHAS DISTRICT,MIRPUR KHAS TALUKA,32,348,3864,4212
MIRPUR KHAS DISTRICT,MIRPUR KHAS TALUKA,33,339,3702,4041
MIRPUR KHAS DISTRICT,MIRPUR KHAS TALUKA,34,350,3390,3740
MIRPUR KHAS DISTRICT,MIRPUR KHAS TALUKA,35,280,2889,3169
MIRPUR KHAS DISTRICT,MIRPUR KHAS TALUKA,36,281,2989,3270
MIRPUR KHAS DISTRICT,MIRPUR KHAS TALUKA,37,354,3195,3549
MIRPUR KHAS DISTRICT,MIRPUR KHAS TALUKA,38,272,3083,3355
MIRPUR KHAS DISTRICT,MIRPUR KHAS TALUKA,39,317,3081,3398
MIRPUR KHAS DISTRICT,MIRPUR KHAS TALUKA,40,255,2604,2859
MIRPUR KHAS DISTRICT,MIRPUR KHAS TALUKA,41,281,2790,3071
MIRPUR KHAS DISTRICT,MIRPUR KHAS TALUKA,42,226,2637,2863
MIRPUR KHAS DISTRICT,MIRPUR KHAS TALUKA,43,222,2614,2836
MIRPUR KHAS DISTRICT,MIRPUR KHAS TALUKA,44,199,2434,2633
MIRPUR KHAS DISTRICT,MIRPUR KHAS TALUKA,45,203,1935,2138
MIRPUR KHAS DISTRICT,MIRPUR KHAS TALUKA,46,161,2210,2371
MIRPUR KHAS DISTRICT,MIRPUR KHAS TALUKA,47,248,2225,2473
MIRPUR KHAS DISTRICT,MIRPUR KHAS TALUKA,48,175,2190,2365
MIRPUR KHAS DISTRICT,MIRPUR KHAS TALUKA,49,208,2386,2594
MIRPUR KHAS DISTRICT,MIRPUR KHAS TALUKA,50,184,1870,2054
MIRPUR KHAS DISTRICT,MIRPUR KHAS TALUKA,51,171,2083,2254
MIRPUR KHAS DISTRICT,MIRPUR KHAS TALUKA,52,139,1910,2049
MIRPUR KHAS DISTRICT,MIRPUR KHAS TALUKA,53,121,1831,1952
MIRPUR KHAS DISTRICT,MIRPUR KHAS TALUKA,54,115,1646,1761
MIRPUR KHAS DISTRICT,MIRPUR KHAS TALUKA,55,118,1345,1463
MIRPUR KHAS DISTRICT,MIRPUR KHAS TALUKA,56,92,1215,1307
MIRPUR KHAS DISTRICT,MIRPUR KHAS TALUKA,57,114,1377,1491
MIRPUR KHAS DISTRICT,MIRPUR KHAS TALUKA,58,97,1156,1253
MIRPUR KHAS DISTRICT,MIRPUR KHAS TALUKA,59,103,1197,1300
MIRPUR KHAS DISTRICT,MIRPUR KHAS TALUKA,60,104,907,1011
MIRPUR KHAS DISTRICT,MIRPUR KHAS TALUKA,61,113,1257,1370
MIRPUR KHAS DISTRICT,MIRPUR KHAS TALUKA,62,87,1066,1153
MIRPUR KHAS DISTRICT,MIRPUR KHAS TALUKA,63,89,1029,1118
MIRPUR KHAS DISTRICT,MIRPUR KHAS TALUKA,64,90,788,878
MIRPUR KHAS DISTRICT,MIRPUR KHAS TALUKA,65,68,693,761
MIRPUR KHAS DISTRICT,MIRPUR KHAS TALUKA,66,64,622,686
MIRPUR KHAS DISTRICT,MIRPUR KHAS TALUKA,67,51,587,638
MIRPUR KHAS DISTRICT,MIRPUR KHAS TALUKA,68,67,700,767
MIRPUR KHAS DISTRICT,MIRPUR KHAS TALUKA,69,50,570,620
MIRPUR KHAS DISTRICT,MIRPUR KHAS TALUKA,70,52,429,481
MIRPUR KHAS DISTRICT,MIRPUR KHAS TALUKA,71,38,509,547
MIRPUR KHAS DISTRICT,MIRPUR KHAS TALUKA,72,33,454,487
MIRPUR KHAS DISTRICT,MIRPUR KHAS TALUKA,73,40,522,562
MIRPUR KHAS DISTRICT,MIRPUR KHAS TALUKA,74,28,319,347
MIRPUR KHAS DISTRICT,MIRPUR KHAS TALUKA,>=75,219,2511,2730
MIRPUR KHAS DISTRICT,SHUJAABAD TALUKA,<1,3544,481,4025
MIRPUR KHAS DISTRICT,SHUJAABAD TALUKA,1,4448,511,4959
MIRPUR KHAS DISTRICT,SHUJAABAD TALUKA,2,4986,593,5579
MIRPUR KHAS DISTRICT,SHUJAABAD TALUKA,3,5273,618,5891
MIRPUR KHAS DISTRICT,SHUJAABAD TALUKA,4,5681,594,6275
MIRPUR KHAS DISTRICT,SHUJAABAD TALUKA,5,5278,613,5891
MIRPUR KHAS DISTRICT,SHUJAABAD TALUKA,6,5337,566,5903
MIRPUR KHAS DISTRICT,SHUJAABAD TALUKA,7,4885,580,5465
MIRPUR KHAS DISTRICT,SHUJAABAD TALUKA,8,5265,579,5844
MIRPUR KHAS DISTRICT,SHUJAABAD TALUKA,9,4249,527,4776
MIRPUR KHAS DISTRICT,SHUJAABAD TALUKA,10,4759,533,5292
MIRPUR KHAS DISTRICT,SHUJAABAD TALUKA,11,3511,579,4090
MIRPUR KHAS DISTRICT,SHUJAABAD TALUKA,12,3755,489,4244
MIRPUR KHAS DISTRICT,SHUJAABAD TALUKA,13,3106,498,3604
MIRPUR KHAS DISTRICT,SHUJAABAD TALUKA,14,2888,439,3327
MIRPUR KHAS DISTRICT,SHUJAABAD TALUKA,15,3176,498,3674
MIRPUR KHAS DISTRICT,SHUJAABAD TALUKA,16,2829,496,3325
MIRPUR KHAS DISTRICT,SHUJAABAD TALUKA,17,2694,430,3124
MIRPUR KHAS DISTRICT,SHUJAABAD TALUKA,18,3049,474,3523
MIRPUR KHAS DISTRICT,SHUJAABAD TALUKA,19,2698,451,3149
MIRPUR KHAS DISTRICT,SHUJAABAD TALUKA,20,3049,421,3470
MIRPUR KHAS DISTRICT,SHUJAABAD TALUKA,21,2400,369,2769
MIRPUR KHAS DISTRICT,SHUJAABAD TALUKA,22,2201,386,2587
MIRPUR KHAS DISTRICT,SHUJAABAD TALUKA,23,2024,360,2384
MIRPUR KHAS DISTRICT,SHUJAABAD TALUKA,24,1976,362,2338
MIRPUR KHAS DISTRICT,SHUJAABAD TALUKA,25,2126,330,2456
MIRPUR KHAS DISTRICT,SHUJAABAD TALUKA,26,2029,349,2378
MIRPUR KHAS DISTRICT,SHUJAABAD TALUKA,27,2260,327,2587
MIRPUR KHAS DISTRICT,SHUJAABAD TALUKA,28,2130,365,2495
MIRPUR KHAS DISTRICT,SHUJAABAD TALUKA,29,2630,385,3015
MIRPUR KHAS DISTRICT,SHUJAABAD TALUKA,30,1993,314,2307
MIRPUR KHAS DISTRICT,SHUJAABAD TALUKA,31,2355,371,2726
MIRPUR KHAS DISTRICT,SHUJAABAD TALUKA,32,2025,294,2319
MIRPUR KHAS DISTRICT,SHUJAABAD TALUKA,33,1887,291,2178
MIRPUR KHAS DISTRICT,SHUJAABAD TALUKA,34,1776,263,2039
MIRPUR KHAS DISTRICT,SHUJAABAD TALUKA,35,1569,269,1838
MIRPUR KHAS DISTRICT,SHUJAABAD TALUKA,36,1799,268,2067
MIRPUR KHAS DISTRICT,SHUJAABAD TALUKA,37,2137,277,2414
MIRPUR KHAS DISTRICT,SHUJAABAD TALUKA,38,1567,267,1834
MIRPUR KHAS DISTRICT,SHUJAABAD TALUKA,39,1801,256,2057
MIRPUR KHAS DISTRICT,SHUJAABAD TALUKA,40,1157,191,1348
MIRPUR KHAS DISTRICT,SHUJAABAD TALUKA,41,1423,188,1611
MIRPUR KHAS DISTRICT,SHUJAABAD TALUKA,42,1399,220,1619
MIRPUR KHAS DISTRICT,SHUJAABAD TALUKA,43,1270,176,1446
MIRPUR KHAS DISTRICT,SHUJAABAD TALUKA,44,1112,187,1299
MIRPUR KHAS DISTRICT,SHUJAABAD TALUKA,45,908,147,1055
MIRPUR KHAS DISTRICT,SHUJAABAD TALUKA,46,1088,158,1246
MIRPUR KHAS DISTRICT,SHUJAABAD TALUKA,47,1185,189,1374
MIRPUR KHAS DISTRICT,SHUJAABAD TALUKA,48,950,174,1124
MIRPUR KHAS DISTRICT,SHUJAABAD TALUKA,49,1075,162,1237
MIRPUR KHAS DISTRICT,SHUJAABAD TALUKA,50,742,164,906
MIRPUR KHAS DISTRICT,SHUJAABAD TALUKA,51,951,122,1073
MIRPUR KHAS DISTRICT,SHUJAABAD TALUKA,52,743,128,871
MIRPUR KHAS DISTRICT,SHUJAABAD TALUKA,53,652,158,810
MIRPUR KHAS DISTRICT,SHUJAABAD TALUKA,54,557,120,677
MIRPUR KHAS DISTRICT,SHUJAABAD TALUKA,55,508,104,612
MIRPUR KHAS DISTRICT,SHUJAABAD TALUKA,56,491,87,578
MIRPUR KHAS DISTRICT,SHUJAABAD TALUKA,57,627,78,705
MIRPUR KHAS DISTRICT,SHUJAABAD TALUKA,58,545,81,626
MIRPUR KHAS DISTRICT,SHUJAABAD TALUKA,59,524,91,615
MIRPUR KHAS DISTRICT,SHUJAABAD TALUKA,60,410,94,504
MIRPUR KHAS DISTRICT,SHUJAABAD TALUKA,61,534,81,615
MIRPUR KHAS DISTRICT,SHUJAABAD TALUKA,62,510,65,575
MIRPUR KHAS DISTRICT,SHUJAABAD TALUKA,63,480,61,541
MIRPUR KHAS DISTRICT,SHUJAABAD TALUKA,64,482,54,536
MIRPUR KHAS DISTRICT,SHUJAABAD TALUKA,65,343,54,397
MIRPUR KHAS DISTRICT,SHUJAABAD TALUKA,66,343,68,411
MIRPUR KHAS DISTRICT,SHUJAABAD TALUKA,67,408,58,466
MIRPUR KHAS DISTRICT,SHUJAABAD TALUKA,68,353,56,409
MIRPUR KHAS DISTRICT,SHUJAABAD TALUKA,69,348,47,395
MIRPUR KHAS DISTRICT,SHUJAABAD TALUKA,70,235,43,278
MIRPUR KHAS DISTRICT,SHUJAABAD TALUKA,71,254,34,288
MIRPUR KHAS DISTRICT,SHUJAABAD TALUKA,72,239,43,282
MIRPUR KHAS DISTRICT,SHUJAABAD TALUKA,73,238,24,262
MIRPUR KHAS DISTRICT,SHUJAABAD TALUKA,74,188,22,210
MIRPUR KHAS DISTRICT,SHUJAABAD TALUKA,>=75,1316,198,1514
MIRPUR KHAS DISTRICT,SINDHRI TALUKA,<1,5280,390,5670
MIRPUR KHAS DISTRICT,SINDHRI TALUKA,1,6452,405,6857
MIRPUR KHAS DISTRICT,SINDHRI TALUKA,2,7526,522,8048
MIRPUR KHAS DISTRICT,SINDHRI TALUKA,3,8053,577,8630
MIRPUR KHAS DISTRICT,SINDHRI TALUKA,4,8061,582,8643
MIRPUR KHAS DISTRICT,SINDHRI TALUKA,5,8096,619,8715
MIRPUR KHAS DISTRICT,SINDHRI TALUKA,6,8240,606,8846
MIRPUR KHAS DISTRICT,SINDHRI TALUKA,7,6912,522,7434
MIRPUR KHAS DISTRICT,SINDHRI TALUKA,8,8798,703,9501
MIRPUR KHAS DISTRICT,SINDHRI TALUKA,9,6335,450,6785
MIRPUR KHAS DISTRICT,SINDHRI TALUKA,10,7892,597,8489
MIRPUR KHAS DISTRICT,SINDHRI TALUKA,11,4994,401,5395
MIRPUR KHAS DISTRICT,SINDHRI TALUKA,12,6136,517,6653
MIRPUR KHAS DISTRICT,SINDHRI TALUKA,13,4339,307,4646
MIRPUR KHAS DISTRICT,SINDHRI TALUKA,14,4595,381,4976
MIRPUR KHAS DISTRICT,SINDHRI TALUKA,15,4545,367,4912
MIRPUR KHAS DISTRICT,SINDHRI TALUKA,16,4259,326,4585
MIRPUR KHAS DISTRICT,SINDHRI TALUKA,17,3655,331,3986
MIRPUR KHAS DISTRICT,SINDHRI TALUKA,18,4617,392,5009
MIRPUR KHAS DISTRICT,SINDHRI TALUKA,19,3591,251,3842
MIRPUR KHAS DISTRICT,SINDHRI TALUKA,20,4527,378,4905
MIRPUR KHAS DISTRICT,SINDHRI TALUKA,21,3060,239,3299
MIRPUR KHAS DISTRICT,SINDHRI TALUKA,22,3441,267,3708
MIRPUR KHAS DISTRICT,SINDHRI TALUKA,23,2820,233,3053
MIRPUR KHAS DISTRICT,SINDHRI TALUKA,24,2683,179,2862
MIRPUR KHAS DISTRICT,SINDHRI TALUKA,25,3324,332,3656
MIRPUR KHAS DISTRICT,SINDHRI TALUKA,26,2697,184,2881
MIRPUR KHAS DISTRICT,SINDHRI TALUKA,27,3202,207,3409
MIRPUR KHAS DISTRICT,SINDHRI TALUKA,28,3081,194,3275
MIRPUR KHAS DISTRICT,SINDHRI TALUKA,29,3372,218,3590
MIRPUR KHAS DISTRICT,SINDHRI TALUKA,30,2921,243,3164
MIRPUR KHAS DISTRICT,SINDHRI TALUKA,31,2962,241,3203
MIRPUR KHAS DISTRICT,SINDHRI TALUKA,32,3050,237,3287
MIRPUR KHAS DISTRICT,SINDHRI TALUKA,33,2718,231,2949
MIRPUR KHAS DISTRICT,SINDHRI TALUKA,34,2529,181,2710
MIRPUR KHAS DISTRICT,SINDHRI TALUKA,35,2740,286,3026
MIRPUR KHAS DISTRICT,SINDHRI TALUKA,36,2414,179,2593
MIRPUR KHAS DISTRICT,SINDHRI TALUKA,37,3686,311,3997
MIRPUR KHAS DISTRICT,SINDHRI TALUKA,38,2253,193,2446
MIRPUR KHAS DISTRICT,SINDHRI TALUKA,39,2847,206,3053
MIRPUR KHAS DISTRICT,SINDHRI TALUKA,40,1847,177,2024
MIRPUR KHAS DISTRICT,SINDHRI TALUKA,41,2159,153,2312
MIRPUR KHAS DISTRICT,SINDHRI TALUKA,42,2154,173,2327
MIRPUR KHAS DISTRICT,SINDHRI TALUKA,43,1671,141,1812
MIRPUR KHAS DISTRICT,SINDHRI TALUKA,44,1553,135,1688
MIRPUR KHAS DISTRICT,SINDHRI TALUKA,45,1443,130,1573
MIRPUR KHAS DISTRICT,SINDHRI TALUKA,46,1412,87,1499
MIRPUR KHAS DISTRICT,SINDHRI TALUKA,47,2025,155,2180
MIRPUR KHAS DISTRICT,SINDHRI TALUKA,48,1323,96,1419
MIRPUR KHAS DISTRICT,SINDHRI TALUKA,49,1520,128,1648
MIRPUR KHAS DISTRICT,SINDHRI TALUKA,50,1081,104,1185
MIRPUR KHAS DISTRICT,SINDHRI TALUKA,51,1225,87,1312
MIRPUR KHAS DISTRICT,SINDHRI TALUKA,52,1276,81,1357
MIRPUR KHAS DISTRICT,SINDHRI TALUKA,53,925,86,1011
MIRPUR KHAS DISTRICT,SINDHRI TALUKA,54,823,45,868
MIRPUR KHAS DISTRICT,SINDHRI TALUKA,55,822,51,873
MIRPUR KHAS DISTRICT,SINDHRI TALUKA,56,640,41,681
MIRPUR KHAS DISTRICT,SINDHRI TALUKA,57,1026,81,1107
MIRPUR KHAS DISTRICT,SINDHRI TALUKA,58,681,43,724
MIRPUR KHAS DISTRICT,SINDHRI TALUKA,59,739,66,805
MIRPUR KHAS DISTRICT,SINDHRI TALUKA,60,650,58,708
MIRPUR KHAS DISTRICT,SINDHRI TALUKA,61,739,57,796
MIRPUR KHAS DISTRICT,SINDHRI TALUKA,62,809,61,870
MIRPUR KHAS DISTRICT,SINDHRI TALUKA,63,662,48,710
MIRPUR KHAS DISTRICT,SINDHRI TALUKA,64,644,32,676
MIRPUR KHAS DISTRICT,SINDHRI TALUKA,65,557,57,614
MIRPUR KHAS DISTRICT,SINDHRI TALUKA,66,551,41,592
MIRPUR KHAS DISTRICT,SINDHRI TALUKA,67,624,48,672
MIRPUR KHAS DISTRICT,SINDHRI TALUKA,68,481,32,513
MIRPUR KHAS DISTRICT,SINDHRI TALUKA,69,485,41,526
MIRPUR KHAS DISTRICT,SINDHRI TALUKA,70,392,31,423
MIRPUR KHAS DISTRICT,SINDHRI TALUKA,71,449,28,477
MIRPUR KHAS DISTRICT,SINDHRI TALUKA,72,393,26,419
MIRPUR KHAS DISTRICT,SINDHRI TALUKA,73,373,26,399
MIRPUR KHAS DISTRICT,SINDHRI TALUKA,74,269,11,280
MIRPUR KHAS DISTRICT,SINDHRI TALUKA,>=75,2263,163,2426
MOHMAND AGENCY,AMBAR UTMAN KHEL TEHSIL,<1,1677,0,1677
MOHMAND AGENCY,AMBAR UTMAN KHEL TEHSIL,1,2358,0,2358
MOHMAND AGENCY,AMBAR UTMAN KHEL TEHSIL,2,2708,0,2708
MOHMAND AGENCY,AMBAR UTMAN KHEL TEHSIL,3,2425,0,2425
MOHMAND AGENCY,AMBAR UTMAN KHEL TEHSIL,4,2866,0,2866
MOHMAND AGENCY,AMBAR UTMAN KHEL TEHSIL,5,2293,0,2293
MOHMAND AGENCY,AMBAR UTMAN KHEL TEHSIL,6,2993,0,2993
MOHMAND AGENCY,AMBAR UTMAN KHEL TEHSIL,7,2176,0,2176
MOHMAND AGENCY,AMBAR UTMAN KHEL TEHSIL,8,2882,0,2882
MOHMAND AGENCY,AMBAR UTMAN KHEL TEHSIL,9,2142,0,2142
MOHMAND AGENCY,AMBAR UTMAN KHEL TEHSIL,10,2479,0,2479
MOHMAND AGENCY,AMBAR UTMAN KHEL TEHSIL,11,1756,0,1756
MOHMAND AGENCY,AMBAR UTMAN KHEL TEHSIL,12,1851,0,1851
MOHMAND AGENCY,AMBAR UTMAN KHEL TEHSIL,13,1516,0,1516
MOHMAND AGENCY,AMBAR UTMAN KHEL TEHSIL,14,1587,0,1587
MOHMAND AGENCY,AMBAR UTMAN KHEL TEHSIL,15,1239,0,1239
MOHMAND AGENCY,AMBAR UTMAN KHEL TEHSIL,16,1177,0,1177
MOHMAND AGENCY,AMBAR UTMAN KHEL TEHSIL,17,885,0,885
MOHMAND AGENCY,AMBAR UTMAN KHEL TEHSIL,18,1263,0,1263
MOHMAND AGENCY,AMBAR UTMAN KHEL TEHSIL,19,1067,0,1067
MOHMAND AGENCY,AMBAR UTMAN KHEL TEHSIL,20,1275,0,1275
MOHMAND AGENCY,AMBAR UTMAN KHEL TEHSIL,21,932,0,932
MOHMAND AGENCY,AMBAR UTMAN KHEL TEHSIL,22,934,0,934
MOHMAND AGENCY,AMBAR UTMAN KHEL TEHSIL,23,949,0,949
MOHMAND AGENCY,AMBAR UTMAN KHEL TEHSIL,24,822,0,822
MOHMAND AGENCY,AMBAR UTMAN KHEL TEHSIL,25,1081,0,1081
MOHMAND AGENCY,AMBAR UTMAN KHEL TEHSIL,26,899,0,899
MOHMAND AGENCY,AMBAR UTMAN KHEL TEHSIL,27,724,0,724
MOHMAND AGENCY,AMBAR UTMAN KHEL TEHSIL,28,802,0,802
MOHMAND AGENCY,AMBAR UTMAN KHEL TEHSIL,29,670,0,670
MOHMAND AGENCY,AMBAR UTMAN KHEL TEHSIL,30,728,0,728
MOHMAND AGENCY,AMBAR UTMAN KHEL TEHSIL,31,673,0,673
MOHMAND AGENCY,AMBAR UTMAN KHEL TEHSIL,32,558,0,558
MOHMAND AGENCY,AMBAR UTMAN KHEL TEHSIL,33,606,0,606
MOHMAND AGENCY,AMBAR UTMAN KHEL TEHSIL,34,490,0,490
MOHMAND AGENCY,AMBAR UTMAN KHEL TEHSIL,35,543,0,543
MOHMAND AGENCY,AMBAR UTMAN KHEL TEHSIL,36,473,0,473
MOHMAND AGENCY,AMBAR UTMAN KHEL TEHSIL,37,441,0,441
MOHMAND AGENCY,AMBAR UTMAN KHEL TEHSIL,38,494,0,494
MOHMAND AGENCY,AMBAR UTMAN KHEL TEHSIL,39,452,0,452
MOHMAND AGENCY,AMBAR UTMAN KHEL TEHSIL,40,473,0,473
MOHMAND AGENCY,AMBAR UTMAN KHEL TEHSIL,41,420,0,420
MOHMAND AGENCY,AMBAR UTMAN KHEL TEHSIL,42,337,0,337
MOHMAND AGENCY,AMBAR UTMAN KHEL TEHSIL,43,328,0,328
MOHMAND AGENCY,AMBAR UTMAN KHEL TEHSIL,44,289,0,289
MOHMAND AGENCY,AMBAR UTMAN KHEL TEHSIL,45,309,0,309
MOHMAND AGENCY,AMBAR UTMAN KHEL TEHSIL,46,309,0,309
MOHMAND AGENCY,AMBAR UTMAN KHEL TEHSIL,47,318,0,318
MOHMAND AGENCY,AMBAR UTMAN KHEL TEHSIL,48,269,0,269
MOHMAND AGENCY,AMBAR UTMAN KHEL TEHSIL,49,245,0,245
MOHMAND AGENCY,AMBAR UTMAN KHEL TEHSIL,50,373,0,373
MOHMAND AGENCY,AMBAR UTMAN KHEL TEHSIL,51,273,0,273
MOHMAND AGENCY,AMBAR UTMAN KHEL TEHSIL,52,294,0,294
MOHMAND AGENCY,AMBAR UTMAN KHEL TEHSIL,53,258,0,258
MOHMAND AGENCY,AMBAR UTMAN KHEL TEHSIL,54,227,0,227
MOHMAND AGENCY,AMBAR UTMAN KHEL TEHSIL,55,269,0,269
MOHMAND AGENCY,AMBAR UTMAN KHEL TEHSIL,56,299,0,299
MOHMAND AGENCY,AMBAR UTMAN KHEL TEHSIL,57,250,0,250
MOHMAND AGENCY,AMBAR UTMAN KHEL TEHSIL,58,164,0,164
MOHMAND AGENCY,AMBAR UTMAN KHEL TEHSIL,59,136,0,136
MOHMAND AGENCY,AMBAR UTMAN KHEL TEHSIL,60,241,0,241
MOHMAND AGENCY,AMBAR UTMAN KHEL TEHSIL,61,159,0,159
MOHMAND AGENCY,AMBAR UTMAN KHEL TEHSIL,62,148,0,148
MOHMAND AGENCY,AMBAR UTMAN KHEL TEHSIL,63,115,0,115
MOHMAND AGENCY,AMBAR UTMAN KHEL TEHSIL,64,108,0,108
MOHMAND AGENCY,AMBAR UTMAN KHEL TEHSIL,65,139,0,139
MOHMAND AGENCY,AMBAR UTMAN KHEL TEHSIL,66,128,0,128
MOHMAND AGENCY,AMBAR UTMAN KHEL TEHSIL,67,108,0,108
MOHMAND AGENCY,AMBAR UTMAN KHEL TEHSIL,68,84,0,84
MOHMAND AGENCY,AMBAR UTMAN KHEL TEHSIL,69,60,0,60
MOHMAND AGENCY,AMBAR UTMAN KHEL TEHSIL,70,116,0,116
MOHMAND AGENCY,AMBAR UTMAN KHEL TEHSIL,71,79,0,79
MOHMAND AGENCY,AMBAR UTMAN KHEL TEHSIL,72,75,0,75
MOHMAND AGENCY,AMBAR UTMAN KHEL TEHSIL,73,73,0,73
MOHMAND AGENCY,AMBAR UTMAN KHEL TEHSIL,74,52,0,52
MOHMAND AGENCY,AMBAR UTMAN KHEL TEHSIL,>=75,540,0,540
MOHMAND AGENCY,HALIM ZAI TEHSIL,<1,1796,0,1796
MOHMAND AGENCY,HALIM ZAI TEHSIL,1,2054,0,2054
MOHMAND AGENCY,HALIM ZAI TEHSIL,2,2336,0,2336
MOHMAND AGENCY,HALIM ZAI TEHSIL,3,2642,0,2642
MOHMAND AGENCY,HALIM ZAI TEHSIL,4,2485,0,2485
MOHMAND AGENCY,HALIM ZAI TEHSIL,5,2691,0,2691
MOHMAND AGENCY,HALIM ZAI TEHSIL,6,2848,0,2848
MOHMAND AGENCY,HALIM ZAI TEHSIL,7,2565,0,2565
MOHMAND AGENCY,HALIM ZAI TEHSIL,8,2872,0,2872
MOHMAND AGENCY,HALIM ZAI TEHSIL,9,2465,0,2465
MOHMAND AGENCY,HALIM ZAI TEHSIL,10,2461,0,2461
MOHMAND AGENCY,HALIM ZAI TEHSIL,11,2100,0,2100
MOHMAND AGENCY,HALIM ZAI TEHSIL,12,2228,0,2228
MOHMAND AGENCY,HALIM ZAI TEHSIL,13,2055,0,2055
MOHMAND AGENCY,HALIM ZAI TEHSIL,14,2056,0,2056
MOHMAND AGENCY,HALIM ZAI TEHSIL,15,2036,0,2036
MOHMAND AGENCY,HALIM ZAI TEHSIL,16,1687,0,1687
MOHMAND AGENCY,HALIM ZAI TEHSIL,17,1472,0,1472
MOHMAND AGENCY,HALIM ZAI TEHSIL,18,1800,0,1800
MOHMAND AGENCY,HALIM ZAI TEHSIL,19,1341,0,1341
MOHMAND AGENCY,HALIM ZAI TEHSIL,20,1854,0,1854
MOHMAND AGENCY,HALIM ZAI TEHSIL,21,1262,0,1262
MOHMAND AGENCY,HALIM ZAI TEHSIL,22,1528,0,1528
MOHMAND AGENCY,HALIM ZAI TEHSIL,23,1239,0,1239
MOHMAND AGENCY,HALIM ZAI TEHSIL,24,1148,0,1148
MOHMAND AGENCY,HALIM ZAI TEHSIL,25,1509,0,1509
MOHMAND AGENCY,HALIM ZAI TEHSIL,26,1080,0,1080
MOHMAND AGENCY,HALIM ZAI TEHSIL,27,1059,0,1059
MOHMAND AGENCY,HALIM ZAI TEHSIL,28,1288,0,1288
MOHMAND AGENCY,HALIM ZAI TEHSIL,29,968,0,968
MOHMAND AGENCY,HALIM ZAI TEHSIL,30,1436,0,1436
MOHMAND AGENCY,HALIM ZAI TEHSIL,31,934,0,934
MOHMAND AGENCY,HALIM ZAI TEHSIL,32,836,0,836
MOHMAND AGENCY,HALIM ZAI TEHSIL,33,902,0,902
MOHMAND AGENCY,HALIM ZAI TEHSIL,34,628,0,628
MOHMAND AGENCY,HALIM ZAI TEHSIL,35,1000,0,1000
MOHMAND AGENCY,HALIM ZAI TEHSIL,36,574,0,574
MOHMAND AGENCY,HALIM ZAI TEHSIL,37,621,0,621
MOHMAND AGENCY,HALIM ZAI TEHSIL,38,762,0,762
MOHMAND AGENCY,HALIM ZAI TEHSIL,39,625,0,625
MOHMAND AGENCY,HALIM ZAI TEHSIL,40,1055,0,1055
MOHMAND AGENCY,HALIM ZAI TEHSIL,41,533,0,533
MOHMAND AGENCY,HALIM ZAI TEHSIL,42,515,0,515
MOHMAND AGENCY,HALIM ZAI TEHSIL,43,572,0,572
MOHMAND AGENCY,HALIM ZAI TEHSIL,44,451,0,451
MOHMAND AGENCY,HALIM ZAI TEHSIL,45,779,0,779
MOHMAND AGENCY,HALIM ZAI TEHSIL,46,351,0,351
MOHMAND AGENCY,HALIM ZAI TEHSIL,47,428,0,428
MOHMAND AGENCY,HALIM ZAI TEHSIL,48,512,0,512
MOHMAND AGENCY,HALIM ZAI TEHSIL,49,451,0,451
MOHMAND AGENCY,HALIM ZAI TEHSIL,50,754,0,754
MOHMAND AGENCY,HALIM ZAI TEHSIL,51,352,0,352
MOHMAND AGENCY,HALIM ZAI TEHSIL,52,349,0,349
MOHMAND AGENCY,HALIM ZAI TEHSIL,53,405,0,405
MOHMAND AGENCY,HALIM ZAI TEHSIL,54,370,0,370
MOHMAND AGENCY,HALIM ZAI TEHSIL,55,501,0,501
MOHMAND AGENCY,HALIM ZAI TEHSIL,56,317,0,317
MOHMAND AGENCY,HALIM ZAI TEHSIL,57,310,0,310
MOHMAND AGENCY,HALIM ZAI TEHSIL,58,308,0,308
MOHMAND AGENCY,HALIM ZAI TEHSIL,59,290,0,290
MOHMAND AGENCY,HALIM ZAI TEHSIL,60,435,0,435
MOHMAND AGENCY,HALIM ZAI TEHSIL,61,240,0,240
MOHMAND AGENCY,HALIM ZAI TEHSIL,62,211,0,211
MOHMAND AGENCY,HALIM ZAI TEHSIL,63,248,0,248
MOHMAND AGENCY,HALIM ZAI TEHSIL,64,217,0,217
MOHMAND AGENCY,HALIM ZAI TEHSIL,65,275,0,275
MOHMAND AGENCY,HALIM ZAI TEHSIL,66,150,0,150
MOHMAND AGENCY,HALIM ZAI TEHSIL,67,153,0,153
MOHMAND AGENCY,HALIM ZAI TEHSIL,68,171,0,171
MOHMAND AGENCY,HALIM ZAI TEHSIL,69,151,0,151
MOHMAND AGENCY,HALIM ZAI TEHSIL,70,247,0,247
MOHMAND AGENCY,HALIM ZAI TEHSIL,71,112,0,112
MOHMAND AGENCY,HALIM ZAI TEHSIL,72,105,0,105
MOHMAND AGENCY,HALIM ZAI TEHSIL,73,126,0,126
MOHMAND AGENCY,HALIM ZAI TEHSIL,74,104,0,104
MOHMAND AGENCY,HALIM ZAI TEHSIL,>=75,914,0,914
MOHMAND AGENCY,PINDIALI TEHSIL,<1,2319,0,2319
MOHMAND AGENCY,PINDIALI TEHSIL,1,2573,0,2573
MOHMAND AGENCY,PINDIALI TEHSIL,2,3299,0,3299
MOHMAND AGENCY,PINDIALI TEHSIL,3,3247,0,3247
MOHMAND AGENCY,PINDIALI TEHSIL,4,3567,0,3567
MOHMAND AGENCY,PINDIALI TEHSIL,5,3124,0,3124
MOHMAND AGENCY,PINDIALI TEHSIL,6,3544,0,3544
MOHMAND AGENCY,PINDIALI TEHSIL,7,3084,0,3084
MOHMAND AGENCY,PINDIALI TEHSIL,8,3600,0,3600
MOHMAND AGENCY,PINDIALI TEHSIL,9,3013,0,3013
MOHMAND AGENCY,PINDIALI TEHSIL,10,3275,0,3275
MOHMAND AGENCY,PINDIALI TEHSIL,11,2312,0,2312
MOHMAND AGENCY,PINDIALI TEHSIL,12,2585,0,2585
MOHMAND AGENCY,PINDIALI TEHSIL,13,2045,0,2045
MOHMAND AGENCY,PINDIALI TEHSIL,14,2228,0,2228
MOHMAND AGENCY,PINDIALI TEHSIL,15,1994,0,1994
MOHMAND AGENCY,PINDIALI TEHSIL,16,1865,0,1865
MOHMAND AGENCY,PINDIALI TEHSIL,17,1427,0,1427
MOHMAND AGENCY,PINDIALI TEHSIL,18,2033,0,2033
MOHMAND AGENCY,PINDIALI TEHSIL,19,1608,0,1608
MOHMAND AGENCY,PINDIALI TEHSIL,20,1993,0,1993
MOHMAND AGENCY,PINDIALI TEHSIL,21,1382,0,1382
MOHMAND AGENCY,PINDIALI TEHSIL,22,1428,0,1428
MOHMAND AGENCY,PINDIALI TEHSIL,23,1322,0,1322
MOHMAND AGENCY,PINDIALI TEHSIL,24,1212,0,1212
MOHMAND AGENCY,PINDIALI TEHSIL,25,1679,0,1679
MOHMAND AGENCY,PINDIALI TEHSIL,26,1126,0,1126
MOHMAND AGENCY,PINDIALI TEHSIL,27,1198,0,1198
MOHMAND AGENCY,PINDIALI TEHSIL,28,1212,0,1212
MOHMAND AGENCY,PINDIALI TEHSIL,29,991,0,991
MOHMAND AGENCY,PINDIALI TEHSIL,30,1482,0,1482
MOHMAND AGENCY,PINDIALI TEHSIL,31,935,0,935
MOHMAND AGENCY,PINDIALI TEHSIL,32,907,0,907
MOHMAND AGENCY,PINDIALI TEHSIL,33,936,0,936
MOHMAND AGENCY,PINDIALI TEHSIL,34,711,0,711
MOHMAND AGENCY,PINDIALI TEHSIL,35,1026,0,1026
MOHMAND AGENCY,PINDIALI TEHSIL,36,568,0,568
MOHMAND AGENCY,PINDIALI TEHSIL,37,773,0,773
MOHMAND AGENCY,PINDIALI TEHSIL,38,778,0,778
MOHMAND AGENCY,PINDIALI TEHSIL,39,719,0,719
MOHMAND AGENCY,PINDIALI TEHSIL,40,1087,0,1087
MOHMAND AGENCY,PINDIALI TEHSIL,41,565,0,565
MOHMAND AGENCY,PINDIALI TEHSIL,42,586,0,586
MOHMAND AGENCY,PINDIALI TEHSIL,43,645,0,645
MOHMAND AGENCY,PINDIALI TEHSIL,44,485,0,485
MOHMAND AGENCY,PINDIALI TEHSIL,45,709,0,709
MOHMAND AGENCY,PINDIALI TEHSIL,46,353,0,353
MOHMAND AGENCY,PINDIALI TEHSIL,47,613,0,613
MOHMAND AGENCY,PINDIALI TEHSIL,48,478,0,478
MOHMAND AGENCY,PINDIALI TEHSIL,49,500,0,500
MOHMAND AGENCY,PINDIALI TEHSIL,50,805,0,805
MOHMAND AGENCY,PINDIALI TEHSIL,51,382,0,382
MOHMAND AGENCY,PINDIALI TEHSIL,52,430,0,430
MOHMAND AGENCY,PINDIALI TEHSIL,53,424,0,424
MOHMAND AGENCY,PINDIALI TEHSIL,54,373,0,373
MOHMAND AGENCY,PINDIALI TEHSIL,55,503,0,503
MOHMAND AGENCY,PINDIALI TEHSIL,56,297,0,297
MOHMAND AGENCY,PINDIALI TEHSIL,57,438,0,438
MOHMAND AGENCY,PINDIALI TEHSIL,58,296,0,296
MOHMAND AGENCY,PINDIALI TEHSIL,59,356,0,356
MOHMAND AGENCY,PINDIALI TEHSIL,60,452,0,452
MOHMAND AGENCY,PINDIALI TEHSIL,61,244,0,244
MOHMAND AGENCY,PINDIALI TEHSIL,62,277,0,277
MOHMAND AGENCY,PINDIALI TEHSIL,63,263,0,263
MOHMAND AGENCY,PINDIALI TEHSIL,64,260,0,260
MOHMAND AGENCY,PINDIALI TEHSIL,65,274,0,274
MOHMAND AGENCY,PINDIALI TEHSIL,66,132,0,132
MOHMAND AGENCY,PINDIALI TEHSIL,67,242,0,242
MOHMAND AGENCY,PINDIALI TEHSIL,68,147,0,147
MOHMAND AGENCY,PINDIALI TEHSIL,69,137,0,137
MOHMAND AGENCY,PINDIALI TEHSIL,70,229,0,229
MOHMAND AGENCY,PINDIALI TEHSIL,71,114,0,114
MOHMAND AGENCY,PINDIALI TEHSIL,72,132,0,132
MOHMAND AGENCY,PINDIALI TEHSIL,73,133,0,133
MOHMAND AGENCY,PINDIALI TEHSIL,74,129,0,129
MOHMAND AGENCY,PINDIALI TEHSIL,>=75,1101,0,1101
MOHMAND AGENCY,PRANG GHAR TEHSIL,<1,1092,0,1092
MOHMAND AGENCY,PRANG GHAR TEHSIL,1,1074,0,1074
MOHMAND AGENCY,PRANG GHAR TEHSIL,2,1230,0,1230
MOHMAND AGENCY,PRANG GHAR TEHSIL,3,1259,0,1259
MOHMAND AGENCY,PRANG GHAR TEHSIL,4,1348,0,1348
MOHMAND AGENCY,PRANG GHAR TEHSIL,5,1218,0,1218
MOHMAND AGENCY,PRANG GHAR TEHSIL,6,1438,0,1438
MOHMAND AGENCY,PRANG GHAR TEHSIL,7,1169,0,1169
MOHMAND AGENCY,PRANG GHAR TEHSIL,8,1506,0,1506
MOHMAND AGENCY,PRANG GHAR TEHSIL,9,1075,0,1075
MOHMAND AGENCY,PRANG GHAR TEHSIL,10,1372,0,1372
MOHMAND AGENCY,PRANG GHAR TEHSIL,11,938,0,938
MOHMAND AGENCY,PRANG GHAR TEHSIL,12,1119,0,1119
MOHMAND AGENCY,PRANG GHAR TEHSIL,13,888,0,888
MOHMAND AGENCY,PRANG GHAR TEHSIL,14,1004,0,1004
MOHMAND AGENCY,PRANG GHAR TEHSIL,15,847,0,847
MOHMAND AGENCY,PRANG GHAR TEHSIL,16,794,0,794
MOHMAND AGENCY,PRANG GHAR TEHSIL,17,634,0,634
MOHMAND AGENCY,PRANG GHAR TEHSIL,18,847,0,847
MOHMAND AGENCY,PRANG GHAR TEHSIL,19,651,0,651
MOHMAND AGENCY,PRANG GHAR TEHSIL,20,909,0,909
MOHMAND AGENCY,PRANG GHAR TEHSIL,21,629,0,629
MOHMAND AGENCY,PRANG GHAR TEHSIL,22,632,0,632
MOHMAND AGENCY,PRANG GHAR TEHSIL,23,679,0,679
MOHMAND AGENCY,PRANG GHAR TEHSIL,24,622,0,622
MOHMAND AGENCY,PRANG GHAR TEHSIL,25,712,0,712
MOHMAND AGENCY,PRANG GHAR TEHSIL,26,501,0,501
MOHMAND AGENCY,PRANG GHAR TEHSIL,27,568,0,568
MOHMAND AGENCY,PRANG GHAR TEHSIL,28,504,0,504
MOHMAND AGENCY,PRANG GHAR TEHSIL,29,468,0,468
MOHMAND AGENCY,PRANG GHAR TEHSIL,30,544,0,544
MOHMAND AGENCY,PRANG GHAR TEHSIL,31,363,0,363
MOHMAND AGENCY,PRANG GHAR TEHSIL,32,350,0,350
MOHMAND AGENCY,PRANG GHAR TEHSIL,33,388,0,388
MOHMAND AGENCY,PRANG GHAR TEHSIL,34,281,0,281
MOHMAND AGENCY,PRANG GHAR TEHSIL,35,397,0,397
MOHMAND AGENCY,PRANG GHAR TEHSIL,36,210,0,210
MOHMAND AGENCY,PRANG GHAR TEHSIL,37,349,0,349
MOHMAND AGENCY,PRANG GHAR TEHSIL,38,270,0,270
MOHMAND AGENCY,PRANG GHAR TEHSIL,39,278,0,278
MOHMAND AGENCY,PRANG GHAR TEHSIL,40,338,0,338
MOHMAND AGENCY,PRANG GHAR TEHSIL,41,207,0,207
MOHMAND AGENCY,PRANG GHAR TEHSIL,42,251,0,251
MOHMAND AGENCY,PRANG GHAR TEHSIL,43,219,0,219
MOHMAND AGENCY,PRANG GHAR TEHSIL,44,197,0,197
MOHMAND AGENCY,PRANG GHAR TEHSIL,45,257,0,257
MOHMAND AGENCY,PRANG GHAR TEHSIL,46,109,0,109
MOHMAND AGENCY,PRANG GHAR TEHSIL,47,268,0,268
MOHMAND AGENCY,PRANG GHAR TEHSIL,48,229,0,229
MOHMAND AGENCY,PRANG GHAR TEHSIL,49,163,0,163
MOHMAND AGENCY,PRANG GHAR TEHSIL,50,257,0,257
MOHMAND AGENCY,PRANG GHAR TEHSIL,51,162,0,162
MOHMAND AGENCY,PRANG GHAR TEHSIL,52,175,0,175
MOHMAND AGENCY,PRANG GHAR TEHSIL,53,170,0,170
MOHMAND AGENCY,PRANG GHAR TEHSIL,54,139,0,139
MOHMAND AGENCY,PRANG GHAR TEHSIL,55,188,0,188
MOHMAND AGENCY,PRANG GHAR TEHSIL,56,90,0,90
MOHMAND AGENCY,PRANG GHAR TEHSIL,57,189,0,189
MOHMAND AGENCY,PRANG GHAR TEHSIL,58,113,0,113
MOHMAND AGENCY,PRANG GHAR TEHSIL,59,120,0,120
MOHMAND AGENCY,PRANG GHAR TEHSIL,60,171,0,171
MOHMAND AGENCY,PRANG GHAR TEHSIL,61,86,0,86
MOHMAND AGENCY,PRANG GHAR TEHSIL,62,91,0,91
MOHMAND AGENCY,PRANG GHAR TEHSIL,63,79,0,79
MOHMAND AGENCY,PRANG GHAR TEHSIL,64,87,0,87
MOHMAND AGENCY,PRANG GHAR TEHSIL,65,99,0,99
MOHMAND AGENCY,PRANG GHAR TEHSIL,66,36,0,36
MOHMAND AGENCY,PRANG GHAR TEHSIL,67,99,0,99
MOHMAND AGENCY,PRANG GHAR TEHSIL,68,64,0,64
MOHMAND AGENCY,PRANG GHAR TEHSIL,69,79,0,79
MOHMAND AGENCY,PRANG GHAR TEHSIL,70,97,0,97
MOHMAND AGENCY,PRANG GHAR TEHSIL,71,36,0,36
MOHMAND AGENCY,PRANG GHAR TEHSIL,72,59,0,59
MOHMAND AGENCY,PRANG GHAR TEHSIL,73,39,0,39
MOHMAND AGENCY,PRANG GHAR TEHSIL,74,44,0,44
MOHMAND AGENCY,PRANG GHAR TEHSIL,>=75,405,0,405
MOHMAND AGENCY,SAFI TEHSIL,<1,2504,0,2504
MOHMAND AGENCY,SAFI TEHSIL,1,3251,0,3251
MOHMAND AGENCY,SAFI TEHSIL,2,3848,0,3848
MOHMAND AGENCY,SAFI TEHSIL,3,3798,0,3798
MOHMAND AGENCY,SAFI TEHSIL,4,3854,0,3854
MOHMAND AGENCY,SAFI TEHSIL,5,3734,0,3734
MOHMAND AGENCY,SAFI TEHSIL,6,3981,0,3981
MOHMAND AGENCY,SAFI TEHSIL,7,3472,0,3472
MOHMAND AGENCY,SAFI TEHSIL,8,3914,0,3914
MOHMAND AGENCY,SAFI TEHSIL,9,3276,0,3276
MOHMAND AGENCY,SAFI TEHSIL,10,3498,0,3498
MOHMAND AGENCY,SAFI TEHSIL,11,2627,0,2627
MOHMAND AGENCY,SAFI TEHSIL,12,2887,0,2887
MOHMAND AGENCY,SAFI TEHSIL,13,2442,0,2442
MOHMAND AGENCY,SAFI TEHSIL,14,2441,0,2441
MOHMAND AGENCY,SAFI TEHSIL,15,2326,0,2326
MOHMAND AGENCY,SAFI TEHSIL,16,2006,0,2006
MOHMAND AGENCY,SAFI TEHSIL,17,1465,0,1465
MOHMAND AGENCY,SAFI TEHSIL,18,1954,0,1954
MOHMAND AGENCY,SAFI TEHSIL,19,1581,0,1581
MOHMAND AGENCY,SAFI TEHSIL,20,2106,0,2106
MOHMAND AGENCY,SAFI TEHSIL,21,1585,0,1585
MOHMAND AGENCY,SAFI TEHSIL,22,1641,0,1641
MOHMAND AGENCY,SAFI TEHSIL,23,1701,0,1701
MOHMAND AGENCY,SAFI TEHSIL,24,1473,0,1473
MOHMAND AGENCY,SAFI TEHSIL,25,1790,0,1790
MOHMAND AGENCY,SAFI TEHSIL,26,1344,0,1344
MOHMAND AGENCY,SAFI TEHSIL,27,1250,0,1250
MOHMAND AGENCY,SAFI TEHSIL,28,1411,0,1411
MOHMAND AGENCY,SAFI TEHSIL,29,1107,0,1107
MOHMAND AGENCY,SAFI TEHSIL,30,1338,0,1338
MOHMAND AGENCY,SAFI TEHSIL,31,1082,0,1082
MOHMAND AGENCY,SAFI TEHSIL,32,1085,0,1085
MOHMAND AGENCY,SAFI TEHSIL,33,1087,0,1087
MOHMAND AGENCY,SAFI TEHSIL,34,859,0,859
MOHMAND AGENCY,SAFI TEHSIL,35,981,0,981
MOHMAND AGENCY,SAFI TEHSIL,36,692,0,692
MOHMAND AGENCY,SAFI TEHSIL,37,782,0,782
MOHMAND AGENCY,SAFI TEHSIL,38,802,0,802
MOHMAND AGENCY,SAFI TEHSIL,39,778,0,778
MOHMAND AGENCY,SAFI TEHSIL,40,837,0,837
MOHMAND AGENCY,SAFI TEHSIL,41,603,0,603
MOHMAND AGENCY,SAFI TEHSIL,42,632,0,632
MOHMAND AGENCY,SAFI TEHSIL,43,570,0,570
MOHMAND AGENCY,SAFI TEHSIL,44,494,0,494
MOHMAND AGENCY,SAFI TEHSIL,45,686,0,686
MOHMAND AGENCY,SAFI TEHSIL,46,418,0,418
MOHMAND AGENCY,SAFI TEHSIL,47,538,0,538
MOHMAND AGENCY,SAFI TEHSIL,48,524,0,524
MOHMAND AGENCY,SAFI TEHSIL,49,462,0,462
MOHMAND AGENCY,SAFI TEHSIL,50,675,0,675
MOHMAND AGENCY,SAFI TEHSIL,51,428,0,428
MOHMAND AGENCY,SAFI TEHSIL,52,452,0,452
MOHMAND AGENCY,SAFI TEHSIL,53,425,0,425
MOHMAND AGENCY,SAFI TEHSIL,54,356,0,356
MOHMAND AGENCY,SAFI TEHSIL,55,470,0,470
MOHMAND AGENCY,SAFI TEHSIL,56,344,0,344
MOHMAND AGENCY,SAFI TEHSIL,57,402,0,402
MOHMAND AGENCY,SAFI TEHSIL,58,382,0,382
MOHMAND AGENCY,SAFI TEHSIL,59,348,0,348
MOHMAND AGENCY,SAFI TEHSIL,60,431,0,431
MOHMAND AGENCY,SAFI TEHSIL,61,277,0,277
MOHMAND AGENCY,SAFI TEHSIL,62,324,0,324
MOHMAND AGENCY,SAFI TEHSIL,63,283,0,283
MOHMAND AGENCY,SAFI TEHSIL,64,298,0,298
MOHMAND AGENCY,SAFI TEHSIL,65,311,0,311
MOHMAND AGENCY,SAFI TEHSIL,66,192,0,192
MOHMAND AGENCY,SAFI TEHSIL,67,278,0,278
MOHMAND AGENCY,SAFI TEHSIL,68,198,0,198
MOHMAND AGENCY,SAFI TEHSIL,69,216,0,216
MOHMAND AGENCY,SAFI TEHSIL,70,241,0,241
MOHMAND AGENCY,SAFI TEHSIL,71,115,0,115
MOHMAND AGENCY,SAFI TEHSIL,72,143,0,143
MOHMAND AGENCY,SAFI TEHSIL,73,150,0,150
MOHMAND AGENCY,SAFI TEHSIL,74,134,0,134
MOHMAND AGENCY,SAFI TEHSIL,>=75,1111,0,1111
MOHMAND AGENCY,UPPER MOHMAND TEHSIL,<1,1306,0,1306
MOHMAND AGENCY,UPPER MOHMAND TEHSIL,1,1499,0,1499
MOHMAND AGENCY,UPPER MOHMAND TEHSIL,2,1851,0,1851
MOHMAND AGENCY,UPPER MOHMAND TEHSIL,3,1859,0,1859
MOHMAND AGENCY,UPPER MOHMAND TEHSIL,4,1933,0,1933
MOHMAND AGENCY,UPPER MOHMAND TEHSIL,5,1730,0,1730
MOHMAND AGENCY,UPPER MOHMAND TEHSIL,6,2110,0,2110
MOHMAND AGENCY,UPPER MOHMAND TEHSIL,7,1737,0,1737
MOHMAND AGENCY,UPPER MOHMAND TEHSIL,8,2171,0,2171
MOHMAND AGENCY,UPPER MOHMAND TEHSIL,9,1522,0,1522
MOHMAND AGENCY,UPPER MOHMAND TEHSIL,10,1879,0,1879
MOHMAND AGENCY,UPPER MOHMAND TEHSIL,11,1366,0,1366
MOHMAND AGENCY,UPPER MOHMAND TEHSIL,12,1500,0,1500
MOHMAND AGENCY,UPPER MOHMAND TEHSIL,13,1294,0,1294
MOHMAND AGENCY,UPPER MOHMAND TEHSIL,14,1297,0,1297
MOHMAND AGENCY,UPPER MOHMAND TEHSIL,15,1093,0,1093
MOHMAND AGENCY,UPPER MOHMAND TEHSIL,16,1129,0,1129
MOHMAND AGENCY,UPPER MOHMAND TEHSIL,17,820,0,820
MOHMAND AGENCY,UPPER MOHMAND TEHSIL,18,1110,0,1110
MOHMAND AGENCY,UPPER MOHMAND TEHSIL,19,869,0,869
MOHMAND AGENCY,UPPER MOHMAND TEHSIL,20,1180,0,1180
MOHMAND AGENCY,UPPER MOHMAND TEHSIL,21,859,0,859
MOHMAND AGENCY,UPPER MOHMAND TEHSIL,22,834,0,834
MOHMAND AGENCY,UPPER MOHMAND TEHSIL,23,799,0,799
MOHMAND AGENCY,UPPER MOHMAND TEHSIL,24,661,0,661
MOHMAND AGENCY,UPPER MOHMAND TEHSIL,25,903,0,903
MOHMAND AGENCY,UPPER MOHMAND TEHSIL,26,654,0,654
MOHMAND AGENCY,UPPER MOHMAND TEHSIL,27,640,0,640
MOHMAND AGENCY,UPPER MOHMAND TEHSIL,28,701,0,701
MOHMAND AGENCY,UPPER MOHMAND TEHSIL,29,554,0,554
MOHMAND AGENCY,UPPER MOHMAND TEHSIL,30,808,0,808
MOHMAND AGENCY,UPPER MOHMAND TEHSIL,31,525,0,525
MOHMAND AGENCY,UPPER MOHMAND TEHSIL,32,472,0,472
MOHMAND AGENCY,UPPER MOHMAND TEHSIL,33,526,0,526
MOHMAND AGENCY,UPPER MOHMAND TEHSIL,34,387,0,387
MOHMAND AGENCY,UPPER MOHMAND TEHSIL,35,556,0,556
MOHMAND AGENCY,UPPER MOHMAND TEHSIL,36,353,0,353
MOHMAND AGENCY,UPPER MOHMAND TEHSIL,37,407,0,407
MOHMAND AGENCY,UPPER MOHMAND TEHSIL,38,446,0,446
MOHMAND AGENCY,UPPER MOHMAND TEHSIL,39,423,0,423
MOHMAND AGENCY,UPPER MOHMAND TEHSIL,40,524,0,524
MOHMAND AGENCY,UPPER MOHMAND TEHSIL,41,368,0,368
MOHMAND AGENCY,UPPER MOHMAND TEHSIL,42,295,0,295
MOHMAND AGENCY,UPPER MOHMAND TEHSIL,43,346,0,346
MOHMAND AGENCY,UPPER MOHMAND TEHSIL,44,272,0,272
MOHMAND AGENCY,UPPER MOHMAND TEHSIL,45,388,0,388
MOHMAND AGENCY,UPPER MOHMAND TEHSIL,46,232,0,232
MOHMAND AGENCY,UPPER MOHMAND TEHSIL,47,308,0,308
MOHMAND AGENCY,UPPER MOHMAND TEHSIL,48,297,0,297
MOHMAND AGENCY,UPPER MOHMAND TEHSIL,49,284,0,284
MOHMAND AGENCY,UPPER MOHMAND TEHSIL,50,413,0,413
MOHMAND AGENCY,UPPER MOHMAND TEHSIL,51,223,0,223
MOHMAND AGENCY,UPPER MOHMAND TEHSIL,52,246,0,246
MOHMAND AGENCY,UPPER MOHMAND TEHSIL,53,227,0,227
MOHMAND AGENCY,UPPER MOHMAND TEHSIL,54,202,0,202
MOHMAND AGENCY,UPPER MOHMAND TEHSIL,55,294,0,294
MOHMAND AGENCY,UPPER MOHMAND TEHSIL,56,194,0,194
MOHMAND AGENCY,UPPER MOHMAND TEHSIL,57,194,0,194
MOHMAND AGENCY,UPPER MOHMAND TEHSIL,58,162,0,162
MOHMAND AGENCY,UPPER MOHMAND TEHSIL,59,193,0,193
MOHMAND AGENCY,UPPER MOHMAND TEHSIL,60,259,0,259
MOHMAND AGENCY,UPPER MOHMAND TEHSIL,61,177,0,177
MOHMAND AGENCY,UPPER MOHMAND TEHSIL,62,203,0,203
MOHMAND AGENCY,UPPER MOHMAND TEHSIL,63,194,0,194
MOHMAND AGENCY,UPPER MOHMAND TEHSIL,64,161,0,161
MOHMAND AGENCY,UPPER MOHMAND TEHSIL,65,158,0,158
MOHMAND AGENCY,UPPER MOHMAND TEHSIL,66,146,0,146
MOHMAND AGENCY,UPPER MOHMAND TEHSIL,67,149,0,149
MOHMAND AGENCY,UPPER MOHMAND TEHSIL,68,96,0,96
MOHMAND AGENCY,UPPER MOHMAND TEHSIL,69,107,0,107
MOHMAND AGENCY,UPPER MOHMAND TEHSIL,70,155,0,155
MOHMAND AGENCY,UPPER MOHMAND TEHSIL,71,90,0,90
MOHMAND AGENCY,UPPER MOHMAND TEHSIL,72,70,0,70
MOHMAND AGENCY,UPPER MOHMAND TEHSIL,73,78,0,78
MOHMAND AGENCY,UPPER MOHMAND TEHSIL,74,71,0,71
MOHMAND AGENCY,UPPER MOHMAND TEHSIL,>=75,615,0,615
MOHMAND AGENCY,YAKE GHUND TEHSIL,<1,1577,0,1577
MOHMAND AGENCY,YAKE GHUND TEHSIL,1,1608,0,1608
MOHMAND AGENCY,YAKE GHUND TEHSIL,2,1680,0,1680
MOHMAND AGENCY,YAKE GHUND TEHSIL,3,1773,0,1773
MOHMAND AGENCY,YAKE GHUND TEHSIL,4,1979,0,1979
MOHMAND AGENCY,YAKE GHUND TEHSIL,5,1971,0,1971
MOHMAND AGENCY,YAKE GHUND TEHSIL,6,2009,0,2009
MOHMAND AGENCY,YAKE GHUND TEHSIL,7,1917,0,1917
MOHMAND AGENCY,YAKE GHUND TEHSIL,8,2053,0,2053
MOHMAND AGENCY,YAKE GHUND TEHSIL,9,1811,0,1811
MOHMAND AGENCY,YAKE GHUND TEHSIL,10,1798,0,1798
MOHMAND AGENCY,YAKE GHUND TEHSIL,11,1556,0,1556
MOHMAND AGENCY,YAKE GHUND TEHSIL,12,1526,0,1526
MOHMAND AGENCY,YAKE GHUND TEHSIL,13,1444,0,1444
MOHMAND AGENCY,YAKE GHUND TEHSIL,14,1500,0,1500
MOHMAND AGENCY,YAKE GHUND TEHSIL,15,1432,0,1432
MOHMAND AGENCY,YAKE GHUND TEHSIL,16,1372,0,1372
MOHMAND AGENCY,YAKE GHUND TEHSIL,17,1176,0,1176
MOHMAND AGENCY,YAKE GHUND TEHSIL,18,1388,0,1388
MOHMAND AGENCY,YAKE GHUND TEHSIL,19,1072,0,1072
MOHMAND AGENCY,YAKE GHUND TEHSIL,20,1359,0,1359
MOHMAND AGENCY,YAKE GHUND TEHSIL,21,1027,0,1027
MOHMAND AGENCY,YAKE GHUND TEHSIL,22,1099,0,1099
MOHMAND AGENCY,YAKE GHUND TEHSIL,23,967,0,967
MOHMAND AGENCY,YAKE GHUND TEHSIL,24,859,0,859
MOHMAND AGENCY,YAKE GHUND TEHSIL,25,1162,0,1162
MOHMAND AGENCY,YAKE GHUND TEHSIL,26,788,0,788
MOHMAND AGENCY,YAKE GHUND TEHSIL,27,790,0,790
MOHMAND AGENCY,YAKE GHUND TEHSIL,28,839,0,839
MOHMAND AGENCY,YAKE GHUND TEHSIL,29,677,0,677
MOHMAND AGENCY,YAKE GHUND TEHSIL,30,985,0,985
MOHMAND AGENCY,YAKE GHUND TEHSIL,31,679,0,679
MOHMAND AGENCY,YAKE GHUND TEHSIL,32,653,0,653
MOHMAND AGENCY,YAKE GHUND TEHSIL,33,625,0,625
MOHMAND AGENCY,YAKE GHUND TEHSIL,34,509,0,509
MOHMAND AGENCY,YAKE GHUND TEHSIL,35,722,0,722
MOHMAND AGENCY,YAKE GHUND TEHSIL,36,426,0,426
MOHMAND AGENCY,YAKE GHUND TEHSIL,37,479,0,479
MOHMAND AGENCY,YAKE GHUND TEHSIL,38,526,0,526
MOHMAND AGENCY,YAKE GHUND TEHSIL,39,472,0,472
MOHMAND AGENCY,YAKE GHUND TEHSIL,40,735,0,735
MOHMAND AGENCY,YAKE GHUND TEHSIL,41,423,0,423
MOHMAND AGENCY,YAKE GHUND TEHSIL,42,378,0,378
MOHMAND AGENCY,YAKE GHUND TEHSIL,43,405,0,405
MOHMAND AGENCY,YAKE GHUND TEHSIL,44,358,0,358
MOHMAND AGENCY,YAKE GHUND TEHSIL,45,468,0,468
MOHMAND AGENCY,YAKE GHUND TEHSIL,46,270,0,270
MOHMAND AGENCY,YAKE GHUND TEHSIL,47,353,0,353
MOHMAND AGENCY,YAKE GHUND TEHSIL,48,302,0,302
MOHMAND AGENCY,YAKE GHUND TEHSIL,49,327,0,327
MOHMAND AGENCY,YAKE GHUND TEHSIL,50,437,0,437
MOHMAND AGENCY,YAKE GHUND TEHSIL,51,261,0,261
MOHMAND AGENCY,YAKE GHUND TEHSIL,52,301,0,301
MOHMAND AGENCY,YAKE GHUND TEHSIL,53,286,0,286
MOHMAND AGENCY,YAKE GHUND TEHSIL,54,254,0,254
MOHMAND AGENCY,YAKE GHUND TEHSIL,55,371,0,371
MOHMAND AGENCY,YAKE GHUND TEHSIL,56,211,0,211
MOHMAND AGENCY,YAKE GHUND TEHSIL,57,240,0,240
MOHMAND AGENCY,YAKE GHUND TEHSIL,58,221,0,221
MOHMAND AGENCY,YAKE GHUND TEHSIL,59,211,0,211
MOHMAND AGENCY,YAKE GHUND TEHSIL,60,283,0,283
MOHMAND AGENCY,YAKE GHUND TEHSIL,61,191,0,191
MOHMAND AGENCY,YAKE GHUND TEHSIL,62,167,0,167
MOHMAND AGENCY,YAKE GHUND TEHSIL,63,167,0,167
MOHMAND AGENCY,YAKE GHUND TEHSIL,64,175,0,175
MOHMAND AGENCY,YAKE GHUND TEHSIL,65,194,0,194
MOHMAND AGENCY,YAKE GHUND TEHSIL,66,103,0,103
MOHMAND AGENCY,YAKE GHUND TEHSIL,67,118,0,118
MOHMAND AGENCY,YAKE GHUND TEHSIL,68,91,0,91
MOHMAND AGENCY,YAKE GHUND TEHSIL,69,103,0,103
MOHMAND AGENCY,YAKE GHUND TEHSIL,70,143,0,143
MOHMAND AGENCY,YAKE GHUND TEHSIL,71,79,0,79
MOHMAND AGENCY,YAKE GHUND TEHSIL,72,87,0,87
MOHMAND AGENCY,YAKE GHUND TEHSIL,73,78,0,78
MOHMAND AGENCY,YAKE GHUND TEHSIL,74,90,0,90
MOHMAND AGENCY,YAKE GHUND TEHSIL,>=75,588,0,588
MULTAN DISTRICT,JALALPUR PIRWALA TEHSIL,<1,11229,1480,12709
MULTAN DISTRICT,JALALPUR PIRWALA TEHSIL,1,13324,1786,15110
MULTAN DISTRICT,JALALPUR PIRWALA TEHSIL,2,14746,1825,16571
MULTAN DISTRICT,JALALPUR PIRWALA TEHSIL,3,16614,2004,18618
MULTAN DISTRICT,JALALPUR PIRWALA TEHSIL,4,17434,1914,19348
MULTAN DISTRICT,JALALPUR PIRWALA TEHSIL,5,16565,2135,18700
MULTAN DISTRICT,JALALPUR PIRWALA TEHSIL,6,15949,1900,17849
MULTAN DISTRICT,JALALPUR PIRWALA TEHSIL,7,17457,2257,19714
MULTAN DISTRICT,JALALPUR PIRWALA TEHSIL,8,17286,2015,19301
MULTAN DISTRICT,JALALPUR PIRWALA TEHSIL,9,15758,2084,17842
MULTAN DISTRICT,JALALPUR PIRWALA TEHSIL,10,15190,1734,16924
MULTAN DISTRICT,JALALPUR PIRWALA TEHSIL,11,12246,1849,14095
MULTAN DISTRICT,JALALPUR PIRWALA TEHSIL,12,12884,1685,14569
MULTAN DISTRICT,JALALPUR PIRWALA TEHSIL,13,10575,1695,12270
MULTAN DISTRICT,JALALPUR PIRWALA TEHSIL,14,10645,1591,12236
MULTAN DISTRICT,JALALPUR PIRWALA TEHSIL,15,9536,1519,11055
MULTAN DISTRICT,JALALPUR PIRWALA TEHSIL,16,9477,1469,10946
MULTAN DISTRICT,JALALPUR PIRWALA TEHSIL,17,8188,1338,9526
MULTAN DISTRICT,JALALPUR PIRWALA TEHSIL,18,9828,1424,11252
MULTAN DISTRICT,JALALPUR PIRWALA TEHSIL,19,9000,1449,10449
MULTAN DISTRICT,JALALPUR PIRWALA TEHSIL,20,9384,1199,10583
MULTAN DISTRICT,JALALPUR PIRWALA TEHSIL,21,8026,1344,9370
MULTAN DISTRICT,JALALPUR PIRWALA TEHSIL,22,8131,1221,9352
MULTAN DISTRICT,JALALPUR PIRWALA TEHSIL,23,7164,1154,8318
MULTAN DISTRICT,JALALPUR PIRWALA TEHSIL,24,6376,1008,7384
MULTAN DISTRICT,JALALPUR PIRWALA TEHSIL,25,7841,1168,9009
MULTAN DISTRICT,JALALPUR PIRWALA TEHSIL,26,6317,953,7270
MULTAN DISTRICT,JALALPUR PIRWALA TEHSIL,27,7055,1115,8170
MULTAN DISTRICT,JALALPUR PIRWALA TEHSIL,28,6643,993,7636
MULTAN DISTRICT,JALALPUR PIRWALA TEHSIL,29,7342,1138,8480
MULTAN DISTRICT,JALALPUR PIRWALA TEHSIL,30,6387,931,7318
MULTAN DISTRICT,JALALPUR PIRWALA TEHSIL,31,6291,915,7206
MULTAN DISTRICT,JALALPUR PIRWALA TEHSIL,32,5529,893,6422
MULTAN DISTRICT,JALALPUR PIRWALA TEHSIL,33,5105,736,5841
MULTAN DISTRICT,JALALPUR PIRWALA TEHSIL,34,5283,806,6089
MULTAN DISTRICT,JALALPUR PIRWALA TEHSIL,35,5779,861,6640
MULTAN DISTRICT,JALALPUR PIRWALA TEHSIL,36,5922,748,6670
MULTAN DISTRICT,JALALPUR PIRWALA TEHSIL,37,6442,830,7272
MULTAN DISTRICT,JALALPUR PIRWALA TEHSIL,38,4798,738,5536
MULTAN DISTRICT,JALALPUR PIRWALA TEHSIL,39,5491,784,6275
MULTAN DISTRICT,JALALPUR PIRWALA TEHSIL,40,4070,680,4750
MULTAN DISTRICT,JALALPUR PIRWALA TEHSIL,41,4852,637,5489
MULTAN DISTRICT,JALALPUR PIRWALA TEHSIL,42,4614,643,5257
MULTAN DISTRICT,JALALPUR PIRWALA TEHSIL,43,3415,587,4002
MULTAN DISTRICT,JALALPUR PIRWALA TEHSIL,44,3459,521,3980
MULTAN DISTRICT,JALALPUR PIRWALA TEHSIL,45,3249,613,3862
MULTAN DISTRICT,JALALPUR PIRWALA TEHSIL,46,3618,478,4096
MULTAN DISTRICT,JALALPUR PIRWALA TEHSIL,47,4226,556,4782
MULTAN DISTRICT,JALALPUR PIRWALA TEHSIL,48,3156,471,3627
MULTAN DISTRICT,JALALPUR PIRWALA TEHSIL,49,3549,510,4059
MULTAN DISTRICT,JALALPUR PIRWALA TEHSIL,50,2954,438,3392
MULTAN DISTRICT,JALALPUR PIRWALA TEHSIL,51,3438,502,3940
MULTAN DISTRICT,JALALPUR PIRWALA TEHSIL,52,3289,451,3740
MULTAN DISTRICT,JALALPUR PIRWALA TEHSIL,53,2400,394,2794
MULTAN DISTRICT,JALALPUR PIRWALA TEHSIL,54,2327,324,2651
MULTAN DISTRICT,JALALPUR PIRWALA TEHSIL,55,2168,355,2523
MULTAN DISTRICT,JALALPUR PIRWALA TEHSIL,56,2186,247,2433
MULTAN DISTRICT,JALALPUR PIRWALA TEHSIL,57,2499,285,2784
MULTAN DISTRICT,JALALPUR PIRWALA TEHSIL,58,1638,264,1902
MULTAN DISTRICT,JALALPUR PIRWALA TEHSIL,59,2154,296,2450
MULTAN DISTRICT,JALALPUR PIRWALA TEHSIL,60,1925,278,2203
MULTAN DISTRICT,JALALPUR PIRWALA TEHSIL,61,2137,288,2425
MULTAN DISTRICT,JALALPUR PIRWALA TEHSIL,62,1960,262,2222
MULTAN DISTRICT,JALALPUR PIRWALA TEHSIL,63,1766,248,2014
MULTAN DISTRICT,JALALPUR PIRWALA TEHSIL,64,1749,190,1939
MULTAN DISTRICT,JALALPUR PIRWALA TEHSIL,65,1625,211,1836
MULTAN DISTRICT,JALALPUR PIRWALA TEHSIL,66,1669,173,1842
MULTAN DISTRICT,JALALPUR PIRWALA TEHSIL,67,1559,149,1708
MULTAN DISTRICT,JALALPUR PIRWALA TEHSIL,68,1229,132,1361
MULTAN DISTRICT,JALALPUR PIRWALA TEHSIL,69,1424,148,1572
MULTAN DISTRICT,JALALPUR PIRWALA TEHSIL,70,1237,144,1381
MULTAN DISTRICT,JALALPUR PIRWALA TEHSIL,71,1314,159,1473
MULTAN DISTRICT,JALALPUR PIRWALA TEHSIL,72,979,135,1114
MULTAN DISTRICT,JALALPUR PIRWALA TEHSIL,73,880,110,990
MULTAN DISTRICT,JALALPUR PIRWALA TEHSIL,74,883,75,958
MULTAN DISTRICT,JALALPUR PIRWALA TEHSIL,>=75,6684,811,7495
MULTAN DISTRICT,MULTAN CITY TEHSIL,<1,10080,37781,47861
MULTAN DISTRICT,MULTAN CITY TEHSIL,1,10840,42755,53595
MULTAN DISTRICT,MULTAN CITY TEHSIL,2,11309,43620,54929
MULTAN DISTRICT,MULTAN CITY TEHSIL,3,12593,47477,60070
MULTAN DISTRICT,MULTAN CITY TEHSIL,4,11607,44122,55729
MULTAN DISTRICT,MULTAN CITY TEHSIL,5,12543,45565,58108
MULTAN DISTRICT,MULTAN CITY TEHSIL,6,11374,43734,55108
MULTAN DISTRICT,MULTAN CITY TEHSIL,7,12852,46911,59763
MULTAN DISTRICT,MULTAN CITY TEHSIL,8,11722,41984,53706
MULTAN DISTRICT,MULTAN CITY TEHSIL,9,12106,46163,58269
MULTAN DISTRICT,MULTAN CITY TEHSIL,10,10863,39712,50575
MULTAN DISTRICT,MULTAN CITY TEHSIL,11,10625,44395,55020
MULTAN DISTRICT,MULTAN CITY TEHSIL,12,9869,38647,48516
MULTAN DISTRICT,MULTAN CITY TEHSIL,13,9439,40085,49524
MULTAN DISTRICT,MULTAN CITY TEHSIL,14,8857,37073,45930
MULTAN DISTRICT,MULTAN CITY TEHSIL,15,8981,37845,46826
MULTAN DISTRICT,MULTAN CITY TEHSIL,16,8901,37900,46801
MULTAN DISTRICT,MULTAN CITY TEHSIL,17,8882,39653,48535
MULTAN DISTRICT,MULTAN CITY TEHSIL,18,9345,37382,46727
MULTAN DISTRICT,MULTAN CITY TEHSIL,19,9184,39718,48902
MULTAN DISTRICT,MULTAN CITY TEHSIL,20,9026,36206,45232
MULTAN DISTRICT,MULTAN CITY TEHSIL,21,8270,38242,46512
MULTAN DISTRICT,MULTAN CITY TEHSIL,22,8730,37180,45910
MULTAN DISTRICT,MULTAN CITY TEHSIL,23,7644,35161,42805
MULTAN DISTRICT,MULTAN CITY TEHSIL,24,7110,33897,41007
MULTAN DISTRICT,MULTAN CITY TEHSIL,25,8124,32584,40708
MULTAN DISTRICT,MULTAN CITY TEHSIL,26,7200,32614,39814
MULTAN DISTRICT,MULTAN CITY TEHSIL,27,7120,32108,39228
MULTAN DISTRICT,MULTAN CITY TEHSIL,28,7270,32635,39905
MULTAN DISTRICT,MULTAN CITY TEHSIL,29,6999,30311,37310
MULTAN DISTRICT,MULTAN CITY TEHSIL,30,7501,31284,38785
MULTAN DISTRICT,MULTAN CITY TEHSIL,31,6532,28663,35195
MULTAN DISTRICT,MULTAN CITY TEHSIL,32,6547,29550,36097
MULTAN DISTRICT,MULTAN CITY TEHSIL,33,5899,26956,32855
MULTAN DISTRICT,MULTAN CITY TEHSIL,34,5446,24509,29955
MULTAN DISTRICT,MULTAN CITY TEHSIL,35,6308,26032,32340
MULTAN DISTRICT,MULTAN CITY TEHSIL,36,5082,23057,28139
MULTAN DISTRICT,MULTAN CITY TEHSIL,37,5156,21939,27095
MULTAN DISTRICT,MULTAN CITY TEHSIL,38,5367,25491,30858
MULTAN DISTRICT,MULTAN CITY TEHSIL,39,5093,22466,27559
MULTAN DISTRICT,MULTAN CITY TEHSIL,40,5397,24502,29899
MULTAN DISTRICT,MULTAN CITY TEHSIL,41,4334,19846,24180
MULTAN DISTRICT,MULTAN CITY TEHSIL,42,4257,19722,23979
MULTAN DISTRICT,MULTAN CITY TEHSIL,43,4007,18781,22788
MULTAN DISTRICT,MULTAN CITY TEHSIL,44,3626,16540,20166
MULTAN DISTRICT,MULTAN CITY TEHSIL,45,4046,18342,22388
MULTAN DISTRICT,MULTAN CITY TEHSIL,46,3057,13996,17053
MULTAN DISTRICT,MULTAN CITY TEHSIL,47,3098,13814,16912
MULTAN DISTRICT,MULTAN CITY TEHSIL,48,3304,15733,19037
MULTAN DISTRICT,MULTAN CITY TEHSIL,49,3239,14996,18235
MULTAN DISTRICT,MULTAN CITY TEHSIL,50,3674,17046,20720
MULTAN DISTRICT,MULTAN CITY TEHSIL,51,2890,13515,16405
MULTAN DISTRICT,MULTAN CITY TEHSIL,52,2934,13682,16616
MULTAN DISTRICT,MULTAN CITY TEHSIL,53,2627,13406,16033
MULTAN DISTRICT,MULTAN CITY TEHSIL,54,2391,11864,14255
MULTAN DISTRICT,MULTAN CITY TEHSIL,55,2623,12666,15289
MULTAN DISTRICT,MULTAN CITY TEHSIL,56,1851,9275,11126
MULTAN DISTRICT,MULTAN CITY TEHSIL,57,1770,8245,10015
MULTAN DISTRICT,MULTAN CITY TEHSIL,58,1615,9073,10688
MULTAN DISTRICT,MULTAN CITY TEHSIL,59,1761,8507,10268
MULTAN DISTRICT,MULTAN CITY TEHSIL,60,2097,9273,11370
MULTAN DISTRICT,MULTAN CITY TEHSIL,61,1613,8108,9721
MULTAN DISTRICT,MULTAN CITY TEHSIL,62,1656,7711,9367
MULTAN DISTRICT,MULTAN CITY TEHSIL,63,1539,8066,9605
MULTAN DISTRICT,MULTAN CITY TEHSIL,64,1440,6574,8014
MULTAN DISTRICT,MULTAN CITY TEHSIL,65,1464,6837,8301
MULTAN DISTRICT,MULTAN CITY TEHSIL,66,927,4486,5413
MULTAN DISTRICT,MULTAN CITY TEHSIL,67,944,4300,5244
MULTAN DISTRICT,MULTAN CITY TEHSIL,68,969,4404,5373
MULTAN DISTRICT,MULTAN CITY TEHSIL,69,872,3960,4832
MULTAN DISTRICT,MULTAN CITY TEHSIL,70,988,4239,5227
MULTAN DISTRICT,MULTAN CITY TEHSIL,71,718,3432,4150
MULTAN DISTRICT,MULTAN CITY TEHSIL,72,702,3288,3990
MULTAN DISTRICT,MULTAN CITY TEHSIL,73,600,3251,3851
MULTAN DISTRICT,MULTAN CITY TEHSIL,74,534,2578,3112
MULTAN DISTRICT,MULTAN CITY TEHSIL,>=75,4154,19536,23690
MULTAN DISTRICT,MULTAN SADDAR TEHSIL,<1,29275,1587,30862
MULTAN DISTRICT,MULTAN SADDAR TEHSIL,1,33438,2193,35631
MULTAN DISTRICT,MULTAN SADDAR TEHSIL,2,34627,1745,36372
MULTAN DISTRICT,MULTAN SADDAR TEHSIL,3,37553,1955,39508
MULTAN DISTRICT,MULTAN SADDAR TEHSIL,4,38871,1892,40763
MULTAN DISTRICT,MULTAN SADDAR TEHSIL,5,36714,1853,38567
MULTAN DISTRICT,MULTAN SADDAR TEHSIL,6,35711,1812,37523
MULTAN DISTRICT,MULTAN SADDAR TEHSIL,7,37846,1986,39832
MULTAN DISTRICT,MULTAN SADDAR TEHSIL,8,36981,1778,38759
MULTAN DISTRICT,MULTAN SADDAR TEHSIL,9,36123,1913,38036
MULTAN DISTRICT,MULTAN SADDAR TEHSIL,10,33487,1666,35153
MULTAN DISTRICT,MULTAN SADDAR TEHSIL,11,31183,1911,33094
MULTAN DISTRICT,MULTAN SADDAR TEHSIL,12,29577,1544,31121
MULTAN DISTRICT,MULTAN SADDAR TEHSIL,13,27228,1636,28864
MULTAN DISTRICT,MULTAN SADDAR TEHSIL,14,26541,1450,27991
MULTAN DISTRICT,MULTAN SADDAR TEHSIL,15,25497,1334,26831
MULTAN DISTRICT,MULTAN SADDAR TEHSIL,16,24859,1398,26257
MULTAN DISTRICT,MULTAN SADDAR TEHSIL,17,23920,1405,25325
MULTAN DISTRICT,MULTAN SADDAR TEHSIL,18,25291,1254,26545
MULTAN DISTRICT,MULTAN SADDAR TEHSIL,19,24419,1388,25807
MULTAN DISTRICT,MULTAN SADDAR TEHSIL,20,25321,1291,26612
MULTAN DISTRICT,MULTAN SADDAR TEHSIL,21,22135,1625,23760
MULTAN DISTRICT,MULTAN SADDAR TEHSIL,22,22236,1575,23811
MULTAN DISTRICT,MULTAN SADDAR TEHSIL,23,19837,1812,21649
MULTAN DISTRICT,MULTAN SADDAR TEHSIL,24,18698,1755,20453
MULTAN DISTRICT,MULTAN SADDAR TEHSIL,25,21280,1603,22883
MULTAN DISTRICT,MULTAN SADDAR TEHSIL,26,18390,1787,20177
MULTAN DISTRICT,MULTAN SADDAR TEHSIL,27,18458,1935,20393
MULTAN DISTRICT,MULTAN SADDAR TEHSIL,28,18482,1817,20299
MULTAN DISTRICT,MULTAN SADDAR TEHSIL,29,19392,2003,21395
MULTAN DISTRICT,MULTAN SADDAR TEHSIL,30,19000,1682,20682
MULTAN DISTRICT,MULTAN SADDAR TEHSIL,31,17712,1835,19547
MULTAN DISTRICT,MULTAN SADDAR TEHSIL,32,16725,1730,18455
MULTAN DISTRICT,MULTAN SADDAR TEHSIL,33,15314,1822,17136
MULTAN DISTRICT,MULTAN SADDAR TEHSIL,34,15130,1765,16895
MULTAN DISTRICT,MULTAN SADDAR TEHSIL,35,16453,1465,17918
MULTAN DISTRICT,MULTAN SADDAR TEHSIL,36,15864,1531,17395
MULTAN DISTRICT,MULTAN SADDAR TEHSIL,37,16506,1467,17973
MULTAN DISTRICT,MULTAN SADDAR TEHSIL,38,14103,1462,15565
MULTAN DISTRICT,MULTAN SADDAR TEHSIL,39,14634,1458,16092
MULTAN DISTRICT,MULTAN SADDAR TEHSIL,40,12809,1057,13866
MULTAN DISTRICT,MULTAN SADDAR TEHSIL,41,12620,1075,13695
MULTAN DISTRICT,MULTAN SADDAR TEHSIL,42,12326,996,13322
MULTAN DISTRICT,MULTAN SADDAR TEHSIL,43,9798,966,10764
MULTAN DISTRICT,MULTAN SADDAR TEHSIL,44,9447,844,10291
MULTAN DISTRICT,MULTAN SADDAR TEHSIL,45,9881,704,10585
MULTAN DISTRICT,MULTAN SADDAR TEHSIL,46,9056,726,9782
MULTAN DISTRICT,MULTAN SADDAR TEHSIL,47,10107,636,10743
MULTAN DISTRICT,MULTAN SADDAR TEHSIL,48,9147,664,9811
MULTAN DISTRICT,MULTAN SADDAR TEHSIL,49,9542,664,10206
MULTAN DISTRICT,MULTAN SADDAR TEHSIL,50,9044,590,9634
MULTAN DISTRICT,MULTAN SADDAR TEHSIL,51,8776,595,9371
MULTAN DISTRICT,MULTAN SADDAR TEHSIL,52,8986,551,9537
MULTAN DISTRICT,MULTAN SADDAR TEHSIL,53,7462,507,7969
MULTAN DISTRICT,MULTAN SADDAR TEHSIL,54,6576,503,7079
MULTAN DISTRICT,MULTAN SADDAR TEHSIL,55,6711,447,7158
MULTAN DISTRICT,MULTAN SADDAR TEHSIL,56,5770,351,6121
MULTAN DISTRICT,MULTAN SADDAR TEHSIL,57,6137,360,6497
MULTAN DISTRICT,MULTAN SADDAR TEHSIL,58,5231,369,5600
MULTAN DISTRICT,MULTAN SADDAR TEHSIL,59,5451,407,5858
MULTAN DISTRICT,MULTAN SADDAR TEHSIL,60,5512,294,5806
MULTAN DISTRICT,MULTAN SADDAR TEHSIL,61,5145,348,5493
MULTAN DISTRICT,MULTAN SADDAR TEHSIL,62,5268,311,5579
MULTAN DISTRICT,MULTAN SADDAR TEHSIL,63,4679,346,5025
MULTAN DISTRICT,MULTAN SADDAR TEHSIL,64,4300,281,4581
MULTAN DISTRICT,MULTAN SADDAR TEHSIL,65,4347,259,4606
MULTAN DISTRICT,MULTAN SADDAR TEHSIL,66,3533,231,3764
MULTAN DISTRICT,MULTAN SADDAR TEHSIL,67,3866,207,4073
MULTAN DISTRICT,MULTAN SADDAR TEHSIL,68,3084,178,3262
MULTAN DISTRICT,MULTAN SADDAR TEHSIL,69,2986,180,3166
MULTAN DISTRICT,MULTAN SADDAR TEHSIL,70,3098,169,3267
MULTAN DISTRICT,MULTAN SADDAR TEHSIL,71,2483,150,2633
MULTAN DISTRICT,MULTAN SADDAR TEHSIL,72,2580,145,2725
MULTAN DISTRICT,MULTAN SADDAR TEHSIL,73,2111,134,2245
MULTAN DISTRICT,MULTAN SADDAR TEHSIL,74,1831,126,1957
MULTAN DISTRICT,MULTAN SADDAR TEHSIL,>=75,14197,877,15074
MULTAN DISTRICT,SHUJABAD TEHSIL,<1,12860,1620,14480
MULTAN DISTRICT,SHUJABAD TEHSIL,1,15433,1980,17413
MULTAN DISTRICT,SHUJABAD TEHSIL,2,15537,2038,17575
MULTAN DISTRICT,SHUJABAD TEHSIL,3,17228,2103,19331
MULTAN DISTRICT,SHUJABAD TEHSIL,4,17569,2091,19660
MULTAN DISTRICT,SHUJABAD TEHSIL,5,17454,2124,19578
MULTAN DISTRICT,SHUJABAD TEHSIL,6,16767,1959,18726
MULTAN DISTRICT,SHUJABAD TEHSIL,7,17670,2167,19837
MULTAN DISTRICT,SHUJABAD TEHSIL,8,17456,1965,19421
MULTAN DISTRICT,SHUJABAD TEHSIL,9,16454,2286,18740
MULTAN DISTRICT,SHUJABAD TEHSIL,10,15517,1908,17425
MULTAN DISTRICT,SHUJABAD TEHSIL,11,13828,2184,16012
MULTAN DISTRICT,SHUJABAD TEHSIL,12,13635,1889,15524
MULTAN DISTRICT,SHUJABAD TEHSIL,13,11964,1951,13915
MULTAN DISTRICT,SHUJABAD TEHSIL,14,11714,1924,13638
MULTAN DISTRICT,SHUJABAD TEHSIL,15,11089,1913,13002
MULTAN DISTRICT,SHUJABAD TEHSIL,16,10740,1814,12554
MULTAN DISTRICT,SHUJABAD TEHSIL,17,9681,1904,11585
MULTAN DISTRICT,SHUJABAD TEHSIL,18,10591,1603,12194
MULTAN DISTRICT,SHUJABAD TEHSIL,19,9513,1782,11295
MULTAN DISTRICT,SHUJABAD TEHSIL,20,10439,1577,12016
MULTAN DISTRICT,SHUJABAD TEHSIL,21,8764,1692,10456
MULTAN DISTRICT,SHUJABAD TEHSIL,22,8677,1550,10227
MULTAN DISTRICT,SHUJABAD TEHSIL,23,7510,1439,8949
MULTAN DISTRICT,SHUJABAD TEHSIL,24,6873,1458,8331
MULTAN DISTRICT,SHUJABAD TEHSIL,25,8432,1306,9738
MULTAN DISTRICT,SHUJABAD TEHSIL,26,7563,1324,8887
MULTAN DISTRICT,SHUJABAD TEHSIL,27,7939,1405,9344
MULTAN DISTRICT,SHUJABAD TEHSIL,28,8003,1279,9282
MULTAN DISTRICT,SHUJABAD TEHSIL,29,8442,1350,9792
MULTAN DISTRICT,SHUJABAD TEHSIL,30,7102,1142,8244
MULTAN DISTRICT,SHUJABAD TEHSIL,31,7480,1228,8708
MULTAN DISTRICT,SHUJABAD TEHSIL,32,6786,1133,7919
MULTAN DISTRICT,SHUJABAD TEHSIL,33,6074,1073,7147
MULTAN DISTRICT,SHUJABAD TEHSIL,34,6752,1028,7780
MULTAN DISTRICT,SHUJABAD TEHSIL,35,6095,979,7074
MULTAN DISTRICT,SHUJABAD TEHSIL,36,7064,957,8021
MULTAN DISTRICT,SHUJABAD TEHSIL,37,6533,970,7503
MULTAN DISTRICT,SHUJABAD TEHSIL,38,5356,909,6265
MULTAN DISTRICT,SHUJABAD TEHSIL,39,5841,930,6771
MULTAN DISTRICT,SHUJABAD TEHSIL,40,4477,882,5359
MULTAN DISTRICT,SHUJABAD TEHSIL,41,5701,821,6522
MULTAN DISTRICT,SHUJABAD TEHSIL,42,4795,805,5600
MULTAN DISTRICT,SHUJABAD TEHSIL,43,4019,756,4775
MULTAN DISTRICT,SHUJABAD TEHSIL,44,4025,726,4751
MULTAN DISTRICT,SHUJABAD TEHSIL,45,3403,674,4077
MULTAN DISTRICT,SHUJABAD TEHSIL,46,4131,662,4793
MULTAN DISTRICT,SHUJABAD TEHSIL,47,4044,662,4706
MULTAN DISTRICT,SHUJABAD TEHSIL,48,3509,661,4170
MULTAN DISTRICT,SHUJABAD TEHSIL,49,3683,669,4352
MULTAN DISTRICT,SHUJABAD TEHSIL,50,3208,657,3865
MULTAN DISTRICT,SHUJABAD TEHSIL,51,3883,638,4521
MULTAN DISTRICT,SHUJABAD TEHSIL,52,3470,629,4099
MULTAN DISTRICT,SHUJABAD TEHSIL,53,2938,521,3459
MULTAN DISTRICT,SHUJABAD TEHSIL,54,2664,536,3200
MULTAN DISTRICT,SHUJABAD TEHSIL,55,2373,417,2790
MULTAN DISTRICT,SHUJABAD TEHSIL,56,2590,392,2982
MULTAN DISTRICT,SHUJABAD TEHSIL,57,2505,368,2873
MULTAN DISTRICT,SHUJABAD TEHSIL,58,1972,356,2328
MULTAN DISTRICT,SHUJABAD TEHSIL,59,2086,342,2428
MULTAN DISTRICT,SHUJABAD TEHSIL,60,1964,298,2262
MULTAN DISTRICT,SHUJABAD TEHSIL,61,2318,317,2635
MULTAN DISTRICT,SHUJABAD TEHSIL,62,2100,335,2435
MULTAN DISTRICT,SHUJABAD TEHSIL,63,1954,309,2263
MULTAN DISTRICT,SHUJABAD TEHSIL,64,1859,274,2133
MULTAN DISTRICT,SHUJABAD TEHSIL,65,1547,243,1790
MULTAN DISTRICT,SHUJABAD TEHSIL,66,1825,224,2049
MULTAN DISTRICT,SHUJABAD TEHSIL,67,1641,174,1815
MULTAN DISTRICT,SHUJABAD TEHSIL,68,1265,185,1450
MULTAN DISTRICT,SHUJABAD TEHSIL,69,1334,170,1504
MULTAN DISTRICT,SHUJABAD TEHSIL,70,1094,140,1234
MULTAN DISTRICT,SHUJABAD TEHSIL,71,1219,133,1352
MULTAN DISTRICT,SHUJABAD TEHSIL,72,1055,142,1197
MULTAN DISTRICT,SHUJABAD TEHSIL,73,832,112,944
MULTAN DISTRICT,SHUJABAD TEHSIL,74,830,112,942
MULTAN DISTRICT,SHUJABAD TEHSIL,>=75,6168,822,6990
MUSAKHEL,DRUG TEHSIL,<1,1910,0,1910
MUSAKHEL,DRUG TEHSIL,1,1330,0,1330
MUSAKHEL,DRUG TEHSIL,2,1406,0,1406
MUSAKHEL,DRUG TEHSIL,3,1490,0,1490
MUSAKHEL,DRUG TEHSIL,4,1392,0,1392
MUSAKHEL,DRUG TEHSIL,5,1550,0,1550
MUSAKHEL,DRUG TEHSIL,6,1437,0,1437
MUSAKHEL,DRUG TEHSIL,7,1404,0,1404
MUSAKHEL,DRUG TEHSIL,8,1314,0,1314
MUSAKHEL,DRUG TEHSIL,9,1324,0,1324
MUSAKHEL,DRUG TEHSIL,10,1061,0,1061
MUSAKHEL,DRUG TEHSIL,11,978,0,978
MUSAKHEL,DRUG TEHSIL,12,820,0,820
MUSAKHEL,DRUG TEHSIL,13,775,0,775
MUSAKHEL,DRUG TEHSIL,14,661,0,661
MUSAKHEL,DRUG TEHSIL,15,686,0,686
MUSAKHEL,DRUG TEHSIL,16,565,0,565
MUSAKHEL,DRUG TEHSIL,17,616,0,616
MUSAKHEL,DRUG TEHSIL,18,735,0,735
MUSAKHEL,DRUG TEHSIL,19,649,0,649
MUSAKHEL,DRUG TEHSIL,20,588,0,588
MUSAKHEL,DRUG TEHSIL,21,616,0,616
MUSAKHEL,DRUG TEHSIL,22,510,0,510
MUSAKHEL,DRUG TEHSIL,23,558,0,558
MUSAKHEL,DRUG TEHSIL,24,486,0,486
MUSAKHEL,DRUG TEHSIL,25,531,0,531
MUSAKHEL,DRUG TEHSIL,26,588,0,588
MUSAKHEL,DRUG TEHSIL,27,568,0,568
MUSAKHEL,DRUG TEHSIL,28,530,0,530
MUSAKHEL,DRUG TEHSIL,29,591,0,591
MUSAKHEL,DRUG TEHSIL,30,478,0,478
MUSAKHEL,DRUG TEHSIL,31,502,0,502
MUSAKHEL,DRUG TEHSIL,32,420,0,420
MUSAKHEL,DRUG TEHSIL,33,404,0,404
MUSAKHEL,DRUG TEHSIL,34,318,0,318
MUSAKHEL,DRUG TEHSIL,35,296,0,296
MUSAKHEL,DRUG TEHSIL,36,385,0,385
MUSAKHEL,DRUG TEHSIL,37,467,0,467
MUSAKHEL,DRUG TEHSIL,38,345,0,345
MUSAKHEL,DRUG TEHSIL,39,378,0,378
MUSAKHEL,DRUG TEHSIL,40,308,0,308
MUSAKHEL,DRUG TEHSIL,41,330,0,330
MUSAKHEL,DRUG TEHSIL,42,295,0,295
MUSAKHEL,DRUG TEHSIL,43,209,0,209
MUSAKHEL,DRUG TEHSIL,44,253,0,253
MUSAKHEL,DRUG TEHSIL,45,242,0,242
MUSAKHEL,DRUG TEHSIL,46,276,0,276
MUSAKHEL,DRUG TEHSIL,47,304,0,304
MUSAKHEL,DRUG TEHSIL,48,205,0,205
MUSAKHEL,DRUG TEHSIL,49,235,0,235
MUSAKHEL,DRUG TEHSIL,50,184,0,184
MUSAKHEL,DRUG TEHSIL,51,198,0,198
MUSAKHEL,DRUG TEHSIL,52,151,0,151
MUSAKHEL,DRUG TEHSIL,53,145,0,145
MUSAKHEL,DRUG TEHSIL,54,137,0,137
MUSAKHEL,DRUG TEHSIL,55,148,0,148
MUSAKHEL,DRUG TEHSIL,56,149,0,149
MUSAKHEL,DRUG TEHSIL,57,178,0,178
MUSAKHEL,DRUG TEHSIL,58,129,0,129
MUSAKHEL,DRUG TEHSIL,59,163,0,163
MUSAKHEL,DRUG TEHSIL,60,128,0,128
MUSAKHEL,DRUG TEHSIL,61,133,0,133
MUSAKHEL,DRUG TEHSIL,62,138,0,138
MUSAKHEL,DRUG TEHSIL,63,98,0,98
MUSAKHEL,DRUG TEHSIL,64,112,0,112
MUSAKHEL,DRUG TEHSIL,65,71,0,71
MUSAKHEL,DRUG TEHSIL,66,92,0,92
MUSAKHEL,DRUG TEHSIL,67,104,0,104
MUSAKHEL,DRUG TEHSIL,68,77,0,77
MUSAKHEL,DRUG TEHSIL,69,108,0,108
MUSAKHEL,DRUG TEHSIL,70,70,0,70
MUSAKHEL,DRUG TEHSIL,71,56,0,56
MUSAKHEL,DRUG TEHSIL,72,59,0,59
MUSAKHEL,DRUG TEHSIL,73,44,0,44
MUSAKHEL,DRUG TEHSIL,74,53,0,53
MUSAKHEL,DRUG TEHSIL,>=75,355,0,355
MUSAKHEL,KINGRI TEHSIL,<1,1181,0,1181
MUSAKHEL,KINGRI TEHSIL,1,1066,0,1066
MUSAKHEL,KINGRI TEHSIL,2,1422,0,1422
MUSAKHEL,KINGRI TEHSIL,3,1251,0,1251
MUSAKHEL,KINGRI TEHSIL,4,1476,0,1476
MUSAKHEL,KINGRI TEHSIL,5,1223,0,1223
MUSAKHEL,KINGRI TEHSIL,6,1420,0,1420
MUSAKHEL,KINGRI TEHSIL,7,1183,0,1183
MUSAKHEL,KINGRI TEHSIL,8,1296,0,1296
MUSAKHEL,KINGRI TEHSIL,9,952,0,952
MUSAKHEL,KINGRI TEHSIL,10,1140,0,1140
MUSAKHEL,KINGRI TEHSIL,11,737,0,737
MUSAKHEL,KINGRI TEHSIL,12,761,0,761
MUSAKHEL,KINGRI TEHSIL,13,605,0,605
MUSAKHEL,KINGRI TEHSIL,14,582,0,582
MUSAKHEL,KINGRI TEHSIL,15,499,0,499
MUSAKHEL,KINGRI TEHSIL,16,449,0,449
MUSAKHEL,KINGRI TEHSIL,17,392,0,392
MUSAKHEL,KINGRI TEHSIL,18,607,0,607
MUSAKHEL,KINGRI TEHSIL,19,475,0,475
MUSAKHEL,KINGRI TEHSIL,20,485,0,485
MUSAKHEL,KINGRI TEHSIL,21,464,0,464
MUSAKHEL,KINGRI TEHSIL,22,475,0,475
MUSAKHEL,KINGRI TEHSIL,23,389,0,389
MUSAKHEL,KINGRI TEHSIL,24,368,0,368
MUSAKHEL,KINGRI TEHSIL,25,437,0,437
MUSAKHEL,KINGRI TEHSIL,26,475,0,475
MUSAKHEL,KINGRI TEHSIL,27,430,0,430
MUSAKHEL,KINGRI TEHSIL,28,457,0,457
MUSAKHEL,KINGRI TEHSIL,29,370,0,370
MUSAKHEL,KINGRI TEHSIL,30,411,0,411
MUSAKHEL,KINGRI TEHSIL,31,441,0,441
MUSAKHEL,KINGRI TEHSIL,32,337,0,337
MUSAKHEL,KINGRI TEHSIL,33,296,0,296
MUSAKHEL,KINGRI TEHSIL,34,287,0,287
MUSAKHEL,KINGRI TEHSIL,35,285,0,285
MUSAKHEL,KINGRI TEHSIL,36,451,0,451
MUSAKHEL,KINGRI TEHSIL,37,298,0,298
MUSAKHEL,KINGRI TEHSIL,38,280,0,280
MUSAKHEL,KINGRI TEHSIL,39,289,0,289
MUSAKHEL,KINGRI TEHSIL,40,282,0,282
MUSAKHEL,KINGRI TEHSIL,41,287,0,287
MUSAKHEL,KINGRI TEHSIL,42,183,0,183
MUSAKHEL,KINGRI TEHSIL,43,188,0,188
MUSAKHEL,KINGRI TEHSIL,44,196,0,196
MUSAKHEL,KINGRI TEHSIL,45,206,0,206
MUSAKHEL,KINGRI TEHSIL,46,286,0,286
MUSAKHEL,KINGRI TEHSIL,47,224,0,224
MUSAKHEL,KINGRI TEHSIL,48,168,0,168
MUSAKHEL,KINGRI TEHSIL,49,159,0,159
MUSAKHEL,KINGRI TEHSIL,50,200,0,200
MUSAKHEL,KINGRI TEHSIL,51,176,0,176
MUSAKHEL,KINGRI TEHSIL,52,130,0,130
MUSAKHEL,KINGRI TEHSIL,53,141,0,141
MUSAKHEL,KINGRI TEHSIL,54,118,0,118
MUSAKHEL,KINGRI TEHSIL,55,110,0,110
MUSAKHEL,KINGRI TEHSIL,56,144,0,144
MUSAKHEL,KINGRI TEHSIL,57,121,0,121
MUSAKHEL,KINGRI TEHSIL,58,116,0,116
MUSAKHEL,KINGRI TEHSIL,59,102,0,102
MUSAKHEL,KINGRI TEHSIL,60,102,0,102
MUSAKHEL,KINGRI TEHSIL,61,103,0,103
MUSAKHEL,KINGRI TEHSIL,62,87,0,87
MUSAKHEL,KINGRI TEHSIL,63,80,0,80
MUSAKHEL,KINGRI TEHSIL,64,98,0,98
MUSAKHEL,KINGRI TEHSIL,65,68,0,68
MUSAKHEL,KINGRI TEHSIL,66,88,0,88
MUSAKHEL,KINGRI TEHSIL,67,59,0,59
MUSAKHEL,KINGRI TEHSIL,68,62,0,62
MUSAKHEL,KINGRI TEHSIL,69,78,0,78
MUSAKHEL,KINGRI TEHSIL,70,61,0,61
MUSAKHEL,KINGRI TEHSIL,71,38,0,38
MUSAKHEL,KINGRI TEHSIL,72,40,0,40
MUSAKHEL,KINGRI TEHSIL,73,40,0,40
MUSAKHEL,KINGRI TEHSIL,74,49,0,49
MUSAKHEL,KINGRI TEHSIL,>=75,307,0,307
MUSAKHEL,MUSAKHEL TEHSIL,<1,3534,530,4064
MUSAKHEL,MUSAKHEL TEHSIL,1,3495,672,4167
MUSAKHEL,MUSAKHEL TEHSIL,2,3960,722,4682
MUSAKHEL,MUSAKHEL TEHSIL,3,3934,664,4598
MUSAKHEL,MUSAKHEL TEHSIL,4,3926,699,4625
MUSAKHEL,MUSAKHEL TEHSIL,5,3632,585,4217
MUSAKHEL,MUSAKHEL TEHSIL,6,3627,661,4288
MUSAKHEL,MUSAKHEL TEHSIL,7,3543,533,4076
MUSAKHEL,MUSAKHEL TEHSIL,8,3276,608,3884
MUSAKHEL,MUSAKHEL TEHSIL,9,3545,505,4050
MUSAKHEL,MUSAKHEL TEHSIL,10,2678,444,3122
MUSAKHEL,MUSAKHEL TEHSIL,11,2774,349,3123
MUSAKHEL,MUSAKHEL TEHSIL,12,2037,334,2371
MUSAKHEL,MUSAKHEL TEHSIL,13,2188,291,2479
MUSAKHEL,MUSAKHEL TEHSIL,14,1795,271,2066
MUSAKHEL,MUSAKHEL TEHSIL,15,1805,259,2064
MUSAKHEL,MUSAKHEL TEHSIL,16,1536,220,1756
MUSAKHEL,MUSAKHEL TEHSIL,17,1581,259,1840
MUSAKHEL,MUSAKHEL TEHSIL,18,1155,221,1376
MUSAKHEL,MUSAKHEL TEHSIL,19,1250,227,1477
MUSAKHEL,MUSAKHEL TEHSIL,20,1009,184,1193
MUSAKHEL,MUSAKHEL TEHSIL,21,1081,201,1282
MUSAKHEL,MUSAKHEL TEHSIL,22,898,153,1051
MUSAKHEL,MUSAKHEL TEHSIL,23,925,178,1103
MUSAKHEL,MUSAKHEL TEHSIL,24,824,164,988
MUSAKHEL,MUSAKHEL TEHSIL,25,846,137,983
MUSAKHEL,MUSAKHEL TEHSIL,26,972,194,1166
MUSAKHEL,MUSAKHEL TEHSIL,27,1061,167,1228
MUSAKHEL,MUSAKHEL TEHSIL,28,945,200,1145
MUSAKHEL,MUSAKHEL TEHSIL,29,1037,182,1219
MUSAKHEL,MUSAKHEL TEHSIL,30,739,126,865
MUSAKHEL,MUSAKHEL TEHSIL,31,984,169,1153
MUSAKHEL,MUSAKHEL TEHSIL,32,756,159,915
MUSAKHEL,MUSAKHEL TEHSIL,33,688,121,809
MUSAKHEL,MUSAKHEL TEHSIL,34,653,118,771
MUSAKHEL,MUSAKHEL TEHSIL,35,588,99,687
MUSAKHEL,MUSAKHEL TEHSIL,36,779,119,898
MUSAKHEL,MUSAKHEL TEHSIL,37,741,142,883
MUSAKHEL,MUSAKHEL TEHSIL,38,739,124,863
MUSAKHEL,MUSAKHEL TEHSIL,39,711,112,823
MUSAKHEL,MUSAKHEL TEHSIL,40,509,78,587
MUSAKHEL,MUSAKHEL TEHSIL,41,737,138,875
MUSAKHEL,MUSAKHEL TEHSIL,42,610,116,726
MUSAKHEL,MUSAKHEL TEHSIL,43,497,82,579
MUSAKHEL,MUSAKHEL TEHSIL,44,499,102,601
MUSAKHEL,MUSAKHEL TEHSIL,45,398,65,463
MUSAKHEL,MUSAKHEL TEHSIL,46,641,104,745
MUSAKHEL,MUSAKHEL TEHSIL,47,656,91,747
MUSAKHEL,MUSAKHEL TEHSIL,48,446,97,543
MUSAKHEL,MUSAKHEL TEHSIL,49,412,81,493
MUSAKHEL,MUSAKHEL TEHSIL,50,286,48,334
MUSAKHEL,MUSAKHEL TEHSIL,51,481,72,553
MUSAKHEL,MUSAKHEL TEHSIL,52,350,52,402
MUSAKHEL,MUSAKHEL TEHSIL,53,264,62,326
MUSAKHEL,MUSAKHEL TEHSIL,54,225,62,287
MUSAKHEL,MUSAKHEL TEHSIL,55,195,31,226
MUSAKHEL,MUSAKHEL TEHSIL,56,312,45,357
MUSAKHEL,MUSAKHEL TEHSIL,57,295,65,360
MUSAKHEL,MUSAKHEL TEHSIL,58,233,44,277
MUSAKHEL,MUSAKHEL TEHSIL,59,253,52,305
MUSAKHEL,MUSAKHEL TEHSIL,60,207,38,245
MUSAKHEL,MUSAKHEL TEHSIL,61,265,44,309
MUSAKHEL,MUSAKHEL TEHSIL,62,246,26,272
MUSAKHEL,MUSAKHEL TEHSIL,63,224,32,256
MUSAKHEL,MUSAKHEL TEHSIL,64,248,32,280
MUSAKHEL,MUSAKHEL TEHSIL,65,180,31,211
MUSAKHEL,MUSAKHEL TEHSIL,66,252,51,303
MUSAKHEL,MUSAKHEL TEHSIL,67,222,35,257
MUSAKHEL,MUSAKHEL TEHSIL,68,194,29,223
MUSAKHEL,MUSAKHEL TEHSIL,69,182,24,206
MUSAKHEL,MUSAKHEL TEHSIL,70,111,18,129
MUSAKHEL,MUSAKHEL TEHSIL,71,153,16,169
MUSAKHEL,MUSAKHEL TEHSIL,72,99,18,117
MUSAKHEL,MUSAKHEL TEHSIL,73,115,17,132
MUSAKHEL,MUSAKHEL TEHSIL,74,107,9,116
MUSAKHEL,MUSAKHEL TEHSIL,>=75,819,125,944
MUZAFFARGARH DISTRICT,ALIPUR TEHSIL,<1,14257,964,15221
MUZAFFARGARH DISTRICT,ALIPUR TEHSIL,1,16088,1057,17145
MUZAFFARGARH DISTRICT,ALIPUR TEHSIL,2,19787,1095,20882
MUZAFFARGARH DISTRICT,ALIPUR TEHSIL,3,21264,1148,22412
MUZAFFARGARH DISTRICT,ALIPUR TEHSIL,4,22921,1143,24064
MUZAFFARGARH DISTRICT,ALIPUR TEHSIL,5,20438,1186,21624
MUZAFFARGARH DISTRICT,ALIPUR TEHSIL,6,20686,1143,21829
MUZAFFARGARH DISTRICT,ALIPUR TEHSIL,7,21316,1251,22567
MUZAFFARGARH DISTRICT,ALIPUR TEHSIL,8,22802,1123,23925
MUZAFFARGARH DISTRICT,ALIPUR TEHSIL,9,17699,1160,18859
MUZAFFARGARH DISTRICT,ALIPUR TEHSIL,10,20060,1017,21077
MUZAFFARGARH DISTRICT,ALIPUR TEHSIL,11,13925,1144,15069
MUZAFFARGARH DISTRICT,ALIPUR TEHSIL,12,16823,1071,17894
MUZAFFARGARH DISTRICT,ALIPUR TEHSIL,13,12404,1135,13539
MUZAFFARGARH DISTRICT,ALIPUR TEHSIL,14,13894,995,14889
MUZAFFARGARH DISTRICT,ALIPUR TEHSIL,15,12764,1057,13821
MUZAFFARGARH DISTRICT,ALIPUR TEHSIL,16,12854,1037,13891
MUZAFFARGARH DISTRICT,ALIPUR TEHSIL,17,10459,1173,11632
MUZAFFARGARH DISTRICT,ALIPUR TEHSIL,18,13954,971,14925
MUZAFFARGARH DISTRICT,ALIPUR TEHSIL,19,10522,1003,11525
MUZAFFARGARH DISTRICT,ALIPUR TEHSIL,20,13640,880,14520
MUZAFFARGARH DISTRICT,ALIPUR TEHSIL,21,8877,909,9786
MUZAFFARGARH DISTRICT,ALIPUR TEHSIL,22,10065,797,10862
MUZAFFARGARH DISTRICT,ALIPUR TEHSIL,23,7938,822,8760
MUZAFFARGARH DISTRICT,ALIPUR TEHSIL,24,7711,734,8445
MUZAFFARGARH DISTRICT,ALIPUR TEHSIL,25,11251,731,11982
MUZAFFARGARH DISTRICT,ALIPUR TEHSIL,26,7301,674,7975
MUZAFFARGARH DISTRICT,ALIPUR TEHSIL,27,7293,748,8041
MUZAFFARGARH DISTRICT,ALIPUR TEHSIL,28,8577,713,9290
MUZAFFARGARH DISTRICT,ALIPUR TEHSIL,29,7745,679,8424
MUZAFFARGARH DISTRICT,ALIPUR TEHSIL,30,10039,701,10740
MUZAFFARGARH DISTRICT,ALIPUR TEHSIL,31,6885,644,7529
MUZAFFARGARH DISTRICT,ALIPUR TEHSIL,32,7121,628,7749
MUZAFFARGARH DISTRICT,ALIPUR TEHSIL,33,6291,613,6904
MUZAFFARGARH DISTRICT,ALIPUR TEHSIL,34,5793,573,6366
MUZAFFARGARH DISTRICT,ALIPUR TEHSIL,35,8112,558,8670
MUZAFFARGARH DISTRICT,ALIPUR TEHSIL,36,6014,611,6625
MUZAFFARGARH DISTRICT,ALIPUR TEHSIL,37,6521,521,7042
MUZAFFARGARH DISTRICT,ALIPUR TEHSIL,38,5943,600,6543
MUZAFFARGARH DISTRICT,ALIPUR TEHSIL,39,5922,525,6447
MUZAFFARGARH DISTRICT,ALIPUR TEHSIL,40,6600,522,7122
MUZAFFARGARH DISTRICT,ALIPUR TEHSIL,41,5264,454,5718
MUZAFFARGARH DISTRICT,ALIPUR TEHSIL,42,5185,427,5612
MUZAFFARGARH DISTRICT,ALIPUR TEHSIL,43,4140,447,4587
MUZAFFARGARH DISTRICT,ALIPUR TEHSIL,44,3747,406,4153
MUZAFFARGARH DISTRICT,ALIPUR TEHSIL,45,4874,350,5224
MUZAFFARGARH DISTRICT,ALIPUR TEHSIL,46,3490,342,3832
MUZAFFARGARH DISTRICT,ALIPUR TEHSIL,47,3855,368,4223
MUZAFFARGARH DISTRICT,ALIPUR TEHSIL,48,3676,371,4047
MUZAFFARGARH DISTRICT,ALIPUR TEHSIL,49,3576,355,3931
MUZAFFARGARH DISTRICT,ALIPUR TEHSIL,50,4343,343,4686
MUZAFFARGARH DISTRICT,ALIPUR TEHSIL,51,3003,311,3314
MUZAFFARGARH DISTRICT,ALIPUR TEHSIL,52,3118,287,3405
MUZAFFARGARH DISTRICT,ALIPUR TEHSIL,53,2790,299,3089
MUZAFFARGARH DISTRICT,ALIPUR TEHSIL,54,2405,274,2679
MUZAFFARGARH DISTRICT,ALIPUR TEHSIL,55,2890,272,3162
MUZAFFARGARH DISTRICT,ALIPUR TEHSIL,56,2050,210,2260
MUZAFFARGARH DISTRICT,ALIPUR TEHSIL,57,2188,183,2371
MUZAFFARGARH DISTRICT,ALIPUR TEHSIL,58,1784,183,1967
MUZAFFARGARH DISTRICT,ALIPUR TEHSIL,59,1869,210,2079
MUZAFFARGARH DISTRICT,ALIPUR TEHSIL,60,2698,191,2889
MUZAFFARGARH DISTRICT,ALIPUR TEHSIL,61,2034,205,2239
MUZAFFARGARH DISTRICT,ALIPUR TEHSIL,62,2103,183,2286
MUZAFFARGARH DISTRICT,ALIPUR TEHSIL,63,1871,180,2051
MUZAFFARGARH DISTRICT,ALIPUR TEHSIL,64,1759,154,1913
MUZAFFARGARH DISTRICT,ALIPUR TEHSIL,65,2109,138,2247
MUZAFFARGARH DISTRICT,ALIPUR TEHSIL,66,1591,133,1724
MUZAFFARGARH DISTRICT,ALIPUR TEHSIL,67,1462,109,1571
MUZAFFARGARH DISTRICT,ALIPUR TEHSIL,68,1251,119,1370
MUZAFFARGARH DISTRICT,ALIPUR TEHSIL,69,1289,109,1398
MUZAFFARGARH DISTRICT,ALIPUR TEHSIL,70,1699,79,1778
MUZAFFARGARH DISTRICT,ALIPUR TEHSIL,71,1316,90,1406
MUZAFFARGARH DISTRICT,ALIPUR TEHSIL,72,1043,73,1116
MUZAFFARGARH DISTRICT,ALIPUR TEHSIL,73,1001,85,1086
MUZAFFARGARH DISTRICT,ALIPUR TEHSIL,74,781,51,832
MUZAFFARGARH DISTRICT,ALIPUR TEHSIL,>=75,7070,457,7527
MUZAFFARGARH DISTRICT,JATOI TEHSIL,<1,14400,3827,18227
MUZAFFARGARH DISTRICT,JATOI TEHSIL,1,15958,4656,20614
MUZAFFARGARH DISTRICT,JATOI TEHSIL,2,18617,5045,23662
MUZAFFARGARH DISTRICT,JATOI TEHSIL,3,20380,5314,25694
MUZAFFARGARH DISTRICT,JATOI TEHSIL,4,21371,5577,26948
MUZAFFARGARH DISTRICT,JATOI TEHSIL,5,20066,5439,25505
MUZAFFARGARH DISTRICT,JATOI TEHSIL,6,19709,4982,24691
MUZAFFARGARH DISTRICT,JATOI TEHSIL,7,20696,5425,26121
MUZAFFARGARH DISTRICT,JATOI TEHSIL,8,21362,5427,26789
MUZAFFARGARH DISTRICT,JATOI TEHSIL,9,18012,4679,22691
MUZAFFARGARH DISTRICT,JATOI TEHSIL,10,18289,4859,23148
MUZAFFARGARH DISTRICT,JATOI TEHSIL,11,13413,3725,17138
MUZAFFARGARH DISTRICT,JATOI TEHSIL,12,15300,4120,19420
MUZAFFARGARH DISTRICT,JATOI TEHSIL,13,11999,3471,15470
MUZAFFARGARH DISTRICT,JATOI TEHSIL,14,12666,3538,16204
MUZAFFARGARH DISTRICT,JATOI TEHSIL,15,11096,3361,14457
MUZAFFARGARH DISTRICT,JATOI TEHSIL,16,11206,3196,14402
MUZAFFARGARH DISTRICT,JATOI TEHSIL,17,10122,3326,13448
MUZAFFARGARH DISTRICT,JATOI TEHSIL,18,12991,3485,16476
MUZAFFARGARH DISTRICT,JATOI TEHSIL,19,10187,3079,13266
MUZAFFARGARH DISTRICT,JATOI TEHSIL,20,11883,3450,15333
MUZAFFARGARH DISTRICT,JATOI TEHSIL,21,8465,2703,11168
MUZAFFARGARH DISTRICT,JATOI TEHSIL,22,9216,2776,11992
MUZAFFARGARH DISTRICT,JATOI TEHSIL,23,7670,2399,10069
MUZAFFARGARH DISTRICT,JATOI TEHSIL,24,7212,2244,9456
MUZAFFARGARH DISTRICT,JATOI TEHSIL,25,9077,2751,11828
MUZAFFARGARH DISTRICT,JATOI TEHSIL,26,6808,2224,9032
MUZAFFARGARH DISTRICT,JATOI TEHSIL,27,6757,2228,8985
MUZAFFARGARH DISTRICT,JATOI TEHSIL,28,7688,2433,10121
MUZAFFARGARH DISTRICT,JATOI TEHSIL,29,7231,2246,9477
MUZAFFARGARH DISTRICT,JATOI TEHSIL,30,8168,2541,10709
MUZAFFARGARH DISTRICT,JATOI TEHSIL,31,6996,2125,9121
MUZAFFARGARH DISTRICT,JATOI TEHSIL,32,6707,2067,8774
MUZAFFARGARH DISTRICT,JATOI TEHSIL,33,6040,1774,7814
MUZAFFARGARH DISTRICT,JATOI TEHSIL,34,6007,1843,7850
MUZAFFARGARH DISTRICT,JATOI TEHSIL,35,7043,2003,9046
MUZAFFARGARH DISTRICT,JATOI TEHSIL,36,6533,1943,8476
MUZAFFARGARH DISTRICT,JATOI TEHSIL,37,6430,1829,8259
MUZAFFARGARH DISTRICT,JATOI TEHSIL,38,5688,1797,7485
MUZAFFARGARH DISTRICT,JATOI TEHSIL,39,5799,1682,7481
MUZAFFARGARH DISTRICT,JATOI TEHSIL,40,5504,1663,7167
MUZAFFARGARH DISTRICT,JATOI TEHSIL,41,4927,1559,6486
MUZAFFARGARH DISTRICT,JATOI TEHSIL,42,4654,1379,6033
MUZAFFARGARH DISTRICT,JATOI TEHSIL,43,3700,1151,4851
MUZAFFARGARH DISTRICT,JATOI TEHSIL,44,3318,1120,4438
MUZAFFARGARH DISTRICT,JATOI TEHSIL,45,3883,1209,5092
MUZAFFARGARH DISTRICT,JATOI TEHSIL,46,3258,1078,4336
MUZAFFARGARH DISTRICT,JATOI TEHSIL,47,3390,1016,4406
MUZAFFARGARH DISTRICT,JATOI TEHSIL,48,3309,1011,4320
MUZAFFARGARH DISTRICT,JATOI TEHSIL,49,3109,1033,4142
MUZAFFARGARH DISTRICT,JATOI TEHSIL,50,3559,1122,4681
MUZAFFARGARH DISTRICT,JATOI TEHSIL,51,3023,965,3988
MUZAFFARGARH DISTRICT,JATOI TEHSIL,52,2816,827,3643
MUZAFFARGARH DISTRICT,JATOI TEHSIL,53,2425,786,3211
MUZAFFARGARH DISTRICT,JATOI TEHSIL,54,2298,754,3052
MUZAFFARGARH DISTRICT,JATOI TEHSIL,55,2464,723,3187
MUZAFFARGARH DISTRICT,JATOI TEHSIL,56,1955,613,2568
MUZAFFARGARH DISTRICT,JATOI TEHSIL,57,1955,515,2470
MUZAFFARGARH DISTRICT,JATOI TEHSIL,58,1668,550,2218
MUZAFFARGARH DISTRICT,JATOI TEHSIL,59,1751,489,2240
MUZAFFARGARH DISTRICT,JATOI TEHSIL,60,2234,681,2915
MUZAFFARGARH DISTRICT,JATOI TEHSIL,61,1834,566,2400
MUZAFFARGARH DISTRICT,JATOI TEHSIL,62,1940,570,2510
MUZAFFARGARH DISTRICT,JATOI TEHSIL,63,1673,549,2222
MUZAFFARGARH DISTRICT,JATOI TEHSIL,64,1621,508,2129
MUZAFFARGARH DISTRICT,JATOI TEHSIL,65,1829,543,2372
MUZAFFARGARH DISTRICT,JATOI TEHSIL,66,1406,415,1821
MUZAFFARGARH DISTRICT,JATOI TEHSIL,67,1432,400,1832
MUZAFFARGARH DISTRICT,JATOI TEHSIL,68,1277,376,1653
MUZAFFARGARH DISTRICT,JATOI TEHSIL,69,1162,298,1460
MUZAFFARGARH DISTRICT,JATOI TEHSIL,70,1460,403,1863
MUZAFFARGARH DISTRICT,JATOI TEHSIL,71,1087,324,1411
MUZAFFARGARH DISTRICT,JATOI TEHSIL,72,1012,319,1331
MUZAFFARGARH DISTRICT,JATOI TEHSIL,73,867,271,1138
MUZAFFARGARH DISTRICT,JATOI TEHSIL,74,733,259,992
MUZAFFARGARH DISTRICT,JATOI TEHSIL,>=75,6004,1748,7752
MUZAFFARGARH DISTRICT,KOT ADDU TEHSIL,<1,32300,6654,38954
MUZAFFARGARH DISTRICT,KOT ADDU TEHSIL,1,33373,7083,40456
MUZAFFARGARH DISTRICT,KOT ADDU TEHSIL,2,35353,6988,42341
MUZAFFARGARH DISTRICT,KOT ADDU TEHSIL,3,37328,7361,44689
MUZAFFARGARH DISTRICT,KOT ADDU TEHSIL,4,38605,7179,45784
MUZAFFARGARH DISTRICT,KOT ADDU TEHSIL,5,36467,7121,43588
MUZAFFARGARH DISTRICT,KOT ADDU TEHSIL,6,35902,6822,42724
MUZAFFARGARH DISTRICT,KOT ADDU TEHSIL,7,37877,7471,45348
MUZAFFARGARH DISTRICT,KOT ADDU TEHSIL,8,37441,6582,44023
MUZAFFARGARH DISTRICT,KOT ADDU TEHSIL,9,36069,7440,43509
MUZAFFARGARH DISTRICT,KOT ADDU TEHSIL,10,33734,6198,39932
MUZAFFARGARH DISTRICT,KOT ADDU TEHSIL,11,30507,7049,37556
MUZAFFARGARH DISTRICT,KOT ADDU TEHSIL,12,28866,5980,34846
MUZAFFARGARH DISTRICT,KOT ADDU TEHSIL,13,26023,6485,32508
MUZAFFARGARH DISTRICT,KOT ADDU TEHSIL,14,25347,5571,30918
MUZAFFARGARH DISTRICT,KOT ADDU TEHSIL,15,22583,5534,28117
MUZAFFARGARH DISTRICT,KOT ADDU TEHSIL,16,22412,5467,27879
MUZAFFARGARH DISTRICT,KOT ADDU TEHSIL,17,20929,5470,26399
MUZAFFARGARH DISTRICT,KOT ADDU TEHSIL,18,22843,5183,28026
MUZAFFARGARH DISTRICT,KOT ADDU TEHSIL,19,20365,5490,25855
MUZAFFARGARH DISTRICT,KOT ADDU TEHSIL,20,20451,4834,25285
MUZAFFARGARH DISTRICT,KOT ADDU TEHSIL,21,17685,5172,22857
MUZAFFARGARH DISTRICT,KOT ADDU TEHSIL,22,16642,4482,21124
MUZAFFARGARH DISTRICT,KOT ADDU TEHSIL,23,15720,4639,20359
MUZAFFARGARH DISTRICT,KOT ADDU TEHSIL,24,15637,4400,20037
MUZAFFARGARH DISTRICT,KOT ADDU TEHSIL,25,16491,3961,20452
MUZAFFARGARH DISTRICT,KOT ADDU TEHSIL,26,15764,4340,20104
MUZAFFARGARH DISTRICT,KOT ADDU TEHSIL,27,16018,4219,20237
MUZAFFARGARH DISTRICT,KOT ADDU TEHSIL,28,15248,3962,19210
MUZAFFARGARH DISTRICT,KOT ADDU TEHSIL,29,16051,3961,20012
MUZAFFARGARH DISTRICT,KOT ADDU TEHSIL,30,13621,3277,16898
MUZAFFARGARH DISTRICT,KOT ADDU TEHSIL,31,15303,3861,19164
MUZAFFARGARH DISTRICT,KOT ADDU TEHSIL,32,13606,3486,17092
MUZAFFARGARH DISTRICT,KOT ADDU TEHSIL,33,12394,3338,15732
MUZAFFARGARH DISTRICT,KOT ADDU TEHSIL,34,12861,3312,16173
MUZAFFARGARH DISTRICT,KOT ADDU TEHSIL,35,11974,2714,14688
MUZAFFARGARH DISTRICT,KOT ADDU TEHSIL,36,14006,3523,17529
MUZAFFARGARH DISTRICT,KOT ADDU TEHSIL,37,13106,2974,16080
MUZAFFARGARH DISTRICT,KOT ADDU TEHSIL,38,10599,3033,13632
MUZAFFARGARH DISTRICT,KOT ADDU TEHSIL,39,11214,2705,13919
MUZAFFARGARH DISTRICT,KOT ADDU TEHSIL,40,8365,2143,10508
MUZAFFARGARH DISTRICT,KOT ADDU TEHSIL,41,9929,2683,12612
MUZAFFARGARH DISTRICT,KOT ADDU TEHSIL,42,8876,2274,11150
MUZAFFARGARH DISTRICT,KOT ADDU TEHSIL,43,7502,2240,9742
MUZAFFARGARH DISTRICT,KOT ADDU TEHSIL,44,7333,2197,9530
MUZAFFARGARH DISTRICT,KOT ADDU TEHSIL,45,6455,1680,8135
MUZAFFARGARH DISTRICT,KOT ADDU TEHSIL,46,7538,2284,9822
MUZAFFARGARH DISTRICT,KOT ADDU TEHSIL,47,7651,1925,9576
MUZAFFARGARH DISTRICT,KOT ADDU TEHSIL,48,7028,2062,9090
MUZAFFARGARH DISTRICT,KOT ADDU TEHSIL,49,7163,1918,9081
MUZAFFARGARH DISTRICT,KOT ADDU TEHSIL,50,6035,1657,7692
MUZAFFARGARH DISTRICT,KOT ADDU TEHSIL,51,6927,2062,8989
MUZAFFARGARH DISTRICT,KOT ADDU TEHSIL,52,6450,1717,8167
MUZAFFARGARH DISTRICT,KOT ADDU TEHSIL,53,5860,1756,7616
MUZAFFARGARH DISTRICT,KOT ADDU TEHSIL,54,5288,1632,6920
MUZAFFARGARH DISTRICT,KOT ADDU TEHSIL,55,4225,1195,5420
MUZAFFARGARH DISTRICT,KOT ADDU TEHSIL,56,4391,1292,5683
MUZAFFARGARH DISTRICT,KOT ADDU TEHSIL,57,4210,1066,5276
MUZAFFARGARH DISTRICT,KOT ADDU TEHSIL,58,3862,1079,4941
MUZAFFARGARH DISTRICT,KOT ADDU TEHSIL,59,3933,1071,5004
MUZAFFARGARH DISTRICT,KOT ADDU TEHSIL,60,3809,895,4704
MUZAFFARGARH DISTRICT,KOT ADDU TEHSIL,61,3865,1025,4890
MUZAFFARGARH DISTRICT,KOT ADDU TEHSIL,62,3750,915,4665
MUZAFFARGARH DISTRICT,KOT ADDU TEHSIL,63,3655,937,4592
MUZAFFARGARH DISTRICT,KOT ADDU TEHSIL,64,3567,897,4464
MUZAFFARGARH DISTRICT,KOT ADDU TEHSIL,65,3078,679,3757
MUZAFFARGARH DISTRICT,KOT ADDU TEHSIL,66,2983,709,3692
MUZAFFARGARH DISTRICT,KOT ADDU TEHSIL,67,2910,634,3544
MUZAFFARGARH DISTRICT,KOT ADDU TEHSIL,68,2598,645,3243
MUZAFFARGARH DISTRICT,KOT ADDU TEHSIL,69,2545,563,3108
MUZAFFARGARH DISTRICT,KOT ADDU TEHSIL,70,2286,453,2739
MUZAFFARGARH DISTRICT,KOT ADDU TEHSIL,71,2351,520,2871
MUZAFFARGARH DISTRICT,KOT ADDU TEHSIL,72,2033,493,2526
MUZAFFARGARH DISTRICT,KOT ADDU TEHSIL,73,1831,445,2276
MUZAFFARGARH DISTRICT,KOT ADDU TEHSIL,74,1599,352,1951
MUZAFFARGARH DISTRICT,KOT ADDU TEHSIL,>=75,12758,2731,15489
MUZAFFARGARH DISTRICT,MUZAFFARGARH TEHSIL,<1,37574,5523,43097
MUZAFFARGARH DISTRICT,MUZAFFARGARH TEHSIL,1,38660,5798,44458
MUZAFFARGARH DISTRICT,MUZAFFARGARH TEHSIL,2,43140,6063,49203
MUZAFFARGARH DISTRICT,MUZAFFARGARH TEHSIL,3,47650,6610,54260
MUZAFFARGARH DISTRICT,MUZAFFARGARH TEHSIL,4,49365,6424,55789
MUZAFFARGARH DISTRICT,MUZAFFARGARH TEHSIL,5,47498,6662,54160
MUZAFFARGARH DISTRICT,MUZAFFARGARH TEHSIL,6,46083,6172,52255
MUZAFFARGARH DISTRICT,MUZAFFARGARH TEHSIL,7,50407,6795,57202
MUZAFFARGARH DISTRICT,MUZAFFARGARH TEHSIL,8,49412,6357,55769
MUZAFFARGARH DISTRICT,MUZAFFARGARH TEHSIL,9,44880,6531,51411
MUZAFFARGARH DISTRICT,MUZAFFARGARH TEHSIL,10,43932,5868,49800
MUZAFFARGARH DISTRICT,MUZAFFARGARH TEHSIL,11,35948,6293,42241
MUZAFFARGARH DISTRICT,MUZAFFARGARH TEHSIL,12,37943,5683,43626
MUZAFFARGARH DISTRICT,MUZAFFARGARH TEHSIL,13,31733,5614,37347
MUZAFFARGARH DISTRICT,MUZAFFARGARH TEHSIL,14,32116,5329,37445
MUZAFFARGARH DISTRICT,MUZAFFARGARH TEHSIL,15,29044,5406,34450
MUZAFFARGARH DISTRICT,MUZAFFARGARH TEHSIL,16,28673,5263,33936
MUZAFFARGARH DISTRICT,MUZAFFARGARH TEHSIL,17,26552,5225,31777
MUZAFFARGARH DISTRICT,MUZAFFARGARH TEHSIL,18,29913,5006,34919
MUZAFFARGARH DISTRICT,MUZAFFARGARH TEHSIL,19,25296,5143,30439
MUZAFFARGARH DISTRICT,MUZAFFARGARH TEHSIL,20,26544,4751,31295
MUZAFFARGARH DISTRICT,MUZAFFARGARH TEHSIL,21,20506,4613,25119
MUZAFFARGARH DISTRICT,MUZAFFARGARH TEHSIL,22,21861,4625,26486
MUZAFFARGARH DISTRICT,MUZAFFARGARH TEHSIL,23,19375,4416,23791
MUZAFFARGARH DISTRICT,MUZAFFARGARH TEHSIL,24,18653,4115,22768
MUZAFFARGARH DISTRICT,MUZAFFARGARH TEHSIL,25,21513,4254,25767
MUZAFFARGARH DISTRICT,MUZAFFARGARH TEHSIL,26,18116,3996,22112
MUZAFFARGARH DISTRICT,MUZAFFARGARH TEHSIL,27,18991,4060,23051
MUZAFFARGARH DISTRICT,MUZAFFARGARH TEHSIL,28,18571,3969,22540
MUZAFFARGARH DISTRICT,MUZAFFARGARH TEHSIL,29,19496,4176,23672
MUZAFFARGARH DISTRICT,MUZAFFARGARH TEHSIL,30,18561,3753,22314
MUZAFFARGARH DISTRICT,MUZAFFARGARH TEHSIL,31,18538,3573,22111
MUZAFFARGARH DISTRICT,MUZAFFARGARH TEHSIL,32,17576,3673,21249
MUZAFFARGARH DISTRICT,MUZAFFARGARH TEHSIL,33,15691,3265,18956
MUZAFFARGARH DISTRICT,MUZAFFARGARH TEHSIL,34,16158,3058,19216
MUZAFFARGARH DISTRICT,MUZAFFARGARH TEHSIL,35,16400,3207,19607
MUZAFFARGARH DISTRICT,MUZAFFARGARH TEHSIL,36,16879,3015,19894
MUZAFFARGARH DISTRICT,MUZAFFARGARH TEHSIL,37,18019,2895,20914
MUZAFFARGARH DISTRICT,MUZAFFARGARH TEHSIL,38,13841,2970,16811
MUZAFFARGARH DISTRICT,MUZAFFARGARH TEHSIL,39,14845,2700,17545
MUZAFFARGARH DISTRICT,MUZAFFARGARH TEHSIL,40,11782,2704,14486
MUZAFFARGARH DISTRICT,MUZAFFARGARH TEHSIL,41,12476,2532,15008
MUZAFFARGARH DISTRICT,MUZAFFARGARH TEHSIL,42,12265,2480,14745
MUZAFFARGARH DISTRICT,MUZAFFARGARH TEHSIL,43,9442,2210,11652
MUZAFFARGARH DISTRICT,MUZAFFARGARH TEHSIL,44,9098,2099,11197
MUZAFFARGARH DISTRICT,MUZAFFARGARH TEHSIL,45,9175,2177,11352
MUZAFFARGARH DISTRICT,MUZAFFARGARH TEHSIL,46,9277,1863,11140
MUZAFFARGARH DISTRICT,MUZAFFARGARH TEHSIL,47,10366,1828,12194
MUZAFFARGARH DISTRICT,MUZAFFARGARH TEHSIL,48,8583,1930,10513
MUZAFFARGARH DISTRICT,MUZAFFARGARH TEHSIL,49,9051,1967,11018
MUZAFFARGARH DISTRICT,MUZAFFARGARH TEHSIL,50,8318,1954,10272
MUZAFFARGARH DISTRICT,MUZAFFARGARH TEHSIL,51,8368,1736,10104
MUZAFFARGARH DISTRICT,MUZAFFARGARH TEHSIL,52,8499,1726,10225
MUZAFFARGARH DISTRICT,MUZAFFARGARH TEHSIL,53,6960,1648,8608
MUZAFFARGARH DISTRICT,MUZAFFARGARH TEHSIL,54,6741,1474,8215
MUZAFFARGARH DISTRICT,MUZAFFARGARH TEHSIL,55,5982,1440,7422
MUZAFFARGARH DISTRICT,MUZAFFARGARH TEHSIL,56,5548,1180,6728
MUZAFFARGARH DISTRICT,MUZAFFARGARH TEHSIL,57,5722,1045,6767
MUZAFFARGARH DISTRICT,MUZAFFARGARH TEHSIL,58,4650,1084,5734
MUZAFFARGARH DISTRICT,MUZAFFARGARH TEHSIL,59,5070,1020,6090
MUZAFFARGARH DISTRICT,MUZAFFARGARH TEHSIL,60,5078,1018,6096
MUZAFFARGARH DISTRICT,MUZAFFARGARH TEHSIL,61,5035,902,5937
MUZAFFARGARH DISTRICT,MUZAFFARGARH TEHSIL,62,5071,976,6047
MUZAFFARGARH DISTRICT,MUZAFFARGARH TEHSIL,63,4541,927,5468
MUZAFFARGARH DISTRICT,MUZAFFARGARH TEHSIL,64,4591,742,5333
MUZAFFARGARH DISTRICT,MUZAFFARGARH TEHSIL,65,4278,706,4984
MUZAFFARGARH DISTRICT,MUZAFFARGARH TEHSIL,66,3532,513,4045
MUZAFFARGARH DISTRICT,MUZAFFARGARH TEHSIL,67,4104,551,4655
MUZAFFARGARH DISTRICT,MUZAFFARGARH TEHSIL,68,3362,527,3889
MUZAFFARGARH DISTRICT,MUZAFFARGARH TEHSIL,69,3188,468,3656
MUZAFFARGARH DISTRICT,MUZAFFARGARH TEHSIL,70,3118,467,3585
MUZAFFARGARH DISTRICT,MUZAFFARGARH TEHSIL,71,2656,395,3051
MUZAFFARGARH DISTRICT,MUZAFFARGARH TEHSIL,72,2729,389,3118
MUZAFFARGARH DISTRICT,MUZAFFARGARH TEHSIL,73,2336,385,2721
MUZAFFARGARH DISTRICT,MUZAFFARGARH TEHSIL,74,2044,290,2334
MUZAFFARGARH DISTRICT,MUZAFFARGARH TEHSIL,>=75,16120,2176,18296
NANKANA SAHIB DISTRICT,NANKANA SAHIB TEHSIL,<1,17619,2371,19990
NANKANA SAHIB DISTRICT,NANKANA SAHIB TEHSIL,1,19880,2575,22455
NANKANA SAHIB DISTRICT,NANKANA SAHIB TEHSIL,2,20905,2551,23456
NANKANA SAHIB DISTRICT,NANKANA SAHIB TEHSIL,3,22415,2739,25154
NANKANA SAHIB DISTRICT,NANKANA SAHIB TEHSIL,4,22201,2712,24913
NANKANA SAHIB DISTRICT,NANKANA SAHIB TEHSIL,5,21585,2760,24345
NANKANA SAHIB DISTRICT,NANKANA SAHIB TEHSIL,6,21558,2712,24270
NANKANA SAHIB DISTRICT,NANKANA SAHIB TEHSIL,7,22439,2975,25414
NANKANA SAHIB DISTRICT,NANKANA SAHIB TEHSIL,8,21918,2613,24531
NANKANA SAHIB DISTRICT,NANKANA SAHIB TEHSIL,9,20382,2859,23241
NANKANA SAHIB DISTRICT,NANKANA SAHIB TEHSIL,10,20326,2471,22797
NANKANA SAHIB DISTRICT,NANKANA SAHIB TEHSIL,11,18351,2804,21155
NANKANA SAHIB DISTRICT,NANKANA SAHIB TEHSIL,12,18251,2287,20538
NANKANA SAHIB DISTRICT,NANKANA SAHIB TEHSIL,13,16404,2623,19027
NANKANA SAHIB DISTRICT,NANKANA SAHIB TEHSIL,14,16939,2318,19257
NANKANA SAHIB DISTRICT,NANKANA SAHIB TEHSIL,15,15973,2270,18243
NANKANA SAHIB DISTRICT,NANKANA SAHIB TEHSIL,16,16777,2334,19111
NANKANA SAHIB DISTRICT,NANKANA SAHIB TEHSIL,17,15550,2508,18058
NANKANA SAHIB DISTRICT,NANKANA SAHIB TEHSIL,18,16139,1985,18124
NANKANA SAHIB DISTRICT,NANKANA SAHIB TEHSIL,19,14888,2372,17260
NANKANA SAHIB DISTRICT,NANKANA SAHIB TEHSIL,20,15898,2015,17913
NANKANA SAHIB DISTRICT,NANKANA SAHIB TEHSIL,21,13517,2293,15810
NANKANA SAHIB DISTRICT,NANKANA SAHIB TEHSIL,22,14536,2060,16596
NANKANA SAHIB DISTRICT,NANKANA SAHIB TEHSIL,23,12515,2013,14528
NANKANA SAHIB DISTRICT,NANKANA SAHIB TEHSIL,24,11986,2039,14025
NANKANA SAHIB DISTRICT,NANKANA SAHIB TEHSIL,25,13617,1699,15316
NANKANA SAHIB DISTRICT,NANKANA SAHIB TEHSIL,26,11596,1900,13496
NANKANA SAHIB DISTRICT,NANKANA SAHIB TEHSIL,27,10740,1816,12556
NANKANA SAHIB DISTRICT,NANKANA SAHIB TEHSIL,28,11932,1829,13761
NANKANA SAHIB DISTRICT,NANKANA SAHIB TEHSIL,29,10561,1759,12320
NANKANA SAHIB DISTRICT,NANKANA SAHIB TEHSIL,30,12971,1676,14647
NANKANA SAHIB DISTRICT,NANKANA SAHIB TEHSIL,31,9849,1598,11447
NANKANA SAHIB DISTRICT,NANKANA SAHIB TEHSIL,32,10541,1639,12180
NANKANA SAHIB DISTRICT,NANKANA SAHIB TEHSIL,33,9443,1594,11037
NANKANA SAHIB DISTRICT,NANKANA SAHIB TEHSIL,34,8835,1470,10305
NANKANA SAHIB DISTRICT,NANKANA SAHIB TEHSIL,35,11298,1508,12806
NANKANA SAHIB DISTRICT,NANKANA SAHIB TEHSIL,36,8667,1379,10046
NANKANA SAHIB DISTRICT,NANKANA SAHIB TEHSIL,37,8821,1453,10274
NANKANA SAHIB DISTRICT,NANKANA SAHIB TEHSIL,38,9057,1562,10619
NANKANA SAHIB DISTRICT,NANKANA SAHIB TEHSIL,39,9322,1430,10752
NANKANA SAHIB DISTRICT,NANKANA SAHIB TEHSIL,40,9588,1345,10933
NANKANA SAHIB DISTRICT,NANKANA SAHIB TEHSIL,41,7850,1233,9083
NANKANA SAHIB DISTRICT,NANKANA SAHIB TEHSIL,42,7576,1201,8777
NANKANA SAHIB DISTRICT,NANKANA SAHIB TEHSIL,43,6536,1160,7696
NANKANA SAHIB DISTRICT,NANKANA SAHIB TEHSIL,44,5874,1005,6879
NANKANA SAHIB DISTRICT,NANKANA SAHIB TEHSIL,45,7407,1025,8432
NANKANA SAHIB DISTRICT,NANKANA SAHIB TEHSIL,46,5355,947,6302
NANKANA SAHIB DISTRICT,NANKANA SAHIB TEHSIL,47,5934,921,6855
NANKANA SAHIB DISTRICT,NANKANA SAHIB TEHSIL,48,5951,962,6913
NANKANA SAHIB DISTRICT,NANKANA SAHIB TEHSIL,49,5985,1023,7008
NANKANA SAHIB DISTRICT,NANKANA SAHIB TEHSIL,50,7235,878,8113
NANKANA SAHIB DISTRICT,NANKANA SAHIB TEHSIL,51,5602,936,6538
NANKANA SAHIB DISTRICT,NANKANA SAHIB TEHSIL,52,5652,874,6526
NANKANA SAHIB DISTRICT,NANKANA SAHIB TEHSIL,53,4796,847,5643
NANKANA SAHIB DISTRICT,NANKANA SAHIB TEHSIL,54,4553,743,5296
NANKANA SAHIB DISTRICT,NANKANA SAHIB TEHSIL,55,5303,699,6002
NANKANA SAHIB DISTRICT,NANKANA SAHIB TEHSIL,56,3881,596,4477
NANKANA SAHIB DISTRICT,NANKANA SAHIB TEHSIL,57,3790,466,4256
NANKANA SAHIB DISTRICT,NANKANA SAHIB TEHSIL,58,3479,536,4015
NANKANA SAHIB DISTRICT,NANKANA SAHIB TEHSIL,59,3417,535,3952
NANKANA SAHIB DISTRICT,NANKANA SAHIB TEHSIL,60,4581,537,5118
NANKANA SAHIB DISTRICT,NANKANA SAHIB TEHSIL,61,3121,501,3622
NANKANA SAHIB DISTRICT,NANKANA SAHIB TEHSIL,62,3426,448,3874
NANKANA SAHIB DISTRICT,NANKANA SAHIB TEHSIL,63,2921,468,3389
NANKANA SAHIB DISTRICT,NANKANA SAHIB TEHSIL,64,2855,357,3212
NANKANA SAHIB DISTRICT,NANKANA SAHIB TEHSIL,65,3450,359,3809
NANKANA SAHIB DISTRICT,NANKANA SAHIB TEHSIL,66,2014,275,2289
NANKANA SAHIB DISTRICT,NANKANA SAHIB TEHSIL,67,2182,249,2431
NANKANA SAHIB DISTRICT,NANKANA SAHIB TEHSIL,68,2127,297,2424
NANKANA SAHIB DISTRICT,NANKANA SAHIB TEHSIL,69,2235,238,2473
NANKANA SAHIB DISTRICT,NANKANA SAHIB TEHSIL,70,3042,314,3356
NANKANA SAHIB DISTRICT,NANKANA SAHIB TEHSIL,71,1815,244,2059
NANKANA SAHIB DISTRICT,NANKANA SAHIB TEHSIL,72,1944,260,2204
NANKANA SAHIB DISTRICT,NANKANA SAHIB TEHSIL,73,1730,203,1933
NANKANA SAHIB DISTRICT,NANKANA SAHIB TEHSIL,74,1689,214,1903
NANKANA SAHIB DISTRICT,NANKANA SAHIB TEHSIL,>=75,12773,1668,14441
NANKANA SAHIB DISTRICT,SANGLA HILL TEHSIL,<1,3873,1357,5230
NANKANA SAHIB DISTRICT,SANGLA HILL TEHSIL,1,4121,1337,5458
NANKANA SAHIB DISTRICT,SANGLA HILL TEHSIL,2,4018,1446,5464
NANKANA SAHIB DISTRICT,SANGLA HILL TEHSIL,3,4161,1487,5648
NANKANA SAHIB DISTRICT,SANGLA HILL TEHSIL,4,4083,1337,5420
NANKANA SAHIB DISTRICT,SANGLA HILL TEHSIL,5,4069,1408,5477
NANKANA SAHIB DISTRICT,SANGLA HILL TEHSIL,6,4143,1367,5510
NANKANA SAHIB DISTRICT,SANGLA HILL TEHSIL,7,4246,1512,5758
NANKANA SAHIB DISTRICT,SANGLA HILL TEHSIL,8,3931,1347,5278
NANKANA SAHIB DISTRICT,SANGLA HILL TEHSIL,9,4236,1512,5748
NANKANA SAHIB DISTRICT,SANGLA HILL TEHSIL,10,3833,1280,5113
NANKANA SAHIB DISTRICT,SANGLA HILL TEHSIL,11,4127,1448,5575
NANKANA SAHIB DISTRICT,SANGLA HILL TEHSIL,12,3614,1257,4871
NANKANA SAHIB DISTRICT,SANGLA HILL TEHSIL,13,3786,1362,5148
NANKANA SAHIB DISTRICT,SANGLA HILL TEHSIL,14,3592,1296,4888
NANKANA SAHIB DISTRICT,SANGLA HILL TEHSIL,15,3485,1313,4798
NANKANA SAHIB DISTRICT,SANGLA HILL TEHSIL,16,3697,1326,5023
NANKANA SAHIB DISTRICT,SANGLA HILL TEHSIL,17,3631,1352,4983
NANKANA SAHIB DISTRICT,SANGLA HILL TEHSIL,18,3234,1160,4394
NANKANA SAHIB DISTRICT,SANGLA HILL TEHSIL,19,3632,1324,4956
NANKANA SAHIB DISTRICT,SANGLA HILL TEHSIL,20,3251,1186,4437
NANKANA SAHIB DISTRICT,SANGLA HILL TEHSIL,21,3394,1357,4751
NANKANA SAHIB DISTRICT,SANGLA HILL TEHSIL,22,3202,1285,4487
NANKANA SAHIB DISTRICT,SANGLA HILL TEHSIL,23,3004,1279,4283
NANKANA SAHIB DISTRICT,SANGLA HILL TEHSIL,24,2943,1101,4044
NANKANA SAHIB DISTRICT,SANGLA HILL TEHSIL,25,2648,1067,3715
NANKANA SAHIB DISTRICT,SANGLA HILL TEHSIL,26,2763,1128,3891
NANKANA SAHIB DISTRICT,SANGLA HILL TEHSIL,27,2559,1148,3707
NANKANA SAHIB DISTRICT,SANGLA HILL TEHSIL,28,2472,1039,3511
NANKANA SAHIB DISTRICT,SANGLA HILL TEHSIL,29,2413,993,3406
NANKANA SAHIB DISTRICT,SANGLA HILL TEHSIL,30,2579,1006,3585
NANKANA SAHIB DISTRICT,SANGLA HILL TEHSIL,31,2205,913,3118
NANKANA SAHIB DISTRICT,SANGLA HILL TEHSIL,32,2399,1002,3401
NANKANA SAHIB DISTRICT,SANGLA HILL TEHSIL,33,2024,914,2938
NANKANA SAHIB DISTRICT,SANGLA HILL TEHSIL,34,2027,778,2805
NANKANA SAHIB DISTRICT,SANGLA HILL TEHSIL,35,2090,887,2977
NANKANA SAHIB DISTRICT,SANGLA HILL TEHSIL,36,1921,754,2675
NANKANA SAHIB DISTRICT,SANGLA HILL TEHSIL,37,1893,760,2653
NANKANA SAHIB DISTRICT,SANGLA HILL TEHSIL,38,2029,768,2797
NANKANA SAHIB DISTRICT,SANGLA HILL TEHSIL,39,1951,675,2626
NANKANA SAHIB DISTRICT,SANGLA HILL TEHSIL,40,1924,796,2720
NANKANA SAHIB DISTRICT,SANGLA HILL TEHSIL,41,1699,644,2343
NANKANA SAHIB DISTRICT,SANGLA HILL TEHSIL,42,1631,721,2352
NANKANA SAHIB DISTRICT,SANGLA HILL TEHSIL,43,1524,611,2135
NANKANA SAHIB DISTRICT,SANGLA HILL TEHSIL,44,1390,564,1954
NANKANA SAHIB DISTRICT,SANGLA HILL TEHSIL,45,1435,626,2061
NANKANA SAHIB DISTRICT,SANGLA HILL TEHSIL,46,1347,492,1839
NANKANA SAHIB DISTRICT,SANGLA HILL TEHSIL,47,1335,497,1832
NANKANA SAHIB DISTRICT,SANGLA HILL TEHSIL,48,1460,545,2005
NANKANA SAHIB DISTRICT,SANGLA HILL TEHSIL,49,1449,518,1967
NANKANA SAHIB DISTRICT,SANGLA HILL TEHSIL,50,1464,581,2045
NANKANA SAHIB DISTRICT,SANGLA HILL TEHSIL,51,1311,472,1783
NANKANA SAHIB DISTRICT,SANGLA HILL TEHSIL,52,1360,537,1897
NANKANA SAHIB DISTRICT,SANGLA HILL TEHSIL,53,1301,538,1839
NANKANA SAHIB DISTRICT,SANGLA HILL TEHSIL,54,1217,492,1709
NANKANA SAHIB DISTRICT,SANGLA HILL TEHSIL,55,1104,484,1588
NANKANA SAHIB DISTRICT,SANGLA HILL TEHSIL,56,937,345,1282
NANKANA SAHIB DISTRICT,SANGLA HILL TEHSIL,57,919,301,1220
NANKANA SAHIB DISTRICT,SANGLA HILL TEHSIL,58,874,298,1172
NANKANA SAHIB DISTRICT,SANGLA HILL TEHSIL,59,822,310,1132
NANKANA SAHIB DISTRICT,SANGLA HILL TEHSIL,60,882,361,1243
NANKANA SAHIB DISTRICT,SANGLA HILL TEHSIL,61,805,261,1066
NANKANA SAHIB DISTRICT,SANGLA HILL TEHSIL,62,814,274,1088
NANKANA SAHIB DISTRICT,SANGLA HILL TEHSIL,63,739,294,1033
NANKANA SAHIB DISTRICT,SANGLA HILL TEHSIL,64,669,200,869
NANKANA SAHIB DISTRICT,SANGLA HILL TEHSIL,65,718,248,966
NANKANA SAHIB DISTRICT,SANGLA HILL TEHSIL,66,474,172,646
NANKANA SAHIB DISTRICT,SANGLA HILL TEHSIL,67,523,146,669
NANKANA SAHIB DISTRICT,SANGLA HILL TEHSIL,68,512,141,653
NANKANA SAHIB DISTRICT,SANGLA HILL TEHSIL,69,518,140,658
NANKANA SAHIB DISTRICT,SANGLA HILL TEHSIL,70,616,156,772
NANKANA SAHIB DISTRICT,SANGLA HILL TEHSIL,71,481,156,637
NANKANA SAHIB DISTRICT,SANGLA HILL TEHSIL,72,501,121,622
NANKANA SAHIB DISTRICT,SANGLA HILL TEHSIL,73,385,112,497
NANKANA SAHIB DISTRICT,SANGLA HILL TEHSIL,74,408,87,495
NANKANA SAHIB DISTRICT,SANGLA HILL TEHSIL,>=75,3279,989,4268
NANKANA SAHIB DISTRICT,SHAH KOT TEHSIL,<1,3934,1669,5603
NANKANA SAHIB DISTRICT,SHAH KOT TEHSIL,1,4055,1921,5976
NANKANA SAHIB DISTRICT,SHAH KOT TEHSIL,2,4079,1737,5816
NANKANA SAHIB DISTRICT,SHAH KOT TEHSIL,3,4385,1990,6375
NANKANA SAHIB DISTRICT,SHAH KOT TEHSIL,4,4251,1868,6119
NANKANA SAHIB DISTRICT,SHAH KOT TEHSIL,5,4188,1956,6144
NANKANA SAHIB DISTRICT,SHAH KOT TEHSIL,6,4183,1846,6029
NANKANA SAHIB DISTRICT,SHAH KOT TEHSIL,7,4500,1996,6496
NANKANA SAHIB DISTRICT,SHAH KOT TEHSIL,8,3916,1759,5675
NANKANA SAHIB DISTRICT,SHAH KOT TEHSIL,9,4479,1914,6393
NANKANA SAHIB DISTRICT,SHAH KOT TEHSIL,10,3610,1604,5214
NANKANA SAHIB DISTRICT,SHAH KOT TEHSIL,11,4162,1850,6012
NANKANA SAHIB DISTRICT,SHAH KOT TEHSIL,12,3406,1487,4893
NANKANA SAHIB DISTRICT,SHAH KOT TEHSIL,13,3916,1611,5527
NANKANA SAHIB DISTRICT,SHAH KOT TEHSIL,14,3581,1476,5057
NANKANA SAHIB DISTRICT,SHAH KOT TEHSIL,15,3602,1538,5140
NANKANA SAHIB DISTRICT,SHAH KOT TEHSIL,16,3671,1512,5183
NANKANA SAHIB DISTRICT,SHAH KOT TEHSIL,17,3746,1621,5367
NANKANA SAHIB DISTRICT,SHAH KOT TEHSIL,18,3074,1333,4407
NANKANA SAHIB DISTRICT,SHAH KOT TEHSIL,19,3709,1620,5329
NANKANA SAHIB DISTRICT,SHAH KOT TEHSIL,20,3199,1390,4589
NANKANA SAHIB DISTRICT,SHAH KOT TEHSIL,21,3617,1600,5217
NANKANA SAHIB DISTRICT,SHAH KOT TEHSIL,22,3268,1384,4652
NANKANA SAHIB DISTRICT,SHAH KOT TEHSIL,23,3248,1405,4653
NANKANA SAHIB DISTRICT,SHAH KOT TEHSIL,24,2962,1321,4283
NANKANA SAHIB DISTRICT,SHAH KOT TEHSIL,25,2695,1174,3869
NANKANA SAHIB DISTRICT,SHAH KOT TEHSIL,26,2673,1297,3970
NANKANA SAHIB DISTRICT,SHAH KOT TEHSIL,27,2652,1357,4009
NANKANA SAHIB DISTRICT,SHAH KOT TEHSIL,28,2619,1148,3767
NANKANA SAHIB DISTRICT,SHAH KOT TEHSIL,29,2638,1334,3972
NANKANA SAHIB DISTRICT,SHAH KOT TEHSIL,30,2487,1111,3598
NANKANA SAHIB DISTRICT,SHAH KOT TEHSIL,31,2401,1094,3495
NANKANA SAHIB DISTRICT,SHAH KOT TEHSIL,32,2496,1093,3589
NANKANA SAHIB DISTRICT,SHAH KOT TEHSIL,33,2226,1019,3245
NANKANA SAHIB DISTRICT,SHAH KOT TEHSIL,34,2083,934,3017
NANKANA SAHIB DISTRICT,SHAH KOT TEHSIL,35,2092,820,2912
NANKANA SAHIB DISTRICT,SHAH KOT TEHSIL,36,2026,926,2952
NANKANA SAHIB DISTRICT,SHAH KOT TEHSIL,37,2256,993,3249
NANKANA SAHIB DISTRICT,SHAH KOT TEHSIL,38,1987,906,2893
NANKANA SAHIB DISTRICT,SHAH KOT TEHSIL,39,2183,930,3113
NANKANA SAHIB DISTRICT,SHAH KOT TEHSIL,40,1919,789,2708
NANKANA SAHIB DISTRICT,SHAH KOT TEHSIL,41,1822,819,2641
NANKANA SAHIB DISTRICT,SHAH KOT TEHSIL,42,1786,817,2603
NANKANA SAHIB DISTRICT,SHAH KOT TEHSIL,43,1634,697,2331
NANKANA SAHIB DISTRICT,SHAH KOT TEHSIL,44,1527,682,2209
NANKANA SAHIB DISTRICT,SHAH KOT TEHSIL,45,1421,594,2015
NANKANA SAHIB DISTRICT,SHAH KOT TEHSIL,46,1307,584,1891
NANKANA SAHIB DISTRICT,SHAH KOT TEHSIL,47,1509,722,2231
NANKANA SAHIB DISTRICT,SHAH KOT TEHSIL,48,1351,596,1947
NANKANA SAHIB DISTRICT,SHAH KOT TEHSIL,49,1476,667,2143
NANKANA SAHIB DISTRICT,SHAH KOT TEHSIL,50,1379,567,1946
NANKANA SAHIB DISTRICT,SHAH KOT TEHSIL,51,1339,713,2052
NANKANA SAHIB DISTRICT,SHAH KOT TEHSIL,52,1426,597,2023
NANKANA SAHIB DISTRICT,SHAH KOT TEHSIL,53,1306,543,1849
NANKANA SAHIB DISTRICT,SHAH KOT TEHSIL,54,1195,492,1687
NANKANA SAHIB DISTRICT,SHAH KOT TEHSIL,55,1051,471,1522
NANKANA SAHIB DISTRICT,SHAH KOT TEHSIL,56,931,412,1343
NANKANA SAHIB DISTRICT,SHAH KOT TEHSIL,57,951,405,1356
NANKANA SAHIB DISTRICT,SHAH KOT TEHSIL,58,861,380,1241
NANKANA SAHIB DISTRICT,SHAH KOT TEHSIL,59,964,376,1340
NANKANA SAHIB DISTRICT,SHAH KOT TEHSIL,60,866,304,1170
NANKANA SAHIB DISTRICT,SHAH KOT TEHSIL,61,791,366,1157
NANKANA SAHIB DISTRICT,SHAH KOT TEHSIL,62,813,310,1123
NANKANA SAHIB DISTRICT,SHAH KOT TEHSIL,63,787,269,1056
NANKANA SAHIB DISTRICT,SHAH KOT TEHSIL,64,677,234,911
NANKANA SAHIB DISTRICT,SHAH KOT TEHSIL,65,689,207,896
NANKANA SAHIB DISTRICT,SHAH KOT TEHSIL,66,478,200,678
NANKANA SAHIB DISTRICT,SHAH KOT TEHSIL,67,501,179,680
NANKANA SAHIB DISTRICT,SHAH KOT TEHSIL,68,515,188,703
NANKANA SAHIB DISTRICT,SHAH KOT TEHSIL,69,535,165,700
NANKANA SAHIB DISTRICT,SHAH KOT TEHSIL,70,644,175,819
NANKANA SAHIB DISTRICT,SHAH KOT TEHSIL,71,487,173,660
NANKANA SAHIB DISTRICT,SHAH KOT TEHSIL,72,573,126,699
NANKANA SAHIB DISTRICT,SHAH KOT TEHSIL,73,471,153,624
NANKANA SAHIB DISTRICT,SHAH KOT TEHSIL,74,413,86,499
NANKANA SAHIB DISTRICT,SHAH KOT TEHSIL,>=75,3235,889,4124
NAROWAL DISTRICT,NAROWAL TEHSIL,<1,12673,3444,16117
NAROWAL DISTRICT,NAROWAL TEHSIL,1,13057,3168,16225
NAROWAL DISTRICT,NAROWAL TEHSIL,2,12405,3135,15540
NAROWAL DISTRICT,NAROWAL TEHSIL,3,12959,3415,16374
NAROWAL DISTRICT,NAROWAL TEHSIL,4,12820,3202,16022
NAROWAL DISTRICT,NAROWAL TEHSIL,5,12788,3246,16034
NAROWAL DISTRICT,NAROWAL TEHSIL,6,12908,3302,16210
NAROWAL DISTRICT,NAROWAL TEHSIL,7,13065,3613,16678
NAROWAL DISTRICT,NAROWAL TEHSIL,8,12174,3215,15389
NAROWAL DISTRICT,NAROWAL TEHSIL,9,12537,3479,16016
NAROWAL DISTRICT,NAROWAL TEHSIL,10,11311,3137,14448
NAROWAL DISTRICT,NAROWAL TEHSIL,11,12632,3508,16140
NAROWAL DISTRICT,NAROWAL TEHSIL,12,10901,3053,13954
NAROWAL DISTRICT,NAROWAL TEHSIL,13,11573,3217,14790
NAROWAL DISTRICT,NAROWAL TEHSIL,14,10920,3085,14005
NAROWAL DISTRICT,NAROWAL TEHSIL,15,10554,3047,13601
NAROWAL DISTRICT,NAROWAL TEHSIL,16,10772,3193,13965
NAROWAL DISTRICT,NAROWAL TEHSIL,17,10495,3108,13603
NAROWAL DISTRICT,NAROWAL TEHSIL,18,9510,2753,12263
NAROWAL DISTRICT,NAROWAL TEHSIL,19,10059,2953,13012
NAROWAL DISTRICT,NAROWAL TEHSIL,20,8809,2585,11394
NAROWAL DISTRICT,NAROWAL TEHSIL,21,9506,2938,12444
NAROWAL DISTRICT,NAROWAL TEHSIL,22,8493,2679,11172
NAROWAL DISTRICT,NAROWAL TEHSIL,23,8047,2539,10586
NAROWAL DISTRICT,NAROWAL TEHSIL,24,7880,2526,10406
NAROWAL DISTRICT,NAROWAL TEHSIL,25,6604,2085,8689
NAROWAL DISTRICT,NAROWAL TEHSIL,26,7367,2456,9823
NAROWAL DISTRICT,NAROWAL TEHSIL,27,6173,2020,8193
NAROWAL DISTRICT,NAROWAL TEHSIL,28,6664,2167,8831
NAROWAL DISTRICT,NAROWAL TEHSIL,29,5874,1916,7790
NAROWAL DISTRICT,NAROWAL TEHSIL,30,6356,2028,8384
NAROWAL DISTRICT,NAROWAL TEHSIL,31,6109,1870,7979
NAROWAL DISTRICT,NAROWAL TEHSIL,32,5834,1976,7810
NAROWAL DISTRICT,NAROWAL TEHSIL,33,5547,1806,7353
NAROWAL DISTRICT,NAROWAL TEHSIL,34,5434,1742,7176
NAROWAL DISTRICT,NAROWAL TEHSIL,35,4993,1667,6660
NAROWAL DISTRICT,NAROWAL TEHSIL,36,5506,1757,7263
NAROWAL DISTRICT,NAROWAL TEHSIL,37,4722,1371,6093
NAROWAL DISTRICT,NAROWAL TEHSIL,38,5161,1781,6942
NAROWAL DISTRICT,NAROWAL TEHSIL,39,4718,1517,6235
NAROWAL DISTRICT,NAROWAL TEHSIL,40,4502,1650,6152
NAROWAL DISTRICT,NAROWAL TEHSIL,41,4518,1468,5986
NAROWAL DISTRICT,NAROWAL TEHSIL,42,3941,1458,5399
NAROWAL DISTRICT,NAROWAL TEHSIL,43,3757,1420,5177
NAROWAL DISTRICT,NAROWAL TEHSIL,44,3789,1258,5047
NAROWAL DISTRICT,NAROWAL TEHSIL,45,3412,1308,4720
NAROWAL DISTRICT,NAROWAL TEHSIL,46,3716,1223,4939
NAROWAL DISTRICT,NAROWAL TEHSIL,47,3123,992,4115
NAROWAL DISTRICT,NAROWAL TEHSIL,48,3494,1246,4740
NAROWAL DISTRICT,NAROWAL TEHSIL,49,3235,1086,4321
NAROWAL DISTRICT,NAROWAL TEHSIL,50,3179,1159,4338
NAROWAL DISTRICT,NAROWAL TEHSIL,51,3559,1059,4618
NAROWAL DISTRICT,NAROWAL TEHSIL,52,3118,1009,4127
NAROWAL DISTRICT,NAROWAL TEHSIL,53,2918,1071,3989
NAROWAL DISTRICT,NAROWAL TEHSIL,54,2651,955,3606
NAROWAL DISTRICT,NAROWAL TEHSIL,55,2182,832,3014
NAROWAL DISTRICT,NAROWAL TEHSIL,56,2424,805,3229
NAROWAL DISTRICT,NAROWAL TEHSIL,57,1907,500,2407
NAROWAL DISTRICT,NAROWAL TEHSIL,58,2150,665,2815
NAROWAL DISTRICT,NAROWAL TEHSIL,59,1940,589,2529
NAROWAL DISTRICT,NAROWAL TEHSIL,60,2113,664,2777
NAROWAL DISTRICT,NAROWAL TEHSIL,61,1996,593,2589
NAROWAL DISTRICT,NAROWAL TEHSIL,62,1773,585,2358
NAROWAL DISTRICT,NAROWAL TEHSIL,63,1884,574,2458
NAROWAL DISTRICT,NAROWAL TEHSIL,64,1751,480,2231
NAROWAL DISTRICT,NAROWAL TEHSIL,65,1702,469,2171
NAROWAL DISTRICT,NAROWAL TEHSIL,66,1551,383,1934
NAROWAL DISTRICT,NAROWAL TEHSIL,67,1194,280,1474
NAROWAL DISTRICT,NAROWAL TEHSIL,68,1392,395,1787
NAROWAL DISTRICT,NAROWAL TEHSIL,69,1287,322,1609
NAROWAL DISTRICT,NAROWAL TEHSIL,70,1623,390,2013
NAROWAL DISTRICT,NAROWAL TEHSIL,71,1283,325,1608
NAROWAL DISTRICT,NAROWAL TEHSIL,72,1271,319,1590
NAROWAL DISTRICT,NAROWAL TEHSIL,73,1193,280,1473
NAROWAL DISTRICT,NAROWAL TEHSIL,74,1111,239,1350
NAROWAL DISTRICT,NAROWAL TEHSIL,>=75,8295,1945,10240
NAROWAL DISTRICT,SHAKARGARH TEHSIL,<1,16414,1727,18141
NAROWAL DISTRICT,SHAKARGARH TEHSIL,1,16437,1807,18244
NAROWAL DISTRICT,SHAKARGARH TEHSIL,2,15638,1819,17457
NAROWAL DISTRICT,SHAKARGARH TEHSIL,3,16364,2039,18403
NAROWAL DISTRICT,SHAKARGARH TEHSIL,4,16022,2015,18037
NAROWAL DISTRICT,SHAKARGARH TEHSIL,5,16314,1973,18287
NAROWAL DISTRICT,SHAKARGARH TEHSIL,6,15881,1999,17880
NAROWAL DISTRICT,SHAKARGARH TEHSIL,7,16560,2111,18671
NAROWAL DISTRICT,SHAKARGARH TEHSIL,8,15206,2054,17260
NAROWAL DISTRICT,SHAKARGARH TEHSIL,9,15974,2249,18223
NAROWAL DISTRICT,SHAKARGARH TEHSIL,10,14170,1970,16140
NAROWAL DISTRICT,SHAKARGARH TEHSIL,11,15996,2334,18330
NAROWAL DISTRICT,SHAKARGARH TEHSIL,12,13945,2074,16019
NAROWAL DISTRICT,SHAKARGARH TEHSIL,13,14825,2284,17109
NAROWAL DISTRICT,SHAKARGARH TEHSIL,14,13801,2115,15916
NAROWAL DISTRICT,SHAKARGARH TEHSIL,15,13864,2027,15891
NAROWAL DISTRICT,SHAKARGARH TEHSIL,16,13898,2111,16009
NAROWAL DISTRICT,SHAKARGARH TEHSIL,17,13769,2136,15905
NAROWAL DISTRICT,SHAKARGARH TEHSIL,18,12529,1739,14268
NAROWAL DISTRICT,SHAKARGARH TEHSIL,19,13026,1803,14829
NAROWAL DISTRICT,SHAKARGARH TEHSIL,20,11095,1435,12530
NAROWAL DISTRICT,SHAKARGARH TEHSIL,21,11917,1655,13572
NAROWAL DISTRICT,SHAKARGARH TEHSIL,22,10660,1442,12102
NAROWAL DISTRICT,SHAKARGARH TEHSIL,23,10338,1479,11817
NAROWAL DISTRICT,SHAKARGARH TEHSIL,24,9551,1394,10945
NAROWAL DISTRICT,SHAKARGARH TEHSIL,25,8800,1195,9995
NAROWAL DISTRICT,SHAKARGARH TEHSIL,26,8780,1311,10091
NAROWAL DISTRICT,SHAKARGARH TEHSIL,27,7703,1200,8903
NAROWAL DISTRICT,SHAKARGARH TEHSIL,28,8186,1202,9388
NAROWAL DISTRICT,SHAKARGARH TEHSIL,29,7085,1042,8127
NAROWAL DISTRICT,SHAKARGARH TEHSIL,30,8154,1178,9332
NAROWAL DISTRICT,SHAKARGARH TEHSIL,31,6782,1028,7810
NAROWAL DISTRICT,SHAKARGARH TEHSIL,32,7244,1125,8369
NAROWAL DISTRICT,SHAKARGARH TEHSIL,33,6721,977,7698
NAROWAL DISTRICT,SHAKARGARH TEHSIL,34,6412,910,7322
NAROWAL DISTRICT,SHAKARGARH TEHSIL,35,6733,1097,7830
NAROWAL DISTRICT,SHAKARGARH TEHSIL,36,6167,913,7080
NAROWAL DISTRICT,SHAKARGARH TEHSIL,37,5264,768,6032
NAROWAL DISTRICT,SHAKARGARH TEHSIL,38,6273,1057,7330
NAROWAL DISTRICT,SHAKARGARH TEHSIL,39,5510,820,6330
NAROWAL DISTRICT,SHAKARGARH TEHSIL,40,5934,999,6933
NAROWAL DISTRICT,SHAKARGARH TEHSIL,41,5099,790,5889
NAROWAL DISTRICT,SHAKARGARH TEHSIL,42,4618,725,5343
NAROWAL DISTRICT,SHAKARGARH TEHSIL,43,4667,767,5434
NAROWAL DISTRICT,SHAKARGARH TEHSIL,44,4594,687,5281
NAROWAL DISTRICT,SHAKARGARH TEHSIL,45,4707,817,5524
NAROWAL DISTRICT,SHAKARGARH TEHSIL,46,4459,646,5105
NAROWAL DISTRICT,SHAKARGARH TEHSIL,47,4016,637,4653
NAROWAL DISTRICT,SHAKARGARH TEHSIL,48,4674,780,5454
NAROWAL DISTRICT,SHAKARGARH TEHSIL,49,4458,698,5156
NAROWAL DISTRICT,SHAKARGARH TEHSIL,50,4730,854,5584
NAROWAL DISTRICT,SHAKARGARH TEHSIL,51,4331,641,4972
NAROWAL DISTRICT,SHAKARGARH TEHSIL,52,4138,602,4740
NAROWAL DISTRICT,SHAKARGARH TEHSIL,53,4125,570,4695
NAROWAL DISTRICT,SHAKARGARH TEHSIL,54,3757,571,4328
NAROWAL DISTRICT,SHAKARGARH TEHSIL,55,3710,645,4355
NAROWAL DISTRICT,SHAKARGARH TEHSIL,56,3341,416,3757
NAROWAL DISTRICT,SHAKARGARH TEHSIL,57,2804,326,3130
NAROWAL DISTRICT,SHAKARGARH TEHSIL,58,3087,420,3507
NAROWAL DISTRICT,SHAKARGARH TEHSIL,59,2788,370,3158
NAROWAL DISTRICT,SHAKARGARH TEHSIL,60,3093,445,3538
NAROWAL DISTRICT,SHAKARGARH TEHSIL,61,2768,345,3113
NAROWAL DISTRICT,SHAKARGARH TEHSIL,62,2695,298,2993
NAROWAL DISTRICT,SHAKARGARH TEHSIL,63,2621,347,2968
NAROWAL DISTRICT,SHAKARGARH TEHSIL,64,2418,304,2722
NAROWAL DISTRICT,SHAKARGARH TEHSIL,65,2683,322,3005
NAROWAL DISTRICT,SHAKARGARH TEHSIL,66,2248,224,2472
NAROWAL DISTRICT,SHAKARGARH TEHSIL,67,1726,177,1903
NAROWAL DISTRICT,SHAKARGARH TEHSIL,68,2206,244,2450
NAROWAL DISTRICT,SHAKARGARH TEHSIL,69,2080,187,2267
NAROWAL DISTRICT,SHAKARGARH TEHSIL,70,2335,266,2601
NAROWAL DISTRICT,SHAKARGARH TEHSIL,71,1961,183,2144
NAROWAL DISTRICT,SHAKARGARH TEHSIL,72,1786,188,1974
NAROWAL DISTRICT,SHAKARGARH TEHSIL,73,1668,162,1830
NAROWAL DISTRICT,SHAKARGARH TEHSIL,74,1574,156,1730
NAROWAL DISTRICT,SHAKARGARH TEHSIL,>=75,12480,1220,13700
NAROWAL DISTRICT,ZAFARWAL TEHSIL,<1,11012,957,11969
NAROWAL DISTRICT,ZAFARWAL TEHSIL,1,11070,990,12060
NAROWAL DISTRICT,ZAFARWAL TEHSIL,2,10559,1010,11569
NAROWAL DISTRICT,ZAFARWAL TEHSIL,3,11359,1054,12413
NAROWAL DISTRICT,ZAFARWAL TEHSIL,4,11415,1038,12453
NAROWAL DISTRICT,ZAFARWAL TEHSIL,5,11073,1072,12145
NAROWAL DISTRICT,ZAFARWAL TEHSIL,6,10956,1047,12003
NAROWAL DISTRICT,ZAFARWAL TEHSIL,7,11399,1122,12521
NAROWAL DISTRICT,ZAFARWAL TEHSIL,8,10490,1000,11490
NAROWAL DISTRICT,ZAFARWAL TEHSIL,9,10916,1129,12045
NAROWAL DISTRICT,ZAFARWAL TEHSIL,10,10143,970,11113
NAROWAL DISTRICT,ZAFARWAL TEHSIL,11,10944,1139,12083
NAROWAL DISTRICT,ZAFARWAL TEHSIL,12,9613,912,10525
NAROWAL DISTRICT,ZAFARWAL TEHSIL,13,10096,1099,11195
NAROWAL DISTRICT,ZAFARWAL TEHSIL,14,9678,974,10652
NAROWAL DISTRICT,ZAFARWAL TEHSIL,15,9296,989,10285
NAROWAL DISTRICT,ZAFARWAL TEHSIL,16,9724,967,10691
NAROWAL DISTRICT,ZAFARWAL TEHSIL,17,8986,1017,10003
NAROWAL DISTRICT,ZAFARWAL TEHSIL,18,8134,751,8885
NAROWAL DISTRICT,ZAFARWAL TEHSIL,19,8658,903,9561
NAROWAL DISTRICT,ZAFARWAL TEHSIL,20,7792,680,8472
NAROWAL DISTRICT,ZAFARWAL TEHSIL,21,7962,818,8780
NAROWAL DISTRICT,ZAFARWAL TEHSIL,22,7502,680,8182
NAROWAL DISTRICT,ZAFARWAL TEHSIL,23,6946,711,7657
NAROWAL DISTRICT,ZAFARWAL TEHSIL,24,6458,669,7127
NAROWAL DISTRICT,ZAFARWAL TEHSIL,25,5840,538,6378
NAROWAL DISTRICT,ZAFARWAL TEHSIL,26,5907,606,6513
NAROWAL DISTRICT,ZAFARWAL TEHSIL,27,5232,555,5787
NAROWAL DISTRICT,ZAFARWAL TEHSIL,28,5596,539,6135
NAROWAL DISTRICT,ZAFARWAL TEHSIL,29,4927,542,5469
NAROWAL DISTRICT,ZAFARWAL TEHSIL,30,5357,533,5890
NAROWAL DISTRICT,ZAFARWAL TEHSIL,31,4811,473,5284
NAROWAL DISTRICT,ZAFARWAL TEHSIL,32,4877,506,5383
NAROWAL DISTRICT,ZAFARWAL TEHSIL,33,4661,493,5154
NAROWAL DISTRICT,ZAFARWAL TEHSIL,34,4457,429,4886
NAROWAL DISTRICT,ZAFARWAL TEHSIL,35,4288,441,4729
NAROWAL DISTRICT,ZAFARWAL TEHSIL,36,4354,451,4805
NAROWAL DISTRICT,ZAFARWAL TEHSIL,37,3710,432,4142
NAROWAL DISTRICT,ZAFARWAL TEHSIL,38,4071,485,4556
NAROWAL DISTRICT,ZAFARWAL TEHSIL,39,3886,425,4311
NAROWAL DISTRICT,ZAFARWAL TEHSIL,40,3799,456,4255
NAROWAL DISTRICT,ZAFARWAL TEHSIL,41,3703,379,4082
NAROWAL DISTRICT,ZAFARWAL TEHSIL,42,3467,389,3856
NAROWAL DISTRICT,ZAFARWAL TEHSIL,43,3078,369,3447
NAROWAL DISTRICT,ZAFARWAL TEHSIL,44,3085,351,3436
NAROWAL DISTRICT,ZAFARWAL TEHSIL,45,2907,386,3293
NAROWAL DISTRICT,ZAFARWAL TEHSIL,46,3070,331,3401
NAROWAL DISTRICT,ZAFARWAL TEHSIL,47,2798,277,3075
NAROWAL DISTRICT,ZAFARWAL TEHSIL,48,3075,318,3393
NAROWAL DISTRICT,ZAFARWAL TEHSIL,49,2924,273,3197
NAROWAL DISTRICT,ZAFARWAL TEHSIL,50,2938,351,3289
NAROWAL DISTRICT,ZAFARWAL TEHSIL,51,3014,302,3316
NAROWAL DISTRICT,ZAFARWAL TEHSIL,52,3092,306,3398
NAROWAL DISTRICT,ZAFARWAL TEHSIL,53,2689,276,2965
NAROWAL DISTRICT,ZAFARWAL TEHSIL,54,2534,284,2818
NAROWAL DISTRICT,ZAFARWAL TEHSIL,55,2348,263,2611
NAROWAL DISTRICT,ZAFARWAL TEHSIL,56,2311,196,2507
NAROWAL DISTRICT,ZAFARWAL TEHSIL,57,1920,168,2088
NAROWAL DISTRICT,ZAFARWAL TEHSIL,58,2041,170,2211
NAROWAL DISTRICT,ZAFARWAL TEHSIL,59,1814,185,1999
NAROWAL DISTRICT,ZAFARWAL TEHSIL,60,1823,170,1993
NAROWAL DISTRICT,ZAFARWAL TEHSIL,61,1753,125,1878
NAROWAL DISTRICT,ZAFARWAL TEHSIL,62,1726,131,1857
NAROWAL DISTRICT,ZAFARWAL TEHSIL,63,1616,150,1766
NAROWAL DISTRICT,ZAFARWAL TEHSIL,64,1499,132,1631
NAROWAL DISTRICT,ZAFARWAL TEHSIL,65,1641,138,1779
NAROWAL DISTRICT,ZAFARWAL TEHSIL,66,1392,107,1499
NAROWAL DISTRICT,ZAFARWAL TEHSIL,67,1208,76,1284
NAROWAL DISTRICT,ZAFARWAL TEHSIL,68,1253,74,1327
NAROWAL DISTRICT,ZAFARWAL TEHSIL,69,1293,61,1354
NAROWAL DISTRICT,ZAFARWAL TEHSIL,70,1387,112,1499
NAROWAL DISTRICT,ZAFARWAL TEHSIL,71,1239,80,1319
NAROWAL DISTRICT,ZAFARWAL TEHSIL,72,1138,83,1221
NAROWAL DISTRICT,ZAFARWAL TEHSIL,73,996,65,1061
NAROWAL DISTRICT,ZAFARWAL TEHSIL,74,942,61,1003
NAROWAL DISTRICT,ZAFARWAL TEHSIL,>=75,8019,578,8597
NASIRABAD DISTRICT,BABA KOT TEHSIL,<1,1380,0,1380
NASIRABAD DISTRICT,BABA KOT TEHSIL,1,1617,0,1617
NASIRABAD DISTRICT,BABA KOT TEHSIL,2,2100,0,2100
NASIRABAD DISTRICT,BABA KOT TEHSIL,3,2103,0,2103
NASIRABAD DISTRICT,BABA KOT TEHSIL,4,2362,0,2362
NASIRABAD DISTRICT,BABA KOT TEHSIL,5,1950,0,1950
NASIRABAD DISTRICT,BABA KOT TEHSIL,6,2437,0,2437
NASIRABAD DISTRICT,BABA KOT TEHSIL,7,1826,0,1826
NASIRABAD DISTRICT,BABA KOT TEHSIL,8,2305,0,2305
NASIRABAD DISTRICT,BABA KOT TEHSIL,9,1524,0,1524
NASIRABAD DISTRICT,BABA KOT TEHSIL,10,1992,0,1992
NASIRABAD DISTRICT,BABA KOT TEHSIL,11,1182,0,1182
NASIRABAD DISTRICT,BABA KOT TEHSIL,12,1317,0,1317
NASIRABAD DISTRICT,BABA KOT TEHSIL,13,892,0,892
NASIRABAD DISTRICT,BABA KOT TEHSIL,14,929,0,929
NASIRABAD DISTRICT,BABA KOT TEHSIL,15,904,0,904
NASIRABAD DISTRICT,BABA KOT TEHSIL,16,782,0,782
NASIRABAD DISTRICT,BABA KOT TEHSIL,17,484,0,484
NASIRABAD DISTRICT,BABA KOT TEHSIL,18,1023,0,1023
NASIRABAD DISTRICT,BABA KOT TEHSIL,19,714,0,714
NASIRABAD DISTRICT,BABA KOT TEHSIL,20,899,0,899
NASIRABAD DISTRICT,BABA KOT TEHSIL,21,659,0,659
NASIRABAD DISTRICT,BABA KOT TEHSIL,22,536,0,536
NASIRABAD DISTRICT,BABA KOT TEHSIL,23,537,0,537
NASIRABAD DISTRICT,BABA KOT TEHSIL,24,475,0,475
NASIRABAD DISTRICT,BABA KOT TEHSIL,25,749,0,749
NASIRABAD DISTRICT,BABA KOT TEHSIL,26,468,0,468
NASIRABAD DISTRICT,BABA KOT TEHSIL,27,586,0,586
NASIRABAD DISTRICT,BABA KOT TEHSIL,28,564,0,564
NASIRABAD DISTRICT,BABA KOT TEHSIL,29,625,0,625
NASIRABAD DISTRICT,BABA KOT TEHSIL,30,779,0,779
NASIRABAD DISTRICT,BABA KOT TEHSIL,31,571,0,571
NASIRABAD DISTRICT,BABA KOT TEHSIL,32,581,0,581
NASIRABAD DISTRICT,BABA KOT TEHSIL,33,600,0,600
NASIRABAD DISTRICT,BABA KOT TEHSIL,34,506,0,506
NASIRABAD DISTRICT,BABA KOT TEHSIL,35,649,0,649
NASIRABAD DISTRICT,BABA KOT TEHSIL,36,445,0,445
NASIRABAD DISTRICT,BABA KOT TEHSIL,37,715,0,715
NASIRABAD DISTRICT,BABA KOT TEHSIL,38,495,0,495
NASIRABAD DISTRICT,BABA KOT TEHSIL,39,556,0,556
NASIRABAD DISTRICT,BABA KOT TEHSIL,40,459,0,459
NASIRABAD DISTRICT,BABA KOT TEHSIL,41,362,0,362
NASIRABAD DISTRICT,BABA KOT TEHSIL,42,369,0,369
NASIRABAD DISTRICT,BABA KOT TEHSIL,43,318,0,318
NASIRABAD DISTRICT,BABA KOT TEHSIL,44,304,0,304
NASIRABAD DISTRICT,BABA KOT TEHSIL,45,353,0,353
NASIRABAD DISTRICT,BABA KOT TEHSIL,46,251,0,251
NASIRABAD DISTRICT,BABA KOT TEHSIL,47,372,0,372
NASIRABAD DISTRICT,BABA KOT TEHSIL,48,276,0,276
NASIRABAD DISTRICT,BABA KOT TEHSIL,49,289,0,289
NASIRABAD DISTRICT,BABA KOT TEHSIL,50,313,0,313
NASIRABAD DISTRICT,BABA KOT TEHSIL,51,217,0,217
NASIRABAD DISTRICT,BABA KOT TEHSIL,52,249,0,249
NASIRABAD DISTRICT,BABA KOT TEHSIL,53,182,0,182
NASIRABAD DISTRICT,BABA KOT TEHSIL,54,195,0,195
NASIRABAD DISTRICT,BABA KOT TEHSIL,55,216,0,216
NASIRABAD DISTRICT,BABA KOT TEHSIL,56,153,0,153
NASIRABAD DISTRICT,BABA KOT TEHSIL,57,255,0,255
NASIRABAD DISTRICT,BABA KOT TEHSIL,58,149,0,149
NASIRABAD DISTRICT,BABA KOT TEHSIL,59,176,0,176
NASIRABAD DISTRICT,BABA KOT TEHSIL,60,192,0,192
NASIRABAD DISTRICT,BABA KOT TEHSIL,61,137,0,137
NASIRABAD DISTRICT,BABA KOT TEHSIL,62,159,0,159
NASIRABAD DISTRICT,BABA KOT TEHSIL,63,148,0,148
NASIRABAD DISTRICT,BABA KOT TEHSIL,64,116,0,116
NASIRABAD DISTRICT,BABA KOT TEHSIL,65,149,0,149
NASIRABAD DISTRICT,BABA KOT TEHSIL,66,109,0,109
NASIRABAD DISTRICT,BABA KOT TEHSIL,67,133,0,133
NASIRABAD DISTRICT,BABA KOT TEHSIL,68,98,0,98
NASIRABAD DISTRICT,BABA KOT TEHSIL,69,79,0,79
NASIRABAD DISTRICT,BABA KOT TEHSIL,70,93,0,93
NASIRABAD DISTRICT,BABA KOT TEHSIL,71,82,0,82
NASIRABAD DISTRICT,BABA KOT TEHSIL,72,71,0,71
NASIRABAD DISTRICT,BABA KOT TEHSIL,73,64,0,64
NASIRABAD DISTRICT,BABA KOT TEHSIL,74,62,0,62
NASIRABAD DISTRICT,BABA KOT TEHSIL,>=75,512,0,512
NASIRABAD DISTRICT,CHATTAR SUB-TEHSIL,<1,2042,0,2042
NASIRABAD DISTRICT,CHATTAR SUB-TEHSIL,1,2828,0,2828
NASIRABAD DISTRICT,CHATTAR SUB-TEHSIL,2,3236,0,3236
NASIRABAD DISTRICT,CHATTAR SUB-TEHSIL,3,3446,0,3446
NASIRABAD DISTRICT,CHATTAR SUB-TEHSIL,4,3592,0,3592
NASIRABAD DISTRICT,CHATTAR SUB-TEHSIL,5,3154,0,3154
NASIRABAD DISTRICT,CHATTAR SUB-TEHSIL,6,3286,0,3286
NASIRABAD DISTRICT,CHATTAR SUB-TEHSIL,7,3002,0,3002
NASIRABAD DISTRICT,CHATTAR SUB-TEHSIL,8,3239,0,3239
NASIRABAD DISTRICT,CHATTAR SUB-TEHSIL,9,2414,0,2414
NASIRABAD DISTRICT,CHATTAR SUB-TEHSIL,10,2668,0,2668
NASIRABAD DISTRICT,CHATTAR SUB-TEHSIL,11,1582,0,1582
NASIRABAD DISTRICT,CHATTAR SUB-TEHSIL,12,1851,0,1851
NASIRABAD DISTRICT,CHATTAR SUB-TEHSIL,13,1304,0,1304
NASIRABAD DISTRICT,CHATTAR SUB-TEHSIL,14,1333,0,1333
NASIRABAD DISTRICT,CHATTAR SUB-TEHSIL,15,1140,0,1140
NASIRABAD DISTRICT,CHATTAR SUB-TEHSIL,16,1395,0,1395
NASIRABAD DISTRICT,CHATTAR SUB-TEHSIL,17,1072,0,1072
NASIRABAD DISTRICT,CHATTAR SUB-TEHSIL,18,1718,0,1718
NASIRABAD DISTRICT,CHATTAR SUB-TEHSIL,19,1232,0,1232
NASIRABAD DISTRICT,CHATTAR SUB-TEHSIL,20,1358,0,1358
NASIRABAD DISTRICT,CHATTAR SUB-TEHSIL,21,1031,0,1031
NASIRABAD DISTRICT,CHATTAR SUB-TEHSIL,22,926,0,926
NASIRABAD DISTRICT,CHATTAR SUB-TEHSIL,23,891,0,891
NASIRABAD DISTRICT,CHATTAR SUB-TEHSIL,24,887,0,887
NASIRABAD DISTRICT,CHATTAR SUB-TEHSIL,25,1047,0,1047
NASIRABAD DISTRICT,CHATTAR SUB-TEHSIL,26,852,0,852
NASIRABAD DISTRICT,CHATTAR SUB-TEHSIL,27,979,0,979
NASIRABAD DISTRICT,CHATTAR SUB-TEHSIL,28,920,0,920
NASIRABAD DISTRICT,CHATTAR SUB-TEHSIL,29,1071,0,1071
NASIRABAD DISTRICT,CHATTAR SUB-TEHSIL,30,1068,0,1068
NASIRABAD DISTRICT,CHATTAR SUB-TEHSIL,31,982,0,982
NASIRABAD DISTRICT,CHATTAR SUB-TEHSIL,32,961,0,961
NASIRABAD DISTRICT,CHATTAR SUB-TEHSIL,33,815,0,815
NASIRABAD DISTRICT,CHATTAR SUB-TEHSIL,34,829,0,829
NASIRABAD DISTRICT,CHATTAR SUB-TEHSIL,35,861,0,861
NASIRABAD DISTRICT,CHATTAR SUB-TEHSIL,36,864,0,864
NASIRABAD DISTRICT,CHATTAR SUB-TEHSIL,37,1060,0,1060
NASIRABAD DISTRICT,CHATTAR SUB-TEHSIL,38,763,0,763
NASIRABAD DISTRICT,CHATTAR SUB-TEHSIL,39,837,0,837
NASIRABAD DISTRICT,CHATTAR SUB-TEHSIL,40,734,0,734
NASIRABAD DISTRICT,CHATTAR SUB-TEHSIL,41,671,0,671
NASIRABAD DISTRICT,CHATTAR SUB-TEHSIL,42,555,0,555
NASIRABAD DISTRICT,CHATTAR SUB-TEHSIL,43,538,0,538
NASIRABAD DISTRICT,CHATTAR SUB-TEHSIL,44,486,0,486
NASIRABAD DISTRICT,CHATTAR SUB-TEHSIL,45,458,0,458
NASIRABAD DISTRICT,CHATTAR SUB-TEHSIL,46,417,0,417
NASIRABAD DISTRICT,CHATTAR SUB-TEHSIL,47,530,0,530
NASIRABAD DISTRICT,CHATTAR SUB-TEHSIL,48,431,0,431
NASIRABAD DISTRICT,CHATTAR SUB-TEHSIL,49,477,0,477
NASIRABAD DISTRICT,CHATTAR SUB-TEHSIL,50,434,0,434
NASIRABAD DISTRICT,CHATTAR SUB-TEHSIL,51,407,0,407
NASIRABAD DISTRICT,CHATTAR SUB-TEHSIL,52,415,0,415
NASIRABAD DISTRICT,CHATTAR SUB-TEHSIL,53,366,0,366
NASIRABAD DISTRICT,CHATTAR SUB-TEHSIL,54,318,0,318
NASIRABAD DISTRICT,CHATTAR SUB-TEHSIL,55,261,0,261
NASIRABAD DISTRICT,CHATTAR SUB-TEHSIL,56,250,0,250
NASIRABAD DISTRICT,CHATTAR SUB-TEHSIL,57,337,0,337
NASIRABAD DISTRICT,CHATTAR SUB-TEHSIL,58,245,0,245
NASIRABAD DISTRICT,CHATTAR SUB-TEHSIL,59,248,0,248
NASIRABAD DISTRICT,CHATTAR SUB-TEHSIL,60,272,0,272
NASIRABAD DISTRICT,CHATTAR SUB-TEHSIL,61,202,0,202
NASIRABAD DISTRICT,CHATTAR SUB-TEHSIL,62,271,0,271
NASIRABAD DISTRICT,CHATTAR SUB-TEHSIL,63,210,0,210
NASIRABAD DISTRICT,CHATTAR SUB-TEHSIL,64,222,0,222
NASIRABAD DISTRICT,CHATTAR SUB-TEHSIL,65,195,0,195
NASIRABAD DISTRICT,CHATTAR SUB-TEHSIL,66,153,0,153
NASIRABAD DISTRICT,CHATTAR SUB-TEHSIL,67,210,0,210
NASIRABAD DISTRICT,CHATTAR SUB-TEHSIL,68,164,0,164
NASIRABAD DISTRICT,CHATTAR SUB-TEHSIL,69,154,0,154
NASIRABAD DISTRICT,CHATTAR SUB-TEHSIL,70,166,0,166
NASIRABAD DISTRICT,CHATTAR SUB-TEHSIL,71,135,0,135
NASIRABAD DISTRICT,CHATTAR SUB-TEHSIL,72,107,0,107
NASIRABAD DISTRICT,CHATTAR SUB-TEHSIL,73,101,0,101
NASIRABAD DISTRICT,CHATTAR SUB-TEHSIL,74,95,0,95
NASIRABAD DISTRICT,CHATTAR SUB-TEHSIL,>=75,765,0,765
NASIRABAD DISTRICT,DERA MURAD JAMALI TEHSIL,<1,3526,2724,6250
NASIRABAD DISTRICT,DERA MURAD JAMALI TEHSIL,1,5389,3468,8857
NASIRABAD DISTRICT,DERA MURAD JAMALI TEHSIL,2,5912,3633,9545
NASIRABAD DISTRICT,DERA MURAD JAMALI TEHSIL,3,6097,3981,10078
NASIRABAD DISTRICT,DERA MURAD JAMALI TEHSIL,4,6193,3779,9972
NASIRABAD DISTRICT,DERA MURAD JAMALI TEHSIL,5,5707,3923,9630
NASIRABAD DISTRICT,DERA MURAD JAMALI TEHSIL,6,5753,3336,9089
NASIRABAD DISTRICT,DERA MURAD JAMALI TEHSIL,7,5473,3778,9251
NASIRABAD DISTRICT,DERA MURAD JAMALI TEHSIL,8,5871,3379,9250
NASIRABAD DISTRICT,DERA MURAD JAMALI TEHSIL,9,4363,3129,7492
NASIRABAD DISTRICT,DERA MURAD JAMALI TEHSIL,10,4853,2903,7756
NASIRABAD DISTRICT,DERA MURAD JAMALI TEHSIL,11,3045,2526,5571
NASIRABAD DISTRICT,DERA MURAD JAMALI TEHSIL,12,3527,2461,5988
NASIRABAD DISTRICT,DERA MURAD JAMALI TEHSIL,13,2426,2192,4618
NASIRABAD DISTRICT,DERA MURAD JAMALI TEHSIL,14,2619,2191,4810
NASIRABAD DISTRICT,DERA MURAD JAMALI TEHSIL,15,2276,2048,4324
NASIRABAD DISTRICT,DERA MURAD JAMALI TEHSIL,16,2392,1913,4305
NASIRABAD DISTRICT,DERA MURAD JAMALI TEHSIL,17,1917,1847,3764
NASIRABAD DISTRICT,DERA MURAD JAMALI TEHSIL,18,2745,1941,4686
NASIRABAD DISTRICT,DERA MURAD JAMALI TEHSIL,19,2068,1786,3854
NASIRABAD DISTRICT,DERA MURAD JAMALI TEHSIL,20,2399,1473,3872
NASIRABAD DISTRICT,DERA MURAD JAMALI TEHSIL,21,1789,1489,3278
NASIRABAD DISTRICT,DERA MURAD JAMALI TEHSIL,22,1598,1268,2866
NASIRABAD DISTRICT,DERA MURAD JAMALI TEHSIL,23,1453,1254,2707
NASIRABAD DISTRICT,DERA MURAD JAMALI TEHSIL,24,1259,1074,2333
NASIRABAD DISTRICT,DERA MURAD JAMALI TEHSIL,25,2154,1266,3420
NASIRABAD DISTRICT,DERA MURAD JAMALI TEHSIL,26,1184,1228,2412
NASIRABAD DISTRICT,DERA MURAD JAMALI TEHSIL,27,1839,1655,3494
NASIRABAD DISTRICT,DERA MURAD JAMALI TEHSIL,28,1505,1274,2779
NASIRABAD DISTRICT,DERA MURAD JAMALI TEHSIL,29,1817,1547,3364
NASIRABAD DISTRICT,DERA MURAD JAMALI TEHSIL,30,1920,1079,2999
NASIRABAD DISTRICT,DERA MURAD JAMALI TEHSIL,31,1540,1301,2841
NASIRABAD DISTRICT,DERA MURAD JAMALI TEHSIL,32,1590,1268,2858
NASIRABAD DISTRICT,DERA MURAD JAMALI TEHSIL,33,1456,1099,2555
NASIRABAD DISTRICT,DERA MURAD JAMALI TEHSIL,34,1274,1004,2278
NASIRABAD DISTRICT,DERA MURAD JAMALI TEHSIL,35,1737,1020,2757
NASIRABAD DISTRICT,DERA MURAD JAMALI TEHSIL,36,1242,933,2175
NASIRABAD DISTRICT,DERA MURAD JAMALI TEHSIL,37,1955,1406,3361
NASIRABAD DISTRICT,DERA MURAD JAMALI TEHSIL,38,1197,827,2024
NASIRABAD DISTRICT,DERA MURAD JAMALI TEHSIL,39,1537,1108,2645
NASIRABAD DISTRICT,DERA MURAD JAMALI TEHSIL,40,1298,746,2044
NASIRABAD DISTRICT,DERA MURAD JAMALI TEHSIL,41,976,791,1767
NASIRABAD DISTRICT,DERA MURAD JAMALI TEHSIL,42,1022,780,1802
NASIRABAD DISTRICT,DERA MURAD JAMALI TEHSIL,43,887,586,1473
NASIRABAD DISTRICT,DERA MURAD JAMALI TEHSIL,44,727,626,1353
NASIRABAD DISTRICT,DERA MURAD JAMALI TEHSIL,45,925,574,1499
NASIRABAD DISTRICT,DERA MURAD JAMALI TEHSIL,46,644,598,1242
NASIRABAD DISTRICT,DERA MURAD JAMALI TEHSIL,47,931,800,1731
NASIRABAD DISTRICT,DERA MURAD JAMALI TEHSIL,48,667,602,1269
NASIRABAD DISTRICT,DERA MURAD JAMALI TEHSIL,49,809,687,1496
NASIRABAD DISTRICT,DERA MURAD JAMALI TEHSIL,50,814,494,1308
NASIRABAD DISTRICT,DERA MURAD JAMALI TEHSIL,51,609,538,1147
NASIRABAD DISTRICT,DERA MURAD JAMALI TEHSIL,52,648,531,1179
NASIRABAD DISTRICT,DERA MURAD JAMALI TEHSIL,53,558,387,945
NASIRABAD DISTRICT,DERA MURAD JAMALI TEHSIL,54,481,405,886
NASIRABAD DISTRICT,DERA MURAD JAMALI TEHSIL,55,498,319,817
NASIRABAD DISTRICT,DERA MURAD JAMALI TEHSIL,56,373,314,687
NASIRABAD DISTRICT,DERA MURAD JAMALI TEHSIL,57,641,479,1120
NASIRABAD DISTRICT,DERA MURAD JAMALI TEHSIL,58,360,268,628
NASIRABAD DISTRICT,DERA MURAD JAMALI TEHSIL,59,465,329,794
NASIRABAD DISTRICT,DERA MURAD JAMALI TEHSIL,60,427,248,675
NASIRABAD DISTRICT,DERA MURAD JAMALI TEHSIL,61,389,307,696
NASIRABAD DISTRICT,DERA MURAD JAMALI TEHSIL,62,429,286,715
NASIRABAD DISTRICT,DERA MURAD JAMALI TEHSIL,63,354,260,614
NASIRABAD DISTRICT,DERA MURAD JAMALI TEHSIL,64,344,217,561
NASIRABAD DISTRICT,DERA MURAD JAMALI TEHSIL,65,301,182,483
NASIRABAD DISTRICT,DERA MURAD JAMALI TEHSIL,66,290,271,561
NASIRABAD DISTRICT,DERA MURAD JAMALI TEHSIL,67,334,220,554
NASIRABAD DISTRICT,DERA MURAD JAMALI TEHSIL,68,208,170,378
NASIRABAD DISTRICT,DERA MURAD JAMALI TEHSIL,69,239,183,422
NASIRABAD DISTRICT,DERA MURAD JAMALI TEHSIL,70,248,135,383
NASIRABAD DISTRICT,DERA MURAD JAMALI TEHSIL,71,222,166,388
NASIRABAD DISTRICT,DERA MURAD JAMALI TEHSIL,72,189,114,303
NASIRABAD DISTRICT,DERA MURAD JAMALI TEHSIL,73,149,120,269
NASIRABAD DISTRICT,DERA MURAD JAMALI TEHSIL,74,137,117,254
NASIRABAD DISTRICT,DERA MURAD JAMALI TEHSIL,>=75,1269,955,2224
NASIRABAD DISTRICT,TAMBOO TEHSIL,<1,3713,0,3713
NASIRABAD DISTRICT,TAMBOO TEHSIL,1,4989,0,4989
NASIRABAD DISTRICT,TAMBOO TEHSIL,2,5730,0,5730
NASIRABAD DISTRICT,TAMBOO TEHSIL,3,5691,0,5691
NASIRABAD DISTRICT,TAMBOO TEHSIL,4,5993,0,5993
NASIRABAD DISTRICT,TAMBOO TEHSIL,5,5560,0,5560
NASIRABAD DISTRICT,TAMBOO TEHSIL,6,5534,0,5534
NASIRABAD DISTRICT,TAMBOO TEHSIL,7,5623,0,5623
NASIRABAD DISTRICT,TAMBOO TEHSIL,8,5573,0,5573
NASIRABAD DISTRICT,TAMBOO TEHSIL,9,4532,0,4532
NASIRABAD DISTRICT,TAMBOO TEHSIL,10,4702,0,4702
NASIRABAD DISTRICT,TAMBOO TEHSIL,11,3174,0,3174
NASIRABAD DISTRICT,TAMBOO TEHSIL,12,3464,0,3464
NASIRABAD DISTRICT,TAMBOO TEHSIL,13,2542,0,2542
NASIRABAD DISTRICT,TAMBOO TEHSIL,14,2681,0,2681
NASIRABAD DISTRICT,TAMBOO TEHSIL,15,2396,0,2396
NASIRABAD DISTRICT,TAMBOO TEHSIL,16,2344,0,2344
NASIRABAD DISTRICT,TAMBOO TEHSIL,17,1878,0,1878
NASIRABAD DISTRICT,TAMBOO TEHSIL,18,2469,0,2469
NASIRABAD DISTRICT,TAMBOO TEHSIL,19,1972,0,1972
NASIRABAD DISTRICT,TAMBOO TEHSIL,20,2269,0,2269
NASIRABAD DISTRICT,TAMBOO TEHSIL,21,1663,0,1663
NASIRABAD DISTRICT,TAMBOO TEHSIL,22,1420,0,1420
NASIRABAD DISTRICT,TAMBOO TEHSIL,23,1294,0,1294
NASIRABAD DISTRICT,TAMBOO TEHSIL,24,1237,0,1237
NASIRABAD DISTRICT,TAMBOO TEHSIL,25,1762,0,1762
NASIRABAD DISTRICT,TAMBOO TEHSIL,26,1275,0,1275
NASIRABAD DISTRICT,TAMBOO TEHSIL,27,1752,0,1752
NASIRABAD DISTRICT,TAMBOO TEHSIL,28,1571,0,1571
NASIRABAD DISTRICT,TAMBOO TEHSIL,29,1876,0,1876
NASIRABAD DISTRICT,TAMBOO TEHSIL,30,1785,0,1785
NASIRABAD DISTRICT,TAMBOO TEHSIL,31,1615,0,1615
NASIRABAD DISTRICT,TAMBOO TEHSIL,32,1687,0,1687
NASIRABAD DISTRICT,TAMBOO TEHSIL,33,1455,0,1455
NASIRABAD DISTRICT,TAMBOO TEHSIL,34,1309,0,1309
NASIRABAD DISTRICT,TAMBOO TEHSIL,35,1534,0,1534
NASIRABAD DISTRICT,TAMBOO TEHSIL,36,1191,0,1191
NASIRABAD DISTRICT,TAMBOO TEHSIL,37,2053,0,2053
NASIRABAD DISTRICT,TAMBOO TEHSIL,38,1243,0,1243
NASIRABAD DISTRICT,TAMBOO TEHSIL,39,1477,0,1477
NASIRABAD DISTRICT,TAMBOO TEHSIL,40,1254,0,1254
NASIRABAD DISTRICT,TAMBOO TEHSIL,41,936,0,936
NASIRABAD DISTRICT,TAMBOO TEHSIL,42,977,0,977
NASIRABAD DISTRICT,TAMBOO TEHSIL,43,764,0,764
NASIRABAD DISTRICT,TAMBOO TEHSIL,44,739,0,739
NASIRABAD DISTRICT,TAMBOO TEHSIL,45,863,0,863
NASIRABAD DISTRICT,TAMBOO TEHSIL,46,569,0,569
NASIRABAD DISTRICT,TAMBOO TEHSIL,47,956,0,956
NASIRABAD DISTRICT,TAMBOO TEHSIL,48,634,0,634
NASIRABAD DISTRICT,TAMBOO TEHSIL,49,726,0,726
NASIRABAD DISTRICT,TAMBOO TEHSIL,50,777,0,777
NASIRABAD DISTRICT,TAMBOO TEHSIL,51,594,0,594
NASIRABAD DISTRICT,TAMBOO TEHSIL,52,683,0,683
NASIRABAD DISTRICT,TAMBOO TEHSIL,53,477,0,477
NASIRABAD DISTRICT,TAMBOO TEHSIL,54,455,0,455
NASIRABAD DISTRICT,TAMBOO TEHSIL,55,473,0,473
NASIRABAD DISTRICT,TAMBOO TEHSIL,56,399,0,399
NASIRABAD DISTRICT,TAMBOO TEHSIL,57,685,0,685
NASIRABAD DISTRICT,TAMBOO TEHSIL,58,400,0,400
NASIRABAD DISTRICT,TAMBOO TEHSIL,59,426,0,426
NASIRABAD DISTRICT,TAMBOO TEHSIL,60,430,0,430
NASIRABAD DISTRICT,TAMBOO TEHSIL,61,327,0,327
NASIRABAD DISTRICT,TAMBOO TEHSIL,62,419,0,419
NASIRABAD DISTRICT,TAMBOO TEHSIL,63,336,0,336
NASIRABAD DISTRICT,TAMBOO TEHSIL,64,317,0,317
NASIRABAD DISTRICT,TAMBOO TEHSIL,65,317,0,317
NASIRABAD DISTRICT,TAMBOO TEHSIL,66,243,0,243
NASIRABAD DISTRICT,TAMBOO TEHSIL,67,345,0,345
NASIRABAD DISTRICT,TAMBOO TEHSIL,68,219,0,219
NASIRABAD DISTRICT,TAMBOO TEHSIL,69,251,0,251
NASIRABAD DISTRICT,TAMBOO TEHSIL,70,239,0,239
NASIRABAD DISTRICT,TAMBOO TEHSIL,71,209,0,209
NASIRABAD DISTRICT,TAMBOO TEHSIL,72,181,0,181
NASIRABAD DISTRICT,TAMBOO TEHSIL,73,131,0,131
NASIRABAD DISTRICT,TAMBOO TEHSIL,74,164,0,164
NASIRABAD DISTRICT,TAMBOO TEHSIL,>=75,1113,0,1113
NAUSHAHRO FEROZE DISTRICT,BHIRIA TALUKA,<1,4811,1263,6074
NAUSHAHRO FEROZE DISTRICT,BHIRIA TALUKA,1,6683,1611,8294
NAUSHAHRO FEROZE DISTRICT,BHIRIA TALUKA,2,7662,1568,9230
NAUSHAHRO FEROZE DISTRICT,BHIRIA TALUKA,3,8590,1871,10461
NAUSHAHRO FEROZE DISTRICT,BHIRIA TALUKA,4,9008,1849,10857
NAUSHAHRO FEROZE DISTRICT,BHIRIA TALUKA,5,9065,1995,11060
NAUSHAHRO FEROZE DISTRICT,BHIRIA TALUKA,6,8057,1745,9802
NAUSHAHRO FEROZE DISTRICT,BHIRIA TALUKA,7,7503,1833,9336
NAUSHAHRO FEROZE DISTRICT,BHIRIA TALUKA,8,7852,1671,9523
NAUSHAHRO FEROZE DISTRICT,BHIRIA TALUKA,9,6454,1770,8224
NAUSHAHRO FEROZE DISTRICT,BHIRIA TALUKA,10,6786,1559,8345
NAUSHAHRO FEROZE DISTRICT,BHIRIA TALUKA,11,5423,1532,6955
NAUSHAHRO FEROZE DISTRICT,BHIRIA TALUKA,12,5787,1561,7348
NAUSHAHRO FEROZE DISTRICT,BHIRIA TALUKA,13,4951,1427,6378
NAUSHAHRO FEROZE DISTRICT,BHIRIA TALUKA,14,5370,1441,6811
NAUSHAHRO FEROZE DISTRICT,BHIRIA TALUKA,15,5317,1488,6805
NAUSHAHRO FEROZE DISTRICT,BHIRIA TALUKA,16,5300,1423,6723
NAUSHAHRO FEROZE DISTRICT,BHIRIA TALUKA,17,4898,1465,6363
NAUSHAHRO FEROZE DISTRICT,BHIRIA TALUKA,18,5700,1479,7179
NAUSHAHRO FEROZE DISTRICT,BHIRIA TALUKA,19,4543,1357,5900
NAUSHAHRO FEROZE DISTRICT,BHIRIA TALUKA,20,5026,1269,6295
NAUSHAHRO FEROZE DISTRICT,BHIRIA TALUKA,21,3831,1139,4970
NAUSHAHRO FEROZE DISTRICT,BHIRIA TALUKA,22,4066,1189,5255
NAUSHAHRO FEROZE DISTRICT,BHIRIA TALUKA,23,3635,1116,4751
NAUSHAHRO FEROZE DISTRICT,BHIRIA TALUKA,24,3567,1011,4578
NAUSHAHRO FEROZE DISTRICT,BHIRIA TALUKA,25,4044,1089,5133
NAUSHAHRO FEROZE DISTRICT,BHIRIA TALUKA,26,3624,1068,4692
NAUSHAHRO FEROZE DISTRICT,BHIRIA TALUKA,27,3513,994,4507
NAUSHAHRO FEROZE DISTRICT,BHIRIA TALUKA,28,3715,1050,4765
NAUSHAHRO FEROZE DISTRICT,BHIRIA TALUKA,29,3665,920,4585
NAUSHAHRO FEROZE DISTRICT,BHIRIA TALUKA,30,3520,974,4494
NAUSHAHRO FEROZE DISTRICT,BHIRIA TALUKA,31,3321,865,4186
NAUSHAHRO FEROZE DISTRICT,BHIRIA TALUKA,32,3247,884,4131
NAUSHAHRO FEROZE DISTRICT,BHIRIA TALUKA,33,2728,761,3489
NAUSHAHRO FEROZE DISTRICT,BHIRIA TALUKA,34,2553,679,3232
NAUSHAHRO FEROZE DISTRICT,BHIRIA TALUKA,35,2747,850,3597
NAUSHAHRO FEROZE DISTRICT,BHIRIA TALUKA,36,2613,667,3280
NAUSHAHRO FEROZE DISTRICT,BHIRIA TALUKA,37,2763,665,3428
NAUSHAHRO FEROZE DISTRICT,BHIRIA TALUKA,38,2451,720,3171
NAUSHAHRO FEROZE DISTRICT,BHIRIA TALUKA,39,2387,650,3037
NAUSHAHRO FEROZE DISTRICT,BHIRIA TALUKA,40,2442,755,3197
NAUSHAHRO FEROZE DISTRICT,BHIRIA TALUKA,41,2018,597,2615
NAUSHAHRO FEROZE DISTRICT,BHIRIA TALUKA,42,2131,606,2737
NAUSHAHRO FEROZE DISTRICT,BHIRIA TALUKA,43,1816,546,2362
NAUSHAHRO FEROZE DISTRICT,BHIRIA TALUKA,44,1863,538,2401
NAUSHAHRO FEROZE DISTRICT,BHIRIA TALUKA,45,1902,529,2431
NAUSHAHRO FEROZE DISTRICT,BHIRIA TALUKA,46,1842,573,2415
NAUSHAHRO FEROZE DISTRICT,BHIRIA TALUKA,47,2013,497,2510
NAUSHAHRO FEROZE DISTRICT,BHIRIA TALUKA,48,1808,468,2276
NAUSHAHRO FEROZE DISTRICT,BHIRIA TALUKA,49,1714,456,2170
NAUSHAHRO FEROZE DISTRICT,BHIRIA TALUKA,50,1592,485,2077
NAUSHAHRO FEROZE DISTRICT,BHIRIA TALUKA,51,1506,409,1915
NAUSHAHRO FEROZE DISTRICT,BHIRIA TALUKA,52,1411,366,1777
NAUSHAHRO FEROZE DISTRICT,BHIRIA TALUKA,53,1211,341,1552
NAUSHAHRO FEROZE DISTRICT,BHIRIA TALUKA,54,969,310,1279
NAUSHAHRO FEROZE DISTRICT,BHIRIA TALUKA,55,1144,349,1493
NAUSHAHRO FEROZE DISTRICT,BHIRIA TALUKA,56,965,245,1210
NAUSHAHRO FEROZE DISTRICT,BHIRIA TALUKA,57,922,231,1153
NAUSHAHRO FEROZE DISTRICT,BHIRIA TALUKA,58,864,224,1088
NAUSHAHRO FEROZE DISTRICT,BHIRIA TALUKA,59,979,264,1243
NAUSHAHRO FEROZE DISTRICT,BHIRIA TALUKA,60,974,257,1231
NAUSHAHRO FEROZE DISTRICT,BHIRIA TALUKA,61,901,188,1089
NAUSHAHRO FEROZE DISTRICT,BHIRIA TALUKA,62,876,215,1091
NAUSHAHRO FEROZE DISTRICT,BHIRIA TALUKA,63,871,205,1076
NAUSHAHRO FEROZE DISTRICT,BHIRIA TALUKA,64,761,187,948
NAUSHAHRO FEROZE DISTRICT,BHIRIA TALUKA,65,715,181,896
NAUSHAHRO FEROZE DISTRICT,BHIRIA TALUKA,66,702,172,874
NAUSHAHRO FEROZE DISTRICT,BHIRIA TALUKA,67,545,129,674
NAUSHAHRO FEROZE DISTRICT,BHIRIA TALUKA,68,533,138,671
NAUSHAHRO FEROZE DISTRICT,BHIRIA TALUKA,69,515,92,607
NAUSHAHRO FEROZE DISTRICT,BHIRIA TALUKA,70,439,124,563
NAUSHAHRO FEROZE DISTRICT,BHIRIA TALUKA,71,475,101,576
NAUSHAHRO FEROZE DISTRICT,BHIRIA TALUKA,72,346,91,437
NAUSHAHRO FEROZE DISTRICT,BHIRIA TALUKA,73,330,74,404
NAUSHAHRO FEROZE DISTRICT,BHIRIA TALUKA,74,272,79,351
NAUSHAHRO FEROZE DISTRICT,BHIRIA TALUKA,>=75,2312,599,2911
NAUSHAHRO FEROZE DISTRICT,KANDIARO TALUKA,<1,5688,791,6479
NAUSHAHRO FEROZE DISTRICT,KANDIARO TALUKA,1,7678,971,8649
NAUSHAHRO FEROZE DISTRICT,KANDIARO TALUKA,2,8911,987,9898
NAUSHAHRO FEROZE DISTRICT,KANDIARO TALUKA,3,10483,1280,11763
NAUSHAHRO FEROZE DISTRICT,KANDIARO TALUKA,4,10660,1171,11831
NAUSHAHRO FEROZE DISTRICT,KANDIARO TALUKA,5,10680,1243,11923
NAUSHAHRO FEROZE DISTRICT,KANDIARO TALUKA,6,9492,1080,10572
NAUSHAHRO FEROZE DISTRICT,KANDIARO TALUKA,7,8961,1179,10140
NAUSHAHRO FEROZE DISTRICT,KANDIARO TALUKA,8,9490,1089,10579
NAUSHAHRO FEROZE DISTRICT,KANDIARO TALUKA,9,8100,1039,9139
NAUSHAHRO FEROZE DISTRICT,KANDIARO TALUKA,10,8270,1022,9292
NAUSHAHRO FEROZE DISTRICT,KANDIARO TALUKA,11,6438,913,7351
NAUSHAHRO FEROZE DISTRICT,KANDIARO TALUKA,12,6874,977,7851
NAUSHAHRO FEROZE DISTRICT,KANDIARO TALUKA,13,6147,918,7065
NAUSHAHRO FEROZE DISTRICT,KANDIARO TALUKA,14,6349,844,7193
NAUSHAHRO FEROZE DISTRICT,KANDIARO TALUKA,15,6634,969,7603
NAUSHAHRO FEROZE DISTRICT,KANDIARO TALUKA,16,6357,939,7296
NAUSHAHRO FEROZE DISTRICT,KANDIARO TALUKA,17,6302,990,7292
NAUSHAHRO FEROZE DISTRICT,KANDIARO TALUKA,18,6522,952,7474
NAUSHAHRO FEROZE DISTRICT,KANDIARO TALUKA,19,5683,875,6558
NAUSHAHRO FEROZE DISTRICT,KANDIARO TALUKA,20,5650,831,6481
NAUSHAHRO FEROZE DISTRICT,KANDIARO TALUKA,21,4576,696,5272
NAUSHAHRO FEROZE DISTRICT,KANDIARO TALUKA,22,4640,787,5427
NAUSHAHRO FEROZE DISTRICT,KANDIARO TALUKA,23,4159,660,4819
NAUSHAHRO FEROZE DISTRICT,KANDIARO TALUKA,24,3859,664,4523
NAUSHAHRO FEROZE DISTRICT,KANDIARO TALUKA,25,4658,683,5341
NAUSHAHRO FEROZE DISTRICT,KANDIARO TALUKA,26,4099,597,4696
NAUSHAHRO FEROZE DISTRICT,KANDIARO TALUKA,27,4589,637,5226
NAUSHAHRO FEROZE DISTRICT,KANDIARO TALUKA,28,4303,641,4944
NAUSHAHRO FEROZE DISTRICT,KANDIARO TALUKA,29,4548,561,5109
NAUSHAHRO FEROZE DISTRICT,KANDIARO TALUKA,30,4071,704,4775
NAUSHAHRO FEROZE DISTRICT,KANDIARO TALUKA,31,4011,522,4533
NAUSHAHRO FEROZE DISTRICT,KANDIARO TALUKA,32,4020,601,4621
NAUSHAHRO FEROZE DISTRICT,KANDIARO TALUKA,33,3282,484,3766
NAUSHAHRO FEROZE DISTRICT,KANDIARO TALUKA,34,2889,437,3326
NAUSHAHRO FEROZE DISTRICT,KANDIARO TALUKA,35,3256,560,3816
NAUSHAHRO FEROZE DISTRICT,KANDIARO TALUKA,36,2694,412,3106
NAUSHAHRO FEROZE DISTRICT,KANDIARO TALUKA,37,3397,431,3828
NAUSHAHRO FEROZE DISTRICT,KANDIARO TALUKA,38,2666,471,3137
NAUSHAHRO FEROZE DISTRICT,KANDIARO TALUKA,39,2843,372,3215
NAUSHAHRO FEROZE DISTRICT,KANDIARO TALUKA,40,2623,519,3142
NAUSHAHRO FEROZE DISTRICT,KANDIARO TALUKA,41,2393,362,2755
NAUSHAHRO FEROZE DISTRICT,KANDIARO TALUKA,42,2531,369,2900
NAUSHAHRO FEROZE DISTRICT,KANDIARO TALUKA,43,2072,372,2444
NAUSHAHRO FEROZE DISTRICT,KANDIARO TALUKA,44,2071,318,2389
NAUSHAHRO FEROZE DISTRICT,KANDIARO TALUKA,45,2131,364,2495
NAUSHAHRO FEROZE DISTRICT,KANDIARO TALUKA,46,1990,273,2263
NAUSHAHRO FEROZE DISTRICT,KANDIARO TALUKA,47,2723,283,3006
NAUSHAHRO FEROZE DISTRICT,KANDIARO TALUKA,48,1919,280,2199
NAUSHAHRO FEROZE DISTRICT,KANDIARO TALUKA,49,1899,235,2134
NAUSHAHRO FEROZE DISTRICT,KANDIARO TALUKA,50,1804,312,2116
NAUSHAHRO FEROZE DISTRICT,KANDIARO TALUKA,51,1765,213,1978
NAUSHAHRO FEROZE DISTRICT,KANDIARO TALUKA,52,1672,199,1871
NAUSHAHRO FEROZE DISTRICT,KANDIARO TALUKA,53,1355,197,1552
NAUSHAHRO FEROZE DISTRICT,KANDIARO TALUKA,54,1255,185,1440
NAUSHAHRO FEROZE DISTRICT,KANDIARO TALUKA,55,1297,247,1544
NAUSHAHRO FEROZE DISTRICT,KANDIARO TALUKA,56,1024,126,1150
NAUSHAHRO FEROZE DISTRICT,KANDIARO TALUKA,57,1252,143,1395
NAUSHAHRO FEROZE DISTRICT,KANDIARO TALUKA,58,980,136,1116
NAUSHAHRO FEROZE DISTRICT,KANDIARO TALUKA,59,990,137,1127
NAUSHAHRO FEROZE DISTRICT,KANDIARO TALUKA,60,1070,159,1229
NAUSHAHRO FEROZE DISTRICT,KANDIARO TALUKA,61,1045,115,1160
NAUSHAHRO FEROZE DISTRICT,KANDIARO TALUKA,62,1077,119,1196
NAUSHAHRO FEROZE DISTRICT,KANDIARO TALUKA,63,1063,144,1207
NAUSHAHRO FEROZE DISTRICT,KANDIARO TALUKA,64,900,97,997
NAUSHAHRO FEROZE DISTRICT,KANDIARO TALUKA,65,811,116,927
NAUSHAHRO FEROZE DISTRICT,KANDIARO TALUKA,66,732,75,807
NAUSHAHRO FEROZE DISTRICT,KANDIARO TALUKA,67,810,65,875
NAUSHAHRO FEROZE DISTRICT,KANDIARO TALUKA,68,592,70,662
NAUSHAHRO FEROZE DISTRICT,KANDIARO TALUKA,69,614,64,678
NAUSHAHRO FEROZE DISTRICT,KANDIARO TALUKA,70,537,66,603
NAUSHAHRO FEROZE DISTRICT,KANDIARO TALUKA,71,549,44,593
NAUSHAHRO FEROZE DISTRICT,KANDIARO TALUKA,72,457,42,499
NAUSHAHRO FEROZE DISTRICT,KANDIARO TALUKA,73,402,42,444
NAUSHAHRO FEROZE DISTRICT,KANDIARO TALUKA,74,333,34,367
NAUSHAHRO FEROZE DISTRICT,KANDIARO TALUKA,>=75,2840,367,3207
NAUSHAHRO FEROZE DISTRICT,MEHRABPUR TALUKA,<1,3507,1584,5091
NAUSHAHRO FEROZE DISTRICT,MEHRABPUR TALUKA,1,5078,2005,7083
NAUSHAHRO FEROZE DISTRICT,MEHRABPUR TALUKA,2,5699,2150,7849
NAUSHAHRO FEROZE DISTRICT,MEHRABPUR TALUKA,3,6461,2412,8873
NAUSHAHRO FEROZE DISTRICT,MEHRABPUR TALUKA,4,6635,2407,9042
NAUSHAHRO FEROZE DISTRICT,MEHRABPUR TALUKA,5,6400,2571,8971
NAUSHAHRO FEROZE DISTRICT,MEHRABPUR TALUKA,6,6012,2313,8325
NAUSHAHRO FEROZE DISTRICT,MEHRABPUR TALUKA,7,5310,2266,7576
NAUSHAHRO FEROZE DISTRICT,MEHRABPUR TALUKA,8,6025,2318,8343
NAUSHAHRO FEROZE DISTRICT,MEHRABPUR TALUKA,9,4798,2110,6908
NAUSHAHRO FEROZE DISTRICT,MEHRABPUR TALUKA,10,5181,2050,7231
NAUSHAHRO FEROZE DISTRICT,MEHRABPUR TALUKA,11,3908,1855,5763
NAUSHAHRO FEROZE DISTRICT,MEHRABPUR TALUKA,12,4488,1899,6387
NAUSHAHRO FEROZE DISTRICT,MEHRABPUR TALUKA,13,3644,1746,5390
NAUSHAHRO FEROZE DISTRICT,MEHRABPUR TALUKA,14,3589,1728,5317
NAUSHAHRO FEROZE DISTRICT,MEHRABPUR TALUKA,15,3944,1862,5806
NAUSHAHRO FEROZE DISTRICT,MEHRABPUR TALUKA,16,3732,1826,5558
NAUSHAHRO FEROZE DISTRICT,MEHRABPUR TALUKA,17,3442,1776,5218
NAUSHAHRO FEROZE DISTRICT,MEHRABPUR TALUKA,18,4201,1872,6073
NAUSHAHRO FEROZE DISTRICT,MEHRABPUR TALUKA,19,3274,1717,4991
NAUSHAHRO FEROZE DISTRICT,MEHRABPUR TALUKA,20,3602,1709,5311
NAUSHAHRO FEROZE DISTRICT,MEHRABPUR TALUKA,21,2767,1507,4274
NAUSHAHRO FEROZE DISTRICT,MEHRABPUR TALUKA,22,2909,1466,4375
NAUSHAHRO FEROZE DISTRICT,MEHRABPUR TALUKA,23,2441,1348,3789
NAUSHAHRO FEROZE DISTRICT,MEHRABPUR TALUKA,24,2311,1247,3558
NAUSHAHRO FEROZE DISTRICT,MEHRABPUR TALUKA,25,2888,1341,4229
NAUSHAHRO FEROZE DISTRICT,MEHRABPUR TALUKA,26,2290,1201,3491
NAUSHAHRO FEROZE DISTRICT,MEHRABPUR TALUKA,27,2229,1162,3391
NAUSHAHRO FEROZE DISTRICT,MEHRABPUR TALUKA,28,2522,1246,3768
NAUSHAHRO FEROZE DISTRICT,MEHRABPUR TALUKA,29,2186,1167,3353
NAUSHAHRO FEROZE DISTRICT,MEHRABPUR TALUKA,30,2597,1259,3856
NAUSHAHRO FEROZE DISTRICT,MEHRABPUR TALUKA,31,2109,1040,3149
NAUSHAHRO FEROZE DISTRICT,MEHRABPUR TALUKA,32,2180,1124,3304
NAUSHAHRO FEROZE DISTRICT,MEHRABPUR TALUKA,33,1851,958,2809
NAUSHAHRO FEROZE DISTRICT,MEHRABPUR TALUKA,34,1716,770,2486
NAUSHAHRO FEROZE DISTRICT,MEHRABPUR TALUKA,35,2139,983,3122
NAUSHAHRO FEROZE DISTRICT,MEHRABPUR TALUKA,36,1680,786,2466
NAUSHAHRO FEROZE DISTRICT,MEHRABPUR TALUKA,37,1715,888,2603
NAUSHAHRO FEROZE DISTRICT,MEHRABPUR TALUKA,38,1676,816,2492
NAUSHAHRO FEROZE DISTRICT,MEHRABPUR TALUKA,39,1528,774,2302
NAUSHAHRO FEROZE DISTRICT,MEHRABPUR TALUKA,40,1827,841,2668
NAUSHAHRO FEROZE DISTRICT,MEHRABPUR TALUKA,41,1321,708,2029
NAUSHAHRO FEROZE DISTRICT,MEHRABPUR TALUKA,42,1383,701,2084
NAUSHAHRO FEROZE DISTRICT,MEHRABPUR TALUKA,43,1182,638,1820
NAUSHAHRO FEROZE DISTRICT,MEHRABPUR TALUKA,44,1161,554,1715
NAUSHAHRO FEROZE DISTRICT,MEHRABPUR TALUKA,45,1411,647,2058
NAUSHAHRO FEROZE DISTRICT,MEHRABPUR TALUKA,46,1154,538,1692
NAUSHAHRO FEROZE DISTRICT,MEHRABPUR TALUKA,47,1282,599,1881
NAUSHAHRO FEROZE DISTRICT,MEHRABPUR TALUKA,48,1244,494,1738
NAUSHAHRO FEROZE DISTRICT,MEHRABPUR TALUKA,49,1071,569,1640
NAUSHAHRO FEROZE DISTRICT,MEHRABPUR TALUKA,50,1245,601,1846
NAUSHAHRO FEROZE DISTRICT,MEHRABPUR TALUKA,51,940,444,1384
NAUSHAHRO FEROZE DISTRICT,MEHRABPUR TALUKA,52,898,460,1358
NAUSHAHRO FEROZE DISTRICT,MEHRABPUR TALUKA,53,868,420,1288
NAUSHAHRO FEROZE DISTRICT,MEHRABPUR TALUKA,54,705,395,1100
NAUSHAHRO FEROZE DISTRICT,MEHRABPUR TALUKA,55,892,438,1330
NAUSHAHRO FEROZE DISTRICT,MEHRABPUR TALUKA,56,639,288,927
NAUSHAHRO FEROZE DISTRICT,MEHRABPUR TALUKA,57,598,320,918
NAUSHAHRO FEROZE DISTRICT,MEHRABPUR TALUKA,58,571,294,865
NAUSHAHRO FEROZE DISTRICT,MEHRABPUR TALUKA,59,574,285,859
NAUSHAHRO FEROZE DISTRICT,MEHRABPUR TALUKA,60,715,332,1047
NAUSHAHRO FEROZE DISTRICT,MEHRABPUR TALUKA,61,567,293,860
NAUSHAHRO FEROZE DISTRICT,MEHRABPUR TALUKA,62,548,248,796
NAUSHAHRO FEROZE DISTRICT,MEHRABPUR TALUKA,63,579,252,831
NAUSHAHRO FEROZE DISTRICT,MEHRABPUR TALUKA,64,470,233,703
NAUSHAHRO FEROZE DISTRICT,MEHRABPUR TALUKA,65,571,220,791
NAUSHAHRO FEROZE DISTRICT,MEHRABPUR TALUKA,66,458,177,635
NAUSHAHRO FEROZE DISTRICT,MEHRABPUR TALUKA,67,382,141,523
NAUSHAHRO FEROZE DISTRICT,MEHRABPUR TALUKA,68,372,160,532
NAUSHAHRO FEROZE DISTRICT,MEHRABPUR TALUKA,69,316,135,451
NAUSHAHRO FEROZE DISTRICT,MEHRABPUR TALUKA,70,407,144,551
NAUSHAHRO FEROZE DISTRICT,MEHRABPUR TALUKA,71,295,128,423
NAUSHAHRO FEROZE DISTRICT,MEHRABPUR TALUKA,72,245,104,349
NAUSHAHRO FEROZE DISTRICT,MEHRABPUR TALUKA,73,222,112,334
NAUSHAHRO FEROZE DISTRICT,MEHRABPUR TALUKA,74,193,73,266
NAUSHAHRO FEROZE DISTRICT,MEHRABPUR TALUKA,>=75,1691,743,2434
NAUSHAHRO FEROZE DISTRICT,MORO TALUKA,<1,5801,1836,7637
NAUSHAHRO FEROZE DISTRICT,MORO TALUKA,1,6983,2358,9341
NAUSHAHRO FEROZE DISTRICT,MORO TALUKA,2,8881,2720,11601
NAUSHAHRO FEROZE DISTRICT,MORO TALUKA,3,10066,3094,13160
NAUSHAHRO FEROZE DISTRICT,MORO TALUKA,4,10488,3149,13637
NAUSHAHRO FEROZE DISTRICT,MORO TALUKA,5,10672,3314,13986
NAUSHAHRO FEROZE DISTRICT,MORO TALUKA,6,9315,2773,12088
NAUSHAHRO FEROZE DISTRICT,MORO TALUKA,7,8480,2858,11338
NAUSHAHRO FEROZE DISTRICT,MORO TALUKA,8,9327,2708,12035
NAUSHAHRO FEROZE DISTRICT,MORO TALUKA,9,7129,2427,9556
NAUSHAHRO FEROZE DISTRICT,MORO TALUKA,10,8138,2578,10716
NAUSHAHRO FEROZE DISTRICT,MORO TALUKA,11,5630,2137,7767
NAUSHAHRO FEROZE DISTRICT,MORO TALUKA,12,6659,2261,8920
NAUSHAHRO FEROZE DISTRICT,MORO TALUKA,13,5414,2052,7466
NAUSHAHRO FEROZE DISTRICT,MORO TALUKA,14,5696,2064,7760
NAUSHAHRO FEROZE DISTRICT,MORO TALUKA,15,6166,2273,8439
NAUSHAHRO FEROZE DISTRICT,MORO TALUKA,16,5820,2234,8054
NAUSHAHRO FEROZE DISTRICT,MORO TALUKA,17,5706,2273,7979
NAUSHAHRO FEROZE DISTRICT,MORO TALUKA,18,6350,2134,8484
NAUSHAHRO FEROZE DISTRICT,MORO TALUKA,19,5137,2053,7190
NAUSHAHRO FEROZE DISTRICT,MORO TALUKA,20,5587,2050,7637
NAUSHAHRO FEROZE DISTRICT,MORO TALUKA,21,4067,1681,5748
NAUSHAHRO FEROZE DISTRICT,MORO TALUKA,22,4577,1795,6372
NAUSHAHRO FEROZE DISTRICT,MORO TALUKA,23,3899,1592,5491
NAUSHAHRO FEROZE DISTRICT,MORO TALUKA,24,3465,1413,4878
NAUSHAHRO FEROZE DISTRICT,MORO TALUKA,25,4860,1750,6610
NAUSHAHRO FEROZE DISTRICT,MORO TALUKA,26,3633,1395,5028
NAUSHAHRO FEROZE DISTRICT,MORO TALUKA,27,3882,1572,5454
NAUSHAHRO FEROZE DISTRICT,MORO TALUKA,28,4444,1711,6155
NAUSHAHRO FEROZE DISTRICT,MORO TALUKA,29,3991,1362,5353
NAUSHAHRO FEROZE DISTRICT,MORO TALUKA,30,4507,1632,6139
NAUSHAHRO FEROZE DISTRICT,MORO TALUKA,31,3722,1445,5167
NAUSHAHRO FEROZE DISTRICT,MORO TALUKA,32,3772,1400,5172
NAUSHAHRO FEROZE DISTRICT,MORO TALUKA,33,3329,1297,4626
NAUSHAHRO FEROZE DISTRICT,MORO TALUKA,34,2789,1118,3907
NAUSHAHRO FEROZE DISTRICT,MORO TALUKA,35,3693,1337,5030
NAUSHAHRO FEROZE DISTRICT,MORO TALUKA,36,2649,951,3600
NAUSHAHRO FEROZE DISTRICT,MORO TALUKA,37,3187,1023,4210
NAUSHAHRO FEROZE DISTRICT,MORO TALUKA,38,2838,1150,3988
NAUSHAHRO FEROZE DISTRICT,MORO TALUKA,39,2926,1000,3926
NAUSHAHRO FEROZE DISTRICT,MORO TALUKA,40,3228,1235,4463
NAUSHAHRO FEROZE DISTRICT,MORO TALUKA,41,2173,877,3050
NAUSHAHRO FEROZE DISTRICT,MORO TALUKA,42,2407,963,3370
NAUSHAHRO FEROZE DISTRICT,MORO TALUKA,43,2063,901,2964
NAUSHAHRO FEROZE DISTRICT,MORO TALUKA,44,1888,750,2638
NAUSHAHRO FEROZE DISTRICT,MORO TALUKA,45,2445,934,3379
NAUSHAHRO FEROZE DISTRICT,MORO TALUKA,46,1897,637,2534
NAUSHAHRO FEROZE DISTRICT,MORO TALUKA,47,2465,756,3221
NAUSHAHRO FEROZE DISTRICT,MORO TALUKA,48,1974,756,2730
NAUSHAHRO FEROZE DISTRICT,MORO TALUKA,49,2010,713,2723
NAUSHAHRO FEROZE DISTRICT,MORO TALUKA,50,2130,805,2935
NAUSHAHRO FEROZE DISTRICT,MORO TALUKA,51,1674,554,2228
NAUSHAHRO FEROZE DISTRICT,MORO TALUKA,52,1585,550,2135
NAUSHAHRO FEROZE DISTRICT,MORO TALUKA,53,1291,471,1762
NAUSHAHRO FEROZE DISTRICT,MORO TALUKA,54,1120,474,1594
NAUSHAHRO FEROZE DISTRICT,MORO TALUKA,55,1362,541,1903
NAUSHAHRO FEROZE DISTRICT,MORO TALUKA,56,954,346,1300
NAUSHAHRO FEROZE DISTRICT,MORO TALUKA,57,1171,382,1553
NAUSHAHRO FEROZE DISTRICT,MORO TALUKA,58,931,344,1275
NAUSHAHRO FEROZE DISTRICT,MORO TALUKA,59,1017,320,1337
NAUSHAHRO FEROZE DISTRICT,MORO TALUKA,60,1191,432,1623
NAUSHAHRO FEROZE DISTRICT,MORO TALUKA,61,1015,334,1349
NAUSHAHRO FEROZE DISTRICT,MORO TALUKA,62,1050,295,1345
NAUSHAHRO FEROZE DISTRICT,MORO TALUKA,63,931,298,1229
NAUSHAHRO FEROZE DISTRICT,MORO TALUKA,64,849,259,1108
NAUSHAHRO FEROZE DISTRICT,MORO TALUKA,65,949,327,1276
NAUSHAHRO FEROZE DISTRICT,MORO TALUKA,66,733,194,927
NAUSHAHRO FEROZE DISTRICT,MORO TALUKA,67,760,177,937
NAUSHAHRO FEROZE DISTRICT,MORO TALUKA,68,596,200,796
NAUSHAHRO FEROZE DISTRICT,MORO TALUKA,69,551,163,714
NAUSHAHRO FEROZE DISTRICT,MORO TALUKA,70,639,191,830
NAUSHAHRO FEROZE DISTRICT,MORO TALUKA,71,484,137,621
NAUSHAHRO FEROZE DISTRICT,MORO TALUKA,72,395,139,534
NAUSHAHRO FEROZE DISTRICT,MORO TALUKA,73,416,119,535
NAUSHAHRO FEROZE DISTRICT,MORO TALUKA,74,338,102,440
NAUSHAHRO FEROZE DISTRICT,MORO TALUKA,>=75,2774,802,3576
NAUSHAHRO FEROZE DISTRICT,NAUSHAHRO FEROZE TALUKA,<1,5312,1992,7304
NAUSHAHRO FEROZE DISTRICT,NAUSHAHRO FEROZE TALUKA,1,7086,2611,9697
NAUSHAHRO FEROZE DISTRICT,NAUSHAHRO FEROZE TALUKA,2,8346,2899,11245
NAUSHAHRO FEROZE DISTRICT,NAUSHAHRO FEROZE TALUKA,3,9524,3413,12937
NAUSHAHRO FEROZE DISTRICT,NAUSHAHRO FEROZE TALUKA,4,9769,3227,12996
NAUSHAHRO FEROZE DISTRICT,NAUSHAHRO FEROZE TALUKA,5,10234,3500,13734
NAUSHAHRO FEROZE DISTRICT,NAUSHAHRO FEROZE TALUKA,6,9170,3114,12284
NAUSHAHRO FEROZE DISTRICT,NAUSHAHRO FEROZE TALUKA,7,8264,3117,11381
NAUSHAHRO FEROZE DISTRICT,NAUSHAHRO FEROZE TALUKA,8,9381,3119,12500
NAUSHAHRO FEROZE DISTRICT,NAUSHAHRO FEROZE TALUKA,9,7261,2760,10021
NAUSHAHRO FEROZE DISTRICT,NAUSHAHRO FEROZE TALUKA,10,8464,2809,11273
NAUSHAHRO FEROZE DISTRICT,NAUSHAHRO FEROZE TALUKA,11,5712,2400,8112
NAUSHAHRO FEROZE DISTRICT,NAUSHAHRO FEROZE TALUKA,12,6801,2522,9323
NAUSHAHRO FEROZE DISTRICT,NAUSHAHRO FEROZE TALUKA,13,5259,2423,7682
NAUSHAHRO FEROZE DISTRICT,NAUSHAHRO FEROZE TALUKA,14,5743,2381,8124
NAUSHAHRO FEROZE DISTRICT,NAUSHAHRO FEROZE TALUKA,15,6037,2616,8653
NAUSHAHRO FEROZE DISTRICT,NAUSHAHRO FEROZE TALUKA,16,5694,2455,8149
NAUSHAHRO FEROZE DISTRICT,NAUSHAHRO FEROZE TALUKA,17,5209,2541,7750
NAUSHAHRO FEROZE DISTRICT,NAUSHAHRO FEROZE TALUKA,18,6213,2540,8753
NAUSHAHRO FEROZE DISTRICT,NAUSHAHRO FEROZE TALUKA,19,4872,2344,7216
NAUSHAHRO FEROZE DISTRICT,NAUSHAHRO FEROZE TALUKA,20,6051,2308,8359
NAUSHAHRO FEROZE DISTRICT,NAUSHAHRO FEROZE TALUKA,21,3986,2047,6033
NAUSHAHRO FEROZE DISTRICT,NAUSHAHRO FEROZE TALUKA,22,4812,2075,6887
NAUSHAHRO FEROZE DISTRICT,NAUSHAHRO FEROZE TALUKA,23,4070,1864,5934
NAUSHAHRO FEROZE DISTRICT,NAUSHAHRO FEROZE TALUKA,24,3788,1771,5559
NAUSHAHRO FEROZE DISTRICT,NAUSHAHRO FEROZE TALUKA,25,5178,2035,7213
NAUSHAHRO FEROZE DISTRICT,NAUSHAHRO FEROZE TALUKA,26,3779,1591,5370
NAUSHAHRO FEROZE DISTRICT,NAUSHAHRO FEROZE TALUKA,27,3671,1719,5390
NAUSHAHRO FEROZE DISTRICT,NAUSHAHRO FEROZE TALUKA,28,4483,1707,6190
NAUSHAHRO FEROZE DISTRICT,NAUSHAHRO FEROZE TALUKA,29,3689,1620,5309
NAUSHAHRO FEROZE DISTRICT,NAUSHAHRO FEROZE TALUKA,30,4831,1788,6619
NAUSHAHRO FEROZE DISTRICT,NAUSHAHRO FEROZE TALUKA,31,3522,1380,4902
NAUSHAHRO FEROZE DISTRICT,NAUSHAHRO FEROZE TALUKA,32,3407,1393,4800
NAUSHAHRO FEROZE DISTRICT,NAUSHAHRO FEROZE TALUKA,33,3179,1390,4569
NAUSHAHRO FEROZE DISTRICT,NAUSHAHRO FEROZE TALUKA,34,2633,1154,3787
NAUSHAHRO FEROZE DISTRICT,NAUSHAHRO FEROZE TALUKA,35,3764,1432,5196
NAUSHAHRO FEROZE DISTRICT,NAUSHAHRO FEROZE TALUKA,36,2604,1008,3612
NAUSHAHRO FEROZE DISTRICT,NAUSHAHRO FEROZE TALUKA,37,2503,1138,3641
NAUSHAHRO FEROZE DISTRICT,NAUSHAHRO FEROZE TALUKA,38,2779,1190,3969
NAUSHAHRO FEROZE DISTRICT,NAUSHAHRO FEROZE TALUKA,39,2466,1053,3519
NAUSHAHRO FEROZE DISTRICT,NAUSHAHRO FEROZE TALUKA,40,3371,1273,4644
NAUSHAHRO FEROZE DISTRICT,NAUSHAHRO FEROZE TALUKA,41,2118,997,3115
NAUSHAHRO FEROZE DISTRICT,NAUSHAHRO FEROZE TALUKA,42,2157,969,3126
NAUSHAHRO FEROZE DISTRICT,NAUSHAHRO FEROZE TALUKA,43,1971,889,2860
NAUSHAHRO FEROZE DISTRICT,NAUSHAHRO FEROZE TALUKA,44,1999,890,2889
NAUSHAHRO FEROZE DISTRICT,NAUSHAHRO FEROZE TALUKA,45,2624,991,3615
NAUSHAHRO FEROZE DISTRICT,NAUSHAHRO FEROZE TALUKA,46,1830,754,2584
NAUSHAHRO FEROZE DISTRICT,NAUSHAHRO FEROZE TALUKA,47,1775,810,2585
NAUSHAHRO FEROZE DISTRICT,NAUSHAHRO FEROZE TALUKA,48,1994,849,2843
NAUSHAHRO FEROZE DISTRICT,NAUSHAHRO FEROZE TALUKA,49,1772,776,2548
NAUSHAHRO FEROZE DISTRICT,NAUSHAHRO FEROZE TALUKA,50,2317,842,3159
NAUSHAHRO FEROZE DISTRICT,NAUSHAHRO FEROZE TALUKA,51,1474,625,2099
NAUSHAHRO FEROZE DISTRICT,NAUSHAHRO FEROZE TALUKA,52,1272,658,1930
NAUSHAHRO FEROZE DISTRICT,NAUSHAHRO FEROZE TALUKA,53,1324,585,1909
NAUSHAHRO FEROZE DISTRICT,NAUSHAHRO FEROZE TALUKA,54,1207,519,1726
NAUSHAHRO FEROZE DISTRICT,NAUSHAHRO FEROZE TALUKA,55,1617,624,2241
NAUSHAHRO FEROZE DISTRICT,NAUSHAHRO FEROZE TALUKA,56,931,392,1323
NAUSHAHRO FEROZE DISTRICT,NAUSHAHRO FEROZE TALUKA,57,848,381,1229
NAUSHAHRO FEROZE DISTRICT,NAUSHAHRO FEROZE TALUKA,58,951,377,1328
NAUSHAHRO FEROZE DISTRICT,NAUSHAHRO FEROZE TALUKA,59,966,393,1359
NAUSHAHRO FEROZE DISTRICT,NAUSHAHRO FEROZE TALUKA,60,1460,419,1879
NAUSHAHRO FEROZE DISTRICT,NAUSHAHRO FEROZE TALUKA,61,912,374,1286
NAUSHAHRO FEROZE DISTRICT,NAUSHAHRO FEROZE TALUKA,62,802,355,1157
NAUSHAHRO FEROZE DISTRICT,NAUSHAHRO FEROZE TALUKA,63,923,349,1272
NAUSHAHRO FEROZE DISTRICT,NAUSHAHRO FEROZE TALUKA,64,778,282,1060
NAUSHAHRO FEROZE DISTRICT,NAUSHAHRO FEROZE TALUKA,65,920,326,1246
NAUSHAHRO FEROZE DISTRICT,NAUSHAHRO FEROZE TALUKA,66,658,243,901
NAUSHAHRO FEROZE DISTRICT,NAUSHAHRO FEROZE TALUKA,67,484,203,687
NAUSHAHRO FEROZE DISTRICT,NAUSHAHRO FEROZE TALUKA,68,559,196,755
NAUSHAHRO FEROZE DISTRICT,NAUSHAHRO FEROZE TALUKA,69,541,193,734
NAUSHAHRO FEROZE DISTRICT,NAUSHAHRO FEROZE TALUKA,70,694,236,930
NAUSHAHRO FEROZE DISTRICT,NAUSHAHRO FEROZE TALUKA,71,480,188,668
NAUSHAHRO FEROZE DISTRICT,NAUSHAHRO FEROZE TALUKA,72,308,135,443
NAUSHAHRO FEROZE DISTRICT,NAUSHAHRO FEROZE TALUKA,73,386,158,544
NAUSHAHRO FEROZE DISTRICT,NAUSHAHRO FEROZE TALUKA,74,313,122,435
NAUSHAHRO FEROZE DISTRICT,NAUSHAHRO FEROZE TALUKA,>=75,2778,1020,3798
NORTH WAZIRISTAN AGENCY,DATTA KHEL TEHSIL,<1,2237,0,2237
NORTH WAZIRISTAN AGENCY,DATTA KHEL TEHSIL,1,2367,0,2367
NORTH WAZIRISTAN AGENCY,DATTA KHEL TEHSIL,2,2757,0,2757
NORTH WAZIRISTAN AGENCY,DATTA KHEL TEHSIL,3,3077,0,3077
NORTH WAZIRISTAN AGENCY,DATTA KHEL TEHSIL,4,2955,0,2955
NORTH WAZIRISTAN AGENCY,DATTA KHEL TEHSIL,5,3152,0,3152
NORTH WAZIRISTAN AGENCY,DATTA KHEL TEHSIL,6,2905,0,2905
NORTH WAZIRISTAN AGENCY,DATTA KHEL TEHSIL,7,2937,0,2937
NORTH WAZIRISTAN AGENCY,DATTA KHEL TEHSIL,8,2923,0,2923
NORTH WAZIRISTAN AGENCY,DATTA KHEL TEHSIL,9,2515,0,2515
NORTH WAZIRISTAN AGENCY,DATTA KHEL TEHSIL,10,2105,0,2105
NORTH WAZIRISTAN AGENCY,DATTA KHEL TEHSIL,11,2016,0,2016
NORTH WAZIRISTAN AGENCY,DATTA KHEL TEHSIL,12,1865,0,1865
NORTH WAZIRISTAN AGENCY,DATTA KHEL TEHSIL,13,1642,0,1642
NORTH WAZIRISTAN AGENCY,DATTA KHEL TEHSIL,14,1366,0,1366
NORTH WAZIRISTAN AGENCY,DATTA KHEL TEHSIL,15,1331,0,1331
NORTH WAZIRISTAN AGENCY,DATTA KHEL TEHSIL,16,1220,0,1220
NORTH WAZIRISTAN AGENCY,DATTA KHEL TEHSIL,17,1134,0,1134
NORTH WAZIRISTAN AGENCY,DATTA KHEL TEHSIL,18,1274,0,1274
NORTH WAZIRISTAN AGENCY,DATTA KHEL TEHSIL,19,1322,0,1322
NORTH WAZIRISTAN AGENCY,DATTA KHEL TEHSIL,20,1429,0,1429
NORTH WAZIRISTAN AGENCY,DATTA KHEL TEHSIL,21,1650,0,1650
NORTH WAZIRISTAN AGENCY,DATTA KHEL TEHSIL,22,1242,0,1242
NORTH WAZIRISTAN AGENCY,DATTA KHEL TEHSIL,23,1182,0,1182
NORTH WAZIRISTAN AGENCY,DATTA KHEL TEHSIL,24,1096,0,1096
NORTH WAZIRISTAN AGENCY,DATTA KHEL TEHSIL,25,1412,0,1412
NORTH WAZIRISTAN AGENCY,DATTA KHEL TEHSIL,26,1115,0,1115
NORTH WAZIRISTAN AGENCY,DATTA KHEL TEHSIL,27,1593,0,1593
NORTH WAZIRISTAN AGENCY,DATTA KHEL TEHSIL,28,938,0,938
NORTH WAZIRISTAN AGENCY,DATTA KHEL TEHSIL,29,1109,0,1109
NORTH WAZIRISTAN AGENCY,DATTA KHEL TEHSIL,30,982,0,982
NORTH WAZIRISTAN AGENCY,DATTA KHEL TEHSIL,31,978,0,978
NORTH WAZIRISTAN AGENCY,DATTA KHEL TEHSIL,32,974,0,974
NORTH WAZIRISTAN AGENCY,DATTA KHEL TEHSIL,33,770,0,770
NORTH WAZIRISTAN AGENCY,DATTA KHEL TEHSIL,34,588,0,588
NORTH WAZIRISTAN AGENCY,DATTA KHEL TEHSIL,35,693,0,693
NORTH WAZIRISTAN AGENCY,DATTA KHEL TEHSIL,36,547,0,547
NORTH WAZIRISTAN AGENCY,DATTA KHEL TEHSIL,37,889,0,889
NORTH WAZIRISTAN AGENCY,DATTA KHEL TEHSIL,38,544,0,544
NORTH WAZIRISTAN AGENCY,DATTA KHEL TEHSIL,39,602,0,602
NORTH WAZIRISTAN AGENCY,DATTA KHEL TEHSIL,40,595,0,595
NORTH WAZIRISTAN AGENCY,DATTA KHEL TEHSIL,41,581,0,581
NORTH WAZIRISTAN AGENCY,DATTA KHEL TEHSIL,42,614,0,614
NORTH WAZIRISTAN AGENCY,DATTA KHEL TEHSIL,43,444,0,444
NORTH WAZIRISTAN AGENCY,DATTA KHEL TEHSIL,44,373,0,373
NORTH WAZIRISTAN AGENCY,DATTA KHEL TEHSIL,45,458,0,458
NORTH WAZIRISTAN AGENCY,DATTA KHEL TEHSIL,46,357,0,357
NORTH WAZIRISTAN AGENCY,DATTA KHEL TEHSIL,47,585,0,585
NORTH WAZIRISTAN AGENCY,DATTA KHEL TEHSIL,48,390,0,390
NORTH WAZIRISTAN AGENCY,DATTA KHEL TEHSIL,49,405,0,405
NORTH WAZIRISTAN AGENCY,DATTA KHEL TEHSIL,50,460,0,460
NORTH WAZIRISTAN AGENCY,DATTA KHEL TEHSIL,51,420,0,420
NORTH WAZIRISTAN AGENCY,DATTA KHEL TEHSIL,52,467,0,467
NORTH WAZIRISTAN AGENCY,DATTA KHEL TEHSIL,53,313,0,313
NORTH WAZIRISTAN AGENCY,DATTA KHEL TEHSIL,54,311,0,311
NORTH WAZIRISTAN AGENCY,DATTA KHEL TEHSIL,55,332,0,332
NORTH WAZIRISTAN AGENCY,DATTA KHEL TEHSIL,56,309,0,309
NORTH WAZIRISTAN AGENCY,DATTA KHEL TEHSIL,57,453,0,453
NORTH WAZIRISTAN AGENCY,DATTA KHEL TEHSIL,58,238,0,238
NORTH WAZIRISTAN AGENCY,DATTA KHEL TEHSIL,59,277,0,277
NORTH WAZIRISTAN AGENCY,DATTA KHEL TEHSIL,60,272,0,272
NORTH WAZIRISTAN AGENCY,DATTA KHEL TEHSIL,61,265,0,265
NORTH WAZIRISTAN AGENCY,DATTA KHEL TEHSIL,62,347,0,347
NORTH WAZIRISTAN AGENCY,DATTA KHEL TEHSIL,63,207,0,207
NORTH WAZIRISTAN AGENCY,DATTA KHEL TEHSIL,64,186,0,186
NORTH WAZIRISTAN AGENCY,DATTA KHEL TEHSIL,65,162,0,162
NORTH WAZIRISTAN AGENCY,DATTA KHEL TEHSIL,66,162,0,162
NORTH WAZIRISTAN AGENCY,DATTA KHEL TEHSIL,67,260,0,260
NORTH WAZIRISTAN AGENCY,DATTA KHEL TEHSIL,68,121,0,121
NORTH WAZIRISTAN AGENCY,DATTA KHEL TEHSIL,69,129,0,129
NORTH WAZIRISTAN AGENCY,DATTA KHEL TEHSIL,70,98,0,98
NORTH WAZIRISTAN AGENCY,DATTA KHEL TEHSIL,71,104,0,104
NORTH WAZIRISTAN AGENCY,DATTA KHEL TEHSIL,72,126,0,126
NORTH WAZIRISTAN AGENCY,DATTA KHEL TEHSIL,73,69,0,69
NORTH WAZIRISTAN AGENCY,DATTA KHEL TEHSIL,74,65,0,65
NORTH WAZIRISTAN AGENCY,DATTA KHEL TEHSIL,>=75,615,0,615
NORTH WAZIRISTAN AGENCY,DOSSALI TEHSIL,<1,1219,0,1219
NORTH WAZIRISTAN AGENCY,DOSSALI TEHSIL,1,1195,0,1195
NORTH WAZIRISTAN AGENCY,DOSSALI TEHSIL,2,1606,0,1606
NORTH WAZIRISTAN AGENCY,DOSSALI TEHSIL,3,1722,0,1722
NORTH WAZIRISTAN AGENCY,DOSSALI TEHSIL,4,1675,0,1675
NORTH WAZIRISTAN AGENCY,DOSSALI TEHSIL,5,1639,0,1639
NORTH WAZIRISTAN AGENCY,DOSSALI TEHSIL,6,1623,0,1623
NORTH WAZIRISTAN AGENCY,DOSSALI TEHSIL,7,1502,0,1502
NORTH WAZIRISTAN AGENCY,DOSSALI TEHSIL,8,1555,0,1555
NORTH WAZIRISTAN AGENCY,DOSSALI TEHSIL,9,1257,0,1257
NORTH WAZIRISTAN AGENCY,DOSSALI TEHSIL,10,1234,0,1234
NORTH WAZIRISTAN AGENCY,DOSSALI TEHSIL,11,984,0,984
NORTH WAZIRISTAN AGENCY,DOSSALI TEHSIL,12,933,0,933
NORTH WAZIRISTAN AGENCY,DOSSALI TEHSIL,13,839,0,839
NORTH WAZIRISTAN AGENCY,DOSSALI TEHSIL,14,706,0,706
NORTH WAZIRISTAN AGENCY,DOSSALI TEHSIL,15,752,0,752
NORTH WAZIRISTAN AGENCY,DOSSALI TEHSIL,16,629,0,629
NORTH WAZIRISTAN AGENCY,DOSSALI TEHSIL,17,549,0,549
NORTH WAZIRISTAN AGENCY,DOSSALI TEHSIL,18,803,0,803
NORTH WAZIRISTAN AGENCY,DOSSALI TEHSIL,19,787,0,787
NORTH WAZIRISTAN AGENCY,DOSSALI TEHSIL,20,804,0,804
NORTH WAZIRISTAN AGENCY,DOSSALI TEHSIL,21,768,0,768
NORTH WAZIRISTAN AGENCY,DOSSALI TEHSIL,22,712,0,712
NORTH WAZIRISTAN AGENCY,DOSSALI TEHSIL,23,690,0,690
NORTH WAZIRISTAN AGENCY,DOSSALI TEHSIL,24,618,0,618
NORTH WAZIRISTAN AGENCY,DOSSALI TEHSIL,25,846,0,846
NORTH WAZIRISTAN AGENCY,DOSSALI TEHSIL,26,590,0,590
NORTH WAZIRISTAN AGENCY,DOSSALI TEHSIL,27,672,0,672
NORTH WAZIRISTAN AGENCY,DOSSALI TEHSIL,28,624,0,624
NORTH WAZIRISTAN AGENCY,DOSSALI TEHSIL,29,628,0,628
NORTH WAZIRISTAN AGENCY,DOSSALI TEHSIL,30,668,0,668
NORTH WAZIRISTAN AGENCY,DOSSALI TEHSIL,31,466,0,466
NORTH WAZIRISTAN AGENCY,DOSSALI TEHSIL,32,383,0,383
NORTH WAZIRISTAN AGENCY,DOSSALI TEHSIL,33,470,0,470
NORTH WAZIRISTAN AGENCY,DOSSALI TEHSIL,34,332,0,332
NORTH WAZIRISTAN AGENCY,DOSSALI TEHSIL,35,436,0,436
NORTH WAZIRISTAN AGENCY,DOSSALI TEHSIL,36,333,0,333
NORTH WAZIRISTAN AGENCY,DOSSALI TEHSIL,37,302,0,302
NORTH WAZIRISTAN AGENCY,DOSSALI TEHSIL,38,377,0,377
NORTH WAZIRISTAN AGENCY,DOSSALI TEHSIL,39,367,0,367
NORTH WAZIRISTAN AGENCY,DOSSALI TEHSIL,40,460,0,460
NORTH WAZIRISTAN AGENCY,DOSSALI TEHSIL,41,303,0,303
NORTH WAZIRISTAN AGENCY,DOSSALI TEHSIL,42,229,0,229
NORTH WAZIRISTAN AGENCY,DOSSALI TEHSIL,43,259,0,259
NORTH WAZIRISTAN AGENCY,DOSSALI TEHSIL,44,183,0,183
NORTH WAZIRISTAN AGENCY,DOSSALI TEHSIL,45,269,0,269
NORTH WAZIRISTAN AGENCY,DOSSALI TEHSIL,46,196,0,196
NORTH WAZIRISTAN AGENCY,DOSSALI TEHSIL,47,177,0,177
NORTH WAZIRISTAN AGENCY,DOSSALI TEHSIL,48,234,0,234
NORTH WAZIRISTAN AGENCY,DOSSALI TEHSIL,49,172,0,172
NORTH WAZIRISTAN AGENCY,DOSSALI TEHSIL,50,303,0,303
NORTH WAZIRISTAN AGENCY,DOSSALI TEHSIL,51,161,0,161
NORTH WAZIRISTAN AGENCY,DOSSALI TEHSIL,52,128,0,128
NORTH WAZIRISTAN AGENCY,DOSSALI TEHSIL,53,169,0,169
NORTH WAZIRISTAN AGENCY,DOSSALI TEHSIL,54,171,0,171
NORTH WAZIRISTAN AGENCY,DOSSALI TEHSIL,55,212,0,212
NORTH WAZIRISTAN AGENCY,DOSSALI TEHSIL,56,109,0,109
NORTH WAZIRISTAN AGENCY,DOSSALI TEHSIL,57,121,0,121
NORTH WAZIRISTAN AGENCY,DOSSALI TEHSIL,58,114,0,114
NORTH WAZIRISTAN AGENCY,DOSSALI TEHSIL,59,131,0,131
NORTH WAZIRISTAN AGENCY,DOSSALI TEHSIL,60,163,0,163
NORTH WAZIRISTAN AGENCY,DOSSALI TEHSIL,61,115,0,115
NORTH WAZIRISTAN AGENCY,DOSSALI TEHSIL,62,133,0,133
NORTH WAZIRISTAN AGENCY,DOSSALI TEHSIL,63,131,0,131
NORTH WAZIRISTAN AGENCY,DOSSALI TEHSIL,64,96,0,96
NORTH WAZIRISTAN AGENCY,DOSSALI TEHSIL,65,102,0,102
NORTH WAZIRISTAN AGENCY,DOSSALI TEHSIL,66,77,0,77
NORTH WAZIRISTAN AGENCY,DOSSALI TEHSIL,67,57,0,57
NORTH WAZIRISTAN AGENCY,DOSSALI TEHSIL,68,62,0,62
NORTH WAZIRISTAN AGENCY,DOSSALI TEHSIL,69,51,0,51
NORTH WAZIRISTAN AGENCY,DOSSALI TEHSIL,70,62,0,62
NORTH WAZIRISTAN AGENCY,DOSSALI TEHSIL,71,57,0,57
NORTH WAZIRISTAN AGENCY,DOSSALI TEHSIL,72,35,0,35
NORTH WAZIRISTAN AGENCY,DOSSALI TEHSIL,73,38,0,38
NORTH WAZIRISTAN AGENCY,DOSSALI TEHSIL,74,46,0,46
NORTH WAZIRISTAN AGENCY,DOSSALI TEHSIL,>=75,324,0,324
NORTH WAZIRISTAN AGENCY,GHARYUM TEHSIL,<1,399,0,399
NORTH WAZIRISTAN AGENCY,GHARYUM TEHSIL,1,283,0,283
NORTH WAZIRISTAN AGENCY,GHARYUM TEHSIL,2,488,0,488
NORTH WAZIRISTAN AGENCY,GHARYUM TEHSIL,3,383,0,383
NORTH WAZIRISTAN AGENCY,GHARYUM TEHSIL,4,545,0,545
NORTH WAZIRISTAN AGENCY,GHARYUM TEHSIL,5,387,0,387
NORTH WAZIRISTAN AGENCY,GHARYUM TEHSIL,6,569,0,569
NORTH WAZIRISTAN AGENCY,GHARYUM TEHSIL,7,302,0,302
NORTH WAZIRISTAN AGENCY,GHARYUM TEHSIL,8,556,0,556
NORTH WAZIRISTAN AGENCY,GHARYUM TEHSIL,9,349,0,349
NORTH WAZIRISTAN AGENCY,GHARYUM TEHSIL,10,508,0,508
NORTH WAZIRISTAN AGENCY,GHARYUM TEHSIL,11,263,0,263
NORTH WAZIRISTAN AGENCY,GHARYUM TEHSIL,12,371,0,371
NORTH WAZIRISTAN AGENCY,GHARYUM TEHSIL,13,179,0,179
NORTH WAZIRISTAN AGENCY,GHARYUM TEHSIL,14,283,0,283
NORTH WAZIRISTAN AGENCY,GHARYUM TEHSIL,15,197,0,197
NORTH WAZIRISTAN AGENCY,GHARYUM TEHSIL,16,224,0,224
NORTH WAZIRISTAN AGENCY,GHARYUM TEHSIL,17,131,0,131
NORTH WAZIRISTAN AGENCY,GHARYUM TEHSIL,18,251,0,251
NORTH WAZIRISTAN AGENCY,GHARYUM TEHSIL,19,167,0,167
NORTH WAZIRISTAN AGENCY,GHARYUM TEHSIL,20,305,0,305
NORTH WAZIRISTAN AGENCY,GHARYUM TEHSIL,21,203,0,203
NORTH WAZIRISTAN AGENCY,GHARYUM TEHSIL,22,194,0,194
NORTH WAZIRISTAN AGENCY,GHARYUM TEHSIL,23,174,0,174
NORTH WAZIRISTAN AGENCY,GHARYUM TEHSIL,24,135,0,135
NORTH WAZIRISTAN AGENCY,GHARYUM TEHSIL,25,279,0,279
NORTH WAZIRISTAN AGENCY,GHARYUM TEHSIL,26,160,0,160
NORTH WAZIRISTAN AGENCY,GHARYUM TEHSIL,27,190,0,190
NORTH WAZIRISTAN AGENCY,GHARYUM TEHSIL,28,178,0,178
NORTH WAZIRISTAN AGENCY,GHARYUM TEHSIL,29,152,0,152
NORTH WAZIRISTAN AGENCY,GHARYUM TEHSIL,30,242,0,242
NORTH WAZIRISTAN AGENCY,GHARYUM TEHSIL,31,150,0,150
NORTH WAZIRISTAN AGENCY,GHARYUM TEHSIL,32,119,0,119
NORTH WAZIRISTAN AGENCY,GHARYUM TEHSIL,33,138,0,138
NORTH WAZIRISTAN AGENCY,GHARYUM TEHSIL,34,76,0,76
NORTH WAZIRISTAN AGENCY,GHARYUM TEHSIL,35,144,0,144
NORTH WAZIRISTAN AGENCY,GHARYUM TEHSIL,36,102,0,102
NORTH WAZIRISTAN AGENCY,GHARYUM TEHSIL,37,101,0,101
NORTH WAZIRISTAN AGENCY,GHARYUM TEHSIL,38,118,0,118
NORTH WAZIRISTAN AGENCY,GHARYUM TEHSIL,39,103,0,103
NORTH WAZIRISTAN AGENCY,GHARYUM TEHSIL,40,191,0,191
NORTH WAZIRISTAN AGENCY,GHARYUM TEHSIL,41,99,0,99
NORTH WAZIRISTAN AGENCY,GHARYUM TEHSIL,42,58,0,58
NORTH WAZIRISTAN AGENCY,GHARYUM TEHSIL,43,79,0,79
NORTH WAZIRISTAN AGENCY,GHARYUM TEHSIL,44,73,0,73
NORTH WAZIRISTAN AGENCY,GHARYUM TEHSIL,45,120,0,120
NORTH WAZIRISTAN AGENCY,GHARYUM TEHSIL,46,36,0,36
NORTH WAZIRISTAN AGENCY,GHARYUM TEHSIL,47,47,0,47
NORTH WAZIRISTAN AGENCY,GHARYUM TEHSIL,48,30,0,30
NORTH WAZIRISTAN AGENCY,GHARYUM TEHSIL,49,66,0,66
NORTH WAZIRISTAN AGENCY,GHARYUM TEHSIL,50,114,0,114
NORTH WAZIRISTAN AGENCY,GHARYUM TEHSIL,51,46,0,46
NORTH WAZIRISTAN AGENCY,GHARYUM TEHSIL,52,39,0,39
NORTH WAZIRISTAN AGENCY,GHARYUM TEHSIL,53,66,0,66
NORTH WAZIRISTAN AGENCY,GHARYUM TEHSIL,54,42,0,42
NORTH WAZIRISTAN AGENCY,GHARYUM TEHSIL,55,58,0,58
NORTH WAZIRISTAN AGENCY,GHARYUM TEHSIL,56,30,0,30
NORTH WAZIRISTAN AGENCY,GHARYUM TEHSIL,57,35,0,35
NORTH WAZIRISTAN AGENCY,GHARYUM TEHSIL,58,27,0,27
NORTH WAZIRISTAN AGENCY,GHARYUM TEHSIL,59,22,0,22
NORTH WAZIRISTAN AGENCY,GHARYUM TEHSIL,60,61,0,61
NORTH WAZIRISTAN AGENCY,GHARYUM TEHSIL,61,36,0,36
NORTH WAZIRISTAN AGENCY,GHARYUM TEHSIL,62,30,0,30
NORTH WAZIRISTAN AGENCY,GHARYUM TEHSIL,63,29,0,29
NORTH WAZIRISTAN AGENCY,GHARYUM TEHSIL,64,28,0,28
NORTH WAZIRISTAN AGENCY,GHARYUM TEHSIL,65,24,0,24
NORTH WAZIRISTAN AGENCY,GHARYUM TEHSIL,66,16,0,16
NORTH WAZIRISTAN AGENCY,GHARYUM TEHSIL,67,19,0,19
NORTH WAZIRISTAN AGENCY,GHARYUM TEHSIL,68,13,0,13
NORTH WAZIRISTAN AGENCY,GHARYUM TEHSIL,69,20,0,20
NORTH WAZIRISTAN AGENCY,GHARYUM TEHSIL,70,29,0,29
NORTH WAZIRISTAN AGENCY,GHARYUM TEHSIL,71,9,0,9
NORTH WAZIRISTAN AGENCY,GHARYUM TEHSIL,72,10,0,10
NORTH WAZIRISTAN AGENCY,GHARYUM TEHSIL,73,15,0,15
NORTH WAZIRISTAN AGENCY,GHARYUM TEHSIL,74,5,0,5
NORTH WAZIRISTAN AGENCY,GHARYUM TEHSIL,>=75,91,0,91
NORTH WAZIRISTAN AGENCY,GHULAM KHAN TEHSIL,<1,873,0,873
NORTH WAZIRISTAN AGENCY,GHULAM KHAN TEHSIL,1,863,0,863
NORTH WAZIRISTAN AGENCY,GHULAM KHAN TEHSIL,2,1126,0,1126
NORTH WAZIRISTAN AGENCY,GHULAM KHAN TEHSIL,3,1095,0,1095
NORTH WAZIRISTAN AGENCY,GHULAM KHAN TEHSIL,4,1170,0,1170
NORTH WAZIRISTAN AGENCY,GHULAM KHAN TEHSIL,5,1043,0,1043
NORTH WAZIRISTAN AGENCY,GHULAM KHAN TEHSIL,6,1004,0,1004
NORTH WAZIRISTAN AGENCY,GHULAM KHAN TEHSIL,7,1075,0,1075
NORTH WAZIRISTAN AGENCY,GHULAM KHAN TEHSIL,8,1031,0,1031
NORTH WAZIRISTAN AGENCY,GHULAM KHAN TEHSIL,9,934,0,934
NORTH WAZIRISTAN AGENCY,GHULAM KHAN TEHSIL,10,824,0,824
NORTH WAZIRISTAN AGENCY,GHULAM KHAN TEHSIL,11,697,0,697
NORTH WAZIRISTAN AGENCY,GHULAM KHAN TEHSIL,12,621,0,621
NORTH WAZIRISTAN AGENCY,GHULAM KHAN TEHSIL,13,587,0,587
NORTH WAZIRISTAN AGENCY,GHULAM KHAN TEHSIL,14,498,0,498
NORTH WAZIRISTAN AGENCY,GHULAM KHAN TEHSIL,15,444,0,444
NORTH WAZIRISTAN AGENCY,GHULAM KHAN TEHSIL,16,387,0,387
NORTH WAZIRISTAN AGENCY,GHULAM KHAN TEHSIL,17,460,0,460
NORTH WAZIRISTAN AGENCY,GHULAM KHAN TEHSIL,18,418,0,418
NORTH WAZIRISTAN AGENCY,GHULAM KHAN TEHSIL,19,452,0,452
NORTH WAZIRISTAN AGENCY,GHULAM KHAN TEHSIL,20,564,0,564
NORTH WAZIRISTAN AGENCY,GHULAM KHAN TEHSIL,21,632,0,632
NORTH WAZIRISTAN AGENCY,GHULAM KHAN TEHSIL,22,478,0,478
NORTH WAZIRISTAN AGENCY,GHULAM KHAN TEHSIL,23,490,0,490
NORTH WAZIRISTAN AGENCY,GHULAM KHAN TEHSIL,24,501,0,501
NORTH WAZIRISTAN AGENCY,GHULAM KHAN TEHSIL,25,529,0,529
NORTH WAZIRISTAN AGENCY,GHULAM KHAN TEHSIL,26,483,0,483
NORTH WAZIRISTAN AGENCY,GHULAM KHAN TEHSIL,27,573,0,573
NORTH WAZIRISTAN AGENCY,GHULAM KHAN TEHSIL,28,364,0,364
NORTH WAZIRISTAN AGENCY,GHULAM KHAN TEHSIL,29,429,0,429
NORTH WAZIRISTAN AGENCY,GHULAM KHAN TEHSIL,30,368,0,368
NORTH WAZIRISTAN AGENCY,GHULAM KHAN TEHSIL,31,411,0,411
NORTH WAZIRISTAN AGENCY,GHULAM KHAN TEHSIL,32,277,0,277
NORTH WAZIRISTAN AGENCY,GHULAM KHAN TEHSIL,33,294,0,294
NORTH WAZIRISTAN AGENCY,GHULAM KHAN TEHSIL,34,236,0,236
NORTH WAZIRISTAN AGENCY,GHULAM KHAN TEHSIL,35,236,0,236
NORTH WAZIRISTAN AGENCY,GHULAM KHAN TEHSIL,36,247,0,247
NORTH WAZIRISTAN AGENCY,GHULAM KHAN TEHSIL,37,273,0,273
NORTH WAZIRISTAN AGENCY,GHULAM KHAN TEHSIL,38,231,0,231
NORTH WAZIRISTAN AGENCY,GHULAM KHAN TEHSIL,39,205,0,205
NORTH WAZIRISTAN AGENCY,GHULAM KHAN TEHSIL,40,244,0,244
NORTH WAZIRISTAN AGENCY,GHULAM KHAN TEHSIL,41,220,0,220
NORTH WAZIRISTAN AGENCY,GHULAM KHAN TEHSIL,42,151,0,151
NORTH WAZIRISTAN AGENCY,GHULAM KHAN TEHSIL,43,168,0,168
NORTH WAZIRISTAN AGENCY,GHULAM KHAN TEHSIL,44,114,0,114
NORTH WAZIRISTAN AGENCY,GHULAM KHAN TEHSIL,45,119,0,119
NORTH WAZIRISTAN AGENCY,GHULAM KHAN TEHSIL,46,113,0,113
NORTH WAZIRISTAN AGENCY,GHULAM KHAN TEHSIL,47,139,0,139
NORTH WAZIRISTAN AGENCY,GHULAM KHAN TEHSIL,48,109,0,109
NORTH WAZIRISTAN AGENCY,GHULAM KHAN TEHSIL,49,108,0,108
NORTH WAZIRISTAN AGENCY,GHULAM KHAN TEHSIL,50,147,0,147
NORTH WAZIRISTAN AGENCY,GHULAM KHAN TEHSIL,51,141,0,141
NORTH WAZIRISTAN AGENCY,GHULAM KHAN TEHSIL,52,109,0,109
NORTH WAZIRISTAN AGENCY,GHULAM KHAN TEHSIL,53,88,0,88
NORTH WAZIRISTAN AGENCY,GHULAM KHAN TEHSIL,54,92,0,92
NORTH WAZIRISTAN AGENCY,GHULAM KHAN TEHSIL,55,129,0,129
NORTH WAZIRISTAN AGENCY,GHULAM KHAN TEHSIL,56,110,0,110
NORTH WAZIRISTAN AGENCY,GHULAM KHAN TEHSIL,57,123,0,123
NORTH WAZIRISTAN AGENCY,GHULAM KHAN TEHSIL,58,88,0,88
NORTH WAZIRISTAN AGENCY,GHULAM KHAN TEHSIL,59,86,0,86
NORTH WAZIRISTAN AGENCY,GHULAM KHAN TEHSIL,60,84,0,84
NORTH WAZIRISTAN AGENCY,GHULAM KHAN TEHSIL,61,98,0,98
NORTH WAZIRISTAN AGENCY,GHULAM KHAN TEHSIL,62,101,0,101
NORTH WAZIRISTAN AGENCY,GHULAM KHAN TEHSIL,63,73,0,73
NORTH WAZIRISTAN AGENCY,GHULAM KHAN TEHSIL,64,69,0,69
NORTH WAZIRISTAN AGENCY,GHULAM KHAN TEHSIL,65,49,0,49
NORTH WAZIRISTAN AGENCY,GHULAM KHAN TEHSIL,66,67,0,67
NORTH WAZIRISTAN AGENCY,GHULAM KHAN TEHSIL,67,62,0,62
NORTH WAZIRISTAN AGENCY,GHULAM KHAN TEHSIL,68,42,0,42
NORTH WAZIRISTAN AGENCY,GHULAM KHAN TEHSIL,69,31,0,31
NORTH WAZIRISTAN AGENCY,GHULAM KHAN TEHSIL,70,36,0,36
NORTH WAZIRISTAN AGENCY,GHULAM KHAN TEHSIL,71,29,0,29
NORTH WAZIRISTAN AGENCY,GHULAM KHAN TEHSIL,72,28,0,28
NORTH WAZIRISTAN AGENCY,GHULAM KHAN TEHSIL,73,21,0,21
NORTH WAZIRISTAN AGENCY,GHULAM KHAN TEHSIL,74,17,0,17
NORTH WAZIRISTAN AGENCY,GHULAM KHAN TEHSIL,>=75,187,0,187
NORTH WAZIRISTAN AGENCY,MIR ALI TEHSIL,<1,5836,0,5836
NORTH WAZIRISTAN AGENCY,MIR ALI TEHSIL,1,6216,0,6216
NORTH WAZIRISTAN AGENCY,MIR ALI TEHSIL,2,7130,0,7130
NORTH WAZIRISTAN AGENCY,MIR ALI TEHSIL,3,7330,0,7330
NORTH WAZIRISTAN AGENCY,MIR ALI TEHSIL,4,7644,0,7644
NORTH WAZIRISTAN AGENCY,MIR ALI TEHSIL,5,6933,0,6933
NORTH WAZIRISTAN AGENCY,MIR ALI TEHSIL,6,7299,0,7299
NORTH WAZIRISTAN AGENCY,MIR ALI TEHSIL,7,6402,0,6402
NORTH WAZIRISTAN AGENCY,MIR ALI TEHSIL,8,7193,0,7193
NORTH WAZIRISTAN AGENCY,MIR ALI TEHSIL,9,5725,0,5725
NORTH WAZIRISTAN AGENCY,MIR ALI TEHSIL,10,6164,0,6164
NORTH WAZIRISTAN AGENCY,MIR ALI TEHSIL,11,4681,0,4681
NORTH WAZIRISTAN AGENCY,MIR ALI TEHSIL,12,4917,0,4917
NORTH WAZIRISTAN AGENCY,MIR ALI TEHSIL,13,4221,0,4221
NORTH WAZIRISTAN AGENCY,MIR ALI TEHSIL,14,4033,0,4033
NORTH WAZIRISTAN AGENCY,MIR ALI TEHSIL,15,3932,0,3932
NORTH WAZIRISTAN AGENCY,MIR ALI TEHSIL,16,3410,0,3410
NORTH WAZIRISTAN AGENCY,MIR ALI TEHSIL,17,3517,0,3517
NORTH WAZIRISTAN AGENCY,MIR ALI TEHSIL,18,3654,0,3654
NORTH WAZIRISTAN AGENCY,MIR ALI TEHSIL,19,3307,0,3307
NORTH WAZIRISTAN AGENCY,MIR ALI TEHSIL,20,4280,0,4280
NORTH WAZIRISTAN AGENCY,MIR ALI TEHSIL,21,3841,0,3841
NORTH WAZIRISTAN AGENCY,MIR ALI TEHSIL,22,3315,0,3315
NORTH WAZIRISTAN AGENCY,MIR ALI TEHSIL,23,3065,0,3065
NORTH WAZIRISTAN AGENCY,MIR ALI TEHSIL,24,2737,0,2737
NORTH WAZIRISTAN AGENCY,MIR ALI TEHSIL,25,3622,0,3622
NORTH WAZIRISTAN AGENCY,MIR ALI TEHSIL,26,2689,0,2689
NORTH WAZIRISTAN AGENCY,MIR ALI TEHSIL,27,3037,0,3037
NORTH WAZIRISTAN AGENCY,MIR ALI TEHSIL,28,2738,0,2738
NORTH WAZIRISTAN AGENCY,MIR ALI TEHSIL,29,2661,0,2661
NORTH WAZIRISTAN AGENCY,MIR ALI TEHSIL,30,2802,0,2802
NORTH WAZIRISTAN AGENCY,MIR ALI TEHSIL,31,2268,0,2268
NORTH WAZIRISTAN AGENCY,MIR ALI TEHSIL,32,1919,0,1919
NORTH WAZIRISTAN AGENCY,MIR ALI TEHSIL,33,2122,0,2122
NORTH WAZIRISTAN AGENCY,MIR ALI TEHSIL,34,1653,0,1653
NORTH WAZIRISTAN AGENCY,MIR ALI TEHSIL,35,1839,0,1839
NORTH WAZIRISTAN AGENCY,MIR ALI TEHSIL,36,1397,0,1397
NORTH WAZIRISTAN AGENCY,MIR ALI TEHSIL,37,1454,0,1454
NORTH WAZIRISTAN AGENCY,MIR ALI TEHSIL,38,1534,0,1534
NORTH WAZIRISTAN AGENCY,MIR ALI TEHSIL,39,1393,0,1393
NORTH WAZIRISTAN AGENCY,MIR ALI TEHSIL,40,1886,0,1886
NORTH WAZIRISTAN AGENCY,MIR ALI TEHSIL,41,1272,0,1272
NORTH WAZIRISTAN AGENCY,MIR ALI TEHSIL,42,1113,0,1113
NORTH WAZIRISTAN AGENCY,MIR ALI TEHSIL,43,1138,0,1138
NORTH WAZIRISTAN AGENCY,MIR ALI TEHSIL,44,990,0,990
NORTH WAZIRISTAN AGENCY,MIR ALI TEHSIL,45,1303,0,1303
NORTH WAZIRISTAN AGENCY,MIR ALI TEHSIL,46,794,0,794
NORTH WAZIRISTAN AGENCY,MIR ALI TEHSIL,47,889,0,889
NORTH WAZIRISTAN AGENCY,MIR ALI TEHSIL,48,809,0,809
NORTH WAZIRISTAN AGENCY,MIR ALI TEHSIL,49,924,0,924
NORTH WAZIRISTAN AGENCY,MIR ALI TEHSIL,50,1237,0,1237
NORTH WAZIRISTAN AGENCY,MIR ALI TEHSIL,51,825,0,825
NORTH WAZIRISTAN AGENCY,MIR ALI TEHSIL,52,666,0,666
NORTH WAZIRISTAN AGENCY,MIR ALI TEHSIL,53,765,0,765
NORTH WAZIRISTAN AGENCY,MIR ALI TEHSIL,54,688,0,688
NORTH WAZIRISTAN AGENCY,MIR ALI TEHSIL,55,874,0,874
NORTH WAZIRISTAN AGENCY,MIR ALI TEHSIL,56,584,0,584
NORTH WAZIRISTAN AGENCY,MIR ALI TEHSIL,57,674,0,674
NORTH WAZIRISTAN AGENCY,MIR ALI TEHSIL,58,525,0,525
NORTH WAZIRISTAN AGENCY,MIR ALI TEHSIL,59,545,0,545
NORTH WAZIRISTAN AGENCY,MIR ALI TEHSIL,60,782,0,782
NORTH WAZIRISTAN AGENCY,MIR ALI TEHSIL,61,538,0,538
NORTH WAZIRISTAN AGENCY,MIR ALI TEHSIL,62,601,0,601
NORTH WAZIRISTAN AGENCY,MIR ALI TEHSIL,63,511,0,511
NORTH WAZIRISTAN AGENCY,MIR ALI TEHSIL,64,437,0,437
NORTH WAZIRISTAN AGENCY,MIR ALI TEHSIL,65,449,0,449
NORTH WAZIRISTAN AGENCY,MIR ALI TEHSIL,66,341,0,341
NORTH WAZIRISTAN AGENCY,MIR ALI TEHSIL,67,332,0,332
NORTH WAZIRISTAN AGENCY,MIR ALI TEHSIL,68,249,0,249
NORTH WAZIRISTAN AGENCY,MIR ALI TEHSIL,69,234,0,234
NORTH WAZIRISTAN AGENCY,MIR ALI TEHSIL,70,252,0,252
NORTH WAZIRISTAN AGENCY,MIR ALI TEHSIL,71,216,0,216
NORTH WAZIRISTAN AGENCY,MIR ALI TEHSIL,72,154,0,154
NORTH WAZIRISTAN AGENCY,MIR ALI TEHSIL,73,145,0,145
NORTH WAZIRISTAN AGENCY,MIR ALI TEHSIL,74,126,0,126
NORTH WAZIRISTAN AGENCY,MIR ALI TEHSIL,>=75,1208,0,1208
NORTH WAZIRISTAN AGENCY,MIRAN SHAH TEHSIL,<1,2755,37,2792
NORTH WAZIRISTAN AGENCY,MIRAN SHAH TEHSIL,1,3165,58,3223
NORTH WAZIRISTAN AGENCY,MIRAN SHAH TEHSIL,2,3522,60,3582
NORTH WAZIRISTAN AGENCY,MIRAN SHAH TEHSIL,3,3801,64,3865
NORTH WAZIRISTAN AGENCY,MIRAN SHAH TEHSIL,4,3813,64,3877
NORTH WAZIRISTAN AGENCY,MIRAN SHAH TEHSIL,5,3837,66,3903
NORTH WAZIRISTAN AGENCY,MIRAN SHAH TEHSIL,6,3710,70,3780
NORTH WAZIRISTAN AGENCY,MIRAN SHAH TEHSIL,7,3600,83,3683
NORTH WAZIRISTAN AGENCY,MIRAN SHAH TEHSIL,8,3738,68,3806
NORTH WAZIRISTAN AGENCY,MIRAN SHAH TEHSIL,9,3074,74,3148
NORTH WAZIRISTAN AGENCY,MIRAN SHAH TEHSIL,10,3140,54,3194
NORTH WAZIRISTAN AGENCY,MIRAN SHAH TEHSIL,11,2697,74,2771
NORTH WAZIRISTAN AGENCY,MIRAN SHAH TEHSIL,12,2576,70,2646
NORTH WAZIRISTAN AGENCY,MIRAN SHAH TEHSIL,13,2351,77,2428
NORTH WAZIRISTAN AGENCY,MIRAN SHAH TEHSIL,14,2139,70,2209
NORTH WAZIRISTAN AGENCY,MIRAN SHAH TEHSIL,15,2081,69,2150
NORTH WAZIRISTAN AGENCY,MIRAN SHAH TEHSIL,16,1763,60,1823
NORTH WAZIRISTAN AGENCY,MIRAN SHAH TEHSIL,17,1535,54,1589
NORTH WAZIRISTAN AGENCY,MIRAN SHAH TEHSIL,18,1937,53,1990
NORTH WAZIRISTAN AGENCY,MIRAN SHAH TEHSIL,19,1850,67,1917
NORTH WAZIRISTAN AGENCY,MIRAN SHAH TEHSIL,20,2078,87,2165
NORTH WAZIRISTAN AGENCY,MIRAN SHAH TEHSIL,21,2006,122,2128
NORTH WAZIRISTAN AGENCY,MIRAN SHAH TEHSIL,22,1792,110,1902
NORTH WAZIRISTAN AGENCY,MIRAN SHAH TEHSIL,23,1657,146,1803
NORTH WAZIRISTAN AGENCY,MIRAN SHAH TEHSIL,24,1432,131,1563
NORTH WAZIRISTAN AGENCY,MIRAN SHAH TEHSIL,25,1771,133,1904
NORTH WAZIRISTAN AGENCY,MIRAN SHAH TEHSIL,26,1444,178,1622
NORTH WAZIRISTAN AGENCY,MIRAN SHAH TEHSIL,27,1638,173,1811
NORTH WAZIRISTAN AGENCY,MIRAN SHAH TEHSIL,28,1315,156,1471
NORTH WAZIRISTAN AGENCY,MIRAN SHAH TEHSIL,29,1369,218,1587
NORTH WAZIRISTAN AGENCY,MIRAN SHAH TEHSIL,30,1336,171,1507
NORTH WAZIRISTAN AGENCY,MIRAN SHAH TEHSIL,31,1104,168,1272
NORTH WAZIRISTAN AGENCY,MIRAN SHAH TEHSIL,32,1007,116,1123
NORTH WAZIRISTAN AGENCY,MIRAN SHAH TEHSIL,33,1009,136,1145
NORTH WAZIRISTAN AGENCY,MIRAN SHAH TEHSIL,34,863,121,984
NORTH WAZIRISTAN AGENCY,MIRAN SHAH TEHSIL,35,939,84,1023
NORTH WAZIRISTAN AGENCY,MIRAN SHAH TEHSIL,36,771,93,864
NORTH WAZIRISTAN AGENCY,MIRAN SHAH TEHSIL,37,839,77,916
NORTH WAZIRISTAN AGENCY,MIRAN SHAH TEHSIL,38,807,75,882
NORTH WAZIRISTAN AGENCY,MIRAN SHAH TEHSIL,39,741,91,832
NORTH WAZIRISTAN AGENCY,MIRAN SHAH TEHSIL,40,910,43,953
NORTH WAZIRISTAN AGENCY,MIRAN SHAH TEHSIL,41,662,50,712
NORTH WAZIRISTAN AGENCY,MIRAN SHAH TEHSIL,42,618,43,661
NORTH WAZIRISTAN AGENCY,MIRAN SHAH TEHSIL,43,623,52,675
NORTH WAZIRISTAN AGENCY,MIRAN SHAH TEHSIL,44,518,31,549
NORTH WAZIRISTAN AGENCY,MIRAN SHAH TEHSIL,45,595,36,631
NORTH WAZIRISTAN AGENCY,MIRAN SHAH TEHSIL,46,414,27,441
NORTH WAZIRISTAN AGENCY,MIRAN SHAH TEHSIL,47,557,26,583
NORTH WAZIRISTAN AGENCY,MIRAN SHAH TEHSIL,48,391,19,410
NORTH WAZIRISTAN AGENCY,MIRAN SHAH TEHSIL,49,460,18,478
NORTH WAZIRISTAN AGENCY,MIRAN SHAH TEHSIL,50,600,18,618
NORTH WAZIRISTAN AGENCY,MIRAN SHAH TEHSIL,51,404,12,416
NORTH WAZIRISTAN AGENCY,MIRAN SHAH TEHSIL,52,408,10,418
NORTH WAZIRISTAN AGENCY,MIRAN SHAH TEHSIL,53,420,8,428
NORTH WAZIRISTAN AGENCY,MIRAN SHAH TEHSIL,54,360,11,371
NORTH WAZIRISTAN AGENCY,MIRAN SHAH TEHSIL,55,432,12,444
NORTH WAZIRISTAN AGENCY,MIRAN SHAH TEHSIL,56,337,3,340
NORTH WAZIRISTAN AGENCY,MIRAN SHAH TEHSIL,57,410,9,419
NORTH WAZIRISTAN AGENCY,MIRAN SHAH TEHSIL,58,285,8,293
NORTH WAZIRISTAN AGENCY,MIRAN SHAH TEHSIL,59,305,2,307
NORTH WAZIRISTAN AGENCY,MIRAN SHAH TEHSIL,60,399,4,403
NORTH WAZIRISTAN AGENCY,MIRAN SHAH TEHSIL,61,298,4,302
NORTH WAZIRISTAN AGENCY,MIRAN SHAH TEHSIL,62,297,3,300
NORTH WAZIRISTAN AGENCY,MIRAN SHAH TEHSIL,63,274,0,274
NORTH WAZIRISTAN AGENCY,MIRAN SHAH TEHSIL,64,238,1,239
NORTH WAZIRISTAN AGENCY,MIRAN SHAH TEHSIL,65,219,6,225
NORTH WAZIRISTAN AGENCY,MIRAN SHAH TEHSIL,66,195,2,197
NORTH WAZIRISTAN AGENCY,MIRAN SHAH TEHSIL,67,228,1,229
NORTH WAZIRISTAN AGENCY,MIRAN SHAH TEHSIL,68,128,0,128
NORTH WAZIRISTAN AGENCY,MIRAN SHAH TEHSIL,69,139,2,141
NORTH WAZIRISTAN AGENCY,MIRAN SHAH TEHSIL,70,131,2,133
NORTH WAZIRISTAN AGENCY,MIRAN SHAH TEHSIL,71,111,2,113
NORTH WAZIRISTAN AGENCY,MIRAN SHAH TEHSIL,72,102,2,104
NORTH WAZIRISTAN AGENCY,MIRAN SHAH TEHSIL,73,90,0,90
NORTH WAZIRISTAN AGENCY,MIRAN SHAH TEHSIL,74,85,1,86
NORTH WAZIRISTAN AGENCY,MIRAN SHAH TEHSIL,>=75,635,18,653
NORTH WAZIRISTAN AGENCY,RAZMAK TEHSIL,<1,459,0,459
NORTH WAZIRISTAN AGENCY,RAZMAK TEHSIL,1,513,0,513
NORTH WAZIRISTAN AGENCY,RAZMAK TEHSIL,2,648,0,648
NORTH WAZIRISTAN AGENCY,RAZMAK TEHSIL,3,698,0,698
NORTH WAZIRISTAN AGENCY,RAZMAK TEHSIL,4,628,0,628
NORTH WAZIRISTAN AGENCY,RAZMAK TEHSIL,5,641,0,641
NORTH WAZIRISTAN AGENCY,RAZMAK TEHSIL,6,649,0,649
NORTH WAZIRISTAN AGENCY,RAZMAK TEHSIL,7,524,0,524
NORTH WAZIRISTAN AGENCY,RAZMAK TEHSIL,8,613,0,613
NORTH WAZIRISTAN AGENCY,RAZMAK TEHSIL,9,496,0,496
NORTH WAZIRISTAN AGENCY,RAZMAK TEHSIL,10,487,0,487
NORTH WAZIRISTAN AGENCY,RAZMAK TEHSIL,11,375,0,375
NORTH WAZIRISTAN AGENCY,RAZMAK TEHSIL,12,406,0,406
NORTH WAZIRISTAN AGENCY,RAZMAK TEHSIL,13,326,0,326
NORTH WAZIRISTAN AGENCY,RAZMAK TEHSIL,14,312,0,312
NORTH WAZIRISTAN AGENCY,RAZMAK TEHSIL,15,263,0,263
NORTH WAZIRISTAN AGENCY,RAZMAK TEHSIL,16,246,0,246
NORTH WAZIRISTAN AGENCY,RAZMAK TEHSIL,17,189,0,189
NORTH WAZIRISTAN AGENCY,RAZMAK TEHSIL,18,273,0,273
NORTH WAZIRISTAN AGENCY,RAZMAK TEHSIL,19,319,0,319
NORTH WAZIRISTAN AGENCY,RAZMAK TEHSIL,20,318,0,318
NORTH WAZIRISTAN AGENCY,RAZMAK TEHSIL,21,291,0,291
NORTH WAZIRISTAN AGENCY,RAZMAK TEHSIL,22,238,0,238
NORTH WAZIRISTAN AGENCY,RAZMAK TEHSIL,23,247,0,247
NORTH WAZIRISTAN AGENCY,RAZMAK TEHSIL,24,220,0,220
NORTH WAZIRISTAN AGENCY,RAZMAK TEHSIL,25,283,0,283
NORTH WAZIRISTAN AGENCY,RAZMAK TEHSIL,26,235,0,235
NORTH WAZIRISTAN AGENCY,RAZMAK TEHSIL,27,278,0,278
NORTH WAZIRISTAN AGENCY,RAZMAK TEHSIL,28,214,0,214
NORTH WAZIRISTAN AGENCY,RAZMAK TEHSIL,29,234,0,234
NORTH WAZIRISTAN AGENCY,RAZMAK TEHSIL,30,239,0,239
NORTH WAZIRISTAN AGENCY,RAZMAK TEHSIL,31,207,0,207
NORTH WAZIRISTAN AGENCY,RAZMAK TEHSIL,32,210,0,210
NORTH WAZIRISTAN AGENCY,RAZMAK TEHSIL,33,207,0,207
NORTH WAZIRISTAN AGENCY,RAZMAK TEHSIL,34,142,0,142
NORTH WAZIRISTAN AGENCY,RAZMAK TEHSIL,35,178,0,178
NORTH WAZIRISTAN AGENCY,RAZMAK TEHSIL,36,146,0,146
NORTH WAZIRISTAN AGENCY,RAZMAK TEHSIL,37,168,0,168
NORTH WAZIRISTAN AGENCY,RAZMAK TEHSIL,38,125,0,125
NORTH WAZIRISTAN AGENCY,RAZMAK TEHSIL,39,152,0,152
NORTH WAZIRISTAN AGENCY,RAZMAK TEHSIL,40,149,0,149
NORTH WAZIRISTAN AGENCY,RAZMAK TEHSIL,41,138,0,138
NORTH WAZIRISTAN AGENCY,RAZMAK TEHSIL,42,95,0,95
NORTH WAZIRISTAN AGENCY,RAZMAK TEHSIL,43,110,0,110
NORTH WAZIRISTAN AGENCY,RAZMAK TEHSIL,44,85,0,85
NORTH WAZIRISTAN AGENCY,RAZMAK TEHSIL,45,113,0,113
NORTH WAZIRISTAN AGENCY,RAZMAK TEHSIL,46,81,0,81
NORTH WAZIRISTAN AGENCY,RAZMAK TEHSIL,47,88,0,88
NORTH WAZIRISTAN AGENCY,RAZMAK TEHSIL,48,71,0,71
NORTH WAZIRISTAN AGENCY,RAZMAK TEHSIL,49,69,0,69
NORTH WAZIRISTAN AGENCY,RAZMAK TEHSIL,50,110,0,110
NORTH WAZIRISTAN AGENCY,RAZMAK TEHSIL,51,72,0,72
NORTH WAZIRISTAN AGENCY,RAZMAK TEHSIL,52,82,0,82
NORTH WAZIRISTAN AGENCY,RAZMAK TEHSIL,53,74,0,74
NORTH WAZIRISTAN AGENCY,RAZMAK TEHSIL,54,64,0,64
NORTH WAZIRISTAN AGENCY,RAZMAK TEHSIL,55,64,0,64
NORTH WAZIRISTAN AGENCY,RAZMAK TEHSIL,56,54,0,54
NORTH WAZIRISTAN AGENCY,RAZMAK TEHSIL,57,56,0,56
NORTH WAZIRISTAN AGENCY,RAZMAK TEHSIL,58,50,0,50
NORTH WAZIRISTAN AGENCY,RAZMAK TEHSIL,59,36,0,36
NORTH WAZIRISTAN AGENCY,RAZMAK TEHSIL,60,60,0,60
NORTH WAZIRISTAN AGENCY,RAZMAK TEHSIL,61,44,0,44
NORTH WAZIRISTAN AGENCY,RAZMAK TEHSIL,62,49,0,49
NORTH WAZIRISTAN AGENCY,RAZMAK TEHSIL,63,54,0,54
NORTH WAZIRISTAN AGENCY,RAZMAK TEHSIL,64,54,0,54
NORTH WAZIRISTAN AGENCY,RAZMAK TEHSIL,65,44,0,44
NORTH WAZIRISTAN AGENCY,RAZMAK TEHSIL,66,32,0,32
NORTH WAZIRISTAN AGENCY,RAZMAK TEHSIL,67,44,0,44
NORTH WAZIRISTAN AGENCY,RAZMAK TEHSIL,68,27,0,27
NORTH WAZIRISTAN AGENCY,RAZMAK TEHSIL,69,27,0,27
NORTH WAZIRISTAN AGENCY,RAZMAK TEHSIL,70,14,0,14
NORTH WAZIRISTAN AGENCY,RAZMAK TEHSIL,71,19,0,19
NORTH WAZIRISTAN AGENCY,RAZMAK TEHSIL,72,17,0,17
NORTH WAZIRISTAN AGENCY,RAZMAK TEHSIL,73,18,0,18
NORTH WAZIRISTAN AGENCY,RAZMAK TEHSIL,74,7,0,7
NORTH WAZIRISTAN AGENCY,RAZMAK TEHSIL,>=75,113,0,113
NORTH WAZIRISTAN AGENCY,SHEWA TEHSIL,<1,1166,0,1166
NORTH WAZIRISTAN AGENCY,SHEWA TEHSIL,1,1377,0,1377
NORTH WAZIRISTAN AGENCY,SHEWA TEHSIL,2,1647,0,1647
NORTH WAZIRISTAN AGENCY,SHEWA TEHSIL,3,1688,0,1688
NORTH WAZIRISTAN AGENCY,SHEWA TEHSIL,4,1715,0,1715
NORTH WAZIRISTAN AGENCY,SHEWA TEHSIL,5,1488,0,1488
NORTH WAZIRISTAN AGENCY,SHEWA TEHSIL,6,1540,0,1540
NORTH WAZIRISTAN AGENCY,SHEWA TEHSIL,7,1545,0,1545
NORTH WAZIRISTAN AGENCY,SHEWA TEHSIL,8,1508,0,1508
NORTH WAZIRISTAN AGENCY,SHEWA TEHSIL,9,1317,0,1317
NORTH WAZIRISTAN AGENCY,SHEWA TEHSIL,10,1271,0,1271
NORTH WAZIRISTAN AGENCY,SHEWA TEHSIL,11,1048,0,1048
NORTH WAZIRISTAN AGENCY,SHEWA TEHSIL,12,1022,0,1022
NORTH WAZIRISTAN AGENCY,SHEWA TEHSIL,13,959,0,959
NORTH WAZIRISTAN AGENCY,SHEWA TEHSIL,14,858,0,858
NORTH WAZIRISTAN AGENCY,SHEWA TEHSIL,15,821,0,821
NORTH WAZIRISTAN AGENCY,SHEWA TEHSIL,16,706,0,706
NORTH WAZIRISTAN AGENCY,SHEWA TEHSIL,17,584,0,584
NORTH WAZIRISTAN AGENCY,SHEWA TEHSIL,18,711,0,711
NORTH WAZIRISTAN AGENCY,SHEWA TEHSIL,19,698,0,698
NORTH WAZIRISTAN AGENCY,SHEWA TEHSIL,20,766,0,766
NORTH WAZIRISTAN AGENCY,SHEWA TEHSIL,21,850,0,850
NORTH WAZIRISTAN AGENCY,SHEWA TEHSIL,22,647,0,647
NORTH WAZIRISTAN AGENCY,SHEWA TEHSIL,23,674,0,674
NORTH WAZIRISTAN AGENCY,SHEWA TEHSIL,24,606,0,606
NORTH WAZIRISTAN AGENCY,SHEWA TEHSIL,25,667,0,667
NORTH WAZIRISTAN AGENCY,SHEWA TEHSIL,26,712,0,712
NORTH WAZIRISTAN AGENCY,SHEWA TEHSIL,27,693,0,693
NORTH WAZIRISTAN AGENCY,SHEWA TEHSIL,28,607,0,607
NORTH WAZIRISTAN AGENCY,SHEWA TEHSIL,29,598,0,598
NORTH WAZIRISTAN AGENCY,SHEWA TEHSIL,30,497,0,497
NORTH WAZIRISTAN AGENCY,SHEWA TEHSIL,31,511,0,511
NORTH WAZIRISTAN AGENCY,SHEWA TEHSIL,32,395,0,395
NORTH WAZIRISTAN AGENCY,SHEWA TEHSIL,33,399,0,399
NORTH WAZIRISTAN AGENCY,SHEWA TEHSIL,34,320,0,320
NORTH WAZIRISTAN AGENCY,SHEWA TEHSIL,35,320,0,320
NORTH WAZIRISTAN AGENCY,SHEWA TEHSIL,36,248,0,248
NORTH WAZIRISTAN AGENCY,SHEWA TEHSIL,37,309,0,309
NORTH WAZIRISTAN AGENCY,SHEWA TEHSIL,38,321,0,321
NORTH WAZIRISTAN AGENCY,SHEWA TEHSIL,39,303,0,303
NORTH WAZIRISTAN AGENCY,SHEWA TEHSIL,40,325,0,325
NORTH WAZIRISTAN AGENCY,SHEWA TEHSIL,41,269,0,269
NORTH WAZIRISTAN AGENCY,SHEWA TEHSIL,42,182,0,182
NORTH WAZIRISTAN AGENCY,SHEWA TEHSIL,43,232,0,232
NORTH WAZIRISTAN AGENCY,SHEWA TEHSIL,44,195,0,195
NORTH WAZIRISTAN AGENCY,SHEWA TEHSIL,45,200,0,200
NORTH WAZIRISTAN AGENCY,SHEWA TEHSIL,46,156,0,156
NORTH WAZIRISTAN AGENCY,SHEWA TEHSIL,47,198,0,198
NORTH WAZIRISTAN AGENCY,SHEWA TEHSIL,48,147,0,147
NORTH WAZIRISTAN AGENCY,SHEWA TEHSIL,49,150,0,150
NORTH WAZIRISTAN AGENCY,SHEWA TEHSIL,50,210,0,210
NORTH WAZIRISTAN AGENCY,SHEWA TEHSIL,51,166,0,166
NORTH WAZIRISTAN AGENCY,SHEWA TEHSIL,52,121,0,121
NORTH WAZIRISTAN AGENCY,SHEWA TEHSIL,53,164,0,164
NORTH WAZIRISTAN AGENCY,SHEWA TEHSIL,54,127,0,127
NORTH WAZIRISTAN AGENCY,SHEWA TEHSIL,55,179,0,179
NORTH WAZIRISTAN AGENCY,SHEWA TEHSIL,56,130,0,130
NORTH WAZIRISTAN AGENCY,SHEWA TEHSIL,57,155,0,155
NORTH WAZIRISTAN AGENCY,SHEWA TEHSIL,58,130,0,130
NORTH WAZIRISTAN AGENCY,SHEWA TEHSIL,59,132,0,132
NORTH WAZIRISTAN AGENCY,SHEWA TEHSIL,60,184,0,184
NORTH WAZIRISTAN AGENCY,SHEWA TEHSIL,61,105,0,105
NORTH WAZIRISTAN AGENCY,SHEWA TEHSIL,62,110,0,110
NORTH WAZIRISTAN AGENCY,SHEWA TEHSIL,63,121,0,121
NORTH WAZIRISTAN AGENCY,SHEWA TEHSIL,64,104,0,104
NORTH WAZIRISTAN AGENCY,SHEWA TEHSIL,65,117,0,117
NORTH WAZIRISTAN AGENCY,SHEWA TEHSIL,66,63,0,63
NORTH WAZIRISTAN AGENCY,SHEWA TEHSIL,67,90,0,90
NORTH WAZIRISTAN AGENCY,SHEWA TEHSIL,68,69,0,69
NORTH WAZIRISTAN AGENCY,SHEWA TEHSIL,69,63,0,63
NORTH WAZIRISTAN AGENCY,SHEWA TEHSIL,70,93,0,93
NORTH WAZIRISTAN AGENCY,SHEWA TEHSIL,71,65,0,65
NORTH WAZIRISTAN AGENCY,SHEWA TEHSIL,72,55,0,55
NORTH WAZIRISTAN AGENCY,SHEWA TEHSIL,73,45,0,45
NORTH WAZIRISTAN AGENCY,SHEWA TEHSIL,74,30,0,30
NORTH WAZIRISTAN AGENCY,SHEWA TEHSIL,>=75,296,0,296
NORTH WAZIRISTAN AGENCY,SPINWAM TEHSIL,<1,1408,0,1408
NORTH WAZIRISTAN AGENCY,SPINWAM TEHSIL,1,1762,0,1762
NORTH WAZIRISTAN AGENCY,SPINWAM TEHSIL,2,2094,0,2094
NORTH WAZIRISTAN AGENCY,SPINWAM TEHSIL,3,2028,0,2028
NORTH WAZIRISTAN AGENCY,SPINWAM TEHSIL,4,1930,0,1930
NORTH WAZIRISTAN AGENCY,SPINWAM TEHSIL,5,1823,0,1823
NORTH WAZIRISTAN AGENCY,SPINWAM TEHSIL,6,1912,0,1912
NORTH WAZIRISTAN AGENCY,SPINWAM TEHSIL,7,1728,0,1728
NORTH WAZIRISTAN AGENCY,SPINWAM TEHSIL,8,1694,0,1694
NORTH WAZIRISTAN AGENCY,SPINWAM TEHSIL,9,1561,0,1561
NORTH WAZIRISTAN AGENCY,SPINWAM TEHSIL,10,1356,0,1356
NORTH WAZIRISTAN AGENCY,SPINWAM TEHSIL,11,1301,0,1301
NORTH WAZIRISTAN AGENCY,SPINWAM TEHSIL,12,1054,0,1054
NORTH WAZIRISTAN AGENCY,SPINWAM TEHSIL,13,928,0,928
NORTH WAZIRISTAN AGENCY,SPINWAM TEHSIL,14,845,0,845
NORTH WAZIRISTAN AGENCY,SPINWAM TEHSIL,15,736,0,736
NORTH WAZIRISTAN AGENCY,SPINWAM TEHSIL,16,607,0,607
NORTH WAZIRISTAN AGENCY,SPINWAM TEHSIL,17,590,0,590
NORTH WAZIRISTAN AGENCY,SPINWAM TEHSIL,18,818,0,818
NORTH WAZIRISTAN AGENCY,SPINWAM TEHSIL,19,902,0,902
NORTH WAZIRISTAN AGENCY,SPINWAM TEHSIL,20,887,0,887
NORTH WAZIRISTAN AGENCY,SPINWAM TEHSIL,21,912,0,912
NORTH WAZIRISTAN AGENCY,SPINWAM TEHSIL,22,791,0,791
NORTH WAZIRISTAN AGENCY,SPINWAM TEHSIL,23,823,0,823
NORTH WAZIRISTAN AGENCY,SPINWAM TEHSIL,24,762,0,762
NORTH WAZIRISTAN AGENCY,SPINWAM TEHSIL,25,850,0,850
NORTH WAZIRISTAN AGENCY,SPINWAM TEHSIL,26,946,0,946
NORTH WAZIRISTAN AGENCY,SPINWAM TEHSIL,27,972,0,972
NORTH WAZIRISTAN AGENCY,SPINWAM TEHSIL,28,792,0,792
NORTH WAZIRISTAN AGENCY,SPINWAM TEHSIL,29,807,0,807
NORTH WAZIRISTAN AGENCY,SPINWAM TEHSIL,30,723,0,723
NORTH WAZIRISTAN AGENCY,SPINWAM TEHSIL,31,705,0,705
NORTH WAZIRISTAN AGENCY,SPINWAM TEHSIL,32,551,0,551
NORTH WAZIRISTAN AGENCY,SPINWAM TEHSIL,33,511,0,511
NORTH WAZIRISTAN AGENCY,SPINWAM TEHSIL,34,419,0,419
NORTH WAZIRISTAN AGENCY,SPINWAM TEHSIL,35,414,0,414
NORTH WAZIRISTAN AGENCY,SPINWAM TEHSIL,36,367,0,367
NORTH WAZIRISTAN AGENCY,SPINWAM TEHSIL,37,445,0,445
NORTH WAZIRISTAN AGENCY,SPINWAM TEHSIL,38,371,0,371
NORTH WAZIRISTAN AGENCY,SPINWAM TEHSIL,39,365,0,365
NORTH WAZIRISTAN AGENCY,SPINWAM TEHSIL,40,398,0,398
NORTH WAZIRISTAN AGENCY,SPINWAM TEHSIL,41,281,0,281
NORTH WAZIRISTAN AGENCY,SPINWAM TEHSIL,42,242,0,242
NORTH WAZIRISTAN AGENCY,SPINWAM TEHSIL,43,242,0,242
NORTH WAZIRISTAN AGENCY,SPINWAM TEHSIL,44,180,0,180
NORTH WAZIRISTAN AGENCY,SPINWAM TEHSIL,45,243,0,243
NORTH WAZIRISTAN AGENCY,SPINWAM TEHSIL,46,174,0,174
NORTH WAZIRISTAN AGENCY,SPINWAM TEHSIL,47,217,0,217
NORTH WAZIRISTAN AGENCY,SPINWAM TEHSIL,48,170,0,170
NORTH WAZIRISTAN AGENCY,SPINWAM TEHSIL,49,186,0,186
NORTH WAZIRISTAN AGENCY,SPINWAM TEHSIL,50,262,0,262
NORTH WAZIRISTAN AGENCY,SPINWAM TEHSIL,51,177,0,177
NORTH WAZIRISTAN AGENCY,SPINWAM TEHSIL,52,177,0,177
NORTH WAZIRISTAN AGENCY,SPINWAM TEHSIL,53,154,0,154
NORTH WAZIRISTAN AGENCY,SPINWAM TEHSIL,54,157,0,157
NORTH WAZIRISTAN AGENCY,SPINWAM TEHSIL,55,158,0,158
NORTH WAZIRISTAN AGENCY,SPINWAM TEHSIL,56,133,0,133
NORTH WAZIRISTAN AGENCY,SPINWAM TEHSIL,57,194,0,194
NORTH WAZIRISTAN AGENCY,SPINWAM TEHSIL,58,104,0,104
NORTH WAZIRISTAN AGENCY,SPINWAM TEHSIL,59,137,0,137
NORTH WAZIRISTAN AGENCY,SPINWAM TEHSIL,60,165,0,165
NORTH WAZIRISTAN AGENCY,SPINWAM TEHSIL,61,140,0,140
NORTH WAZIRISTAN AGENCY,SPINWAM TEHSIL,62,132,0,132
NORTH WAZIRISTAN AGENCY,SPINWAM TEHSIL,63,116,0,116
NORTH WAZIRISTAN AGENCY,SPINWAM TEHSIL,64,124,0,124
NORTH WAZIRISTAN AGENCY,SPINWAM TEHSIL,65,93,0,93
NORTH WAZIRISTAN AGENCY,SPINWAM TEHSIL,66,83,0,83
NORTH WAZIRISTAN AGENCY,SPINWAM TEHSIL,67,120,0,120
NORTH WAZIRISTAN AGENCY,SPINWAM TEHSIL,68,60,0,60
NORTH WAZIRISTAN AGENCY,SPINWAM TEHSIL,69,61,0,61
NORTH WAZIRISTAN AGENCY,SPINWAM TEHSIL,70,87,0,87
NORTH WAZIRISTAN AGENCY,SPINWAM TEHSIL,71,51,0,51
NORTH WAZIRISTAN AGENCY,SPINWAM TEHSIL,72,41,0,41
NORTH WAZIRISTAN AGENCY,SPINWAM TEHSIL,73,35,0,35
NORTH WAZIRISTAN AGENCY,SPINWAM TEHSIL,74,34,0,34
NORTH WAZIRISTAN AGENCY,SPINWAM TEHSIL,>=75,353,0,353
NOWSHERA DISTRICT,JEHANGIRA TEHSIL,<1,7596,2069,9665
NOWSHERA DISTRICT,JEHANGIRA TEHSIL,1,7291,2110,9401
NOWSHERA DISTRICT,JEHANGIRA TEHSIL,2,7555,2246,9801
NOWSHERA DISTRICT,JEHANGIRA TEHSIL,3,8026,2503,10529
NOWSHERA DISTRICT,JEHANGIRA TEHSIL,4,8030,2321,10351
NOWSHERA DISTRICT,JEHANGIRA TEHSIL,5,8063,2314,10377
NOWSHERA DISTRICT,JEHANGIRA TEHSIL,6,7781,2334,10115
NOWSHERA DISTRICT,JEHANGIRA TEHSIL,7,8195,2320,10515
NOWSHERA DISTRICT,JEHANGIRA TEHSIL,8,7629,2228,9857
NOWSHERA DISTRICT,JEHANGIRA TEHSIL,9,8015,2237,10252
NOWSHERA DISTRICT,JEHANGIRA TEHSIL,10,6842,2081,8923
NOWSHERA DISTRICT,JEHANGIRA TEHSIL,11,7325,2113,9438
NOWSHERA DISTRICT,JEHANGIRA TEHSIL,12,6344,2059,8403
NOWSHERA DISTRICT,JEHANGIRA TEHSIL,13,6801,2112,8913
NOWSHERA DISTRICT,JEHANGIRA TEHSIL,14,6388,1991,8379
NOWSHERA DISTRICT,JEHANGIRA TEHSIL,15,6225,1993,8218
NOWSHERA DISTRICT,JEHANGIRA TEHSIL,16,5941,1958,7899
NOWSHERA DISTRICT,JEHANGIRA TEHSIL,17,6176,1934,8110
NOWSHERA DISTRICT,JEHANGIRA TEHSIL,18,5470,1841,7311
NOWSHERA DISTRICT,JEHANGIRA TEHSIL,19,5414,1793,7207
NOWSHERA DISTRICT,JEHANGIRA TEHSIL,20,4959,1716,6675
NOWSHERA DISTRICT,JEHANGIRA TEHSIL,21,5254,1896,7150
NOWSHERA DISTRICT,JEHANGIRA TEHSIL,22,4537,1739,6276
NOWSHERA DISTRICT,JEHANGIRA TEHSIL,23,4552,1769,6321
NOWSHERA DISTRICT,JEHANGIRA TEHSIL,24,4448,1702,6150
NOWSHERA DISTRICT,JEHANGIRA TEHSIL,25,4234,1533,5767
NOWSHERA DISTRICT,JEHANGIRA TEHSIL,26,4758,1660,6418
NOWSHERA DISTRICT,JEHANGIRA TEHSIL,27,4732,1644,6376
NOWSHERA DISTRICT,JEHANGIRA TEHSIL,28,4117,1359,5476
NOWSHERA DISTRICT,JEHANGIRA TEHSIL,29,4148,1423,5571
NOWSHERA DISTRICT,JEHANGIRA TEHSIL,30,3522,1308,4830
NOWSHERA DISTRICT,JEHANGIRA TEHSIL,31,3912,1285,5197
NOWSHERA DISTRICT,JEHANGIRA TEHSIL,32,3247,1139,4386
NOWSHERA DISTRICT,JEHANGIRA TEHSIL,33,3258,1164,4422
NOWSHERA DISTRICT,JEHANGIRA TEHSIL,34,3242,1055,4297
NOWSHERA DISTRICT,JEHANGIRA TEHSIL,35,2607,899,3506
NOWSHERA DISTRICT,JEHANGIRA TEHSIL,36,2848,972,3820
NOWSHERA DISTRICT,JEHANGIRA TEHSIL,37,2645,874,3519
NOWSHERA DISTRICT,JEHANGIRA TEHSIL,38,2677,936,3613
NOWSHERA DISTRICT,JEHANGIRA TEHSIL,39,2793,919,3712
NOWSHERA DISTRICT,JEHANGIRA TEHSIL,40,2462,883,3345
NOWSHERA DISTRICT,JEHANGIRA TEHSIL,41,2554,853,3407
NOWSHERA DISTRICT,JEHANGIRA TEHSIL,42,2247,754,3001
NOWSHERA DISTRICT,JEHANGIRA TEHSIL,43,2236,767,3003
NOWSHERA DISTRICT,JEHANGIRA TEHSIL,44,2199,744,2943
NOWSHERA DISTRICT,JEHANGIRA TEHSIL,45,1737,665,2402
NOWSHERA DISTRICT,JEHANGIRA TEHSIL,46,2024,678,2702
NOWSHERA DISTRICT,JEHANGIRA TEHSIL,47,1906,589,2495
NOWSHERA DISTRICT,JEHANGIRA TEHSIL,48,1830,623,2453
NOWSHERA DISTRICT,JEHANGIRA TEHSIL,49,1868,661,2529
NOWSHERA DISTRICT,JEHANGIRA TEHSIL,50,1684,571,2255
NOWSHERA DISTRICT,JEHANGIRA TEHSIL,51,1781,597,2378
NOWSHERA DISTRICT,JEHANGIRA TEHSIL,52,1506,540,2046
NOWSHERA DISTRICT,JEHANGIRA TEHSIL,53,1479,520,1999
NOWSHERA DISTRICT,JEHANGIRA TEHSIL,54,1374,465,1839
NOWSHERA DISTRICT,JEHANGIRA TEHSIL,55,1149,434,1583
NOWSHERA DISTRICT,JEHANGIRA TEHSIL,56,1263,412,1675
NOWSHERA DISTRICT,JEHANGIRA TEHSIL,57,1245,348,1593
NOWSHERA DISTRICT,JEHANGIRA TEHSIL,58,1234,395,1629
NOWSHERA DISTRICT,JEHANGIRA TEHSIL,59,1295,420,1715
NOWSHERA DISTRICT,JEHANGIRA TEHSIL,60,1131,381,1512
NOWSHERA DISTRICT,JEHANGIRA TEHSIL,61,1151,383,1534
NOWSHERA DISTRICT,JEHANGIRA TEHSIL,62,1007,360,1367
NOWSHERA DISTRICT,JEHANGIRA TEHSIL,63,1018,357,1375
NOWSHERA DISTRICT,JEHANGIRA TEHSIL,64,1078,321,1399
NOWSHERA DISTRICT,JEHANGIRA TEHSIL,65,771,256,1027
NOWSHERA DISTRICT,JEHANGIRA TEHSIL,66,785,260,1045
NOWSHERA DISTRICT,JEHANGIRA TEHSIL,67,720,264,984
NOWSHERA DISTRICT,JEHANGIRA TEHSIL,68,700,236,936
NOWSHERA DISTRICT,JEHANGIRA TEHSIL,69,764,194,958
NOWSHERA DISTRICT,JEHANGIRA TEHSIL,70,552,175,727
NOWSHERA DISTRICT,JEHANGIRA TEHSIL,71,551,175,726
NOWSHERA DISTRICT,JEHANGIRA TEHSIL,72,520,174,694
NOWSHERA DISTRICT,JEHANGIRA TEHSIL,73,433,126,559
NOWSHERA DISTRICT,JEHANGIRA TEHSIL,74,485,128,613
NOWSHERA DISTRICT,JEHANGIRA TEHSIL,>=75,3306,864,4170
NOWSHERA DISTRICT,NOWSHERA TEHSIL,<1,14534,4753,19287
NOWSHERA DISTRICT,NOWSHERA TEHSIL,1,15293,4707,20000
NOWSHERA DISTRICT,NOWSHERA TEHSIL,2,15833,4938,20771
NOWSHERA DISTRICT,NOWSHERA TEHSIL,3,16837,5332,22169
NOWSHERA DISTRICT,NOWSHERA TEHSIL,4,16617,5048,21665
NOWSHERA DISTRICT,NOWSHERA TEHSIL,5,16320,5272,21592
NOWSHERA DISTRICT,NOWSHERA TEHSIL,6,16053,4926,20979
NOWSHERA DISTRICT,NOWSHERA TEHSIL,7,16335,5252,21587
NOWSHERA DISTRICT,NOWSHERA TEHSIL,8,15308,4613,19921
NOWSHERA DISTRICT,NOWSHERA TEHSIL,9,15417,4983,20400
NOWSHERA DISTRICT,NOWSHERA TEHSIL,10,13941,4269,18210
NOWSHERA DISTRICT,NOWSHERA TEHSIL,11,13933,4762,18695
NOWSHERA DISTRICT,NOWSHERA TEHSIL,12,12669,4047,16716
NOWSHERA DISTRICT,NOWSHERA TEHSIL,13,13016,4275,17291
NOWSHERA DISTRICT,NOWSHERA TEHSIL,14,12248,3969,16217
NOWSHERA DISTRICT,NOWSHERA TEHSIL,15,12170,3991,16161
NOWSHERA DISTRICT,NOWSHERA TEHSIL,16,11608,3852,15460
NOWSHERA DISTRICT,NOWSHERA TEHSIL,17,12270,4008,16278
NOWSHERA DISTRICT,NOWSHERA TEHSIL,18,10923,3884,14807
NOWSHERA DISTRICT,NOWSHERA TEHSIL,19,10746,4643,15389
NOWSHERA DISTRICT,NOWSHERA TEHSIL,20,10639,4491,15130
NOWSHERA DISTRICT,NOWSHERA TEHSIL,21,9994,5518,15512
NOWSHERA DISTRICT,NOWSHERA TEHSIL,22,9329,4718,14047
NOWSHERA DISTRICT,NOWSHERA TEHSIL,23,9174,4558,13732
NOWSHERA DISTRICT,NOWSHERA TEHSIL,24,8842,3879,12721
NOWSHERA DISTRICT,NOWSHERA TEHSIL,25,8920,3566,12486
NOWSHERA DISTRICT,NOWSHERA TEHSIL,26,9014,3843,12857
NOWSHERA DISTRICT,NOWSHERA TEHSIL,27,8954,3923,12877
NOWSHERA DISTRICT,NOWSHERA TEHSIL,28,7920,3634,11554
NOWSHERA DISTRICT,NOWSHERA TEHSIL,29,7930,3710,11640
NOWSHERA DISTRICT,NOWSHERA TEHSIL,30,8086,3432,11518
NOWSHERA DISTRICT,NOWSHERA TEHSIL,31,7596,3589,11185
NOWSHERA DISTRICT,NOWSHERA TEHSIL,32,6792,3156,9948
NOWSHERA DISTRICT,NOWSHERA TEHSIL,33,6781,3227,10008
NOWSHERA DISTRICT,NOWSHERA TEHSIL,34,6263,3007,9270
NOWSHERA DISTRICT,NOWSHERA TEHSIL,35,5663,2557,8220
NOWSHERA DISTRICT,NOWSHERA TEHSIL,36,5531,2703,8234
NOWSHERA DISTRICT,NOWSHERA TEHSIL,37,5260,2361,7621
NOWSHERA DISTRICT,NOWSHERA TEHSIL,38,5276,2647,7923
NOWSHERA DISTRICT,NOWSHERA TEHSIL,39,5458,2465,7923
NOWSHERA DISTRICT,NOWSHERA TEHSIL,40,5248,2286,7534
NOWSHERA DISTRICT,NOWSHERA TEHSIL,41,5170,2161,7331
NOWSHERA DISTRICT,NOWSHERA TEHSIL,42,4513,1970,6483
NOWSHERA DISTRICT,NOWSHERA TEHSIL,43,4484,1942,6426
NOWSHERA DISTRICT,NOWSHERA TEHSIL,44,4032,1751,5783
NOWSHERA DISTRICT,NOWSHERA TEHSIL,45,3730,1395,5125
NOWSHERA DISTRICT,NOWSHERA TEHSIL,46,3799,1534,5333
NOWSHERA DISTRICT,NOWSHERA TEHSIL,47,3483,1351,4834
NOWSHERA DISTRICT,NOWSHERA TEHSIL,48,3627,1466,5093
NOWSHERA DISTRICT,NOWSHERA TEHSIL,49,3577,1309,4886
NOWSHERA DISTRICT,NOWSHERA TEHSIL,50,3592,1249,4841
NOWSHERA DISTRICT,NOWSHERA TEHSIL,51,3350,1251,4601
NOWSHERA DISTRICT,NOWSHERA TEHSIL,52,2956,1118,4074
NOWSHERA DISTRICT,NOWSHERA TEHSIL,53,2839,1128,3967
NOWSHERA DISTRICT,NOWSHERA TEHSIL,54,2676,1022,3698
NOWSHERA DISTRICT,NOWSHERA TEHSIL,55,2474,852,3326
NOWSHERA DISTRICT,NOWSHERA TEHSIL,56,2327,879,3206
NOWSHERA DISTRICT,NOWSHERA TEHSIL,57,2153,667,2820
NOWSHERA DISTRICT,NOWSHERA TEHSIL,58,2429,815,3244
NOWSHERA DISTRICT,NOWSHERA TEHSIL,59,2341,745,3086
NOWSHERA DISTRICT,NOWSHERA TEHSIL,60,2295,733,3028
NOWSHERA DISTRICT,NOWSHERA TEHSIL,61,2137,769,2906
NOWSHERA DISTRICT,NOWSHERA TEHSIL,62,1899,676,2575
NOWSHERA DISTRICT,NOWSHERA TEHSIL,63,1907,639,2546
NOWSHERA DISTRICT,NOWSHERA TEHSIL,64,1877,630,2507
NOWSHERA DISTRICT,NOWSHERA TEHSIL,65,1433,448,1881
NOWSHERA DISTRICT,NOWSHERA TEHSIL,66,1353,487,1840
NOWSHERA DISTRICT,NOWSHERA TEHSIL,67,1311,428,1739
NOWSHERA DISTRICT,NOWSHERA TEHSIL,68,1225,403,1628
NOWSHERA DISTRICT,NOWSHERA TEHSIL,69,1222,350,1572
NOWSHERA DISTRICT,NOWSHERA TEHSIL,70,1058,317,1375
NOWSHERA DISTRICT,NOWSHERA TEHSIL,71,983,335,1318
NOWSHERA DISTRICT,NOWSHERA TEHSIL,72,885,296,1181
NOWSHERA DISTRICT,NOWSHERA TEHSIL,73,828,290,1118
NOWSHERA DISTRICT,NOWSHERA TEHSIL,74,767,210,977
NOWSHERA DISTRICT,NOWSHERA TEHSIL,>=75,5299,1633,6932
NOWSHERA DISTRICT,PABBI TEHSIL,<1,10692,1474,12166
NOWSHERA DISTRICT,PABBI TEHSIL,1,11223,1571,12794
NOWSHERA DISTRICT,PABBI TEHSIL,2,11901,1534,13435
NOWSHERA DISTRICT,PABBI TEHSIL,3,12645,1715,14360
NOWSHERA DISTRICT,PABBI TEHSIL,4,12065,1620,13685
NOWSHERA DISTRICT,PABBI TEHSIL,5,12136,1742,13878
NOWSHERA DISTRICT,PABBI TEHSIL,6,11615,1623,13238
NOWSHERA DISTRICT,PABBI TEHSIL,7,11935,1624,13559
NOWSHERA DISTRICT,PABBI TEHSIL,8,11158,1570,12728
NOWSHERA DISTRICT,PABBI TEHSIL,9,11096,1647,12743
NOWSHERA DISTRICT,PABBI TEHSIL,10,10000,1401,11401
NOWSHERA DISTRICT,PABBI TEHSIL,11,10033,1536,11569
NOWSHERA DISTRICT,PABBI TEHSIL,12,9104,1401,10505
NOWSHERA DISTRICT,PABBI TEHSIL,13,9511,1480,10991
NOWSHERA DISTRICT,PABBI TEHSIL,14,8920,1369,10289
NOWSHERA DISTRICT,PABBI TEHSIL,15,8806,1375,10181
NOWSHERA DISTRICT,PABBI TEHSIL,16,8527,1310,9837
NOWSHERA DISTRICT,PABBI TEHSIL,17,8512,1373,9885
NOWSHERA DISTRICT,PABBI TEHSIL,18,7832,1199,9031
NOWSHERA DISTRICT,PABBI TEHSIL,19,7915,1218,9133
NOWSHERA DISTRICT,PABBI TEHSIL,20,7397,1082,8479
NOWSHERA DISTRICT,PABBI TEHSIL,21,7224,1096,8320
NOWSHERA DISTRICT,PABBI TEHSIL,22,6291,888,7179
NOWSHERA DISTRICT,PABBI TEHSIL,23,6443,911,7354
NOWSHERA DISTRICT,PABBI TEHSIL,24,6327,796,7123
NOWSHERA DISTRICT,PABBI TEHSIL,25,6078,902,6980
NOWSHERA DISTRICT,PABBI TEHSIL,26,6368,841,7209
NOWSHERA DISTRICT,PABBI TEHSIL,27,6388,996,7384
NOWSHERA DISTRICT,PABBI TEHSIL,28,5697,836,6533
NOWSHERA DISTRICT,PABBI TEHSIL,29,5874,822,6696
NOWSHERA DISTRICT,PABBI TEHSIL,30,5206,838,6044
NOWSHERA DISTRICT,PABBI TEHSIL,31,5498,824,6322
NOWSHERA DISTRICT,PABBI TEHSIL,32,4603,645,5248
NOWSHERA DISTRICT,PABBI TEHSIL,33,4656,662,5318
NOWSHERA DISTRICT,PABBI TEHSIL,34,4380,615,4995
NOWSHERA DISTRICT,PABBI TEHSIL,35,3981,583,4564
NOWSHERA DISTRICT,PABBI TEHSIL,36,3899,562,4461
NOWSHERA DISTRICT,PABBI TEHSIL,37,3821,574,4395
NOWSHERA DISTRICT,PABBI TEHSIL,38,3680,585,4265
NOWSHERA DISTRICT,PABBI TEHSIL,39,3841,612,4453
NOWSHERA DISTRICT,PABBI TEHSIL,40,3450,562,4012
NOWSHERA DISTRICT,PABBI TEHSIL,41,3677,513,4190
NOWSHERA DISTRICT,PABBI TEHSIL,42,3070,437,3507
NOWSHERA DISTRICT,PABBI TEHSIL,43,3120,483,3603
NOWSHERA DISTRICT,PABBI TEHSIL,44,3050,414,3464
NOWSHERA DISTRICT,PABBI TEHSIL,45,2381,402,2783
NOWSHERA DISTRICT,PABBI TEHSIL,46,2934,358,3292
NOWSHERA DISTRICT,PABBI TEHSIL,47,2524,408,2932
NOWSHERA DISTRICT,PABBI TEHSIL,48,2483,363,2846
NOWSHERA DISTRICT,PABBI TEHSIL,49,2473,385,2858
NOWSHERA DISTRICT,PABBI TEHSIL,50,2424,373,2797
NOWSHERA DISTRICT,PABBI TEHSIL,51,2473,302,2775
NOWSHERA DISTRICT,PABBI TEHSIL,52,2210,307,2517
NOWSHERA DISTRICT,PABBI TEHSIL,53,2098,309,2407
NOWSHERA DISTRICT,PABBI TEHSIL,54,1925,278,2203
NOWSHERA DISTRICT,PABBI TEHSIL,55,1656,268,1924
NOWSHERA DISTRICT,PABBI TEHSIL,56,1908,231,2139
NOWSHERA DISTRICT,PABBI TEHSIL,57,1787,284,2071
NOWSHERA DISTRICT,PABBI TEHSIL,58,1918,262,2180
NOWSHERA DISTRICT,PABBI TEHSIL,59,1923,232,2155
NOWSHERA DISTRICT,PABBI TEHSIL,60,1672,240,1912
NOWSHERA DISTRICT,PABBI TEHSIL,61,1687,260,1947
NOWSHERA DISTRICT,PABBI TEHSIL,62,1478,241,1719
NOWSHERA DISTRICT,PABBI TEHSIL,63,1548,190,1738
NOWSHERA DISTRICT,PABBI TEHSIL,64,1502,189,1691
NOWSHERA DISTRICT,PABBI TEHSIL,65,1073,164,1237
NOWSHERA DISTRICT,PABBI TEHSIL,66,1082,125,1207
NOWSHERA DISTRICT,PABBI TEHSIL,67,1002,141,1143
NOWSHERA DISTRICT,PABBI TEHSIL,68,947,107,1054
NOWSHERA DISTRICT,PABBI TEHSIL,69,943,117,1060
NOWSHERA DISTRICT,PABBI TEHSIL,70,736,97,833
NOWSHERA DISTRICT,PABBI TEHSIL,71,693,90,783
NOWSHERA DISTRICT,PABBI TEHSIL,72,653,114,767
NOWSHERA DISTRICT,PABBI TEHSIL,73,619,81,700
NOWSHERA DISTRICT,PABBI TEHSIL,74,562,69,631
NOWSHERA DISTRICT,PABBI TEHSIL,>=75,4087,522,4609
NUSHKI,NUSHKI TEHSIL,<1,3366,1129,4495
NUSHKI,NUSHKI TEHSIL,1,4702,1465,6167
NUSHKI,NUSHKI TEHSIL,2,4925,1520,6445
NUSHKI,NUSHKI TEHSIL,3,4848,1517,6365
NUSHKI,NUSHKI TEHSIL,4,4720,1455,6175
NUSHKI,NUSHKI TEHSIL,5,4395,1407,5802
NUSHKI,NUSHKI TEHSIL,6,4238,1446,5684
NUSHKI,NUSHKI TEHSIL,7,4586,1503,6089
NUSHKI,NUSHKI TEHSIL,8,4291,1402,5693
NUSHKI,NUSHKI TEHSIL,9,4158,1405,5563
NUSHKI,NUSHKI TEHSIL,10,3921,1228,5149
NUSHKI,NUSHKI TEHSIL,11,3612,1376,4988
NUSHKI,NUSHKI TEHSIL,12,3363,1168,4531
NUSHKI,NUSHKI TEHSIL,13,3235,1228,4463
NUSHKI,NUSHKI TEHSIL,14,3166,1147,4313
NUSHKI,NUSHKI TEHSIL,15,2969,1081,4050
NUSHKI,NUSHKI TEHSIL,16,2792,1075,3867
NUSHKI,NUSHKI TEHSIL,17,2563,1055,3618
NUSHKI,NUSHKI TEHSIL,18,2950,931,3881
NUSHKI,NUSHKI TEHSIL,19,2725,1070,3795
NUSHKI,NUSHKI TEHSIL,20,2558,903,3461
NUSHKI,NUSHKI TEHSIL,21,2479,943,3422
NUSHKI,NUSHKI TEHSIL,22,2187,718,2905
NUSHKI,NUSHKI TEHSIL,23,2085,841,2926
NUSHKI,NUSHKI TEHSIL,24,2033,795,2828
NUSHKI,NUSHKI TEHSIL,25,2136,841,2977
NUSHKI,NUSHKI TEHSIL,26,1965,894,2859
NUSHKI,NUSHKI TEHSIL,27,2298,788,3086
NUSHKI,NUSHKI TEHSIL,28,2146,769,2915
NUSHKI,NUSHKI TEHSIL,29,1986,777,2763
NUSHKI,NUSHKI TEHSIL,30,1735,691,2426
NUSHKI,NUSHKI TEHSIL,31,1795,710,2505
NUSHKI,NUSHKI TEHSIL,32,1463,544,2007
NUSHKI,NUSHKI TEHSIL,33,1559,571,2130
NUSHKI,NUSHKI TEHSIL,34,1511,576,2087
NUSHKI,NUSHKI TEHSIL,35,1453,502,1955
NUSHKI,NUSHKI TEHSIL,36,1267,510,1777
NUSHKI,NUSHKI TEHSIL,37,1543,418,1961
NUSHKI,NUSHKI TEHSIL,38,1262,468,1730
NUSHKI,NUSHKI TEHSIL,39,1240,462,1702
NUSHKI,NUSHKI TEHSIL,40,1013,412,1425
NUSHKI,NUSHKI TEHSIL,41,1052,384,1436
NUSHKI,NUSHKI TEHSIL,42,835,275,1110
NUSHKI,NUSHKI TEHSIL,43,881,347,1228
NUSHKI,NUSHKI TEHSIL,44,802,282,1084
NUSHKI,NUSHKI TEHSIL,45,780,339,1119
NUSHKI,NUSHKI TEHSIL,46,731,301,1032
NUSHKI,NUSHKI TEHSIL,47,910,246,1156
NUSHKI,NUSHKI TEHSIL,48,787,320,1107
NUSHKI,NUSHKI TEHSIL,49,915,301,1216
NUSHKI,NUSHKI TEHSIL,50,730,311,1041
NUSHKI,NUSHKI TEHSIL,51,792,242,1034
NUSHKI,NUSHKI TEHSIL,52,625,190,815
NUSHKI,NUSHKI TEHSIL,53,653,246,899
NUSHKI,NUSHKI TEHSIL,54,571,194,765
NUSHKI,NUSHKI TEHSIL,55,462,180,642
NUSHKI,NUSHKI TEHSIL,56,438,186,624
NUSHKI,NUSHKI TEHSIL,57,486,147,633
NUSHKI,NUSHKI TEHSIL,58,470,162,632
NUSHKI,NUSHKI TEHSIL,59,536,162,698
NUSHKI,NUSHKI TEHSIL,60,388,142,530
NUSHKI,NUSHKI TEHSIL,61,490,171,661
NUSHKI,NUSHKI TEHSIL,62,466,118,584
NUSHKI,NUSHKI TEHSIL,63,373,137,510
NUSHKI,NUSHKI TEHSIL,64,437,105,542
NUSHKI,NUSHKI TEHSIL,65,250,112,362
NUSHKI,NUSHKI TEHSIL,66,337,121,458
NUSHKI,NUSHKI TEHSIL,67,362,82,444
NUSHKI,NUSHKI TEHSIL,68,233,92,325
NUSHKI,NUSHKI TEHSIL,69,268,86,354
NUSHKI,NUSHKI TEHSIL,70,228,77,305
NUSHKI,NUSHKI TEHSIL,71,250,93,343
NUSHKI,NUSHKI TEHSIL,72,245,53,298
NUSHKI,NUSHKI TEHSIL,73,154,61,215
NUSHKI,NUSHKI TEHSIL,74,165,41,206
NUSHKI,NUSHKI TEHSIL,>=75,1210,349,1559
OKARA DISTRICT,DEPALPUR TEHSIL,<1,25662,7439,33101
OKARA DISTRICT,DEPALPUR TEHSIL,1,27767,9222,36989
OKARA DISTRICT,DEPALPUR TEHSIL,2,29207,8950,38157
OKARA DISTRICT,DEPALPUR TEHSIL,3,31734,9624,41358
OKARA DISTRICT,DEPALPUR TEHSIL,4,32163,9231,41394
OKARA DISTRICT,DEPALPUR TEHSIL,5,30306,9618,39924
OKARA DISTRICT,DEPALPUR TEHSIL,6,30167,9199,39366
OKARA DISTRICT,DEPALPUR TEHSIL,7,32231,9920,42151
OKARA DISTRICT,DEPALPUR TEHSIL,8,31759,9283,41042
OKARA DISTRICT,DEPALPUR TEHSIL,9,28913,9388,38301
OKARA DISTRICT,DEPALPUR TEHSIL,10,28400,8668,37068
OKARA DISTRICT,DEPALPUR TEHSIL,11,24821,8918,33739
OKARA DISTRICT,DEPALPUR TEHSIL,12,24968,7935,32903
OKARA DISTRICT,DEPALPUR TEHSIL,13,21707,7821,29528
OKARA DISTRICT,DEPALPUR TEHSIL,14,21912,7422,29334
OKARA DISTRICT,DEPALPUR TEHSIL,15,20694,7374,28068
OKARA DISTRICT,DEPALPUR TEHSIL,16,20812,7163,27975
OKARA DISTRICT,DEPALPUR TEHSIL,17,19196,7090,26286
OKARA DISTRICT,DEPALPUR TEHSIL,18,21168,6652,27820
OKARA DISTRICT,DEPALPUR TEHSIL,19,19286,7108,26394
OKARA DISTRICT,DEPALPUR TEHSIL,20,20559,6477,27036
OKARA DISTRICT,DEPALPUR TEHSIL,21,18241,6584,24825
OKARA DISTRICT,DEPALPUR TEHSIL,22,18534,6527,25061
OKARA DISTRICT,DEPALPUR TEHSIL,23,15964,5883,21847
OKARA DISTRICT,DEPALPUR TEHSIL,24,15403,5624,21027
OKARA DISTRICT,DEPALPUR TEHSIL,25,17776,5737,23513
OKARA DISTRICT,DEPALPUR TEHSIL,26,14945,5372,20317
OKARA DISTRICT,DEPALPUR TEHSIL,27,14656,5536,20192
OKARA DISTRICT,DEPALPUR TEHSIL,28,14376,5137,19513
OKARA DISTRICT,DEPALPUR TEHSIL,29,14664,5226,19890
OKARA DISTRICT,DEPALPUR TEHSIL,30,14947,5196,20143
OKARA DISTRICT,DEPALPUR TEHSIL,31,13450,4624,18074
OKARA DISTRICT,DEPALPUR TEHSIL,32,12927,4933,17860
OKARA DISTRICT,DEPALPUR TEHSIL,33,11982,4525,16507
OKARA DISTRICT,DEPALPUR TEHSIL,34,11846,4083,15929
OKARA DISTRICT,DEPALPUR TEHSIL,35,13483,4532,18015
OKARA DISTRICT,DEPALPUR TEHSIL,36,11954,3750,15704
OKARA DISTRICT,DEPALPUR TEHSIL,37,13178,4354,17532
OKARA DISTRICT,DEPALPUR TEHSIL,38,10629,3996,14625
OKARA DISTRICT,DEPALPUR TEHSIL,39,12088,4229,16317
OKARA DISTRICT,DEPALPUR TEHSIL,40,10517,3803,14320
OKARA DISTRICT,DEPALPUR TEHSIL,41,11215,3661,14876
OKARA DISTRICT,DEPALPUR TEHSIL,42,10524,3737,14261
OKARA DISTRICT,DEPALPUR TEHSIL,43,8354,2965,11319
OKARA DISTRICT,DEPALPUR TEHSIL,44,7723,2690,10413
OKARA DISTRICT,DEPALPUR TEHSIL,45,8272,3055,11327
OKARA DISTRICT,DEPALPUR TEHSIL,46,7575,2491,10066
OKARA DISTRICT,DEPALPUR TEHSIL,47,9012,2963,11975
OKARA DISTRICT,DEPALPUR TEHSIL,48,7158,2679,9837
OKARA DISTRICT,DEPALPUR TEHSIL,49,8217,2924,11141
OKARA DISTRICT,DEPALPUR TEHSIL,50,7616,2836,10452
OKARA DISTRICT,DEPALPUR TEHSIL,51,8302,2785,11087
OKARA DISTRICT,DEPALPUR TEHSIL,52,8385,2791,11176
OKARA DISTRICT,DEPALPUR TEHSIL,53,6577,2465,9042
OKARA DISTRICT,DEPALPUR TEHSIL,54,5800,2022,7822
OKARA DISTRICT,DEPALPUR TEHSIL,55,5578,2028,7606
OKARA DISTRICT,DEPALPUR TEHSIL,56,5057,1652,6709
OKARA DISTRICT,DEPALPUR TEHSIL,57,5914,1784,7698
OKARA DISTRICT,DEPALPUR TEHSIL,58,4166,1342,5508
OKARA DISTRICT,DEPALPUR TEHSIL,59,4417,1445,5862
OKARA DISTRICT,DEPALPUR TEHSIL,60,4480,1437,5917
OKARA DISTRICT,DEPALPUR TEHSIL,61,4456,1389,5845
OKARA DISTRICT,DEPALPUR TEHSIL,62,4709,1382,6091
OKARA DISTRICT,DEPALPUR TEHSIL,63,3972,1298,5270
OKARA DISTRICT,DEPALPUR TEHSIL,64,3888,1146,5034
OKARA DISTRICT,DEPALPUR TEHSIL,65,3887,1230,5117
OKARA DISTRICT,DEPALPUR TEHSIL,66,3219,914,4133
OKARA DISTRICT,DEPALPUR TEHSIL,67,3603,1015,4618
OKARA DISTRICT,DEPALPUR TEHSIL,68,3019,863,3882
OKARA DISTRICT,DEPALPUR TEHSIL,69,3163,902,4065
OKARA DISTRICT,DEPALPUR TEHSIL,70,3214,924,4138
OKARA DISTRICT,DEPALPUR TEHSIL,71,2983,852,3835
OKARA DISTRICT,DEPALPUR TEHSIL,72,2713,805,3518
OKARA DISTRICT,DEPALPUR TEHSIL,73,2517,725,3242
OKARA DISTRICT,DEPALPUR TEHSIL,74,2212,560,2772
OKARA DISTRICT,DEPALPUR TEHSIL,>=75,16371,4615,20986
OKARA DISTRICT,OKARA TEHSIL,<1,18182,9067,27249
OKARA DISTRICT,OKARA TEHSIL,1,20202,10647,30849
OKARA DISTRICT,OKARA TEHSIL,2,20907,10487,31394
OKARA DISTRICT,OKARA TEHSIL,3,22586,11574,34160
OKARA DISTRICT,OKARA TEHSIL,4,22810,10903,33713
OKARA DISTRICT,OKARA TEHSIL,5,21650,10860,32510
OKARA DISTRICT,OKARA TEHSIL,6,20829,10585,31414
OKARA DISTRICT,OKARA TEHSIL,7,22400,11287,33687
OKARA DISTRICT,OKARA TEHSIL,8,21886,10097,31983
OKARA DISTRICT,OKARA TEHSIL,9,20468,11065,31533
OKARA DISTRICT,OKARA TEHSIL,10,19853,9653,29506
OKARA DISTRICT,OKARA TEHSIL,11,18045,10280,28325
OKARA DISTRICT,OKARA TEHSIL,12,17626,9392,27018
OKARA DISTRICT,OKARA TEHSIL,13,15956,9421,25377
OKARA DISTRICT,OKARA TEHSIL,14,16037,8827,24864
OKARA DISTRICT,OKARA TEHSIL,15,15745,8930,24675
OKARA DISTRICT,OKARA TEHSIL,16,15680,8919,24599
OKARA DISTRICT,OKARA TEHSIL,17,15405,9224,24629
OKARA DISTRICT,OKARA TEHSIL,18,15649,8312,23961
OKARA DISTRICT,OKARA TEHSIL,19,14330,8947,23277
OKARA DISTRICT,OKARA TEHSIL,20,15670,8372,24042
OKARA DISTRICT,OKARA TEHSIL,21,13210,9087,22297
OKARA DISTRICT,OKARA TEHSIL,22,14174,8963,23137
OKARA DISTRICT,OKARA TEHSIL,23,11989,8962,20951
OKARA DISTRICT,OKARA TEHSIL,24,11100,8827,19927
OKARA DISTRICT,OKARA TEHSIL,25,13596,8300,21896
OKARA DISTRICT,OKARA TEHSIL,26,10447,9006,19453
OKARA DISTRICT,OKARA TEHSIL,27,10468,8695,19163
OKARA DISTRICT,OKARA TEHSIL,28,10745,8466,19211
OKARA DISTRICT,OKARA TEHSIL,29,10216,7954,18170
OKARA DISTRICT,OKARA TEHSIL,30,12365,8218,20583
OKARA DISTRICT,OKARA TEHSIL,31,9587,7155,16742
OKARA DISTRICT,OKARA TEHSIL,32,9687,7486,17173
OKARA DISTRICT,OKARA TEHSIL,33,9280,7138,16418
OKARA DISTRICT,OKARA TEHSIL,34,8348,6407,14755
OKARA DISTRICT,OKARA TEHSIL,35,11088,6898,17986
OKARA DISTRICT,OKARA TEHSIL,36,8140,5921,14061
OKARA DISTRICT,OKARA TEHSIL,37,8810,5603,14413
OKARA DISTRICT,OKARA TEHSIL,38,8525,6276,14801
OKARA DISTRICT,OKARA TEHSIL,39,9051,5909,14960
OKARA DISTRICT,OKARA TEHSIL,40,9145,5921,15066
OKARA DISTRICT,OKARA TEHSIL,41,7538,4842,12380
OKARA DISTRICT,OKARA TEHSIL,42,7464,4583,12047
OKARA DISTRICT,OKARA TEHSIL,43,6630,4375,11005
OKARA DISTRICT,OKARA TEHSIL,44,6125,3821,9946
OKARA DISTRICT,OKARA TEHSIL,45,7254,4438,11692
OKARA DISTRICT,OKARA TEHSIL,46,5168,3126,8294
OKARA DISTRICT,OKARA TEHSIL,47,6153,3331,9484
OKARA DISTRICT,OKARA TEHSIL,48,5756,3685,9441
OKARA DISTRICT,OKARA TEHSIL,49,6412,3669,10081
OKARA DISTRICT,OKARA TEHSIL,50,6921,4059,10980
OKARA DISTRICT,OKARA TEHSIL,51,5658,3233,8891
OKARA DISTRICT,OKARA TEHSIL,52,5868,3166,9034
OKARA DISTRICT,OKARA TEHSIL,53,5148,3256,8404
OKARA DISTRICT,OKARA TEHSIL,54,4880,2853,7733
OKARA DISTRICT,OKARA TEHSIL,55,5033,3042,8075
OKARA DISTRICT,OKARA TEHSIL,56,3663,2117,5780
OKARA DISTRICT,OKARA TEHSIL,57,4109,1963,6072
OKARA DISTRICT,OKARA TEHSIL,58,3505,2064,5569
OKARA DISTRICT,OKARA TEHSIL,59,3592,1903,5495
OKARA DISTRICT,OKARA TEHSIL,60,4273,2248,6521
OKARA DISTRICT,OKARA TEHSIL,61,3318,1780,5098
OKARA DISTRICT,OKARA TEHSIL,62,3306,1732,5038
OKARA DISTRICT,OKARA TEHSIL,63,3108,1890,4998
OKARA DISTRICT,OKARA TEHSIL,64,3136,1563,4699
OKARA DISTRICT,OKARA TEHSIL,65,3360,1685,5045
OKARA DISTRICT,OKARA TEHSIL,66,1958,938,2896
OKARA DISTRICT,OKARA TEHSIL,67,2328,934,3262
OKARA DISTRICT,OKARA TEHSIL,68,2042,1051,3093
OKARA DISTRICT,OKARA TEHSIL,69,2409,1007,3416
OKARA DISTRICT,OKARA TEHSIL,70,2794,1145,3939
OKARA DISTRICT,OKARA TEHSIL,71,1970,883,2853
OKARA DISTRICT,OKARA TEHSIL,72,1965,870,2835
OKARA DISTRICT,OKARA TEHSIL,73,1822,779,2601
OKARA DISTRICT,OKARA TEHSIL,74,1739,702,2441
OKARA DISTRICT,OKARA TEHSIL,>=75,12148,5105,17253
OKARA DISTRICT,RENALA KHURD TEHSIL,<1,10008,1188,11196
OKARA DISTRICT,RENALA KHURD TEHSIL,1,10617,1274,11891
OKARA DISTRICT,RENALA KHURD TEHSIL,2,10857,1252,12109
OKARA DISTRICT,RENALA KHURD TEHSIL,3,11580,1408,12988
OKARA DISTRICT,RENALA KHURD TEHSIL,4,10732,1277,12009
OKARA DISTRICT,RENALA KHURD TEHSIL,5,11260,1352,12612
OKARA DISTRICT,RENALA KHURD TEHSIL,6,10346,1260,11606
OKARA DISTRICT,RENALA KHURD TEHSIL,7,11367,1379,12746
OKARA DISTRICT,RENALA KHURD TEHSIL,8,10196,1233,11429
OKARA DISTRICT,RENALA KHURD TEHSIL,9,10445,1315,11760
OKARA DISTRICT,RENALA KHURD TEHSIL,10,9614,1123,10737
OKARA DISTRICT,RENALA KHURD TEHSIL,11,9820,1367,11187
OKARA DISTRICT,RENALA KHURD TEHSIL,12,8786,1092,9878
OKARA DISTRICT,RENALA KHURD TEHSIL,13,9053,1299,10352
OKARA DISTRICT,RENALA KHURD TEHSIL,14,8575,1131,9706
OKARA DISTRICT,RENALA KHURD TEHSIL,15,8360,1141,9501
OKARA DISTRICT,RENALA KHURD TEHSIL,16,8447,1100,9547
OKARA DISTRICT,RENALA KHURD TEHSIL,17,8237,1227,9464
OKARA DISTRICT,RENALA KHURD TEHSIL,18,7915,1018,8933
OKARA DISTRICT,RENALA KHURD TEHSIL,19,8492,1240,9732
OKARA DISTRICT,RENALA KHURD TEHSIL,20,7963,989,8952
OKARA DISTRICT,RENALA KHURD TEHSIL,21,8214,1278,9492
OKARA DISTRICT,RENALA KHURD TEHSIL,22,7671,1126,8797
OKARA DISTRICT,RENALA KHURD TEHSIL,23,7389,1173,8562
OKARA DISTRICT,RENALA KHURD TEHSIL,24,6963,1054,8017
OKARA DISTRICT,RENALA KHURD TEHSIL,25,6858,880,7738
OKARA DISTRICT,RENALA KHURD TEHSIL,26,6404,1014,7418
OKARA DISTRICT,RENALA KHURD TEHSIL,27,6316,987,7303
OKARA DISTRICT,RENALA KHURD TEHSIL,28,5939,890,6829
OKARA DISTRICT,RENALA KHURD TEHSIL,29,6023,873,6896
OKARA DISTRICT,RENALA KHURD TEHSIL,30,5737,803,6540
OKARA DISTRICT,RENALA KHURD TEHSIL,31,5701,826,6527
OKARA DISTRICT,RENALA KHURD TEHSIL,32,5176,790,5966
OKARA DISTRICT,RENALA KHURD TEHSIL,33,5013,756,5769
OKARA DISTRICT,RENALA KHURD TEHSIL,34,4965,707,5672
OKARA DISTRICT,RENALA KHURD TEHSIL,35,4966,673,5639
OKARA DISTRICT,RENALA KHURD TEHSIL,36,4604,700,5304
OKARA DISTRICT,RENALA KHURD TEHSIL,37,5063,637,5700
OKARA DISTRICT,RENALA KHURD TEHSIL,38,4455,706,5161
OKARA DISTRICT,RENALA KHURD TEHSIL,39,4769,643,5412
OKARA DISTRICT,RENALA KHURD TEHSIL,40,3982,570,4552
OKARA DISTRICT,RENALA KHURD TEHSIL,41,4276,571,4847
OKARA DISTRICT,RENALA KHURD TEHSIL,42,3939,518,4457
OKARA DISTRICT,RENALA KHURD TEHSIL,43,3496,581,4077
OKARA DISTRICT,RENALA KHURD TEHSIL,44,3328,491,3819
OKARA DISTRICT,RENALA KHURD TEHSIL,45,3234,478,3712
OKARA DISTRICT,RENALA KHURD TEHSIL,46,3098,432,3530
OKARA DISTRICT,RENALA KHURD TEHSIL,47,3465,403,3868
OKARA DISTRICT,RENALA KHURD TEHSIL,48,3144,496,3640
OKARA DISTRICT,RENALA KHURD TEHSIL,49,3481,499,3980
OKARA DISTRICT,RENALA KHURD TEHSIL,50,3017,467,3484
OKARA DISTRICT,RENALA KHURD TEHSIL,51,3299,519,3818
OKARA DISTRICT,RENALA KHURD TEHSIL,52,3275,429,3704
OKARA DISTRICT,RENALA KHURD TEHSIL,53,2872,438,3310
OKARA DISTRICT,RENALA KHURD TEHSIL,54,2726,399,3125
OKARA DISTRICT,RENALA KHURD TEHSIL,55,2461,344,2805
OKARA DISTRICT,RENALA KHURD TEHSIL,56,2273,340,2613
OKARA DISTRICT,RENALA KHURD TEHSIL,57,2349,308,2657
OKARA DISTRICT,RENALA KHURD TEHSIL,58,2033,294,2327
OKARA DISTRICT,RENALA KHURD TEHSIL,59,2163,291,2454
OKARA DISTRICT,RENALA KHURD TEHSIL,60,1833,233,2066
OKARA DISTRICT,RENALA KHURD TEHSIL,61,1888,259,2147
OKARA DISTRICT,RENALA KHURD TEHSIL,62,1835,264,2099
OKARA DISTRICT,RENALA KHURD TEHSIL,63,1771,229,2000
OKARA DISTRICT,RENALA KHURD TEHSIL,64,1671,201,1872
OKARA DISTRICT,RENALA KHURD TEHSIL,65,1452,182,1634
OKARA DISTRICT,RENALA KHURD TEHSIL,66,1240,136,1376
OKARA DISTRICT,RENALA KHURD TEHSIL,67,1314,135,1449
OKARA DISTRICT,RENALA KHURD TEHSIL,68,1297,116,1413
OKARA DISTRICT,RENALA KHURD TEHSIL,69,1302,135,1437
OKARA DISTRICT,RENALA KHURD TEHSIL,70,1238,114,1352
OKARA DISTRICT,RENALA KHURD TEHSIL,71,1098,125,1223
OKARA DISTRICT,RENALA KHURD TEHSIL,72,1102,114,1216
OKARA DISTRICT,RENALA KHURD TEHSIL,73,1052,106,1158
OKARA DISTRICT,RENALA KHURD TEHSIL,74,1004,90,1094
OKARA DISTRICT,RENALA KHURD TEHSIL,>=75,6658,672,7330
ORAKZAI AGENCY,CENTRAL TEHSIL,<1,1780,0,1780
ORAKZAI AGENCY,CENTRAL TEHSIL,1,2193,0,2193
ORAKZAI AGENCY,CENTRAL TEHSIL,2,2531,0,2531
ORAKZAI AGENCY,CENTRAL TEHSIL,3,2508,0,2508
ORAKZAI AGENCY,CENTRAL TEHSIL,4,2436,0,2436
ORAKZAI AGENCY,CENTRAL TEHSIL,5,2235,0,2235
ORAKZAI AGENCY,CENTRAL TEHSIL,6,2378,0,2378
ORAKZAI AGENCY,CENTRAL TEHSIL,7,2085,0,2085
ORAKZAI AGENCY,CENTRAL TEHSIL,8,2401,0,2401
ORAKZAI AGENCY,CENTRAL TEHSIL,9,1897,0,1897
ORAKZAI AGENCY,CENTRAL TEHSIL,10,2013,0,2013
ORAKZAI AGENCY,CENTRAL TEHSIL,11,1529,0,1529
ORAKZAI AGENCY,CENTRAL TEHSIL,12,1540,0,1540
ORAKZAI AGENCY,CENTRAL TEHSIL,13,1487,0,1487
ORAKZAI AGENCY,CENTRAL TEHSIL,14,1294,0,1294
ORAKZAI AGENCY,CENTRAL TEHSIL,15,1247,0,1247
ORAKZAI AGENCY,CENTRAL TEHSIL,16,1195,0,1195
ORAKZAI AGENCY,CENTRAL TEHSIL,17,996,0,996
ORAKZAI AGENCY,CENTRAL TEHSIL,18,1113,0,1113
ORAKZAI AGENCY,CENTRAL TEHSIL,19,996,0,996
ORAKZAI AGENCY,CENTRAL TEHSIL,20,1104,0,1104
ORAKZAI AGENCY,CENTRAL TEHSIL,21,886,0,886
ORAKZAI AGENCY,CENTRAL TEHSIL,22,700,0,700
ORAKZAI AGENCY,CENTRAL TEHSIL,23,911,0,911
ORAKZAI AGENCY,CENTRAL TEHSIL,24,975,0,975
ORAKZAI AGENCY,CENTRAL TEHSIL,25,933,0,933
ORAKZAI AGENCY,CENTRAL TEHSIL,26,1000,0,1000
ORAKZAI AGENCY,CENTRAL TEHSIL,27,787,0,787
ORAKZAI AGENCY,CENTRAL TEHSIL,28,810,0,810
ORAKZAI AGENCY,CENTRAL TEHSIL,29,713,0,713
ORAKZAI AGENCY,CENTRAL TEHSIL,30,697,0,697
ORAKZAI AGENCY,CENTRAL TEHSIL,31,737,0,737
ORAKZAI AGENCY,CENTRAL TEHSIL,32,586,0,586
ORAKZAI AGENCY,CENTRAL TEHSIL,33,592,0,592
ORAKZAI AGENCY,CENTRAL TEHSIL,34,586,0,586
ORAKZAI AGENCY,CENTRAL TEHSIL,35,496,0,496
ORAKZAI AGENCY,CENTRAL TEHSIL,36,551,0,551
ORAKZAI AGENCY,CENTRAL TEHSIL,37,454,0,454
ORAKZAI AGENCY,CENTRAL TEHSIL,38,484,0,484
ORAKZAI AGENCY,CENTRAL TEHSIL,39,397,0,397
ORAKZAI AGENCY,CENTRAL TEHSIL,40,485,0,485
ORAKZAI AGENCY,CENTRAL TEHSIL,41,462,0,462
ORAKZAI AGENCY,CENTRAL TEHSIL,42,324,0,324
ORAKZAI AGENCY,CENTRAL TEHSIL,43,351,0,351
ORAKZAI AGENCY,CENTRAL TEHSIL,44,371,0,371
ORAKZAI AGENCY,CENTRAL TEHSIL,45,327,0,327
ORAKZAI AGENCY,CENTRAL TEHSIL,46,405,0,405
ORAKZAI AGENCY,CENTRAL TEHSIL,47,298,0,298
ORAKZAI AGENCY,CENTRAL TEHSIL,48,303,0,303
ORAKZAI AGENCY,CENTRAL TEHSIL,49,283,0,283
ORAKZAI AGENCY,CENTRAL TEHSIL,50,380,0,380
ORAKZAI AGENCY,CENTRAL TEHSIL,51,347,0,347
ORAKZAI AGENCY,CENTRAL TEHSIL,52,240,0,240
ORAKZAI AGENCY,CENTRAL TEHSIL,53,298,0,298
ORAKZAI AGENCY,CENTRAL TEHSIL,54,236,0,236
ORAKZAI AGENCY,CENTRAL TEHSIL,55,278,0,278
ORAKZAI AGENCY,CENTRAL TEHSIL,56,301,0,301
ORAKZAI AGENCY,CENTRAL TEHSIL,57,226,0,226
ORAKZAI AGENCY,CENTRAL TEHSIL,58,212,0,212
ORAKZAI AGENCY,CENTRAL TEHSIL,59,176,0,176
ORAKZAI AGENCY,CENTRAL TEHSIL,60,275,0,275
ORAKZAI AGENCY,CENTRAL TEHSIL,61,223,0,223
ORAKZAI AGENCY,CENTRAL TEHSIL,62,168,0,168
ORAKZAI AGENCY,CENTRAL TEHSIL,63,178,0,178
ORAKZAI AGENCY,CENTRAL TEHSIL,64,175,0,175
ORAKZAI AGENCY,CENTRAL TEHSIL,65,161,0,161
ORAKZAI AGENCY,CENTRAL TEHSIL,66,163,0,163
ORAKZAI AGENCY,CENTRAL TEHSIL,67,104,0,104
ORAKZAI AGENCY,CENTRAL TEHSIL,68,129,0,129
ORAKZAI AGENCY,CENTRAL TEHSIL,69,112,0,112
ORAKZAI AGENCY,CENTRAL TEHSIL,70,111,0,111
ORAKZAI AGENCY,CENTRAL TEHSIL,71,106,0,106
ORAKZAI AGENCY,CENTRAL TEHSIL,72,60,0,60
ORAKZAI AGENCY,CENTRAL TEHSIL,73,57,0,57
ORAKZAI AGENCY,CENTRAL TEHSIL,74,65,0,65
ORAKZAI AGENCY,CENTRAL TEHSIL,>=75,489,0,489
ORAKZAI AGENCY,ISMAIL ZAI TEHSIL,<1,644,0,644
ORAKZAI AGENCY,ISMAIL ZAI TEHSIL,1,784,0,784
ORAKZAI AGENCY,ISMAIL ZAI TEHSIL,2,826,0,826
ORAKZAI AGENCY,ISMAIL ZAI TEHSIL,3,801,0,801
ORAKZAI AGENCY,ISMAIL ZAI TEHSIL,4,821,0,821
ORAKZAI AGENCY,ISMAIL ZAI TEHSIL,5,803,0,803
ORAKZAI AGENCY,ISMAIL ZAI TEHSIL,6,806,0,806
ORAKZAI AGENCY,ISMAIL ZAI TEHSIL,7,802,0,802
ORAKZAI AGENCY,ISMAIL ZAI TEHSIL,8,849,0,849
ORAKZAI AGENCY,ISMAIL ZAI TEHSIL,9,765,0,765
ORAKZAI AGENCY,ISMAIL ZAI TEHSIL,10,777,0,777
ORAKZAI AGENCY,ISMAIL ZAI TEHSIL,11,641,0,641
ORAKZAI AGENCY,ISMAIL ZAI TEHSIL,12,655,0,655
ORAKZAI AGENCY,ISMAIL ZAI TEHSIL,13,654,0,654
ORAKZAI AGENCY,ISMAIL ZAI TEHSIL,14,577,0,577
ORAKZAI AGENCY,ISMAIL ZAI TEHSIL,15,597,0,597
ORAKZAI AGENCY,ISMAIL ZAI TEHSIL,16,572,0,572
ORAKZAI AGENCY,ISMAIL ZAI TEHSIL,17,411,0,411
ORAKZAI AGENCY,ISMAIL ZAI TEHSIL,18,487,0,487
ORAKZAI AGENCY,ISMAIL ZAI TEHSIL,19,468,0,468
ORAKZAI AGENCY,ISMAIL ZAI TEHSIL,20,458,0,458
ORAKZAI AGENCY,ISMAIL ZAI TEHSIL,21,474,0,474
ORAKZAI AGENCY,ISMAIL ZAI TEHSIL,22,384,0,384
ORAKZAI AGENCY,ISMAIL ZAI TEHSIL,23,379,0,379
ORAKZAI AGENCY,ISMAIL ZAI TEHSIL,24,386,0,386
ORAKZAI AGENCY,ISMAIL ZAI TEHSIL,25,429,0,429
ORAKZAI AGENCY,ISMAIL ZAI TEHSIL,26,365,0,365
ORAKZAI AGENCY,ISMAIL ZAI TEHSIL,27,359,0,359
ORAKZAI AGENCY,ISMAIL ZAI TEHSIL,28,387,0,387
ORAKZAI AGENCY,ISMAIL ZAI TEHSIL,29,353,0,353
ORAKZAI AGENCY,ISMAIL ZAI TEHSIL,30,352,0,352
ORAKZAI AGENCY,ISMAIL ZAI TEHSIL,31,321,0,321
ORAKZAI AGENCY,ISMAIL ZAI TEHSIL,32,245,0,245
ORAKZAI AGENCY,ISMAIL ZAI TEHSIL,33,282,0,282
ORAKZAI AGENCY,ISMAIL ZAI TEHSIL,34,262,0,262
ORAKZAI AGENCY,ISMAIL ZAI TEHSIL,35,246,0,246
ORAKZAI AGENCY,ISMAIL ZAI TEHSIL,36,224,0,224
ORAKZAI AGENCY,ISMAIL ZAI TEHSIL,37,196,0,196
ORAKZAI AGENCY,ISMAIL ZAI TEHSIL,38,190,0,190
ORAKZAI AGENCY,ISMAIL ZAI TEHSIL,39,186,0,186
ORAKZAI AGENCY,ISMAIL ZAI TEHSIL,40,201,0,201
ORAKZAI AGENCY,ISMAIL ZAI TEHSIL,41,201,0,201
ORAKZAI AGENCY,ISMAIL ZAI TEHSIL,42,125,0,125
ORAKZAI AGENCY,ISMAIL ZAI TEHSIL,43,175,0,175
ORAKZAI AGENCY,ISMAIL ZAI TEHSIL,44,160,0,160
ORAKZAI AGENCY,ISMAIL ZAI TEHSIL,45,169,0,169
ORAKZAI AGENCY,ISMAIL ZAI TEHSIL,46,177,0,177
ORAKZAI AGENCY,ISMAIL ZAI TEHSIL,47,134,0,134
ORAKZAI AGENCY,ISMAIL ZAI TEHSIL,48,120,0,120
ORAKZAI AGENCY,ISMAIL ZAI TEHSIL,49,100,0,100
ORAKZAI AGENCY,ISMAIL ZAI TEHSIL,50,152,0,152
ORAKZAI AGENCY,ISMAIL ZAI TEHSIL,51,111,0,111
ORAKZAI AGENCY,ISMAIL ZAI TEHSIL,52,96,0,96
ORAKZAI AGENCY,ISMAIL ZAI TEHSIL,53,124,0,124
ORAKZAI AGENCY,ISMAIL ZAI TEHSIL,54,119,0,119
ORAKZAI AGENCY,ISMAIL ZAI TEHSIL,55,107,0,107
ORAKZAI AGENCY,ISMAIL ZAI TEHSIL,56,108,0,108
ORAKZAI AGENCY,ISMAIL ZAI TEHSIL,57,74,0,74
ORAKZAI AGENCY,ISMAIL ZAI TEHSIL,58,95,0,95
ORAKZAI AGENCY,ISMAIL ZAI TEHSIL,59,76,0,76
ORAKZAI AGENCY,ISMAIL ZAI TEHSIL,60,117,0,117
ORAKZAI AGENCY,ISMAIL ZAI TEHSIL,61,106,0,106
ORAKZAI AGENCY,ISMAIL ZAI TEHSIL,62,72,0,72
ORAKZAI AGENCY,ISMAIL ZAI TEHSIL,63,80,0,80
ORAKZAI AGENCY,ISMAIL ZAI TEHSIL,64,82,0,82
ORAKZAI AGENCY,ISMAIL ZAI TEHSIL,65,71,0,71
ORAKZAI AGENCY,ISMAIL ZAI TEHSIL,66,93,0,93
ORAKZAI AGENCY,ISMAIL ZAI TEHSIL,67,54,0,54
ORAKZAI AGENCY,ISMAIL ZAI TEHSIL,68,50,0,50
ORAKZAI AGENCY,ISMAIL ZAI TEHSIL,69,43,0,43
ORAKZAI AGENCY,ISMAIL ZAI TEHSIL,70,33,0,33
ORAKZAI AGENCY,ISMAIL ZAI TEHSIL,71,36,0,36
ORAKZAI AGENCY,ISMAIL ZAI TEHSIL,72,24,0,24
ORAKZAI AGENCY,ISMAIL ZAI TEHSIL,73,35,0,35
ORAKZAI AGENCY,ISMAIL ZAI TEHSIL,74,32,0,32
ORAKZAI AGENCY,ISMAIL ZAI TEHSIL,>=75,193,0,193
ORAKZAI AGENCY,LOWER TEHSIL,<1,3209,0,3209
ORAKZAI AGENCY,LOWER TEHSIL,1,3963,0,3963
ORAKZAI AGENCY,LOWER TEHSIL,2,4444,0,4444
ORAKZAI AGENCY,LOWER TEHSIL,3,4501,0,4501
ORAKZAI AGENCY,LOWER TEHSIL,4,4418,0,4418
ORAKZAI AGENCY,LOWER TEHSIL,5,4189,0,4189
ORAKZAI AGENCY,LOWER TEHSIL,6,4156,0,4156
ORAKZAI AGENCY,LOWER TEHSIL,7,3791,0,3791
ORAKZAI AGENCY,LOWER TEHSIL,8,3870,0,3870
ORAKZAI AGENCY,LOWER TEHSIL,9,3429,0,3429
ORAKZAI AGENCY,LOWER TEHSIL,10,3479,0,3479
ORAKZAI AGENCY,LOWER TEHSIL,11,2789,0,2789
ORAKZAI AGENCY,LOWER TEHSIL,12,2725,0,2725
ORAKZAI AGENCY,LOWER TEHSIL,13,2542,0,2542
ORAKZAI AGENCY,LOWER TEHSIL,14,2381,0,2381
ORAKZAI AGENCY,LOWER TEHSIL,15,2342,0,2342
ORAKZAI AGENCY,LOWER TEHSIL,16,2019,0,2019
ORAKZAI AGENCY,LOWER TEHSIL,17,1950,0,1950
ORAKZAI AGENCY,LOWER TEHSIL,18,1798,0,1798
ORAKZAI AGENCY,LOWER TEHSIL,19,1891,0,1891
ORAKZAI AGENCY,LOWER TEHSIL,20,1904,0,1904
ORAKZAI AGENCY,LOWER TEHSIL,21,1715,0,1715
ORAKZAI AGENCY,LOWER TEHSIL,22,1341,0,1341
ORAKZAI AGENCY,LOWER TEHSIL,23,1633,0,1633
ORAKZAI AGENCY,LOWER TEHSIL,24,1546,0,1546
ORAKZAI AGENCY,LOWER TEHSIL,25,1659,0,1659
ORAKZAI AGENCY,LOWER TEHSIL,26,1888,0,1888
ORAKZAI AGENCY,LOWER TEHSIL,27,1883,0,1883
ORAKZAI AGENCY,LOWER TEHSIL,28,1407,0,1407
ORAKZAI AGENCY,LOWER TEHSIL,29,1638,0,1638
ORAKZAI AGENCY,LOWER TEHSIL,30,1224,0,1224
ORAKZAI AGENCY,LOWER TEHSIL,31,1542,0,1542
ORAKZAI AGENCY,LOWER TEHSIL,32,1201,0,1201
ORAKZAI AGENCY,LOWER TEHSIL,33,1121,0,1121
ORAKZAI AGENCY,LOWER TEHSIL,34,989,0,989
ORAKZAI AGENCY,LOWER TEHSIL,35,892,0,892
ORAKZAI AGENCY,LOWER TEHSIL,36,881,0,881
ORAKZAI AGENCY,LOWER TEHSIL,37,974,0,974
ORAKZAI AGENCY,LOWER TEHSIL,38,802,0,802
ORAKZAI AGENCY,LOWER TEHSIL,39,815,0,815
ORAKZAI AGENCY,LOWER TEHSIL,40,877,0,877
ORAKZAI AGENCY,LOWER TEHSIL,41,865,0,865
ORAKZAI AGENCY,LOWER TEHSIL,42,688,0,688
ORAKZAI AGENCY,LOWER TEHSIL,43,672,0,672
ORAKZAI AGENCY,LOWER TEHSIL,44,634,0,634
ORAKZAI AGENCY,LOWER TEHSIL,45,600,0,600
ORAKZAI AGENCY,LOWER TEHSIL,46,750,0,750
ORAKZAI AGENCY,LOWER TEHSIL,47,719,0,719
ORAKZAI AGENCY,LOWER TEHSIL,48,577,0,577
ORAKZAI AGENCY,LOWER TEHSIL,49,556,0,556
ORAKZAI AGENCY,LOWER TEHSIL,50,621,0,621
ORAKZAI AGENCY,LOWER TEHSIL,51,649,0,649
ORAKZAI AGENCY,LOWER TEHSIL,52,567,0,567
ORAKZAI AGENCY,LOWER TEHSIL,53,499,0,499
ORAKZAI AGENCY,LOWER TEHSIL,54,440,0,440
ORAKZAI AGENCY,LOWER TEHSIL,55,499,0,499
ORAKZAI AGENCY,LOWER TEHSIL,56,533,0,533
ORAKZAI AGENCY,LOWER TEHSIL,57,521,0,521
ORAKZAI AGENCY,LOWER TEHSIL,58,342,0,342
ORAKZAI AGENCY,LOWER TEHSIL,59,380,0,380
ORAKZAI AGENCY,LOWER TEHSIL,60,357,0,357
ORAKZAI AGENCY,LOWER TEHSIL,61,408,0,408
ORAKZAI AGENCY,LOWER TEHSIL,62,333,0,333
ORAKZAI AGENCY,LOWER TEHSIL,63,303,0,303
ORAKZAI AGENCY,LOWER TEHSIL,64,281,0,281
ORAKZAI AGENCY,LOWER TEHSIL,65,249,0,249
ORAKZAI AGENCY,LOWER TEHSIL,66,281,0,281
ORAKZAI AGENCY,LOWER TEHSIL,67,266,0,266
ORAKZAI AGENCY,LOWER TEHSIL,68,182,0,182
ORAKZAI AGENCY,LOWER TEHSIL,69,187,0,187
ORAKZAI AGENCY,LOWER TEHSIL,70,162,0,162
ORAKZAI AGENCY,LOWER TEHSIL,71,138,0,138
ORAKZAI AGENCY,LOWER TEHSIL,72,139,0,139
ORAKZAI AGENCY,LOWER TEHSIL,73,123,0,123
ORAKZAI AGENCY,LOWER TEHSIL,74,91,0,91
ORAKZAI AGENCY,LOWER TEHSIL,>=75,893,0,893
ORAKZAI AGENCY,UPPER TEHSIL,<1,1896,0,1896
ORAKZAI AGENCY,UPPER TEHSIL,1,2002,0,2002
ORAKZAI AGENCY,UPPER TEHSIL,2,2376,0,2376
ORAKZAI AGENCY,UPPER TEHSIL,3,2345,0,2345
ORAKZAI AGENCY,UPPER TEHSIL,4,2315,0,2315
ORAKZAI AGENCY,UPPER TEHSIL,5,2245,0,2245
ORAKZAI AGENCY,UPPER TEHSIL,6,2325,0,2325
ORAKZAI AGENCY,UPPER TEHSIL,7,2201,0,2201
ORAKZAI AGENCY,UPPER TEHSIL,8,2425,0,2425
ORAKZAI AGENCY,UPPER TEHSIL,9,2253,0,2253
ORAKZAI AGENCY,UPPER TEHSIL,10,2192,0,2192
ORAKZAI AGENCY,UPPER TEHSIL,11,1907,0,1907
ORAKZAI AGENCY,UPPER TEHSIL,12,1827,0,1827
ORAKZAI AGENCY,UPPER TEHSIL,13,1839,0,1839
ORAKZAI AGENCY,UPPER TEHSIL,14,1536,0,1536
ORAKZAI AGENCY,UPPER TEHSIL,15,1529,0,1529
ORAKZAI AGENCY,UPPER TEHSIL,16,1184,0,1184
ORAKZAI AGENCY,UPPER TEHSIL,17,1121,0,1121
ORAKZAI AGENCY,UPPER TEHSIL,18,1029,0,1029
ORAKZAI AGENCY,UPPER TEHSIL,19,1031,0,1031
ORAKZAI AGENCY,UPPER TEHSIL,20,972,0,972
ORAKZAI AGENCY,UPPER TEHSIL,21,984,0,984
ORAKZAI AGENCY,UPPER TEHSIL,22,841,0,841
ORAKZAI AGENCY,UPPER TEHSIL,23,1003,0,1003
ORAKZAI AGENCY,UPPER TEHSIL,24,935,0,935
ORAKZAI AGENCY,UPPER TEHSIL,25,1067,0,1067
ORAKZAI AGENCY,UPPER TEHSIL,26,1018,0,1018
ORAKZAI AGENCY,UPPER TEHSIL,27,1020,0,1020
ORAKZAI AGENCY,UPPER TEHSIL,28,948,0,948
ORAKZAI AGENCY,UPPER TEHSIL,29,1076,0,1076
ORAKZAI AGENCY,UPPER TEHSIL,30,868,0,868
ORAKZAI AGENCY,UPPER TEHSIL,31,1028,0,1028
ORAKZAI AGENCY,UPPER TEHSIL,32,780,0,780
ORAKZAI AGENCY,UPPER TEHSIL,33,832,0,832
ORAKZAI AGENCY,UPPER TEHSIL,34,683,0,683
ORAKZAI AGENCY,UPPER TEHSIL,35,616,0,616
ORAKZAI AGENCY,UPPER TEHSIL,36,538,0,538
ORAKZAI AGENCY,UPPER TEHSIL,37,578,0,578
ORAKZAI AGENCY,UPPER TEHSIL,38,485,0,485
ORAKZAI AGENCY,UPPER TEHSIL,39,490,0,490
ORAKZAI AGENCY,UPPER TEHSIL,40,539,0,539
ORAKZAI AGENCY,UPPER TEHSIL,41,504,0,504
ORAKZAI AGENCY,UPPER TEHSIL,42,393,0,393
ORAKZAI AGENCY,UPPER TEHSIL,43,401,0,401
ORAKZAI AGENCY,UPPER TEHSIL,44,372,0,372
ORAKZAI AGENCY,UPPER TEHSIL,45,343,0,343
ORAKZAI AGENCY,UPPER TEHSIL,46,371,0,371
ORAKZAI AGENCY,UPPER TEHSIL,47,388,0,388
ORAKZAI AGENCY,UPPER TEHSIL,48,321,0,321
ORAKZAI AGENCY,UPPER TEHSIL,49,330,0,330
ORAKZAI AGENCY,UPPER TEHSIL,50,383,0,383
ORAKZAI AGENCY,UPPER TEHSIL,51,321,0,321
ORAKZAI AGENCY,UPPER TEHSIL,52,287,0,287
ORAKZAI AGENCY,UPPER TEHSIL,53,292,0,292
ORAKZAI AGENCY,UPPER TEHSIL,54,277,0,277
ORAKZAI AGENCY,UPPER TEHSIL,55,258,0,258
ORAKZAI AGENCY,UPPER TEHSIL,56,272,0,272
ORAKZAI AGENCY,UPPER TEHSIL,57,281,0,281
ORAKZAI AGENCY,UPPER TEHSIL,58,209,0,209
ORAKZAI AGENCY,UPPER TEHSIL,59,216,0,216
ORAKZAI AGENCY,UPPER TEHSIL,60,238,0,238
ORAKZAI AGENCY,UPPER TEHSIL,61,233,0,233
ORAKZAI AGENCY,UPPER TEHSIL,62,220,0,220
ORAKZAI AGENCY,UPPER TEHSIL,63,198,0,198
ORAKZAI AGENCY,UPPER TEHSIL,64,206,0,206
ORAKZAI AGENCY,UPPER TEHSIL,65,160,0,160
ORAKZAI AGENCY,UPPER TEHSIL,66,154,0,154
ORAKZAI AGENCY,UPPER TEHSIL,67,189,0,189
ORAKZAI AGENCY,UPPER TEHSIL,68,139,0,139
ORAKZAI AGENCY,UPPER TEHSIL,69,137,0,137
ORAKZAI AGENCY,UPPER TEHSIL,70,105,0,105
ORAKZAI AGENCY,UPPER TEHSIL,71,106,0,106
ORAKZAI AGENCY,UPPER TEHSIL,72,77,0,77
ORAKZAI AGENCY,UPPER TEHSIL,73,91,0,91
ORAKZAI AGENCY,UPPER TEHSIL,74,68,0,68
ORAKZAI AGENCY,UPPER TEHSIL,>=75,466,0,466
PAKPATTAN DISTRICT,ARIF WALA TEHSIL,<1,20106,2757,22863
PAKPATTAN DISTRICT,ARIF WALA TEHSIL,1,20986,2874,23860
PAKPATTAN DISTRICT,ARIF WALA TEHSIL,2,20227,2829,23056
PAKPATTAN DISTRICT,ARIF WALA TEHSIL,3,21554,2969,24523
PAKPATTAN DISTRICT,ARIF WALA TEHSIL,4,21951,2948,24899
PAKPATTAN DISTRICT,ARIF WALA TEHSIL,5,20865,2743,23608
PAKPATTAN DISTRICT,ARIF WALA TEHSIL,6,20742,2811,23553
PAKPATTAN DISTRICT,ARIF WALA TEHSIL,7,22464,3038,25502
PAKPATTAN DISTRICT,ARIF WALA TEHSIL,8,20957,2687,23644
PAKPATTAN DISTRICT,ARIF WALA TEHSIL,9,20324,2966,23290
PAKPATTAN DISTRICT,ARIF WALA TEHSIL,10,18738,2477,21215
PAKPATTAN DISTRICT,ARIF WALA TEHSIL,11,17881,2870,20751
PAKPATTAN DISTRICT,ARIF WALA TEHSIL,12,16218,2365,18583
PAKPATTAN DISTRICT,ARIF WALA TEHSIL,13,15424,2601,18025
PAKPATTAN DISTRICT,ARIF WALA TEHSIL,14,14656,2387,17043
PAKPATTAN DISTRICT,ARIF WALA TEHSIL,15,14589,2392,16981
PAKPATTAN DISTRICT,ARIF WALA TEHSIL,16,14257,2355,16612
PAKPATTAN DISTRICT,ARIF WALA TEHSIL,17,13896,2404,16300
PAKPATTAN DISTRICT,ARIF WALA TEHSIL,18,13180,2028,15208
PAKPATTAN DISTRICT,ARIF WALA TEHSIL,19,13445,2323,15768
PAKPATTAN DISTRICT,ARIF WALA TEHSIL,20,13006,1874,14880
PAKPATTAN DISTRICT,ARIF WALA TEHSIL,21,13436,2251,15687
PAKPATTAN DISTRICT,ARIF WALA TEHSIL,22,12669,2058,14727
PAKPATTAN DISTRICT,ARIF WALA TEHSIL,23,12071,2140,14211
PAKPATTAN DISTRICT,ARIF WALA TEHSIL,24,11562,1972,13534
PAKPATTAN DISTRICT,ARIF WALA TEHSIL,25,10903,1635,12538
PAKPATTAN DISTRICT,ARIF WALA TEHSIL,26,11422,1907,13329
PAKPATTAN DISTRICT,ARIF WALA TEHSIL,27,11482,1964,13446
PAKPATTAN DISTRICT,ARIF WALA TEHSIL,28,10880,1762,12642
PAKPATTAN DISTRICT,ARIF WALA TEHSIL,29,12250,2085,14335
PAKPATTAN DISTRICT,ARIF WALA TEHSIL,30,9095,1474,10569
PAKPATTAN DISTRICT,ARIF WALA TEHSIL,31,11474,1873,13347
PAKPATTAN DISTRICT,ARIF WALA TEHSIL,32,9776,1679,11455
PAKPATTAN DISTRICT,ARIF WALA TEHSIL,33,9270,1603,10873
PAKPATTAN DISTRICT,ARIF WALA TEHSIL,34,10248,1609,11857
PAKPATTAN DISTRICT,ARIF WALA TEHSIL,35,8291,1254,9545
PAKPATTAN DISTRICT,ARIF WALA TEHSIL,36,10206,1416,11622
PAKPATTAN DISTRICT,ARIF WALA TEHSIL,37,10289,1623,11912
PAKPATTAN DISTRICT,ARIF WALA TEHSIL,38,8472,1419,9891
PAKPATTAN DISTRICT,ARIF WALA TEHSIL,39,9705,1621,11326
PAKPATTAN DISTRICT,ARIF WALA TEHSIL,40,6079,997,7076
PAKPATTAN DISTRICT,ARIF WALA TEHSIL,41,8980,1321,10301
PAKPATTAN DISTRICT,ARIF WALA TEHSIL,42,7554,1189,8743
PAKPATTAN DISTRICT,ARIF WALA TEHSIL,43,6171,1107,7278
PAKPATTAN DISTRICT,ARIF WALA TEHSIL,44,6561,1031,7592
PAKPATTAN DISTRICT,ARIF WALA TEHSIL,45,4769,808,5577
PAKPATTAN DISTRICT,ARIF WALA TEHSIL,46,7021,1008,8029
PAKPATTAN DISTRICT,ARIF WALA TEHSIL,47,6898,1031,7929
PAKPATTAN DISTRICT,ARIF WALA TEHSIL,48,5767,966,6733
PAKPATTAN DISTRICT,ARIF WALA TEHSIL,49,6452,1119,7571
PAKPATTAN DISTRICT,ARIF WALA TEHSIL,50,4299,710,5009
PAKPATTAN DISTRICT,ARIF WALA TEHSIL,51,6997,1028,8025
PAKPATTAN DISTRICT,ARIF WALA TEHSIL,52,6261,1000,7261
PAKPATTAN DISTRICT,ARIF WALA TEHSIL,53,5088,819,5907
PAKPATTAN DISTRICT,ARIF WALA TEHSIL,54,4875,814,5689
PAKPATTAN DISTRICT,ARIF WALA TEHSIL,55,3445,593,4038
PAKPATTAN DISTRICT,ARIF WALA TEHSIL,56,4954,686,5640
PAKPATTAN DISTRICT,ARIF WALA TEHSIL,57,4628,633,5261
PAKPATTAN DISTRICT,ARIF WALA TEHSIL,58,3551,527,4078
PAKPATTAN DISTRICT,ARIF WALA TEHSIL,59,3980,619,4599
PAKPATTAN DISTRICT,ARIF WALA TEHSIL,60,2430,355,2785
PAKPATTAN DISTRICT,ARIF WALA TEHSIL,61,3778,551,4329
PAKPATTAN DISTRICT,ARIF WALA TEHSIL,62,3435,525,3960
PAKPATTAN DISTRICT,ARIF WALA TEHSIL,63,3036,434,3470
PAKPATTAN DISTRICT,ARIF WALA TEHSIL,64,3043,433,3476
PAKPATTAN DISTRICT,ARIF WALA TEHSIL,65,2095,299,2394
PAKPATTAN DISTRICT,ARIF WALA TEHSIL,66,2918,351,3269
PAKPATTAN DISTRICT,ARIF WALA TEHSIL,67,2595,300,2895
PAKPATTAN DISTRICT,ARIF WALA TEHSIL,68,2343,289,2632
PAKPATTAN DISTRICT,ARIF WALA TEHSIL,69,2609,257,2866
PAKPATTAN DISTRICT,ARIF WALA TEHSIL,70,1628,208,1836
PAKPATTAN DISTRICT,ARIF WALA TEHSIL,71,2346,278,2624
PAKPATTAN DISTRICT,ARIF WALA TEHSIL,72,2011,234,2245
PAKPATTAN DISTRICT,ARIF WALA TEHSIL,73,1844,234,2078
PAKPATTAN DISTRICT,ARIF WALA TEHSIL,74,1650,183,1833
PAKPATTAN DISTRICT,ARIF WALA TEHSIL,>=75,11665,1326,12991
PAKPATTAN DISTRICT,PAKPATTAN TEHSIL,<1,21237,4293,25530
PAKPATTAN DISTRICT,PAKPATTAN TEHSIL,1,21952,4555,26507
PAKPATTAN DISTRICT,PAKPATTAN TEHSIL,2,22010,4511,26521
PAKPATTAN DISTRICT,PAKPATTAN TEHSIL,3,23956,4887,28843
PAKPATTAN DISTRICT,PAKPATTAN TEHSIL,4,24921,4858,29779
PAKPATTAN DISTRICT,PAKPATTAN TEHSIL,5,22485,4374,26859
PAKPATTAN DISTRICT,PAKPATTAN TEHSIL,6,23143,4515,27658
PAKPATTAN DISTRICT,PAKPATTAN TEHSIL,7,24701,4830,29531
PAKPATTAN DISTRICT,PAKPATTAN TEHSIL,8,23544,4263,27807
PAKPATTAN DISTRICT,PAKPATTAN TEHSIL,9,23028,4672,27700
PAKPATTAN DISTRICT,PAKPATTAN TEHSIL,10,20571,3772,24343
PAKPATTAN DISTRICT,PAKPATTAN TEHSIL,11,19168,4315,23483
PAKPATTAN DISTRICT,PAKPATTAN TEHSIL,12,18321,3712,22033
PAKPATTAN DISTRICT,PAKPATTAN TEHSIL,13,16624,3830,20454
PAKPATTAN DISTRICT,PAKPATTAN TEHSIL,14,16705,3528,20233
PAKPATTAN DISTRICT,PAKPATTAN TEHSIL,15,15623,3534,19157
PAKPATTAN DISTRICT,PAKPATTAN TEHSIL,16,16150,3679,19829
PAKPATTAN DISTRICT,PAKPATTAN TEHSIL,17,15413,3849,19262
PAKPATTAN DISTRICT,PAKPATTAN TEHSIL,18,15851,3216,19067
PAKPATTAN DISTRICT,PAKPATTAN TEHSIL,19,15429,3780,19209
PAKPATTAN DISTRICT,PAKPATTAN TEHSIL,20,14115,3129,17244
PAKPATTAN DISTRICT,PAKPATTAN TEHSIL,21,14415,3762,18177
PAKPATTAN DISTRICT,PAKPATTAN TEHSIL,22,13531,3278,16809
PAKPATTAN DISTRICT,PAKPATTAN TEHSIL,23,12150,3253,15403
PAKPATTAN DISTRICT,PAKPATTAN TEHSIL,24,11988,3117,15105
PAKPATTAN DISTRICT,PAKPATTAN TEHSIL,25,11360,2568,13928
PAKPATTAN DISTRICT,PAKPATTAN TEHSIL,26,12139,3184,15323
PAKPATTAN DISTRICT,PAKPATTAN TEHSIL,27,11928,3008,14936
PAKPATTAN DISTRICT,PAKPATTAN TEHSIL,28,11331,2822,14153
PAKPATTAN DISTRICT,PAKPATTAN TEHSIL,29,12515,2979,15494
PAKPATTAN DISTRICT,PAKPATTAN TEHSIL,30,9949,2301,12250
PAKPATTAN DISTRICT,PAKPATTAN TEHSIL,31,11681,2896,14577
PAKPATTAN DISTRICT,PAKPATTAN TEHSIL,32,10039,2565,12604
PAKPATTAN DISTRICT,PAKPATTAN TEHSIL,33,8973,2366,11339
PAKPATTAN DISTRICT,PAKPATTAN TEHSIL,34,9696,2500,12196
PAKPATTAN DISTRICT,PAKPATTAN TEHSIL,35,8731,1997,10728
PAKPATTAN DISTRICT,PAKPATTAN TEHSIL,36,10710,2442,13152
PAKPATTAN DISTRICT,PAKPATTAN TEHSIL,37,10499,2231,12730
PAKPATTAN DISTRICT,PAKPATTAN TEHSIL,38,8205,2179,10384
PAKPATTAN DISTRICT,PAKPATTAN TEHSIL,39,9767,2306,12073
PAKPATTAN DISTRICT,PAKPATTAN TEHSIL,40,6467,1674,8141
PAKPATTAN DISTRICT,PAKPATTAN TEHSIL,41,9298,2119,11417
PAKPATTAN DISTRICT,PAKPATTAN TEHSIL,42,8152,1818,9970
PAKPATTAN DISTRICT,PAKPATTAN TEHSIL,43,6284,1738,8022
PAKPATTAN DISTRICT,PAKPATTAN TEHSIL,44,6411,1635,8046
PAKPATTAN DISTRICT,PAKPATTAN TEHSIL,45,5117,1293,6410
PAKPATTAN DISTRICT,PAKPATTAN TEHSIL,46,6965,1732,8697
PAKPATTAN DISTRICT,PAKPATTAN TEHSIL,47,7620,1714,9334
PAKPATTAN DISTRICT,PAKPATTAN TEHSIL,48,5560,1545,7105
PAKPATTAN DISTRICT,PAKPATTAN TEHSIL,49,6422,1562,7984
PAKPATTAN DISTRICT,PAKPATTAN TEHSIL,50,4666,1226,5892
PAKPATTAN DISTRICT,PAKPATTAN TEHSIL,51,6886,1668,8554
PAKPATTAN DISTRICT,PAKPATTAN TEHSIL,52,6492,1487,7979
PAKPATTAN DISTRICT,PAKPATTAN TEHSIL,53,5130,1336,6466
PAKPATTAN DISTRICT,PAKPATTAN TEHSIL,54,4619,1230,5849
PAKPATTAN DISTRICT,PAKPATTAN TEHSIL,55,3523,890,4413
PAKPATTAN DISTRICT,PAKPATTAN TEHSIL,56,4554,1064,5618
PAKPATTAN DISTRICT,PAKPATTAN TEHSIL,57,4803,900,5703
PAKPATTAN DISTRICT,PAKPATTAN TEHSIL,58,3272,769,4041
PAKPATTAN DISTRICT,PAKPATTAN TEHSIL,59,3797,847,4644
PAKPATTAN DISTRICT,PAKPATTAN TEHSIL,60,2702,659,3361
PAKPATTAN DISTRICT,PAKPATTAN TEHSIL,61,3831,901,4732
PAKPATTAN DISTRICT,PAKPATTAN TEHSIL,62,3480,760,4240
PAKPATTAN DISTRICT,PAKPATTAN TEHSIL,63,3131,764,3895
PAKPATTAN DISTRICT,PAKPATTAN TEHSIL,64,3273,684,3957
PAKPATTAN DISTRICT,PAKPATTAN TEHSIL,65,2447,506,2953
PAKPATTAN DISTRICT,PAKPATTAN TEHSIL,66,2935,607,3542
PAKPATTAN DISTRICT,PAKPATTAN TEHSIL,67,2941,543,3484
PAKPATTAN DISTRICT,PAKPATTAN TEHSIL,68,2396,459,2855
PAKPATTAN DISTRICT,PAKPATTAN TEHSIL,69,2757,501,3258
PAKPATTAN DISTRICT,PAKPATTAN TEHSIL,70,1910,376,2286
PAKPATTAN DISTRICT,PAKPATTAN TEHSIL,71,2452,497,2949
PAKPATTAN DISTRICT,PAKPATTAN TEHSIL,72,2025,400,2425
PAKPATTAN DISTRICT,PAKPATTAN TEHSIL,73,1853,380,2233
PAKPATTAN DISTRICT,PAKPATTAN TEHSIL,74,1754,311,2065
PAKPATTAN DISTRICT,PAKPATTAN TEHSIL,>=75,12034,2235,14269
PANJGUR DISTRICT,GICHK SUB-TEHSIL,<1,125,0,125
PANJGUR DISTRICT,GICHK SUB-TEHSIL,1,311,0,311
PANJGUR DISTRICT,GICHK SUB-TEHSIL,2,268,0,268
PANJGUR DISTRICT,GICHK SUB-TEHSIL,3,266,0,266
PANJGUR DISTRICT,GICHK SUB-TEHSIL,4,320,0,320
PANJGUR DISTRICT,GICHK SUB-TEHSIL,5,344,0,344
PANJGUR DISTRICT,GICHK SUB-TEHSIL,6,382,0,382
PANJGUR DISTRICT,GICHK SUB-TEHSIL,7,429,0,429
PANJGUR DISTRICT,GICHK SUB-TEHSIL,8,426,0,426
PANJGUR DISTRICT,GICHK SUB-TEHSIL,9,506,0,506
PANJGUR DISTRICT,GICHK SUB-TEHSIL,10,559,0,559
PANJGUR DISTRICT,GICHK SUB-TEHSIL,11,534,0,534
PANJGUR DISTRICT,GICHK SUB-TEHSIL,12,406,0,406
PANJGUR DISTRICT,GICHK SUB-TEHSIL,13,427,0,427
PANJGUR DISTRICT,GICHK SUB-TEHSIL,14,459,0,459
PANJGUR DISTRICT,GICHK SUB-TEHSIL,15,510,0,510
PANJGUR DISTRICT,GICHK SUB-TEHSIL,16,391,0,391
PANJGUR DISTRICT,GICHK SUB-TEHSIL,17,454,0,454
PANJGUR DISTRICT,GICHK SUB-TEHSIL,18,543,0,543
PANJGUR DISTRICT,GICHK SUB-TEHSIL,19,442,0,442
PANJGUR DISTRICT,GICHK SUB-TEHSIL,20,563,0,563
PANJGUR DISTRICT,GICHK SUB-TEHSIL,21,472,0,472
PANJGUR DISTRICT,GICHK SUB-TEHSIL,22,426,0,426
PANJGUR DISTRICT,GICHK SUB-TEHSIL,23,310,0,310
PANJGUR DISTRICT,GICHK SUB-TEHSIL,24,296,0,296
PANJGUR DISTRICT,GICHK SUB-TEHSIL,25,384,0,384
PANJGUR DISTRICT,GICHK SUB-TEHSIL,26,160,0,160
PANJGUR DISTRICT,GICHK SUB-TEHSIL,27,268,0,268
PANJGUR DISTRICT,GICHK SUB-TEHSIL,28,262,0,262
PANJGUR DISTRICT,GICHK SUB-TEHSIL,29,324,0,324
PANJGUR DISTRICT,GICHK SUB-TEHSIL,30,235,0,235
PANJGUR DISTRICT,GICHK SUB-TEHSIL,31,240,0,240
PANJGUR DISTRICT,GICHK SUB-TEHSIL,32,113,0,113
PANJGUR DISTRICT,GICHK SUB-TEHSIL,33,125,0,125
PANJGUR DISTRICT,GICHK SUB-TEHSIL,34,130,0,130
PANJGUR DISTRICT,GICHK SUB-TEHSIL,35,168,0,168
PANJGUR DISTRICT,GICHK SUB-TEHSIL,36,104,0,104
PANJGUR DISTRICT,GICHK SUB-TEHSIL,37,134,0,134
PANJGUR DISTRICT,GICHK SUB-TEHSIL,38,184,0,184
PANJGUR DISTRICT,GICHK SUB-TEHSIL,39,201,0,201
PANJGUR DISTRICT,GICHK SUB-TEHSIL,40,303,0,303
PANJGUR DISTRICT,GICHK SUB-TEHSIL,41,171,0,171
PANJGUR DISTRICT,GICHK SUB-TEHSIL,42,128,0,128
PANJGUR DISTRICT,GICHK SUB-TEHSIL,43,155,0,155
PANJGUR DISTRICT,GICHK SUB-TEHSIL,44,128,0,128
PANJGUR DISTRICT,GICHK SUB-TEHSIL,45,209,0,209
PANJGUR DISTRICT,GICHK SUB-TEHSIL,46,89,0,89
PANJGUR DISTRICT,GICHK SUB-TEHSIL,47,74,0,74
PANJGUR DISTRICT,GICHK SUB-TEHSIL,48,216,0,216
PANJGUR DISTRICT,GICHK SUB-TEHSIL,49,195,0,195
PANJGUR DISTRICT,GICHK SUB-TEHSIL,50,239,0,239
PANJGUR DISTRICT,GICHK SUB-TEHSIL,51,104,0,104
PANJGUR DISTRICT,GICHK SUB-TEHSIL,52,63,0,63
PANJGUR DISTRICT,GICHK SUB-TEHSIL,53,95,0,95
PANJGUR DISTRICT,GICHK SUB-TEHSIL,54,108,0,108
PANJGUR DISTRICT,GICHK SUB-TEHSIL,55,115,0,115
PANJGUR DISTRICT,GICHK SUB-TEHSIL,56,52,0,52
PANJGUR DISTRICT,GICHK SUB-TEHSIL,57,58,0,58
PANJGUR DISTRICT,GICHK SUB-TEHSIL,58,110,0,110
PANJGUR DISTRICT,GICHK SUB-TEHSIL,59,113,0,113
PANJGUR DISTRICT,GICHK SUB-TEHSIL,60,125,0,125
PANJGUR DISTRICT,GICHK SUB-TEHSIL,61,81,0,81
PANJGUR DISTRICT,GICHK SUB-TEHSIL,62,47,0,47
PANJGUR DISTRICT,GICHK SUB-TEHSIL,63,50,0,50
PANJGUR DISTRICT,GICHK SUB-TEHSIL,64,43,0,43
PANJGUR DISTRICT,GICHK SUB-TEHSIL,65,60,0,60
PANJGUR DISTRICT,GICHK SUB-TEHSIL,66,20,0,20
PANJGUR DISTRICT,GICHK SUB-TEHSIL,67,10,0,10
PANJGUR DISTRICT,GICHK SUB-TEHSIL,68,33,0,33
PANJGUR DISTRICT,GICHK SUB-TEHSIL,69,35,0,35
PANJGUR DISTRICT,GICHK SUB-TEHSIL,70,41,0,41
PANJGUR DISTRICT,GICHK SUB-TEHSIL,71,26,0,26
PANJGUR DISTRICT,GICHK SUB-TEHSIL,72,15,0,15
PANJGUR DISTRICT,GICHK SUB-TEHSIL,73,27,0,27
PANJGUR DISTRICT,GICHK SUB-TEHSIL,74,9,0,9
PANJGUR DISTRICT,GICHK SUB-TEHSIL,>=75,98,0,98
PANJGUR DISTRICT,GOWARGO TEHSIL,<1,602,0,602
PANJGUR DISTRICT,GOWARGO TEHSIL,1,632,0,632
PANJGUR DISTRICT,GOWARGO TEHSIL,2,812,0,812
PANJGUR DISTRICT,GOWARGO TEHSIL,3,696,0,696
PANJGUR DISTRICT,GOWARGO TEHSIL,4,709,0,709
PANJGUR DISTRICT,GOWARGO TEHSIL,5,486,0,486
PANJGUR DISTRICT,GOWARGO TEHSIL,6,654,0,654
PANJGUR DISTRICT,GOWARGO TEHSIL,7,478,0,478
PANJGUR DISTRICT,GOWARGO TEHSIL,8,604,0,604
PANJGUR DISTRICT,GOWARGO TEHSIL,9,613,0,613
PANJGUR DISTRICT,GOWARGO TEHSIL,10,590,0,590
PANJGUR DISTRICT,GOWARGO TEHSIL,11,471,0,471
PANJGUR DISTRICT,GOWARGO TEHSIL,12,479,0,479
PANJGUR DISTRICT,GOWARGO TEHSIL,13,461,0,461
PANJGUR DISTRICT,GOWARGO TEHSIL,14,411,0,411
PANJGUR DISTRICT,GOWARGO TEHSIL,15,338,0,338
PANJGUR DISTRICT,GOWARGO TEHSIL,16,316,0,316
PANJGUR DISTRICT,GOWARGO TEHSIL,17,278,0,278
PANJGUR DISTRICT,GOWARGO TEHSIL,18,297,0,297
PANJGUR DISTRICT,GOWARGO TEHSIL,19,297,0,297
PANJGUR DISTRICT,GOWARGO TEHSIL,20,353,0,353
PANJGUR DISTRICT,GOWARGO TEHSIL,21,380,0,380
PANJGUR DISTRICT,GOWARGO TEHSIL,22,282,0,282
PANJGUR DISTRICT,GOWARGO TEHSIL,23,247,0,247
PANJGUR DISTRICT,GOWARGO TEHSIL,24,252,0,252
PANJGUR DISTRICT,GOWARGO TEHSIL,25,225,0,225
PANJGUR DISTRICT,GOWARGO TEHSIL,26,191,0,191
PANJGUR DISTRICT,GOWARGO TEHSIL,27,239,0,239
PANJGUR DISTRICT,GOWARGO TEHSIL,28,185,0,185
PANJGUR DISTRICT,GOWARGO TEHSIL,29,171,0,171
PANJGUR DISTRICT,GOWARGO TEHSIL,30,209,0,209
PANJGUR DISTRICT,GOWARGO TEHSIL,31,203,0,203
PANJGUR DISTRICT,GOWARGO TEHSIL,32,208,0,208
PANJGUR DISTRICT,GOWARGO TEHSIL,33,111,0,111
PANJGUR DISTRICT,GOWARGO TEHSIL,34,113,0,113
PANJGUR DISTRICT,GOWARGO TEHSIL,35,111,0,111
PANJGUR DISTRICT,GOWARGO TEHSIL,36,82,0,82
PANJGUR DISTRICT,GOWARGO TEHSIL,37,156,0,156
PANJGUR DISTRICT,GOWARGO TEHSIL,38,115,0,115
PANJGUR DISTRICT,GOWARGO TEHSIL,39,112,0,112
PANJGUR DISTRICT,GOWARGO TEHSIL,40,171,0,171
PANJGUR DISTRICT,GOWARGO TEHSIL,41,106,0,106
PANJGUR DISTRICT,GOWARGO TEHSIL,42,122,0,122
PANJGUR DISTRICT,GOWARGO TEHSIL,43,111,0,111
PANJGUR DISTRICT,GOWARGO TEHSIL,44,85,0,85
PANJGUR DISTRICT,GOWARGO TEHSIL,45,73,0,73
PANJGUR DISTRICT,GOWARGO TEHSIL,46,49,0,49
PANJGUR DISTRICT,GOWARGO TEHSIL,47,107,0,107
PANJGUR DISTRICT,GOWARGO TEHSIL,48,77,0,77
PANJGUR DISTRICT,GOWARGO TEHSIL,49,80,0,80
PANJGUR DISTRICT,GOWARGO TEHSIL,50,80,0,80
PANJGUR DISTRICT,GOWARGO TEHSIL,51,65,0,65
PANJGUR DISTRICT,GOWARGO TEHSIL,52,84,0,84
PANJGUR DISTRICT,GOWARGO TEHSIL,53,78,0,78
PANJGUR DISTRICT,GOWARGO TEHSIL,54,54,0,54
PANJGUR DISTRICT,GOWARGO TEHSIL,55,39,0,39
PANJGUR DISTRICT,GOWARGO TEHSIL,56,32,0,32
PANJGUR DISTRICT,GOWARGO TEHSIL,57,50,0,50
PANJGUR DISTRICT,GOWARGO TEHSIL,58,22,0,22
PANJGUR DISTRICT,GOWARGO TEHSIL,59,63,0,63
PANJGUR DISTRICT,GOWARGO TEHSIL,60,50,0,50
PANJGUR DISTRICT,GOWARGO TEHSIL,61,33,0,33
PANJGUR DISTRICT,GOWARGO TEHSIL,62,55,0,55
PANJGUR DISTRICT,GOWARGO TEHSIL,63,26,0,26
PANJGUR DISTRICT,GOWARGO TEHSIL,64,70,0,70
PANJGUR DISTRICT,GOWARGO TEHSIL,65,35,0,35
PANJGUR DISTRICT,GOWARGO TEHSIL,66,16,0,16
PANJGUR DISTRICT,GOWARGO TEHSIL,67,33,0,33
PANJGUR DISTRICT,GOWARGO TEHSIL,68,12,0,12
PANJGUR DISTRICT,GOWARGO TEHSIL,69,50,0,50
PANJGUR DISTRICT,GOWARGO TEHSIL,70,21,0,21
PANJGUR DISTRICT,GOWARGO TEHSIL,71,11,0,11
PANJGUR DISTRICT,GOWARGO TEHSIL,72,26,0,26
PANJGUR DISTRICT,GOWARGO TEHSIL,73,16,0,16
PANJGUR DISTRICT,GOWARGO TEHSIL,74,37,0,37
PANJGUR DISTRICT,GOWARGO TEHSIL,>=75,121,0,121
PANJGUR DISTRICT,PANJGUR TEHSIL,<1,7574,2929,10503
PANJGUR DISTRICT,PANJGUR TEHSIL,1,5829,2925,8754
PANJGUR DISTRICT,PANJGUR TEHSIL,2,7716,3424,11140
PANJGUR DISTRICT,PANJGUR TEHSIL,3,6637,3086,9723
PANJGUR DISTRICT,PANJGUR TEHSIL,4,7885,3285,11170
PANJGUR DISTRICT,PANJGUR TEHSIL,5,6752,3012,9764
PANJGUR DISTRICT,PANJGUR TEHSIL,6,7471,3127,10598
PANJGUR DISTRICT,PANJGUR TEHSIL,7,6109,2902,9011
PANJGUR DISTRICT,PANJGUR TEHSIL,8,7908,3098,11006
PANJGUR DISTRICT,PANJGUR TEHSIL,9,6839,2958,9797
PANJGUR DISTRICT,PANJGUR TEHSIL,10,7541,2966,10507
PANJGUR DISTRICT,PANJGUR TEHSIL,11,5614,2475,8089
PANJGUR DISTRICT,PANJGUR TEHSIL,12,5865,2294,8159
PANJGUR DISTRICT,PANJGUR TEHSIL,13,4912,2182,7094
PANJGUR DISTRICT,PANJGUR TEHSIL,14,5447,2212,7659
PANJGUR DISTRICT,PANJGUR TEHSIL,15,4703,2056,6759
PANJGUR DISTRICT,PANJGUR TEHSIL,16,4370,1954,6324
PANJGUR DISTRICT,PANJGUR TEHSIL,17,4093,1989,6082
PANJGUR DISTRICT,PANJGUR TEHSIL,18,3559,1768,5327
PANJGUR DISTRICT,PANJGUR TEHSIL,19,2970,1391,4361
PANJGUR DISTRICT,PANJGUR TEHSIL,20,3141,1585,4726
PANJGUR DISTRICT,PANJGUR TEHSIL,21,2685,1291,3976
PANJGUR DISTRICT,PANJGUR TEHSIL,22,2191,1167,3358
PANJGUR DISTRICT,PANJGUR TEHSIL,23,2034,1093,3127
PANJGUR DISTRICT,PANJGUR TEHSIL,24,1755,996,2751
PANJGUR DISTRICT,PANJGUR TEHSIL,25,2174,1225,3399
PANJGUR DISTRICT,PANJGUR TEHSIL,26,1860,923,2783
PANJGUR DISTRICT,PANJGUR TEHSIL,27,1853,1107,2960
PANJGUR DISTRICT,PANJGUR TEHSIL,28,2301,1129,3430
PANJGUR DISTRICT,PANJGUR TEHSIL,29,2194,1117,3311
PANJGUR DISTRICT,PANJGUR TEHSIL,30,2261,1114,3375
PANJGUR DISTRICT,PANJGUR TEHSIL,31,1720,843,2563
PANJGUR DISTRICT,PANJGUR TEHSIL,32,1509,737,2246
PANJGUR DISTRICT,PANJGUR TEHSIL,33,1577,706,2283
PANJGUR DISTRICT,PANJGUR TEHSIL,34,1236,570,1806
PANJGUR DISTRICT,PANJGUR TEHSIL,35,1639,770,2409
PANJGUR DISTRICT,PANJGUR TEHSIL,36,1232,530,1762
PANJGUR DISTRICT,PANJGUR TEHSIL,37,1245,647,1892
PANJGUR DISTRICT,PANJGUR TEHSIL,38,1939,680,2619
PANJGUR DISTRICT,PANJGUR TEHSIL,39,1680,745,2425
PANJGUR DISTRICT,PANJGUR TEHSIL,40,1766,787,2553
PANJGUR DISTRICT,PANJGUR TEHSIL,41,1147,546,1693
PANJGUR DISTRICT,PANJGUR TEHSIL,42,1093,436,1529
PANJGUR DISTRICT,PANJGUR TEHSIL,43,1128,406,1534
PANJGUR DISTRICT,PANJGUR TEHSIL,44,844,352,1196
PANJGUR DISTRICT,PANJGUR TEHSIL,45,1086,429,1515
PANJGUR DISTRICT,PANJGUR TEHSIL,46,573,249,822
PANJGUR DISTRICT,PANJGUR TEHSIL,47,705,331,1036
PANJGUR DISTRICT,PANJGUR TEHSIL,48,935,371,1306
PANJGUR DISTRICT,PANJGUR TEHSIL,49,850,426,1276
PANJGUR DISTRICT,PANJGUR TEHSIL,50,913,417,1330
PANJGUR DISTRICT,PANJGUR TEHSIL,51,558,283,841
PANJGUR DISTRICT,PANJGUR TEHSIL,52,699,294,993
PANJGUR DISTRICT,PANJGUR TEHSIL,53,698,303,1001
PANJGUR DISTRICT,PANJGUR TEHSIL,54,614,283,897
PANJGUR DISTRICT,PANJGUR TEHSIL,55,629,263,892
PANJGUR DISTRICT,PANJGUR TEHSIL,56,434,218,652
PANJGUR DISTRICT,PANJGUR TEHSIL,57,366,182,548
PANJGUR DISTRICT,PANJGUR TEHSIL,58,484,232,716
PANJGUR DISTRICT,PANJGUR TEHSIL,59,462,211,673
PANJGUR DISTRICT,PANJGUR TEHSIL,60,526,245,771
PANJGUR DISTRICT,PANJGUR TEHSIL,61,309,141,450
PANJGUR DISTRICT,PANJGUR TEHSIL,62,338,194,532
PANJGUR DISTRICT,PANJGUR TEHSIL,63,327,164,491
PANJGUR DISTRICT,PANJGUR TEHSIL,64,383,141,524
PANJGUR DISTRICT,PANJGUR TEHSIL,65,365,166,531
PANJGUR DISTRICT,PANJGUR TEHSIL,66,160,78,238
PANJGUR DISTRICT,PANJGUR TEHSIL,67,210,119,329
PANJGUR DISTRICT,PANJGUR TEHSIL,68,250,114,364
PANJGUR DISTRICT,PANJGUR TEHSIL,69,264,122,386
PANJGUR DISTRICT,PANJGUR TEHSIL,70,227,112,339
PANJGUR DISTRICT,PANJGUR TEHSIL,71,145,61,206
PANJGUR DISTRICT,PANJGUR TEHSIL,72,124,74,198
PANJGUR DISTRICT,PANJGUR TEHSIL,73,124,83,207
PANJGUR DISTRICT,PANJGUR TEHSIL,74,152,80,232
PANJGUR DISTRICT,PANJGUR TEHSIL,>=75,844,490,1334
PANJGUR DISTRICT,PAROME TEHSIL,<1,1301,0,1301
PANJGUR DISTRICT,PAROME TEHSIL,1,1250,0,1250
PANJGUR DISTRICT,PAROME TEHSIL,2,1438,0,1438
PANJGUR DISTRICT,PAROME TEHSIL,3,1012,0,1012
PANJGUR DISTRICT,PAROME TEHSIL,4,1303,0,1303
PANJGUR DISTRICT,PAROME TEHSIL,5,1076,0,1076
PANJGUR DISTRICT,PAROME TEHSIL,6,1065,0,1065
PANJGUR DISTRICT,PAROME TEHSIL,7,811,0,811
PANJGUR DISTRICT,PAROME TEHSIL,8,1140,0,1140
PANJGUR DISTRICT,PAROME TEHSIL,9,779,0,779
PANJGUR DISTRICT,PAROME TEHSIL,10,865,0,865
PANJGUR DISTRICT,PAROME TEHSIL,11,605,0,605
PANJGUR DISTRICT,PAROME TEHSIL,12,672,0,672
PANJGUR DISTRICT,PAROME TEHSIL,13,527,0,527
PANJGUR DISTRICT,PAROME TEHSIL,14,588,0,588
PANJGUR DISTRICT,PAROME TEHSIL,15,477,0,477
PANJGUR DISTRICT,PAROME TEHSIL,16,598,0,598
PANJGUR DISTRICT,PAROME TEHSIL,17,301,0,301
PANJGUR DISTRICT,PAROME TEHSIL,18,346,0,346
PANJGUR DISTRICT,PAROME TEHSIL,19,223,0,223
PANJGUR DISTRICT,PAROME TEHSIL,20,323,0,323
PANJGUR DISTRICT,PAROME TEHSIL,21,204,0,204
PANJGUR DISTRICT,PAROME TEHSIL,22,174,0,174
PANJGUR DISTRICT,PAROME TEHSIL,23,156,0,156
PANJGUR DISTRICT,PAROME TEHSIL,24,147,0,147
PANJGUR DISTRICT,PAROME TEHSIL,25,326,0,326
PANJGUR DISTRICT,PAROME TEHSIL,26,176,0,176
PANJGUR DISTRICT,PAROME TEHSIL,27,249,0,249
PANJGUR DISTRICT,PAROME TEHSIL,28,231,0,231
PANJGUR DISTRICT,PAROME TEHSIL,29,218,0,218
PANJGUR DISTRICT,PAROME TEHSIL,30,308,0,308
PANJGUR DISTRICT,PAROME TEHSIL,31,176,0,176
PANJGUR DISTRICT,PAROME TEHSIL,32,140,0,140
PANJGUR DISTRICT,PAROME TEHSIL,33,133,0,133
PANJGUR DISTRICT,PAROME TEHSIL,34,134,0,134
PANJGUR DISTRICT,PAROME TEHSIL,35,304,0,304
PANJGUR DISTRICT,PAROME TEHSIL,36,148,0,148
PANJGUR DISTRICT,PAROME TEHSIL,37,175,0,175
PANJGUR DISTRICT,PAROME TEHSIL,38,184,0,184
PANJGUR DISTRICT,PAROME TEHSIL,39,261,0,261
PANJGUR DISTRICT,PAROME TEHSIL,40,255,0,255
PANJGUR DISTRICT,PAROME TEHSIL,41,182,0,182
PANJGUR DISTRICT,PAROME TEHSIL,42,137,0,137
PANJGUR DISTRICT,PAROME TEHSIL,43,128,0,128
PANJGUR DISTRICT,PAROME TEHSIL,44,103,0,103
PANJGUR DISTRICT,PAROME TEHSIL,45,158,0,158
PANJGUR DISTRICT,PAROME TEHSIL,46,74,0,74
PANJGUR DISTRICT,PAROME TEHSIL,47,84,0,84
PANJGUR DISTRICT,PAROME TEHSIL,48,146,0,146
PANJGUR DISTRICT,PAROME TEHSIL,49,126,0,126
PANJGUR DISTRICT,PAROME TEHSIL,50,160,0,160
PANJGUR DISTRICT,PAROME TEHSIL,51,65,0,65
PANJGUR DISTRICT,PAROME TEHSIL,52,81,0,81
PANJGUR DISTRICT,PAROME TEHSIL,53,79,0,79
PANJGUR DISTRICT,PAROME TEHSIL,54,69,0,69
PANJGUR DISTRICT,PAROME TEHSIL,55,64,0,64
PANJGUR DISTRICT,PAROME TEHSIL,56,35,0,35
PANJGUR DISTRICT,PAROME TEHSIL,57,34,0,34
PANJGUR DISTRICT,PAROME TEHSIL,58,40,0,40
PANJGUR DISTRICT,PAROME TEHSIL,59,61,0,61
PANJGUR DISTRICT,PAROME TEHSIL,60,77,0,77
PANJGUR DISTRICT,PAROME TEHSIL,61,34,0,34
PANJGUR DISTRICT,PAROME TEHSIL,62,27,0,27
PANJGUR DISTRICT,PAROME TEHSIL,63,38,0,38
PANJGUR DISTRICT,PAROME TEHSIL,64,54,0,54
PANJGUR DISTRICT,PAROME TEHSIL,65,45,0,45
PANJGUR DISTRICT,PAROME TEHSIL,66,12,0,12
PANJGUR DISTRICT,PAROME TEHSIL,67,29,0,29
PANJGUR DISTRICT,PAROME TEHSIL,68,28,0,28
PANJGUR DISTRICT,PAROME TEHSIL,69,36,0,36
PANJGUR DISTRICT,PAROME TEHSIL,70,24,0,24
PANJGUR DISTRICT,PAROME TEHSIL,71,9,0,9
PANJGUR DISTRICT,PAROME TEHSIL,72,3,0,3
PANJGUR DISTRICT,PAROME TEHSIL,73,14,0,14
PANJGUR DISTRICT,PAROME TEHSIL,74,20,0,20
PANJGUR DISTRICT,PAROME TEHSIL,>=75,140,0,140
PESHAWAR DISTRICT,PESHAWAR TEHSIL,<1,65595,49306,114901
PESHAWAR DISTRICT,PESHAWAR TEHSIL,1,68828,52167,120995
PESHAWAR DISTRICT,PESHAWAR TEHSIL,2,76076,55784,131860
PESHAWAR DISTRICT,PESHAWAR TEHSIL,3,79697,59622,139319
PESHAWAR DISTRICT,PESHAWAR TEHSIL,4,77718,55978,133696
PESHAWAR DISTRICT,PESHAWAR TEHSIL,5,76023,55979,132002
PESHAWAR DISTRICT,PESHAWAR TEHSIL,6,73474,53262,126736
PESHAWAR DISTRICT,PESHAWAR TEHSIL,7,74153,56048,130201
PESHAWAR DISTRICT,PESHAWAR TEHSIL,8,73021,50629,123650
PESHAWAR DISTRICT,PESHAWAR TEHSIL,9,69030,53794,122824
PESHAWAR DISTRICT,PESHAWAR TEHSIL,10,66334,46876,113210
PESHAWAR DISTRICT,PESHAWAR TEHSIL,11,62431,50839,113270
PESHAWAR DISTRICT,PESHAWAR TEHSIL,12,59180,45215,104395
PESHAWAR DISTRICT,PESHAWAR TEHSIL,13,59470,47912,107382
PESHAWAR DISTRICT,PESHAWAR TEHSIL,14,56271,44063,100334
PESHAWAR DISTRICT,PESHAWAR TEHSIL,15,56286,45563,101849
PESHAWAR DISTRICT,PESHAWAR TEHSIL,16,53295,45105,98400
PESHAWAR DISTRICT,PESHAWAR TEHSIL,17,51384,46538,97922
PESHAWAR DISTRICT,PESHAWAR TEHSIL,18,50327,43535,93862
PESHAWAR DISTRICT,PESHAWAR TEHSIL,19,47027,44677,91704
PESHAWAR DISTRICT,PESHAWAR TEHSIL,20,47411,40525,87936
PESHAWAR DISTRICT,PESHAWAR TEHSIL,21,43682,44033,87715
PESHAWAR DISTRICT,PESHAWAR TEHSIL,22,39567,39646,79213
PESHAWAR DISTRICT,PESHAWAR TEHSIL,23,38779,38833,77612
PESHAWAR DISTRICT,PESHAWAR TEHSIL,24,36341,36712,73053
PESHAWAR DISTRICT,PESHAWAR TEHSIL,25,40330,35212,75542
PESHAWAR DISTRICT,PESHAWAR TEHSIL,26,35889,34290,70179
PESHAWAR DISTRICT,PESHAWAR TEHSIL,27,37033,34402,71435
PESHAWAR DISTRICT,PESHAWAR TEHSIL,28,35140,33011,68151
PESHAWAR DISTRICT,PESHAWAR TEHSIL,29,34011,31613,65624
PESHAWAR DISTRICT,PESHAWAR TEHSIL,30,33881,31141,65022
PESHAWAR DISTRICT,PESHAWAR TEHSIL,31,30953,28774,59727
PESHAWAR DISTRICT,PESHAWAR TEHSIL,32,26278,26379,52657
PESHAWAR DISTRICT,PESHAWAR TEHSIL,33,27530,27010,54540
PESHAWAR DISTRICT,PESHAWAR TEHSIL,34,23667,23409,47076
PESHAWAR DISTRICT,PESHAWAR TEHSIL,35,24222,22959,47181
PESHAWAR DISTRICT,PESHAWAR TEHSIL,36,20294,20426,40720
PESHAWAR DISTRICT,PESHAWAR TEHSIL,37,20131,19715,39846
PESHAWAR DISTRICT,PESHAWAR TEHSIL,38,21093,22470,43563
PESHAWAR DISTRICT,PESHAWAR TEHSIL,39,20208,20200,40408
PESHAWAR DISTRICT,PESHAWAR TEHSIL,40,22946,22489,45435
PESHAWAR DISTRICT,PESHAWAR TEHSIL,41,19279,18025,37304
PESHAWAR DISTRICT,PESHAWAR TEHSIL,42,16259,16456,32715
PESHAWAR DISTRICT,PESHAWAR TEHSIL,43,17084,17765,34849
PESHAWAR DISTRICT,PESHAWAR TEHSIL,44,15107,14766,29873
PESHAWAR DISTRICT,PESHAWAR TEHSIL,45,15578,15581,31159
PESHAWAR DISTRICT,PESHAWAR TEHSIL,46,13951,13136,27087
PESHAWAR DISTRICT,PESHAWAR TEHSIL,47,14010,12680,26690
PESHAWAR DISTRICT,PESHAWAR TEHSIL,48,13386,13696,27082
PESHAWAR DISTRICT,PESHAWAR TEHSIL,49,13420,13396,26816
PESHAWAR DISTRICT,PESHAWAR TEHSIL,50,14817,14677,29494
PESHAWAR DISTRICT,PESHAWAR TEHSIL,51,12386,12049,24435
PESHAWAR DISTRICT,PESHAWAR TEHSIL,52,10894,11727,22621
PESHAWAR DISTRICT,PESHAWAR TEHSIL,53,10883,12023,22906
PESHAWAR DISTRICT,PESHAWAR TEHSIL,54,9778,10410,20188
PESHAWAR DISTRICT,PESHAWAR TEHSIL,55,10345,10858,21203
PESHAWAR DISTRICT,PESHAWAR TEHSIL,56,8742,8633,17375
PESHAWAR DISTRICT,PESHAWAR TEHSIL,57,9083,8099,17182
PESHAWAR DISTRICT,PESHAWAR TEHSIL,58,9114,8716,17830
PESHAWAR DISTRICT,PESHAWAR TEHSIL,59,9022,8247,17269
PESHAWAR DISTRICT,PESHAWAR TEHSIL,60,9185,8408,17593
PESHAWAR DISTRICT,PESHAWAR TEHSIL,61,7824,7720,15544
PESHAWAR DISTRICT,PESHAWAR TEHSIL,62,6951,7371,14322
PESHAWAR DISTRICT,PESHAWAR TEHSIL,63,7376,7411,14787
PESHAWAR DISTRICT,PESHAWAR TEHSIL,64,6938,6260,13198
PESHAWAR DISTRICT,PESHAWAR TEHSIL,65,5752,5473,11225
PESHAWAR DISTRICT,PESHAWAR TEHSIL,66,4792,4292,9084
PESHAWAR DISTRICT,PESHAWAR TEHSIL,67,4770,4417,9187
PESHAWAR DISTRICT,PESHAWAR TEHSIL,68,4558,4457,9015
PESHAWAR DISTRICT,PESHAWAR TEHSIL,69,4689,3757,8446
PESHAWAR DISTRICT,PESHAWAR TEHSIL,70,4120,3606,7726
PESHAWAR DISTRICT,PESHAWAR TEHSIL,71,3256,3090,6346
PESHAWAR DISTRICT,PESHAWAR TEHSIL,72,2804,2794,5598
PESHAWAR DISTRICT,PESHAWAR TEHSIL,73,3039,2980,6019
PESHAWAR DISTRICT,PESHAWAR TEHSIL,74,2655,2287,4942
PESHAWAR DISTRICT,PESHAWAR TEHSIL,>=75,20522,18419,38941
PISHIN DISTRICT,BARSHORE SUB-TEHSIL,<1,5226,0,5226
PISHIN DISTRICT,BARSHORE SUB-TEHSIL,1,4510,0,4510
PISHIN DISTRICT,BARSHORE SUB-TEHSIL,2,4960,0,4960
PISHIN DISTRICT,BARSHORE SUB-TEHSIL,3,4445,0,4445
PISHIN DISTRICT,BARSHORE SUB-TEHSIL,4,4201,0,4201
PISHIN DISTRICT,BARSHORE SUB-TEHSIL,5,3954,0,3954
PISHIN DISTRICT,BARSHORE SUB-TEHSIL,6,3983,0,3983
PISHIN DISTRICT,BARSHORE SUB-TEHSIL,7,3617,0,3617
PISHIN DISTRICT,BARSHORE SUB-TEHSIL,8,3591,0,3591
PISHIN DISTRICT,BARSHORE SUB-TEHSIL,9,3532,0,3532
PISHIN DISTRICT,BARSHORE SUB-TEHSIL,10,2980,0,2980
PISHIN DISTRICT,BARSHORE SUB-TEHSIL,11,2948,0,2948
PISHIN DISTRICT,BARSHORE SUB-TEHSIL,12,2450,0,2450
PISHIN DISTRICT,BARSHORE SUB-TEHSIL,13,2511,0,2511
PISHIN DISTRICT,BARSHORE SUB-TEHSIL,14,2282,0,2282
PISHIN DISTRICT,BARSHORE SUB-TEHSIL,15,2089,0,2089
PISHIN DISTRICT,BARSHORE SUB-TEHSIL,16,2129,0,2129
PISHIN DISTRICT,BARSHORE SUB-TEHSIL,17,2189,0,2189
PISHIN DISTRICT,BARSHORE SUB-TEHSIL,18,2248,0,2248
PISHIN DISTRICT,BARSHORE SUB-TEHSIL,19,2161,0,2161
PISHIN DISTRICT,BARSHORE SUB-TEHSIL,20,1820,0,1820
PISHIN DISTRICT,BARSHORE SUB-TEHSIL,21,1843,0,1843
PISHIN DISTRICT,BARSHORE SUB-TEHSIL,22,1470,0,1470
PISHIN DISTRICT,BARSHORE SUB-TEHSIL,23,1643,0,1643
PISHIN DISTRICT,BARSHORE SUB-TEHSIL,24,1587,0,1587
PISHIN DISTRICT,BARSHORE SUB-TEHSIL,25,1458,0,1458
PISHIN DISTRICT,BARSHORE SUB-TEHSIL,26,1458,0,1458
PISHIN DISTRICT,BARSHORE SUB-TEHSIL,27,1575,0,1575
PISHIN DISTRICT,BARSHORE SUB-TEHSIL,28,1395,0,1395
PISHIN DISTRICT,BARSHORE SUB-TEHSIL,29,1619,0,1619
PISHIN DISTRICT,BARSHORE SUB-TEHSIL,30,1090,0,1090
PISHIN DISTRICT,BARSHORE SUB-TEHSIL,31,1397,0,1397
PISHIN DISTRICT,BARSHORE SUB-TEHSIL,32,1006,0,1006
PISHIN DISTRICT,BARSHORE SUB-TEHSIL,33,933,0,933
PISHIN DISTRICT,BARSHORE SUB-TEHSIL,34,887,0,887
PISHIN DISTRICT,BARSHORE SUB-TEHSIL,35,638,0,638
PISHIN DISTRICT,BARSHORE SUB-TEHSIL,36,834,0,834
PISHIN DISTRICT,BARSHORE SUB-TEHSIL,37,917,0,917
PISHIN DISTRICT,BARSHORE SUB-TEHSIL,38,677,0,677
PISHIN DISTRICT,BARSHORE SUB-TEHSIL,39,708,0,708
PISHIN DISTRICT,BARSHORE SUB-TEHSIL,40,533,0,533
PISHIN DISTRICT,BARSHORE SUB-TEHSIL,41,613,0,613
PISHIN DISTRICT,BARSHORE SUB-TEHSIL,42,545,0,545
PISHIN DISTRICT,BARSHORE SUB-TEHSIL,43,508,0,508
PISHIN DISTRICT,BARSHORE SUB-TEHSIL,44,528,0,528
PISHIN DISTRICT,BARSHORE SUB-TEHSIL,45,346,0,346
PISHIN DISTRICT,BARSHORE SUB-TEHSIL,46,577,0,577
PISHIN DISTRICT,BARSHORE SUB-TEHSIL,47,616,0,616
PISHIN DISTRICT,BARSHORE SUB-TEHSIL,48,507,0,507
PISHIN DISTRICT,BARSHORE SUB-TEHSIL,49,494,0,494
PISHIN DISTRICT,BARSHORE SUB-TEHSIL,50,436,0,436
PISHIN DISTRICT,BARSHORE SUB-TEHSIL,51,599,0,599
PISHIN DISTRICT,BARSHORE SUB-TEHSIL,52,468,0,468
PISHIN DISTRICT,BARSHORE SUB-TEHSIL,53,467,0,467
PISHIN DISTRICT,BARSHORE SUB-TEHSIL,54,356,0,356
PISHIN DISTRICT,BARSHORE SUB-TEHSIL,55,252,0,252
PISHIN DISTRICT,BARSHORE SUB-TEHSIL,56,329,0,329
PISHIN DISTRICT,BARSHORE SUB-TEHSIL,57,372,0,372
PISHIN DISTRICT,BARSHORE SUB-TEHSIL,58,264,0,264
PISHIN DISTRICT,BARSHORE SUB-TEHSIL,59,307,0,307
PISHIN DISTRICT,BARSHORE SUB-TEHSIL,60,191,0,191
PISHIN DISTRICT,BARSHORE SUB-TEHSIL,61,282,0,282
PISHIN DISTRICT,BARSHORE SUB-TEHSIL,62,245,0,245
PISHIN DISTRICT,BARSHORE SUB-TEHSIL,63,268,0,268
PISHIN DISTRICT,BARSHORE SUB-TEHSIL,64,270,0,270
PISHIN DISTRICT,BARSHORE SUB-TEHSIL,65,143,0,143
PISHIN DISTRICT,BARSHORE SUB-TEHSIL,66,223,0,223
PISHIN DISTRICT,BARSHORE SUB-TEHSIL,67,223,0,223
PISHIN DISTRICT,BARSHORE SUB-TEHSIL,68,165,0,165
PISHIN DISTRICT,BARSHORE SUB-TEHSIL,69,175,0,175
PISHIN DISTRICT,BARSHORE SUB-TEHSIL,70,96,0,96
PISHIN DISTRICT,BARSHORE SUB-TEHSIL,71,152,0,152
PISHIN DISTRICT,BARSHORE SUB-TEHSIL,72,112,0,112
PISHIN DISTRICT,BARSHORE SUB-TEHSIL,73,103,0,103
PISHIN DISTRICT,BARSHORE SUB-TEHSIL,74,111,0,111
PISHIN DISTRICT,BARSHORE SUB-TEHSIL,>=75,586,0,586
PISHIN DISTRICT,HURRAM ZAI SUB-TEHSIL,<1,3363,1195,4558
PISHIN DISTRICT,HURRAM ZAI SUB-TEHSIL,1,3669,1193,4862
PISHIN DISTRICT,HURRAM ZAI SUB-TEHSIL,2,3832,1256,5088
PISHIN DISTRICT,HURRAM ZAI SUB-TEHSIL,3,3694,1255,4949
PISHIN DISTRICT,HURRAM ZAI SUB-TEHSIL,4,3709,1175,4884
PISHIN DISTRICT,HURRAM ZAI SUB-TEHSIL,5,3598,1060,4658
PISHIN DISTRICT,HURRAM ZAI SUB-TEHSIL,6,3505,1097,4602
PISHIN DISTRICT,HURRAM ZAI SUB-TEHSIL,7,3503,1010,4513
PISHIN DISTRICT,HURRAM ZAI SUB-TEHSIL,8,3326,1017,4343
PISHIN DISTRICT,HURRAM ZAI SUB-TEHSIL,9,3434,1070,4504
PISHIN DISTRICT,HURRAM ZAI SUB-TEHSIL,10,3105,935,4040
PISHIN DISTRICT,HURRAM ZAI SUB-TEHSIL,11,3206,837,4043
PISHIN DISTRICT,HURRAM ZAI SUB-TEHSIL,12,2813,793,3606
PISHIN DISTRICT,HURRAM ZAI SUB-TEHSIL,13,2858,809,3667
PISHIN DISTRICT,HURRAM ZAI SUB-TEHSIL,14,2681,769,3450
PISHIN DISTRICT,HURRAM ZAI SUB-TEHSIL,15,2446,702,3148
PISHIN DISTRICT,HURRAM ZAI SUB-TEHSIL,16,2395,727,3122
PISHIN DISTRICT,HURRAM ZAI SUB-TEHSIL,17,2309,680,2989
PISHIN DISTRICT,HURRAM ZAI SUB-TEHSIL,18,2332,563,2895
PISHIN DISTRICT,HURRAM ZAI SUB-TEHSIL,19,2414,597,3011
PISHIN DISTRICT,HURRAM ZAI SUB-TEHSIL,20,2186,607,2793
PISHIN DISTRICT,HURRAM ZAI SUB-TEHSIL,21,1989,519,2508
PISHIN DISTRICT,HURRAM ZAI SUB-TEHSIL,22,1601,430,2031
PISHIN DISTRICT,HURRAM ZAI SUB-TEHSIL,23,1627,411,2038
PISHIN DISTRICT,HURRAM ZAI SUB-TEHSIL,24,1498,359,1857
PISHIN DISTRICT,HURRAM ZAI SUB-TEHSIL,25,1620,392,2012
PISHIN DISTRICT,HURRAM ZAI SUB-TEHSIL,26,1350,365,1715
PISHIN DISTRICT,HURRAM ZAI SUB-TEHSIL,27,1467,338,1805
PISHIN DISTRICT,HURRAM ZAI SUB-TEHSIL,28,1382,424,1806
PISHIN DISTRICT,HURRAM ZAI SUB-TEHSIL,29,1528,358,1886
PISHIN DISTRICT,HURRAM ZAI SUB-TEHSIL,30,1335,391,1726
PISHIN DISTRICT,HURRAM ZAI SUB-TEHSIL,31,1447,355,1802
PISHIN DISTRICT,HURRAM ZAI SUB-TEHSIL,32,1132,291,1423
PISHIN DISTRICT,HURRAM ZAI SUB-TEHSIL,33,1142,338,1480
PISHIN DISTRICT,HURRAM ZAI SUB-TEHSIL,34,1072,290,1362
PISHIN DISTRICT,HURRAM ZAI SUB-TEHSIL,35,914,257,1171
PISHIN DISTRICT,HURRAM ZAI SUB-TEHSIL,36,936,254,1190
PISHIN DISTRICT,HURRAM ZAI SUB-TEHSIL,37,1140,233,1373
PISHIN DISTRICT,HURRAM ZAI SUB-TEHSIL,38,886,310,1196
PISHIN DISTRICT,HURRAM ZAI SUB-TEHSIL,39,908,234,1142
PISHIN DISTRICT,HURRAM ZAI SUB-TEHSIL,40,715,212,927
PISHIN DISTRICT,HURRAM ZAI SUB-TEHSIL,41,717,163,880
PISHIN DISTRICT,HURRAM ZAI SUB-TEHSIL,42,594,163,757
PISHIN DISTRICT,HURRAM ZAI SUB-TEHSIL,43,583,155,738
PISHIN DISTRICT,HURRAM ZAI SUB-TEHSIL,44,559,175,734
PISHIN DISTRICT,HURRAM ZAI SUB-TEHSIL,45,521,138,659
PISHIN DISTRICT,HURRAM ZAI SUB-TEHSIL,46,506,108,614
PISHIN DISTRICT,HURRAM ZAI SUB-TEHSIL,47,554,111,665
PISHIN DISTRICT,HURRAM ZAI SUB-TEHSIL,48,518,160,678
PISHIN DISTRICT,HURRAM ZAI SUB-TEHSIL,49,508,117,625
PISHIN DISTRICT,HURRAM ZAI SUB-TEHSIL,50,461,146,607
PISHIN DISTRICT,HURRAM ZAI SUB-TEHSIL,51,547,120,667
PISHIN DISTRICT,HURRAM ZAI SUB-TEHSIL,52,456,123,579
PISHIN DISTRICT,HURRAM ZAI SUB-TEHSIL,53,416,122,538
PISHIN DISTRICT,HURRAM ZAI SUB-TEHSIL,54,391,97,488
PISHIN DISTRICT,HURRAM ZAI SUB-TEHSIL,55,308,145,453
PISHIN DISTRICT,HURRAM ZAI SUB-TEHSIL,56,292,105,397
PISHIN DISTRICT,HURRAM ZAI SUB-TEHSIL,57,388,75,463
PISHIN DISTRICT,HURRAM ZAI SUB-TEHSIL,58,301,87,388
PISHIN DISTRICT,HURRAM ZAI SUB-TEHSIL,59,322,87,409
PISHIN DISTRICT,HURRAM ZAI SUB-TEHSIL,60,254,79,333
PISHIN DISTRICT,HURRAM ZAI SUB-TEHSIL,61,302,71,373
PISHIN DISTRICT,HURRAM ZAI SUB-TEHSIL,62,241,62,303
PISHIN DISTRICT,HURRAM ZAI SUB-TEHSIL,63,255,75,330
PISHIN DISTRICT,HURRAM ZAI SUB-TEHSIL,64,250,62,312
PISHIN DISTRICT,HURRAM ZAI SUB-TEHSIL,65,219,64,283
PISHIN DISTRICT,HURRAM ZAI SUB-TEHSIL,66,225,44,269
PISHIN DISTRICT,HURRAM ZAI SUB-TEHSIL,67,234,32,266
PISHIN DISTRICT,HURRAM ZAI SUB-TEHSIL,68,171,51,222
PISHIN DISTRICT,HURRAM ZAI SUB-TEHSIL,69,201,39,240
PISHIN DISTRICT,HURRAM ZAI SUB-TEHSIL,70,125,38,163
PISHIN DISTRICT,HURRAM ZAI SUB-TEHSIL,71,169,30,199
PISHIN DISTRICT,HURRAM ZAI SUB-TEHSIL,72,133,24,157
PISHIN DISTRICT,HURRAM ZAI SUB-TEHSIL,73,121,27,148
PISHIN DISTRICT,HURRAM ZAI SUB-TEHSIL,74,115,31,146
PISHIN DISTRICT,HURRAM ZAI SUB-TEHSIL,>=75,676,168,844
PISHIN DISTRICT,KAREZAT SUB-TEHSIL,<1,3041,898,3939
PISHIN DISTRICT,KAREZAT SUB-TEHSIL,1,3280,1564,4844
PISHIN DISTRICT,KAREZAT SUB-TEHSIL,2,3537,1314,4851
PISHIN DISTRICT,KAREZAT SUB-TEHSIL,3,3503,1390,4893
PISHIN DISTRICT,KAREZAT SUB-TEHSIL,4,3382,1334,4716
PISHIN DISTRICT,KAREZAT SUB-TEHSIL,5,3347,1268,4615
PISHIN DISTRICT,KAREZAT SUB-TEHSIL,6,3218,1353,4571
PISHIN DISTRICT,KAREZAT SUB-TEHSIL,7,3326,1245,4571
PISHIN DISTRICT,KAREZAT SUB-TEHSIL,8,2970,1235,4205
PISHIN DISTRICT,KAREZAT SUB-TEHSIL,9,3160,1349,4509
PISHIN DISTRICT,KAREZAT SUB-TEHSIL,10,2814,1138,3952
PISHIN DISTRICT,KAREZAT SUB-TEHSIL,11,2763,1135,3898
PISHIN DISTRICT,KAREZAT SUB-TEHSIL,12,2427,998,3425
PISHIN DISTRICT,KAREZAT SUB-TEHSIL,13,2464,1058,3522
PISHIN DISTRICT,KAREZAT SUB-TEHSIL,14,2407,922,3329
PISHIN DISTRICT,KAREZAT SUB-TEHSIL,15,2288,988,3276
PISHIN DISTRICT,KAREZAT SUB-TEHSIL,16,2176,934,3110
PISHIN DISTRICT,KAREZAT SUB-TEHSIL,17,2335,840,3175
PISHIN DISTRICT,KAREZAT SUB-TEHSIL,18,2299,993,3292
PISHIN DISTRICT,KAREZAT SUB-TEHSIL,19,2273,776,3049
PISHIN DISTRICT,KAREZAT SUB-TEHSIL,20,2126,945,3071
PISHIN DISTRICT,KAREZAT SUB-TEHSIL,21,2008,795,2803
PISHIN DISTRICT,KAREZAT SUB-TEHSIL,22,1538,744,2282
PISHIN DISTRICT,KAREZAT SUB-TEHSIL,23,1599,695,2294
PISHIN DISTRICT,KAREZAT SUB-TEHSIL,24,1405,609,2014
PISHIN DISTRICT,KAREZAT SUB-TEHSIL,25,1652,761,2413
PISHIN DISTRICT,KAREZAT SUB-TEHSIL,26,1301,610,1911
PISHIN DISTRICT,KAREZAT SUB-TEHSIL,27,1521,590,2111
PISHIN DISTRICT,KAREZAT SUB-TEHSIL,28,1455,644,2099
PISHIN DISTRICT,KAREZAT SUB-TEHSIL,29,1477,503,1980
PISHIN DISTRICT,KAREZAT SUB-TEHSIL,30,1419,677,2096
PISHIN DISTRICT,KAREZAT SUB-TEHSIL,31,1435,520,1955
PISHIN DISTRICT,KAREZAT SUB-TEHSIL,32,1041,411,1452
PISHIN DISTRICT,KAREZAT SUB-TEHSIL,33,1134,495,1629
PISHIN DISTRICT,KAREZAT SUB-TEHSIL,34,959,391,1350
PISHIN DISTRICT,KAREZAT SUB-TEHSIL,35,964,503,1467
PISHIN DISTRICT,KAREZAT SUB-TEHSIL,36,877,355,1232
PISHIN DISTRICT,KAREZAT SUB-TEHSIL,37,1001,357,1358
PISHIN DISTRICT,KAREZAT SUB-TEHSIL,38,884,415,1299
PISHIN DISTRICT,KAREZAT SUB-TEHSIL,39,919,413,1332
PISHIN DISTRICT,KAREZAT SUB-TEHSIL,40,937,517,1454
PISHIN DISTRICT,KAREZAT SUB-TEHSIL,41,749,327,1076
PISHIN DISTRICT,KAREZAT SUB-TEHSIL,42,588,272,860
PISHIN DISTRICT,KAREZAT SUB-TEHSIL,43,583,301,884
PISHIN DISTRICT,KAREZAT SUB-TEHSIL,44,494,231,725
PISHIN DISTRICT,KAREZAT SUB-TEHSIL,45,532,280,812
PISHIN DISTRICT,KAREZAT SUB-TEHSIL,46,447,171,618
PISHIN DISTRICT,KAREZAT SUB-TEHSIL,47,633,186,819
PISHIN DISTRICT,KAREZAT SUB-TEHSIL,48,457,218,675
PISHIN DISTRICT,KAREZAT SUB-TEHSIL,49,520,169,689
PISHIN DISTRICT,KAREZAT SUB-TEHSIL,50,577,311,888
PISHIN DISTRICT,KAREZAT SUB-TEHSIL,51,526,174,700
PISHIN DISTRICT,KAREZAT SUB-TEHSIL,52,453,145,598
PISHIN DISTRICT,KAREZAT SUB-TEHSIL,53,407,184,591
PISHIN DISTRICT,KAREZAT SUB-TEHSIL,54,421,163,584
PISHIN DISTRICT,KAREZAT SUB-TEHSIL,55,354,203,557
PISHIN DISTRICT,KAREZAT SUB-TEHSIL,56,300,114,414
PISHIN DISTRICT,KAREZAT SUB-TEHSIL,57,379,109,488
PISHIN DISTRICT,KAREZAT SUB-TEHSIL,58,310,139,449
PISHIN DISTRICT,KAREZAT SUB-TEHSIL,59,297,112,409
PISHIN DISTRICT,KAREZAT SUB-TEHSIL,60,343,188,531
PISHIN DISTRICT,KAREZAT SUB-TEHSIL,61,292,124,416
PISHIN DISTRICT,KAREZAT SUB-TEHSIL,62,257,73,330
PISHIN DISTRICT,KAREZAT SUB-TEHSIL,63,305,107,412
PISHIN DISTRICT,KAREZAT SUB-TEHSIL,64,268,98,366
PISHIN DISTRICT,KAREZAT SUB-TEHSIL,65,210,113,323
PISHIN DISTRICT,KAREZAT SUB-TEHSIL,66,187,70,257
PISHIN DISTRICT,KAREZAT SUB-TEHSIL,67,227,59,286
PISHIN DISTRICT,KAREZAT SUB-TEHSIL,68,191,58,249
PISHIN DISTRICT,KAREZAT SUB-TEHSIL,69,186,67,253
PISHIN DISTRICT,KAREZAT SUB-TEHSIL,70,158,87,245
PISHIN DISTRICT,KAREZAT SUB-TEHSIL,71,105,45,150
PISHIN DISTRICT,KAREZAT SUB-TEHSIL,72,125,38,163
PISHIN DISTRICT,KAREZAT SUB-TEHSIL,73,124,56,180
PISHIN DISTRICT,KAREZAT SUB-TEHSIL,74,91,39,130
PISHIN DISTRICT,KAREZAT SUB-TEHSIL,>=75,711,284,995
PISHIN DISTRICT,PISHIN TEHSIL,<1,9412,941,10353
PISHIN DISTRICT,PISHIN TEHSIL,1,10701,1111,11812
PISHIN DISTRICT,PISHIN TEHSIL,2,10297,1110,11407
PISHIN DISTRICT,PISHIN TEHSIL,3,10303,1261,11564
PISHIN DISTRICT,PISHIN TEHSIL,4,9640,1136,10776
PISHIN DISTRICT,PISHIN TEHSIL,5,9373,1120,10493
PISHIN DISTRICT,PISHIN TEHSIL,6,9242,1132,10374
PISHIN DISTRICT,PISHIN TEHSIL,7,8988,1104,10092
PISHIN DISTRICT,PISHIN TEHSIL,8,8622,1077,9699
PISHIN DISTRICT,PISHIN TEHSIL,9,8903,1087,9990
PISHIN DISTRICT,PISHIN TEHSIL,10,7995,948,8943
PISHIN DISTRICT,PISHIN TEHSIL,11,7894,1032,8926
PISHIN DISTRICT,PISHIN TEHSIL,12,6734,933,7667
PISHIN DISTRICT,PISHIN TEHSIL,13,7144,934,8078
PISHIN DISTRICT,PISHIN TEHSIL,14,6629,901,7530
PISHIN DISTRICT,PISHIN TEHSIL,15,6538,932,7470
PISHIN DISTRICT,PISHIN TEHSIL,16,6299,831,7130
PISHIN DISTRICT,PISHIN TEHSIL,17,6493,857,7350
PISHIN DISTRICT,PISHIN TEHSIL,18,6529,831,7360
PISHIN DISTRICT,PISHIN TEHSIL,19,6704,910,7614
PISHIN DISTRICT,PISHIN TEHSIL,20,6077,783,6860
PISHIN DISTRICT,PISHIN TEHSIL,21,5681,779,6460
PISHIN DISTRICT,PISHIN TEHSIL,22,4533,586,5119
PISHIN DISTRICT,PISHIN TEHSIL,23,4382,666,5048
PISHIN DISTRICT,PISHIN TEHSIL,24,4177,518,4695
PISHIN DISTRICT,PISHIN TEHSIL,25,4532,626,5158
PISHIN DISTRICT,PISHIN TEHSIL,26,3849,495,4344
PISHIN DISTRICT,PISHIN TEHSIL,27,3955,545,4500
PISHIN DISTRICT,PISHIN TEHSIL,28,3967,537,4504
PISHIN DISTRICT,PISHIN TEHSIL,29,3721,559,4280
PISHIN DISTRICT,PISHIN TEHSIL,30,3850,506,4356
PISHIN DISTRICT,PISHIN TEHSIL,31,3316,428,3744
PISHIN DISTRICT,PISHIN TEHSIL,32,2864,358,3222
PISHIN DISTRICT,PISHIN TEHSIL,33,2986,465,3451
PISHIN DISTRICT,PISHIN TEHSIL,34,2492,378,2870
PISHIN DISTRICT,PISHIN TEHSIL,35,2741,396,3137
PISHIN DISTRICT,PISHIN TEHSIL,36,2124,314,2438
PISHIN DISTRICT,PISHIN TEHSIL,37,2681,360,3041
PISHIN DISTRICT,PISHIN TEHSIL,38,2531,418,2949
PISHIN DISTRICT,PISHIN TEHSIL,39,2233,343,2576
PISHIN DISTRICT,PISHIN TEHSIL,40,2420,370,2790
PISHIN DISTRICT,PISHIN TEHSIL,41,1718,281,1999
PISHIN DISTRICT,PISHIN TEHSIL,42,1582,247,1829
PISHIN DISTRICT,PISHIN TEHSIL,43,1603,270,1873
PISHIN DISTRICT,PISHIN TEHSIL,44,1303,243,1546
PISHIN DISTRICT,PISHIN TEHSIL,45,1566,257,1823
PISHIN DISTRICT,PISHIN TEHSIL,46,1107,164,1271
PISHIN DISTRICT,PISHIN TEHSIL,47,1341,225,1566
PISHIN DISTRICT,PISHIN TEHSIL,48,1374,217,1591
PISHIN DISTRICT,PISHIN TEHSIL,49,1288,214,1502
PISHIN DISTRICT,PISHIN TEHSIL,50,1578,210,1788
PISHIN DISTRICT,PISHIN TEHSIL,51,1233,214,1447
PISHIN DISTRICT,PISHIN TEHSIL,52,1052,166,1218
PISHIN DISTRICT,PISHIN TEHSIL,53,1123,155,1278
PISHIN DISTRICT,PISHIN TEHSIL,54,1010,168,1178
PISHIN DISTRICT,PISHIN TEHSIL,55,1090,145,1235
PISHIN DISTRICT,PISHIN TEHSIL,56,727,90,817
PISHIN DISTRICT,PISHIN TEHSIL,57,842,136,978
PISHIN DISTRICT,PISHIN TEHSIL,58,742,117,859
PISHIN DISTRICT,PISHIN TEHSIL,59,686,130,816
PISHIN DISTRICT,PISHIN TEHSIL,60,830,132,962
PISHIN DISTRICT,PISHIN TEHSIL,61,682,103,785
PISHIN DISTRICT,PISHIN TEHSIL,62,619,103,722
PISHIN DISTRICT,PISHIN TEHSIL,63,714,98,812
PISHIN DISTRICT,PISHIN TEHSIL,64,607,100,707
PISHIN DISTRICT,PISHIN TEHSIL,65,671,64,735
PISHIN DISTRICT,PISHIN TEHSIL,66,423,52,475
PISHIN DISTRICT,PISHIN TEHSIL,67,516,66,582
PISHIN DISTRICT,PISHIN TEHSIL,68,508,67,575
PISHIN DISTRICT,PISHIN TEHSIL,69,445,65,510
PISHIN DISTRICT,PISHIN TEHSIL,70,441,56,497
PISHIN DISTRICT,PISHIN TEHSIL,71,405,50,455
PISHIN DISTRICT,PISHIN TEHSIL,72,310,30,340
PISHIN DISTRICT,PISHIN TEHSIL,73,334,46,380
PISHIN DISTRICT,PISHIN TEHSIL,74,287,34,321
PISHIN DISTRICT,PISHIN TEHSIL,>=75,1754,214,1968
PISHIN DISTRICT,SARANAN TEHSIL,<1,517,1308,1825
PISHIN DISTRICT,SARANAN TEHSIL,1,640,1551,2191
PISHIN DISTRICT,SARANAN TEHSIL,2,763,1524,2287
PISHIN DISTRICT,SARANAN TEHSIL,3,726,1504,2230
PISHIN DISTRICT,SARANAN TEHSIL,4,670,1344,2014
PISHIN DISTRICT,SARANAN TEHSIL,5,668,1263,1931
PISHIN DISTRICT,SARANAN TEHSIL,6,635,1204,1839
PISHIN DISTRICT,SARANAN TEHSIL,7,671,1129,1800
PISHIN DISTRICT,SARANAN TEHSIL,8,620,1146,1766
PISHIN DISTRICT,SARANAN TEHSIL,9,591,1180,1771
PISHIN DISTRICT,SARANAN TEHSIL,10,584,1000,1584
PISHIN DISTRICT,SARANAN TEHSIL,11,496,1040,1536
PISHIN DISTRICT,SARANAN TEHSIL,12,505,893,1398
PISHIN DISTRICT,SARANAN TEHSIL,13,426,893,1319
PISHIN DISTRICT,SARANAN TEHSIL,14,460,876,1336
PISHIN DISTRICT,SARANAN TEHSIL,15,450,833,1283
PISHIN DISTRICT,SARANAN TEHSIL,16,384,776,1160
PISHIN DISTRICT,SARANAN TEHSIL,17,372,888,1260
PISHIN DISTRICT,SARANAN TEHSIL,18,391,881,1272
PISHIN DISTRICT,SARANAN TEHSIL,19,449,995,1444
PISHIN DISTRICT,SARANAN TEHSIL,20,415,832,1247
PISHIN DISTRICT,SARANAN TEHSIL,21,349,880,1229
PISHIN DISTRICT,SARANAN TEHSIL,22,304,646,950
PISHIN DISTRICT,SARANAN TEHSIL,23,269,717,986
PISHIN DISTRICT,SARANAN TEHSIL,24,317,641,958
PISHIN DISTRICT,SARANAN TEHSIL,25,258,680,938
PISHIN DISTRICT,SARANAN TEHSIL,26,278,547,825
PISHIN DISTRICT,SARANAN TEHSIL,27,279,640,919
PISHIN DISTRICT,SARANAN TEHSIL,28,231,518,749
PISHIN DISTRICT,SARANAN TEHSIL,29,257,630,887
PISHIN DISTRICT,SARANAN TEHSIL,30,265,495,760
PISHIN DISTRICT,SARANAN TEHSIL,31,232,488,720
PISHIN DISTRICT,SARANAN TEHSIL,32,218,459,677
PISHIN DISTRICT,SARANAN TEHSIL,33,176,452,628
PISHIN DISTRICT,SARANAN TEHSIL,34,181,366,547
PISHIN DISTRICT,SARANAN TEHSIL,35,169,384,553
PISHIN DISTRICT,SARANAN TEHSIL,36,124,302,426
PISHIN DISTRICT,SARANAN TEHSIL,37,199,342,541
PISHIN DISTRICT,SARANAN TEHSIL,38,152,352,504
PISHIN DISTRICT,SARANAN TEHSIL,39,180,302,482
PISHIN DISTRICT,SARANAN TEHSIL,40,141,298,439
PISHIN DISTRICT,SARANAN TEHSIL,41,101,245,346
PISHIN DISTRICT,SARANAN TEHSIL,42,152,214,366
PISHIN DISTRICT,SARANAN TEHSIL,43,97,207,304
PISHIN DISTRICT,SARANAN TEHSIL,44,92,183,275
PISHIN DISTRICT,SARANAN TEHSIL,45,105,223,328
PISHIN DISTRICT,SARANAN TEHSIL,46,62,118,180
PISHIN DISTRICT,SARANAN TEHSIL,47,158,216,374
PISHIN DISTRICT,SARANAN TEHSIL,48,76,189,265
PISHIN DISTRICT,SARANAN TEHSIL,49,121,161,282
PISHIN DISTRICT,SARANAN TEHSIL,50,100,193,293
PISHIN DISTRICT,SARANAN TEHSIL,51,86,173,259
PISHIN DISTRICT,SARANAN TEHSIL,52,83,178,261
PISHIN DISTRICT,SARANAN TEHSIL,53,67,153,220
PISHIN DISTRICT,SARANAN TEHSIL,54,59,108,167
PISHIN DISTRICT,SARANAN TEHSIL,55,63,168,231
PISHIN DISTRICT,SARANAN TEHSIL,56,42,90,132
PISHIN DISTRICT,SARANAN TEHSIL,57,71,137,208
PISHIN DISTRICT,SARANAN TEHSIL,58,58,101,159
PISHIN DISTRICT,SARANAN TEHSIL,59,82,121,203
PISHIN DISTRICT,SARANAN TEHSIL,60,51,121,172
PISHIN DISTRICT,SARANAN TEHSIL,61,48,120,168
PISHIN DISTRICT,SARANAN TEHSIL,62,40,97,137
PISHIN DISTRICT,SARANAN TEHSIL,63,53,126,179
PISHIN DISTRICT,SARANAN TEHSIL,64,59,93,152
PISHIN DISTRICT,SARANAN TEHSIL,65,38,113,151
PISHIN DISTRICT,SARANAN TEHSIL,66,34,72,106
PISHIN DISTRICT,SARANAN TEHSIL,67,50,78,128
PISHIN DISTRICT,SARANAN TEHSIL,68,34,82,116
PISHIN DISTRICT,SARANAN TEHSIL,69,44,65,109
PISHIN DISTRICT,SARANAN TEHSIL,70,23,75,98
PISHIN DISTRICT,SARANAN TEHSIL,71,34,46,80
PISHIN DISTRICT,SARANAN TEHSIL,72,21,44,65
PISHIN DISTRICT,SARANAN TEHSIL,73,29,37,66
PISHIN DISTRICT,SARANAN TEHSIL,74,23,37,60
PISHIN DISTRICT,SARANAN TEHSIL,>=75,184,267,451
QUETTA DISTRICT,PANJ PAI SUB-TEHSIL,<1,583,0,583
QUETTA DISTRICT,PANJ PAI SUB-TEHSIL,1,751,0,751
QUETTA DISTRICT,PANJ PAI SUB-TEHSIL,2,716,0,716
QUETTA DISTRICT,PANJ PAI SUB-TEHSIL,3,745,0,745
QUETTA DISTRICT,PANJ PAI SUB-TEHSIL,4,784,0,784
QUETTA DISTRICT,PANJ PAI SUB-TEHSIL,5,671,0,671
QUETTA DISTRICT,PANJ PAI SUB-TEHSIL,6,654,0,654
QUETTA DISTRICT,PANJ PAI SUB-TEHSIL,7,666,0,666
QUETTA DISTRICT,PANJ PAI SUB-TEHSIL,8,635,0,635
QUETTA DISTRICT,PANJ PAI SUB-TEHSIL,9,653,0,653
QUETTA DISTRICT,PANJ PAI SUB-TEHSIL,10,538,0,538
QUETTA DISTRICT,PANJ PAI SUB-TEHSIL,11,534,0,534
QUETTA DISTRICT,PANJ PAI SUB-TEHSIL,12,503,0,503
QUETTA DISTRICT,PANJ PAI SUB-TEHSIL,13,465,0,465
QUETTA DISTRICT,PANJ PAI SUB-TEHSIL,14,453,0,453
QUETTA DISTRICT,PANJ PAI SUB-TEHSIL,15,421,0,421
QUETTA DISTRICT,PANJ PAI SUB-TEHSIL,16,437,0,437
QUETTA DISTRICT,PANJ PAI SUB-TEHSIL,17,401,0,401
QUETTA DISTRICT,PANJ PAI SUB-TEHSIL,18,413,0,413
QUETTA DISTRICT,PANJ PAI SUB-TEHSIL,19,440,0,440
QUETTA DISTRICT,PANJ PAI SUB-TEHSIL,20,370,0,370
QUETTA DISTRICT,PANJ PAI SUB-TEHSIL,21,369,0,369
QUETTA DISTRICT,PANJ PAI SUB-TEHSIL,22,316,0,316
QUETTA DISTRICT,PANJ PAI SUB-TEHSIL,23,289,0,289
QUETTA DISTRICT,PANJ PAI SUB-TEHSIL,24,281,0,281
QUETTA DISTRICT,PANJ PAI SUB-TEHSIL,25,303,0,303
QUETTA DISTRICT,PANJ PAI SUB-TEHSIL,26,264,0,264
QUETTA DISTRICT,PANJ PAI SUB-TEHSIL,27,251,0,251
QUETTA DISTRICT,PANJ PAI SUB-TEHSIL,28,257,0,257
QUETTA DISTRICT,PANJ PAI SUB-TEHSIL,29,276,0,276
QUETTA DISTRICT,PANJ PAI SUB-TEHSIL,30,243,0,243
QUETTA DISTRICT,PANJ PAI SUB-TEHSIL,31,260,0,260
QUETTA DISTRICT,PANJ PAI SUB-TEHSIL,32,185,0,185
QUETTA DISTRICT,PANJ PAI SUB-TEHSIL,33,197,0,197
QUETTA DISTRICT,PANJ PAI SUB-TEHSIL,34,220,0,220
QUETTA DISTRICT,PANJ PAI SUB-TEHSIL,35,168,0,168
QUETTA DISTRICT,PANJ PAI SUB-TEHSIL,36,147,0,147
QUETTA DISTRICT,PANJ PAI SUB-TEHSIL,37,196,0,196
QUETTA DISTRICT,PANJ PAI SUB-TEHSIL,38,150,0,150
QUETTA DISTRICT,PANJ PAI SUB-TEHSIL,39,147,0,147
QUETTA DISTRICT,PANJ PAI SUB-TEHSIL,40,125,0,125
QUETTA DISTRICT,PANJ PAI SUB-TEHSIL,41,159,0,159
QUETTA DISTRICT,PANJ PAI SUB-TEHSIL,42,112,0,112
QUETTA DISTRICT,PANJ PAI SUB-TEHSIL,43,99,0,99
QUETTA DISTRICT,PANJ PAI SUB-TEHSIL,44,112,0,112
QUETTA DISTRICT,PANJ PAI SUB-TEHSIL,45,115,0,115
QUETTA DISTRICT,PANJ PAI SUB-TEHSIL,46,117,0,117
QUETTA DISTRICT,PANJ PAI SUB-TEHSIL,47,109,0,109
QUETTA DISTRICT,PANJ PAI SUB-TEHSIL,48,96,0,96
QUETTA DISTRICT,PANJ PAI SUB-TEHSIL,49,94,0,94
QUETTA DISTRICT,PANJ PAI SUB-TEHSIL,50,88,0,88
QUETTA DISTRICT,PANJ PAI SUB-TEHSIL,51,112,0,112
QUETTA DISTRICT,PANJ PAI SUB-TEHSIL,52,73,0,73
QUETTA DISTRICT,PANJ PAI SUB-TEHSIL,53,84,0,84
QUETTA DISTRICT,PANJ PAI SUB-TEHSIL,54,64,0,64
QUETTA DISTRICT,PANJ PAI SUB-TEHSIL,55,52,0,52
QUETTA DISTRICT,PANJ PAI SUB-TEHSIL,56,66,0,66
QUETTA DISTRICT,PANJ PAI SUB-TEHSIL,57,60,0,60
QUETTA DISTRICT,PANJ PAI SUB-TEHSIL,58,60,0,60
QUETTA DISTRICT,PANJ PAI SUB-TEHSIL,59,67,0,67
QUETTA DISTRICT,PANJ PAI SUB-TEHSIL,60,65,0,65
QUETTA DISTRICT,PANJ PAI SUB-TEHSIL,61,79,0,79
QUETTA DISTRICT,PANJ PAI SUB-TEHSIL,62,69,0,69
QUETTA DISTRICT,PANJ PAI SUB-TEHSIL,63,49,0,49
QUETTA DISTRICT,PANJ PAI SUB-TEHSIL,64,38,0,38
QUETTA DISTRICT,PANJ PAI SUB-TEHSIL,65,36,0,36
QUETTA DISTRICT,PANJ PAI SUB-TEHSIL,66,65,0,65
QUETTA DISTRICT,PANJ PAI SUB-TEHSIL,67,49,0,49
QUETTA DISTRICT,PANJ PAI SUB-TEHSIL,68,35,0,35
QUETTA DISTRICT,PANJ PAI SUB-TEHSIL,69,37,0,37
QUETTA DISTRICT,PANJ PAI SUB-TEHSIL,70,31,0,31
QUETTA DISTRICT,PANJ PAI SUB-TEHSIL,71,38,0,38
QUETTA DISTRICT,PANJ PAI SUB-TEHSIL,72,28,0,28
QUETTA DISTRICT,PANJ PAI SUB-TEHSIL,73,19,0,19
QUETTA DISTRICT,PANJ PAI SUB-TEHSIL,74,11,0,11
QUETTA DISTRICT,PANJ PAI SUB-TEHSIL,>=75,146,0,146
QUETTA DISTRICT,QUETTA CITY TEHSIL,<1,19115,24845,43960
QUETTA DISTRICT,QUETTA CITY TEHSIL,1,27400,29109,56509
QUETTA DISTRICT,QUETTA CITY TEHSIL,2,26262,29362,55624
QUETTA DISTRICT,QUETTA CITY TEHSIL,3,27122,31390,58512
QUETTA DISTRICT,QUETTA CITY TEHSIL,4,25165,28573,53738
QUETTA DISTRICT,QUETTA CITY TEHSIL,5,25182,28918,54100
QUETTA DISTRICT,QUETTA CITY TEHSIL,6,23548,27336,50884
QUETTA DISTRICT,QUETTA CITY TEHSIL,7,26159,29316,55475
QUETTA DISTRICT,QUETTA CITY TEHSIL,8,22969,26126,49095
QUETTA DISTRICT,QUETTA CITY TEHSIL,9,24430,28501,52931
QUETTA DISTRICT,QUETTA CITY TEHSIL,10,20363,23646,44009
QUETTA DISTRICT,QUETTA CITY TEHSIL,11,21705,27039,48744
QUETTA DISTRICT,QUETTA CITY TEHSIL,12,18108,22056,40164
QUETTA DISTRICT,QUETTA CITY TEHSIL,13,19264,24222,43486
QUETTA DISTRICT,QUETTA CITY TEHSIL,14,17582,22034,39616
QUETTA DISTRICT,QUETTA CITY TEHSIL,15,17847,22772,40619
QUETTA DISTRICT,QUETTA CITY TEHSIL,16,16814,22394,39208
QUETTA DISTRICT,QUETTA CITY TEHSIL,17,16513,23154,39667
QUETTA DISTRICT,QUETTA CITY TEHSIL,18,15992,21003,36995
QUETTA DISTRICT,QUETTA CITY TEHSIL,19,16570,23282,39852
QUETTA DISTRICT,QUETTA CITY TEHSIL,20,13964,18975,32939
QUETTA DISTRICT,QUETTA CITY TEHSIL,21,14957,22165,37122
QUETTA DISTRICT,QUETTA CITY TEHSIL,22,11662,18273,29935
QUETTA DISTRICT,QUETTA CITY TEHSIL,23,12197,19767,31964
QUETTA DISTRICT,QUETTA CITY TEHSIL,24,10573,18332,28905
QUETTA DISTRICT,QUETTA CITY TEHSIL,25,11573,17161,28734
QUETTA DISTRICT,QUETTA CITY TEHSIL,26,9848,17516,27364
QUETTA DISTRICT,QUETTA CITY TEHSIL,27,11307,17966,29273
QUETTA DISTRICT,QUETTA CITY TEHSIL,28,9443,16616,26059
QUETTA DISTRICT,QUETTA CITY TEHSIL,29,10544,17229,27773
QUETTA DISTRICT,QUETTA CITY TEHSIL,30,9305,14619,23924
QUETTA DISTRICT,QUETTA CITY TEHSIL,31,9655,16152,25807
QUETTA DISTRICT,QUETTA CITY TEHSIL,32,7871,14251,22122
QUETTA DISTRICT,QUETTA CITY TEHSIL,33,8323,14164,22487
QUETTA DISTRICT,QUETTA CITY TEHSIL,34,6704,12664,19368
QUETTA DISTRICT,QUETTA CITY TEHSIL,35,7421,11202,18623
QUETTA DISTRICT,QUETTA CITY TEHSIL,36,6341,11240,17581
QUETTA DISTRICT,QUETTA CITY TEHSIL,37,7393,11646,19039
QUETTA DISTRICT,QUETTA CITY TEHSIL,38,6323,12074,18397
QUETTA DISTRICT,QUETTA CITY TEHSIL,39,6796,11363,18159
QUETTA DISTRICT,QUETTA CITY TEHSIL,40,5956,9573,15529
QUETTA DISTRICT,QUETTA CITY TEHSIL,41,5877,9750,15627
QUETTA DISTRICT,QUETTA CITY TEHSIL,42,4547,8196,12743
QUETTA DISTRICT,QUETTA CITY TEHSIL,43,4686,8242,12928
QUETTA DISTRICT,QUETTA CITY TEHSIL,44,3970,7105,11075
QUETTA DISTRICT,QUETTA CITY TEHSIL,45,4165,6809,10974
QUETTA DISTRICT,QUETTA CITY TEHSIL,46,4074,6612,10686
QUETTA DISTRICT,QUETTA CITY TEHSIL,47,4680,6711,11391
QUETTA DISTRICT,QUETTA CITY TEHSIL,48,3682,6734,10416
QUETTA DISTRICT,QUETTA CITY TEHSIL,49,4284,6849,11133
QUETTA DISTRICT,QUETTA CITY TEHSIL,50,3818,6177,9995
QUETTA DISTRICT,QUETTA CITY TEHSIL,51,4277,6546,10823
QUETTA DISTRICT,QUETTA CITY TEHSIL,52,3135,5670,8805
QUETTA DISTRICT,QUETTA CITY TEHSIL,53,3140,5474,8614
QUETTA DISTRICT,QUETTA CITY TEHSIL,54,2755,5065,7820
QUETTA DISTRICT,QUETTA CITY TEHSIL,55,2511,4617,7128
QUETTA DISTRICT,QUETTA CITY TEHSIL,56,2521,4278,6799
QUETTA DISTRICT,QUETTA CITY TEHSIL,57,2585,4141,6726
QUETTA DISTRICT,QUETTA CITY TEHSIL,58,1968,4004,5972
QUETTA DISTRICT,QUETTA CITY TEHSIL,59,2202,3728,5930
QUETTA DISTRICT,QUETTA CITY TEHSIL,60,2217,3333,5550
QUETTA DISTRICT,QUETTA CITY TEHSIL,61,2626,4030,6656
QUETTA DISTRICT,QUETTA CITY TEHSIL,62,1957,3636,5593
QUETTA DISTRICT,QUETTA CITY TEHSIL,63,1996,3620,5616
QUETTA DISTRICT,QUETTA CITY TEHSIL,64,1782,3071,4853
QUETTA DISTRICT,QUETTA CITY TEHSIL,65,1486,2432,3918
QUETTA DISTRICT,QUETTA CITY TEHSIL,66,1629,2323,3952
QUETTA DISTRICT,QUETTA CITY TEHSIL,67,1555,2281,3836
QUETTA DISTRICT,QUETTA CITY TEHSIL,68,1243,2409,3652
QUETTA DISTRICT,QUETTA CITY TEHSIL,69,1247,1978,3225
QUETTA DISTRICT,QUETTA CITY TEHSIL,70,976,1444,2420
QUETTA DISTRICT,QUETTA CITY TEHSIL,71,1232,1758,2990
QUETTA DISTRICT,QUETTA CITY TEHSIL,72,885,1432,2317
QUETTA DISTRICT,QUETTA CITY TEHSIL,73,821,1510,2331
QUETTA DISTRICT,QUETTA CITY TEHSIL,74,677,1096,1773
QUETTA DISTRICT,QUETTA CITY TEHSIL,>=75,5889,8298,14187
QUETTA DISTRICT,QUETTA SADDAR TEHSIL,<1,14578,0,14578
QUETTA DISTRICT,QUETTA SADDAR TEHSIL,1,19531,0,19531
QUETTA DISTRICT,QUETTA SADDAR TEHSIL,2,19174,0,19174
QUETTA DISTRICT,QUETTA SADDAR TEHSIL,3,19777,0,19777
QUETTA DISTRICT,QUETTA SADDAR TEHSIL,4,18228,0,18228
QUETTA DISTRICT,QUETTA SADDAR TEHSIL,5,18215,0,18215
QUETTA DISTRICT,QUETTA SADDAR TEHSIL,6,17492,0,17492
QUETTA DISTRICT,QUETTA SADDAR TEHSIL,7,18247,0,18247
QUETTA DISTRICT,QUETTA SADDAR TEHSIL,8,16275,0,16275
QUETTA DISTRICT,QUETTA SADDAR TEHSIL,9,17668,0,17668
QUETTA DISTRICT,QUETTA SADDAR TEHSIL,10,14317,0,14317
QUETTA DISTRICT,QUETTA SADDAR TEHSIL,11,15851,0,15851
QUETTA DISTRICT,QUETTA SADDAR TEHSIL,12,12731,0,12731
QUETTA DISTRICT,QUETTA SADDAR TEHSIL,13,14135,0,14135
QUETTA DISTRICT,QUETTA SADDAR TEHSIL,14,12679,0,12679
QUETTA DISTRICT,QUETTA SADDAR TEHSIL,15,12775,0,12775
QUETTA DISTRICT,QUETTA SADDAR TEHSIL,16,12096,0,12096
QUETTA DISTRICT,QUETTA SADDAR TEHSIL,17,12229,0,12229
QUETTA DISTRICT,QUETTA SADDAR TEHSIL,18,11678,0,11678
QUETTA DISTRICT,QUETTA SADDAR TEHSIL,19,12111,0,12111
QUETTA DISTRICT,QUETTA SADDAR TEHSIL,20,10159,0,10159
QUETTA DISTRICT,QUETTA SADDAR TEHSIL,21,11269,0,11269
QUETTA DISTRICT,QUETTA SADDAR TEHSIL,22,9101,0,9101
QUETTA DISTRICT,QUETTA SADDAR TEHSIL,23,9462,0,9462
QUETTA DISTRICT,QUETTA SADDAR TEHSIL,24,8010,0,8010
QUETTA DISTRICT,QUETTA SADDAR TEHSIL,25,8645,0,8645
QUETTA DISTRICT,QUETTA SADDAR TEHSIL,26,7760,0,7760
QUETTA DISTRICT,QUETTA SADDAR TEHSIL,27,8098,0,8098
QUETTA DISTRICT,QUETTA SADDAR TEHSIL,28,7340,0,7340
QUETTA DISTRICT,QUETTA SADDAR TEHSIL,29,7758,0,7758
QUETTA DISTRICT,QUETTA SADDAR TEHSIL,30,6716,0,6716
QUETTA DISTRICT,QUETTA SADDAR TEHSIL,31,7170,0,7170
QUETTA DISTRICT,QUETTA SADDAR TEHSIL,32,6064,0,6064
QUETTA DISTRICT,QUETTA SADDAR TEHSIL,33,6132,0,6132
QUETTA DISTRICT,QUETTA SADDAR TEHSIL,34,5359,0,5359
QUETTA DISTRICT,QUETTA SADDAR TEHSIL,35,5033,0,5033
QUETTA DISTRICT,QUETTA SADDAR TEHSIL,36,4789,0,4789
QUETTA DISTRICT,QUETTA SADDAR TEHSIL,37,5399,0,5399
QUETTA DISTRICT,QUETTA SADDAR TEHSIL,38,4932,0,4932
QUETTA DISTRICT,QUETTA SADDAR TEHSIL,39,4869,0,4869
QUETTA DISTRICT,QUETTA SADDAR TEHSIL,40,4312,0,4312
QUETTA DISTRICT,QUETTA SADDAR TEHSIL,41,4123,0,4123
QUETTA DISTRICT,QUETTA SADDAR TEHSIL,42,3492,0,3492
QUETTA DISTRICT,QUETTA SADDAR TEHSIL,43,3439,0,3439
QUETTA DISTRICT,QUETTA SADDAR TEHSIL,44,2921,0,2921
QUETTA DISTRICT,QUETTA SADDAR TEHSIL,45,2779,0,2779
QUETTA DISTRICT,QUETTA SADDAR TEHSIL,46,2829,0,2829
QUETTA DISTRICT,QUETTA SADDAR TEHSIL,47,3157,0,3157
QUETTA DISTRICT,QUETTA SADDAR TEHSIL,48,2670,0,2670
QUETTA DISTRICT,QUETTA SADDAR TEHSIL,49,2862,0,2862
QUETTA DISTRICT,QUETTA SADDAR TEHSIL,50,2780,0,2780
QUETTA DISTRICT,QUETTA SADDAR TEHSIL,51,2837,0,2837
QUETTA DISTRICT,QUETTA SADDAR TEHSIL,52,2373,0,2373
QUETTA DISTRICT,QUETTA SADDAR TEHSIL,53,2303,0,2303
QUETTA DISTRICT,QUETTA SADDAR TEHSIL,54,2060,0,2060
QUETTA DISTRICT,QUETTA SADDAR TEHSIL,55,1868,0,1868
QUETTA DISTRICT,QUETTA SADDAR TEHSIL,56,1748,0,1748
QUETTA DISTRICT,QUETTA SADDAR TEHSIL,57,1884,0,1884
QUETTA DISTRICT,QUETTA SADDAR TEHSIL,58,1633,0,1633
QUETTA DISTRICT,QUETTA SADDAR TEHSIL,59,1690,0,1690
QUETTA DISTRICT,QUETTA SADDAR TEHSIL,60,1620,0,1620
QUETTA DISTRICT,QUETTA SADDAR TEHSIL,61,1600,0,1600
QUETTA DISTRICT,QUETTA SADDAR TEHSIL,62,1565,0,1565
QUETTA DISTRICT,QUETTA SADDAR TEHSIL,63,1662,0,1662
QUETTA DISTRICT,QUETTA SADDAR TEHSIL,64,1319,0,1319
QUETTA DISTRICT,QUETTA SADDAR TEHSIL,65,1076,0,1076
QUETTA DISTRICT,QUETTA SADDAR TEHSIL,66,1050,0,1050
QUETTA DISTRICT,QUETTA SADDAR TEHSIL,67,1103,0,1103
QUETTA DISTRICT,QUETTA SADDAR TEHSIL,68,994,0,994
QUETTA DISTRICT,QUETTA SADDAR TEHSIL,69,900,0,900
QUETTA DISTRICT,QUETTA SADDAR TEHSIL,70,693,0,693
QUETTA DISTRICT,QUETTA SADDAR TEHSIL,71,744,0,744
QUETTA DISTRICT,QUETTA SADDAR TEHSIL,72,711,0,711
QUETTA DISTRICT,QUETTA SADDAR TEHSIL,73,650,0,650
QUETTA DISTRICT,QUETTA SADDAR TEHSIL,74,477,0,477
QUETTA DISTRICT,QUETTA SADDAR TEHSIL,>=75,3940,0,3940
RAHIM YAR KHAN DISTRICT,KHANPUR TEHSIL,<1,15629,4839,20468
RAHIM YAR KHAN DISTRICT,KHANPUR TEHSIL,1,20332,5419,25751
RAHIM YAR KHAN DISTRICT,KHANPUR TEHSIL,2,21998,6090,28088
RAHIM YAR KHAN DISTRICT,KHANPUR TEHSIL,3,23401,6591,29992
RAHIM YAR KHAN DISTRICT,KHANPUR TEHSIL,4,24795,6337,31132
RAHIM YAR KHAN DISTRICT,KHANPUR TEHSIL,5,23672,6389,30061
RAHIM YAR KHAN DISTRICT,KHANPUR TEHSIL,6,23105,6075,29180
RAHIM YAR KHAN DISTRICT,KHANPUR TEHSIL,7,24453,6692,31145
RAHIM YAR KHAN DISTRICT,KHANPUR TEHSIL,8,24870,6100,30970
RAHIM YAR KHAN DISTRICT,KHANPUR TEHSIL,9,22228,6463,28691
RAHIM YAR KHAN DISTRICT,KHANPUR TEHSIL,10,22043,5761,27804
RAHIM YAR KHAN DISTRICT,KHANPUR TEHSIL,11,18002,5767,23769
RAHIM YAR KHAN DISTRICT,KHANPUR TEHSIL,12,19094,5479,24573
RAHIM YAR KHAN DISTRICT,KHANPUR TEHSIL,13,16600,5459,22059
RAHIM YAR KHAN DISTRICT,KHANPUR TEHSIL,14,16379,5131,21510
RAHIM YAR KHAN DISTRICT,KHANPUR TEHSIL,15,17076,5394,22470
RAHIM YAR KHAN DISTRICT,KHANPUR TEHSIL,16,15730,4976,20706
RAHIM YAR KHAN DISTRICT,KHANPUR TEHSIL,17,16944,5608,22552
RAHIM YAR KHAN DISTRICT,KHANPUR TEHSIL,18,14547,4582,19129
RAHIM YAR KHAN DISTRICT,KHANPUR TEHSIL,19,13992,4963,18955
RAHIM YAR KHAN DISTRICT,KHANPUR TEHSIL,20,15982,4805,20787
RAHIM YAR KHAN DISTRICT,KHANPUR TEHSIL,21,12801,4848,17649
RAHIM YAR KHAN DISTRICT,KHANPUR TEHSIL,22,14170,4653,18823
RAHIM YAR KHAN DISTRICT,KHANPUR TEHSIL,23,11693,4184,15877
RAHIM YAR KHAN DISTRICT,KHANPUR TEHSIL,24,10988,4032,15020
RAHIM YAR KHAN DISTRICT,KHANPUR TEHSIL,25,13421,3863,17284
RAHIM YAR KHAN DISTRICT,KHANPUR TEHSIL,26,9835,3716,13551
RAHIM YAR KHAN DISTRICT,KHANPUR TEHSIL,27,10367,3886,14253
RAHIM YAR KHAN DISTRICT,KHANPUR TEHSIL,28,11011,3731,14742
RAHIM YAR KHAN DISTRICT,KHANPUR TEHSIL,29,9810,3511,13321
RAHIM YAR KHAN DISTRICT,KHANPUR TEHSIL,30,11911,3486,15397
RAHIM YAR KHAN DISTRICT,KHANPUR TEHSIL,31,9086,3362,12448
RAHIM YAR KHAN DISTRICT,KHANPUR TEHSIL,32,8751,3292,12043
RAHIM YAR KHAN DISTRICT,KHANPUR TEHSIL,33,8031,2865,10896
RAHIM YAR KHAN DISTRICT,KHANPUR TEHSIL,34,7314,2612,9926
RAHIM YAR KHAN DISTRICT,KHANPUR TEHSIL,35,10135,3160,13295
RAHIM YAR KHAN DISTRICT,KHANPUR TEHSIL,36,7621,2534,10155
RAHIM YAR KHAN DISTRICT,KHANPUR TEHSIL,37,8113,2893,11006
RAHIM YAR KHAN DISTRICT,KHANPUR TEHSIL,38,7919,2600,10519
RAHIM YAR KHAN DISTRICT,KHANPUR TEHSIL,39,7470,2623,10093
RAHIM YAR KHAN DISTRICT,KHANPUR TEHSIL,40,8425,2606,11031
RAHIM YAR KHAN DISTRICT,KHANPUR TEHSIL,41,6786,2292,9078
RAHIM YAR KHAN DISTRICT,KHANPUR TEHSIL,42,6696,2275,8971
RAHIM YAR KHAN DISTRICT,KHANPUR TEHSIL,43,5778,2185,7963
RAHIM YAR KHAN DISTRICT,KHANPUR TEHSIL,44,5648,2007,7655
RAHIM YAR KHAN DISTRICT,KHANPUR TEHSIL,45,6722,2169,8891
RAHIM YAR KHAN DISTRICT,KHANPUR TEHSIL,46,5105,1680,6785
RAHIM YAR KHAN DISTRICT,KHANPUR TEHSIL,47,5475,1985,7460
RAHIM YAR KHAN DISTRICT,KHANPUR TEHSIL,48,5528,1922,7450
RAHIM YAR KHAN DISTRICT,KHANPUR TEHSIL,49,5307,1993,7300
RAHIM YAR KHAN DISTRICT,KHANPUR TEHSIL,50,6409,1882,8291
RAHIM YAR KHAN DISTRICT,KHANPUR TEHSIL,51,4752,1752,6504
RAHIM YAR KHAN DISTRICT,KHANPUR TEHSIL,52,4614,1636,6250
RAHIM YAR KHAN DISTRICT,KHANPUR TEHSIL,53,4223,1479,5702
RAHIM YAR KHAN DISTRICT,KHANPUR TEHSIL,54,3750,1292,5042
RAHIM YAR KHAN DISTRICT,KHANPUR TEHSIL,55,4570,1483,6053
RAHIM YAR KHAN DISTRICT,KHANPUR TEHSIL,56,2998,1082,4080
RAHIM YAR KHAN DISTRICT,KHANPUR TEHSIL,57,3064,1138,4202
RAHIM YAR KHAN DISTRICT,KHANPUR TEHSIL,58,2760,937,3697
RAHIM YAR KHAN DISTRICT,KHANPUR TEHSIL,59,2811,985,3796
RAHIM YAR KHAN DISTRICT,KHANPUR TEHSIL,60,4010,1115,5125
RAHIM YAR KHAN DISTRICT,KHANPUR TEHSIL,61,3118,1038,4156
RAHIM YAR KHAN DISTRICT,KHANPUR TEHSIL,62,3062,976,4038
RAHIM YAR KHAN DISTRICT,KHANPUR TEHSIL,63,2927,1002,3929
RAHIM YAR KHAN DISTRICT,KHANPUR TEHSIL,64,2558,850,3408
RAHIM YAR KHAN DISTRICT,KHANPUR TEHSIL,65,3128,848,3976
RAHIM YAR KHAN DISTRICT,KHANPUR TEHSIL,66,2244,698,2942
RAHIM YAR KHAN DISTRICT,KHANPUR TEHSIL,67,2368,673,3041
RAHIM YAR KHAN DISTRICT,KHANPUR TEHSIL,68,2055,557,2612
RAHIM YAR KHAN DISTRICT,KHANPUR TEHSIL,69,1801,490,2291
RAHIM YAR KHAN DISTRICT,KHANPUR TEHSIL,70,2358,541,2899
RAHIM YAR KHAN DISTRICT,KHANPUR TEHSIL,71,1887,525,2412
RAHIM YAR KHAN DISTRICT,KHANPUR TEHSIL,72,1762,477,2239
RAHIM YAR KHAN DISTRICT,KHANPUR TEHSIL,73,1483,448,1931
RAHIM YAR KHAN DISTRICT,KHANPUR TEHSIL,74,1145,297,1442
RAHIM YAR KHAN DISTRICT,KHANPUR TEHSIL,>=75,10572,2781,13353
RAHIM YAR KHAN DISTRICT,LIAQUATPUR TEHSIL,<1,21125,1077,22202
RAHIM YAR KHAN DISTRICT,LIAQUATPUR TEHSIL,1,27809,1379,29188
RAHIM YAR KHAN DISTRICT,LIAQUATPUR TEHSIL,2,29800,1321,31121
RAHIM YAR KHAN DISTRICT,LIAQUATPUR TEHSIL,3,32689,1448,34137
RAHIM YAR KHAN DISTRICT,LIAQUATPUR TEHSIL,4,33865,1377,35242
RAHIM YAR KHAN DISTRICT,LIAQUATPUR TEHSIL,5,33138,1419,34557
RAHIM YAR KHAN DISTRICT,LIAQUATPUR TEHSIL,6,31529,1351,32880
RAHIM YAR KHAN DISTRICT,LIAQUATPUR TEHSIL,7,34279,1531,35810
RAHIM YAR KHAN DISTRICT,LIAQUATPUR TEHSIL,8,33863,1358,35221
RAHIM YAR KHAN DISTRICT,LIAQUATPUR TEHSIL,9,30356,1584,31940
RAHIM YAR KHAN DISTRICT,LIAQUATPUR TEHSIL,10,29617,1237,30854
RAHIM YAR KHAN DISTRICT,LIAQUATPUR TEHSIL,11,23544,1347,24891
RAHIM YAR KHAN DISTRICT,LIAQUATPUR TEHSIL,12,25043,1201,26244
RAHIM YAR KHAN DISTRICT,LIAQUATPUR TEHSIL,13,21067,1183,22250
RAHIM YAR KHAN DISTRICT,LIAQUATPUR TEHSIL,14,21150,1145,22295
RAHIM YAR KHAN DISTRICT,LIAQUATPUR TEHSIL,15,20794,1201,21995
RAHIM YAR KHAN DISTRICT,LIAQUATPUR TEHSIL,16,19736,1137,20873
RAHIM YAR KHAN DISTRICT,LIAQUATPUR TEHSIL,17,21227,1352,22579
RAHIM YAR KHAN DISTRICT,LIAQUATPUR TEHSIL,18,18170,875,19045
RAHIM YAR KHAN DISTRICT,LIAQUATPUR TEHSIL,19,17480,1071,18551
RAHIM YAR KHAN DISTRICT,LIAQUATPUR TEHSIL,20,19682,967,20649
RAHIM YAR KHAN DISTRICT,LIAQUATPUR TEHSIL,21,15621,1136,16757
RAHIM YAR KHAN DISTRICT,LIAQUATPUR TEHSIL,22,17021,947,17968
RAHIM YAR KHAN DISTRICT,LIAQUATPUR TEHSIL,23,14147,904,15051
RAHIM YAR KHAN DISTRICT,LIAQUATPUR TEHSIL,24,13402,906,14308
RAHIM YAR KHAN DISTRICT,LIAQUATPUR TEHSIL,25,16397,804,17201
RAHIM YAR KHAN DISTRICT,LIAQUATPUR TEHSIL,26,12790,840,13630
RAHIM YAR KHAN DISTRICT,LIAQUATPUR TEHSIL,27,13716,850,14566
RAHIM YAR KHAN DISTRICT,LIAQUATPUR TEHSIL,28,13647,808,14455
RAHIM YAR KHAN DISTRICT,LIAQUATPUR TEHSIL,29,13692,896,14588
RAHIM YAR KHAN DISTRICT,LIAQUATPUR TEHSIL,30,14203,693,14896
RAHIM YAR KHAN DISTRICT,LIAQUATPUR TEHSIL,31,13124,793,13917
RAHIM YAR KHAN DISTRICT,LIAQUATPUR TEHSIL,32,12457,735,13192
RAHIM YAR KHAN DISTRICT,LIAQUATPUR TEHSIL,33,10906,652,11558
RAHIM YAR KHAN DISTRICT,LIAQUATPUR TEHSIL,34,10167,633,10800
RAHIM YAR KHAN DISTRICT,LIAQUATPUR TEHSIL,35,12134,572,12706
RAHIM YAR KHAN DISTRICT,LIAQUATPUR TEHSIL,36,10183,554,10737
RAHIM YAR KHAN DISTRICT,LIAQUATPUR TEHSIL,37,11973,628,12601
RAHIM YAR KHAN DISTRICT,LIAQUATPUR TEHSIL,38,9820,574,10394
RAHIM YAR KHAN DISTRICT,LIAQUATPUR TEHSIL,39,10502,605,11107
RAHIM YAR KHAN DISTRICT,LIAQUATPUR TEHSIL,40,9437,471,9908
RAHIM YAR KHAN DISTRICT,LIAQUATPUR TEHSIL,41,8981,518,9499
RAHIM YAR KHAN DISTRICT,LIAQUATPUR TEHSIL,42,9147,568,9715
RAHIM YAR KHAN DISTRICT,LIAQUATPUR TEHSIL,43,7247,512,7759
RAHIM YAR KHAN DISTRICT,LIAQUATPUR TEHSIL,44,7190,421,7611
RAHIM YAR KHAN DISTRICT,LIAQUATPUR TEHSIL,45,7488,429,7917
RAHIM YAR KHAN DISTRICT,LIAQUATPUR TEHSIL,46,6810,400,7210
RAHIM YAR KHAN DISTRICT,LIAQUATPUR TEHSIL,47,8009,428,8437
RAHIM YAR KHAN DISTRICT,LIAQUATPUR TEHSIL,48,6919,445,7364
RAHIM YAR KHAN DISTRICT,LIAQUATPUR TEHSIL,49,7253,478,7731
RAHIM YAR KHAN DISTRICT,LIAQUATPUR TEHSIL,50,7145,389,7534
RAHIM YAR KHAN DISTRICT,LIAQUATPUR TEHSIL,51,6596,415,7011
RAHIM YAR KHAN DISTRICT,LIAQUATPUR TEHSIL,52,6396,414,6810
RAHIM YAR KHAN DISTRICT,LIAQUATPUR TEHSIL,53,5126,347,5473
RAHIM YAR KHAN DISTRICT,LIAQUATPUR TEHSIL,54,4709,333,5042
RAHIM YAR KHAN DISTRICT,LIAQUATPUR TEHSIL,55,4844,282,5126
RAHIM YAR KHAN DISTRICT,LIAQUATPUR TEHSIL,56,4198,257,4455
RAHIM YAR KHAN DISTRICT,LIAQUATPUR TEHSIL,57,4777,275,5052
RAHIM YAR KHAN DISTRICT,LIAQUATPUR TEHSIL,58,3696,221,3917
RAHIM YAR KHAN DISTRICT,LIAQUATPUR TEHSIL,59,3949,271,4220
RAHIM YAR KHAN DISTRICT,LIAQUATPUR TEHSIL,60,4733,236,4969
RAHIM YAR KHAN DISTRICT,LIAQUATPUR TEHSIL,61,4383,273,4656
RAHIM YAR KHAN DISTRICT,LIAQUATPUR TEHSIL,62,4300,245,4545
RAHIM YAR KHAN DISTRICT,LIAQUATPUR TEHSIL,63,3850,209,4059
RAHIM YAR KHAN DISTRICT,LIAQUATPUR TEHSIL,64,3327,192,3519
RAHIM YAR KHAN DISTRICT,LIAQUATPUR TEHSIL,65,3479,151,3630
RAHIM YAR KHAN DISTRICT,LIAQUATPUR TEHSIL,66,3259,154,3413
RAHIM YAR KHAN DISTRICT,LIAQUATPUR TEHSIL,67,3496,158,3654
RAHIM YAR KHAN DISTRICT,LIAQUATPUR TEHSIL,68,2609,141,2750
RAHIM YAR KHAN DISTRICT,LIAQUATPUR TEHSIL,69,2374,115,2489
RAHIM YAR KHAN DISTRICT,LIAQUATPUR TEHSIL,70,2640,87,2727
RAHIM YAR KHAN DISTRICT,LIAQUATPUR TEHSIL,71,2524,96,2620
RAHIM YAR KHAN DISTRICT,LIAQUATPUR TEHSIL,72,2431,106,2537
RAHIM YAR KHAN DISTRICT,LIAQUATPUR TEHSIL,73,1860,95,1955
RAHIM YAR KHAN DISTRICT,LIAQUATPUR TEHSIL,74,1429,67,1496
RAHIM YAR KHAN DISTRICT,LIAQUATPUR TEHSIL,>=75,13542,598,14140
RAHIM YAR KHAN DISTRICT,RAHIM YAR KHAN TEHSIL,<1,22618,10491,33109
RAHIM YAR KHAN DISTRICT,RAHIM YAR KHAN TEHSIL,1,30797,12170,42967
RAHIM YAR KHAN DISTRICT,RAHIM YAR KHAN TEHSIL,2,31925,12225,44150
RAHIM YAR KHAN DISTRICT,RAHIM YAR KHAN TEHSIL,3,33457,13325,46782
RAHIM YAR KHAN DISTRICT,RAHIM YAR KHAN TEHSIL,4,35058,12681,47739
RAHIM YAR KHAN DISTRICT,RAHIM YAR KHAN TEHSIL,5,33650,13261,46911
RAHIM YAR KHAN DISTRICT,RAHIM YAR KHAN TEHSIL,6,33302,12359,45661
RAHIM YAR KHAN DISTRICT,RAHIM YAR KHAN TEHSIL,7,33904,13749,47653
RAHIM YAR KHAN DISTRICT,RAHIM YAR KHAN TEHSIL,8,35076,12007,47083
RAHIM YAR KHAN DISTRICT,RAHIM YAR KHAN TEHSIL,9,30745,13217,43962
RAHIM YAR KHAN DISTRICT,RAHIM YAR KHAN TEHSIL,10,30965,11338,42303
RAHIM YAR KHAN DISTRICT,RAHIM YAR KHAN TEHSIL,11,25408,12521,37929
RAHIM YAR KHAN DISTRICT,RAHIM YAR KHAN TEHSIL,12,26893,10990,37883
RAHIM YAR KHAN DISTRICT,RAHIM YAR KHAN TEHSIL,13,22750,11344,34094
RAHIM YAR KHAN DISTRICT,RAHIM YAR KHAN TEHSIL,14,23269,10666,33935
RAHIM YAR KHAN DISTRICT,RAHIM YAR KHAN TEHSIL,15,22305,10723,33028
RAHIM YAR KHAN DISTRICT,RAHIM YAR KHAN TEHSIL,16,21818,10352,32170
RAHIM YAR KHAN DISTRICT,RAHIM YAR KHAN TEHSIL,17,21061,11788,32849
RAHIM YAR KHAN DISTRICT,RAHIM YAR KHAN TEHSIL,18,22655,9249,31904
RAHIM YAR KHAN DISTRICT,RAHIM YAR KHAN TEHSIL,19,20122,10516,30638
RAHIM YAR KHAN DISTRICT,RAHIM YAR KHAN TEHSIL,20,22753,9538,32291
RAHIM YAR KHAN DISTRICT,RAHIM YAR KHAN TEHSIL,21,17338,9981,27319
RAHIM YAR KHAN DISTRICT,RAHIM YAR KHAN TEHSIL,22,19530,9613,29143
RAHIM YAR KHAN DISTRICT,RAHIM YAR KHAN TEHSIL,23,15925,8867,24792
RAHIM YAR KHAN DISTRICT,RAHIM YAR KHAN TEHSIL,24,15514,8726,24240
RAHIM YAR KHAN DISTRICT,RAHIM YAR KHAN TEHSIL,25,18894,8291,27185
RAHIM YAR KHAN DISTRICT,RAHIM YAR KHAN TEHSIL,26,14403,8318,22721
RAHIM YAR KHAN DISTRICT,RAHIM YAR KHAN TEHSIL,27,13694,7819,21513
RAHIM YAR KHAN DISTRICT,RAHIM YAR KHAN TEHSIL,28,15892,8062,23954
RAHIM YAR KHAN DISTRICT,RAHIM YAR KHAN TEHSIL,29,13345,7398,20743
RAHIM YAR KHAN DISTRICT,RAHIM YAR KHAN TEHSIL,30,17113,7955,25068
RAHIM YAR KHAN DISTRICT,RAHIM YAR KHAN TEHSIL,31,13151,7061,20212
RAHIM YAR KHAN DISTRICT,RAHIM YAR KHAN TEHSIL,32,13030,6977,20007
RAHIM YAR KHAN DISTRICT,RAHIM YAR KHAN TEHSIL,33,11982,6753,18735
RAHIM YAR KHAN DISTRICT,RAHIM YAR KHAN TEHSIL,34,10559,5744,16303
RAHIM YAR KHAN DISTRICT,RAHIM YAR KHAN TEHSIL,35,14522,6688,21210
RAHIM YAR KHAN DISTRICT,RAHIM YAR KHAN TEHSIL,36,10583,5427,16010
RAHIM YAR KHAN DISTRICT,RAHIM YAR KHAN TEHSIL,37,10865,5033,15898
RAHIM YAR KHAN DISTRICT,RAHIM YAR KHAN TEHSIL,38,11412,6073,17485
RAHIM YAR KHAN DISTRICT,RAHIM YAR KHAN TEHSIL,39,10626,5366,15992
RAHIM YAR KHAN DISTRICT,RAHIM YAR KHAN TEHSIL,40,12492,6100,18592
RAHIM YAR KHAN DISTRICT,RAHIM YAR KHAN TEHSIL,41,9304,4839,14143
RAHIM YAR KHAN DISTRICT,RAHIM YAR KHAN TEHSIL,42,8675,4633,13308
RAHIM YAR KHAN DISTRICT,RAHIM YAR KHAN TEHSIL,43,8148,4524,12672
RAHIM YAR KHAN DISTRICT,RAHIM YAR KHAN TEHSIL,44,7552,4321,11873
RAHIM YAR KHAN DISTRICT,RAHIM YAR KHAN TEHSIL,45,9505,4796,14301
RAHIM YAR KHAN DISTRICT,RAHIM YAR KHAN TEHSIL,46,6796,3719,10515
RAHIM YAR KHAN DISTRICT,RAHIM YAR KHAN TEHSIL,47,6820,3556,10376
RAHIM YAR KHAN DISTRICT,RAHIM YAR KHAN TEHSIL,48,7676,4244,11920
RAHIM YAR KHAN DISTRICT,RAHIM YAR KHAN TEHSIL,49,7047,3966,11013
RAHIM YAR KHAN DISTRICT,RAHIM YAR KHAN TEHSIL,50,8797,4577,13374
RAHIM YAR KHAN DISTRICT,RAHIM YAR KHAN TEHSIL,51,6195,3309,9504
RAHIM YAR KHAN DISTRICT,RAHIM YAR KHAN TEHSIL,52,5857,3147,9004
RAHIM YAR KHAN DISTRICT,RAHIM YAR KHAN TEHSIL,53,5914,3360,9274
RAHIM YAR KHAN DISTRICT,RAHIM YAR KHAN TEHSIL,54,5107,2986,8093
RAHIM YAR KHAN DISTRICT,RAHIM YAR KHAN TEHSIL,55,6540,3300,9840
RAHIM YAR KHAN DISTRICT,RAHIM YAR KHAN TEHSIL,56,4116,2501,6617
RAHIM YAR KHAN DISTRICT,RAHIM YAR KHAN TEHSIL,57,3887,2027,5914
RAHIM YAR KHAN DISTRICT,RAHIM YAR KHAN TEHSIL,58,3850,2269,6119
RAHIM YAR KHAN DISTRICT,RAHIM YAR KHAN TEHSIL,59,3817,2077,5894
RAHIM YAR KHAN DISTRICT,RAHIM YAR KHAN TEHSIL,60,5591,2429,8020
RAHIM YAR KHAN DISTRICT,RAHIM YAR KHAN TEHSIL,61,3903,2048,5951
RAHIM YAR KHAN DISTRICT,RAHIM YAR KHAN TEHSIL,62,3752,1925,5677
RAHIM YAR KHAN DISTRICT,RAHIM YAR KHAN TEHSIL,63,3713,1869,5582
RAHIM YAR KHAN DISTRICT,RAHIM YAR KHAN TEHSIL,64,3313,1635,4948
RAHIM YAR KHAN DISTRICT,RAHIM YAR KHAN TEHSIL,65,4198,1845,6043
RAHIM YAR KHAN DISTRICT,RAHIM YAR KHAN TEHSIL,66,2779,1216,3995
RAHIM YAR KHAN DISTRICT,RAHIM YAR KHAN TEHSIL,67,2776,1022,3798
RAHIM YAR KHAN DISTRICT,RAHIM YAR KHAN TEHSIL,68,2595,1137,3732
RAHIM YAR KHAN DISTRICT,RAHIM YAR KHAN TEHSIL,69,2173,964,3137
RAHIM YAR KHAN DISTRICT,RAHIM YAR KHAN TEHSIL,70,3209,1155,4364
RAHIM YAR KHAN DISTRICT,RAHIM YAR KHAN TEHSIL,71,2088,926,3014
RAHIM YAR KHAN DISTRICT,RAHIM YAR KHAN TEHSIL,72,2049,810,2859
RAHIM YAR KHAN DISTRICT,RAHIM YAR KHAN TEHSIL,73,1977,889,2866
RAHIM YAR KHAN DISTRICT,RAHIM YAR KHAN TEHSIL,74,1464,643,2107
RAHIM YAR KHAN DISTRICT,RAHIM YAR KHAN TEHSIL,>=75,12993,5180,18173
RAHIM YAR KHAN DISTRICT,SADIQABAD TEHSIL,<1,23877,6335,30212
RAHIM YAR KHAN DISTRICT,SADIQABAD TEHSIL,1,31011,7159,38170
RAHIM YAR KHAN DISTRICT,SADIQABAD TEHSIL,2,32895,6841,39736
RAHIM YAR KHAN DISTRICT,SADIQABAD TEHSIL,3,34626,7560,42186
RAHIM YAR KHAN DISTRICT,SADIQABAD TEHSIL,4,35758,7276,43034
RAHIM YAR KHAN DISTRICT,SADIQABAD TEHSIL,5,33676,7090,40766
RAHIM YAR KHAN DISTRICT,SADIQABAD TEHSIL,6,33722,6921,40643
RAHIM YAR KHAN DISTRICT,SADIQABAD TEHSIL,7,34412,7623,42035
RAHIM YAR KHAN DISTRICT,SADIQABAD TEHSIL,8,35170,6634,41804
RAHIM YAR KHAN DISTRICT,SADIQABAD TEHSIL,9,30333,7101,37434
RAHIM YAR KHAN DISTRICT,SADIQABAD TEHSIL,10,31175,6042,37217
RAHIM YAR KHAN DISTRICT,SADIQABAD TEHSIL,11,24316,6748,31064
RAHIM YAR KHAN DISTRICT,SADIQABAD TEHSIL,12,25978,5750,31728
RAHIM YAR KHAN DISTRICT,SADIQABAD TEHSIL,13,21622,6162,27784
RAHIM YAR KHAN DISTRICT,SADIQABAD TEHSIL,14,21605,5667,27272
RAHIM YAR KHAN DISTRICT,SADIQABAD TEHSIL,15,21364,5771,27135
RAHIM YAR KHAN DISTRICT,SADIQABAD TEHSIL,16,19886,5685,25571
RAHIM YAR KHAN DISTRICT,SADIQABAD TEHSIL,17,21492,6459,27951
RAHIM YAR KHAN DISTRICT,SADIQABAD TEHSIL,18,18071,4594,22665
RAHIM YAR KHAN DISTRICT,SADIQABAD TEHSIL,19,17661,5553,23214
RAHIM YAR KHAN DISTRICT,SADIQABAD TEHSIL,20,20071,4927,24998
RAHIM YAR KHAN DISTRICT,SADIQABAD TEHSIL,21,16075,5394,21469
RAHIM YAR KHAN DISTRICT,SADIQABAD TEHSIL,22,16573,4738,21311
RAHIM YAR KHAN DISTRICT,SADIQABAD TEHSIL,23,14039,4662,18701
RAHIM YAR KHAN DISTRICT,SADIQABAD TEHSIL,24,13841,4641,18482
RAHIM YAR KHAN DISTRICT,SADIQABAD TEHSIL,25,16213,4229,20442
RAHIM YAR KHAN DISTRICT,SADIQABAD TEHSIL,26,13450,4443,17893
RAHIM YAR KHAN DISTRICT,SADIQABAD TEHSIL,27,13630,4377,18007
RAHIM YAR KHAN DISTRICT,SADIQABAD TEHSIL,28,14089,4210,18299
RAHIM YAR KHAN DISTRICT,SADIQABAD TEHSIL,29,14174,4210,18384
RAHIM YAR KHAN DISTRICT,SADIQABAD TEHSIL,30,14530,3732,18262
RAHIM YAR KHAN DISTRICT,SADIQABAD TEHSIL,31,13645,4070,17715
RAHIM YAR KHAN DISTRICT,SADIQABAD TEHSIL,32,12774,3715,16489
RAHIM YAR KHAN DISTRICT,SADIQABAD TEHSIL,33,11381,3604,14985
RAHIM YAR KHAN DISTRICT,SADIQABAD TEHSIL,34,11228,3422,14650
RAHIM YAR KHAN DISTRICT,SADIQABAD TEHSIL,35,12058,2972,15030
RAHIM YAR KHAN DISTRICT,SADIQABAD TEHSIL,36,11627,3165,14792
RAHIM YAR KHAN DISTRICT,SADIQABAD TEHSIL,37,11730,3023,14753
RAHIM YAR KHAN DISTRICT,SADIQABAD TEHSIL,38,10629,3222,13851
RAHIM YAR KHAN DISTRICT,SADIQABAD TEHSIL,39,10595,3116,13711
RAHIM YAR KHAN DISTRICT,SADIQABAD TEHSIL,40,9590,2769,12359
RAHIM YAR KHAN DISTRICT,SADIQABAD TEHSIL,41,9532,2800,12332
RAHIM YAR KHAN DISTRICT,SADIQABAD TEHSIL,42,8821,2555,11376
RAHIM YAR KHAN DISTRICT,SADIQABAD TEHSIL,43,7585,2488,10073
RAHIM YAR KHAN DISTRICT,SADIQABAD TEHSIL,44,7461,2270,9731
RAHIM YAR KHAN DISTRICT,SADIQABAD TEHSIL,45,7364,2056,9420
RAHIM YAR KHAN DISTRICT,SADIQABAD TEHSIL,46,7211,2248,9459
RAHIM YAR KHAN DISTRICT,SADIQABAD TEHSIL,47,7557,2000,9557
RAHIM YAR KHAN DISTRICT,SADIQABAD TEHSIL,48,6890,2282,9172
RAHIM YAR KHAN DISTRICT,SADIQABAD TEHSIL,49,6750,2218,8968
RAHIM YAR KHAN DISTRICT,SADIQABAD TEHSIL,50,6540,1893,8433
RAHIM YAR KHAN DISTRICT,SADIQABAD TEHSIL,51,6406,2069,8475
RAHIM YAR KHAN DISTRICT,SADIQABAD TEHSIL,52,5764,1932,7696
RAHIM YAR KHAN DISTRICT,SADIQABAD TEHSIL,53,5034,1718,6752
RAHIM YAR KHAN DISTRICT,SADIQABAD TEHSIL,54,4489,1607,6096
RAHIM YAR KHAN DISTRICT,SADIQABAD TEHSIL,55,4476,1360,5836
RAHIM YAR KHAN DISTRICT,SADIQABAD TEHSIL,56,4167,1307,5474
RAHIM YAR KHAN DISTRICT,SADIQABAD TEHSIL,57,4127,1224,5351
RAHIM YAR KHAN DISTRICT,SADIQABAD TEHSIL,58,3650,1141,4791
RAHIM YAR KHAN DISTRICT,SADIQABAD TEHSIL,59,3693,1145,4838
RAHIM YAR KHAN DISTRICT,SADIQABAD TEHSIL,60,4131,1084,5215
RAHIM YAR KHAN DISTRICT,SADIQABAD TEHSIL,61,3885,1173,5058
RAHIM YAR KHAN DISTRICT,SADIQABAD TEHSIL,62,3845,1042,4887
RAHIM YAR KHAN DISTRICT,SADIQABAD TEHSIL,63,3367,1085,4452
RAHIM YAR KHAN DISTRICT,SADIQABAD TEHSIL,64,3117,885,4002
RAHIM YAR KHAN DISTRICT,SADIQABAD TEHSIL,65,3058,808,3866
RAHIM YAR KHAN DISTRICT,SADIQABAD TEHSIL,66,2928,697,3625
RAHIM YAR KHAN DISTRICT,SADIQABAD TEHSIL,67,2845,666,3511
RAHIM YAR KHAN DISTRICT,SADIQABAD TEHSIL,68,2292,641,2933
RAHIM YAR KHAN DISTRICT,SADIQABAD TEHSIL,69,2080,547,2627
RAHIM YAR KHAN DISTRICT,SADIQABAD TEHSIL,70,2228,546,2774
RAHIM YAR KHAN DISTRICT,SADIQABAD TEHSIL,71,2131,527,2658
RAHIM YAR KHAN DISTRICT,SADIQABAD TEHSIL,72,1926,478,2404
RAHIM YAR KHAN DISTRICT,SADIQABAD TEHSIL,73,1515,438,1953
RAHIM YAR KHAN DISTRICT,SADIQABAD TEHSIL,74,1286,331,1617
RAHIM YAR KHAN DISTRICT,SADIQABAD TEHSIL,>=75,11223,2749,13972
RAJANPUR DISTRICT,DE-EXCLUDED AREA RAJANPUR,<1,782,0,782
RAJANPUR DISTRICT,DE-EXCLUDED AREA RAJANPUR,1,1042,0,1042
RAJANPUR DISTRICT,DE-EXCLUDED AREA RAJANPUR,2,1206,0,1206
RAJANPUR DISTRICT,DE-EXCLUDED AREA RAJANPUR,3,1331,0,1331
RAJANPUR DISTRICT,DE-EXCLUDED AREA RAJANPUR,4,1379,0,1379
RAJANPUR DISTRICT,DE-EXCLUDED AREA RAJANPUR,5,1334,0,1334
RAJANPUR DISTRICT,DE-EXCLUDED AREA RAJANPUR,6,1485,0,1485
RAJANPUR DISTRICT,DE-EXCLUDED AREA RAJANPUR,7,1200,0,1200
RAJANPUR DISTRICT,DE-EXCLUDED AREA RAJANPUR,8,1545,0,1545
RAJANPUR DISTRICT,DE-EXCLUDED AREA RAJANPUR,9,1152,0,1152
RAJANPUR DISTRICT,DE-EXCLUDED AREA RAJANPUR,10,1356,0,1356
RAJANPUR DISTRICT,DE-EXCLUDED AREA RAJANPUR,11,828,0,828
RAJANPUR DISTRICT,DE-EXCLUDED AREA RAJANPUR,12,956,0,956
RAJANPUR DISTRICT,DE-EXCLUDED AREA RAJANPUR,13,673,0,673
RAJANPUR DISTRICT,DE-EXCLUDED AREA RAJANPUR,14,711,0,711
RAJANPUR DISTRICT,DE-EXCLUDED AREA RAJANPUR,15,571,0,571
RAJANPUR DISTRICT,DE-EXCLUDED AREA RAJANPUR,16,644,0,644
RAJANPUR DISTRICT,DE-EXCLUDED AREA RAJANPUR,17,377,0,377
RAJANPUR DISTRICT,DE-EXCLUDED AREA RAJANPUR,18,683,0,683
RAJANPUR DISTRICT,DE-EXCLUDED AREA RAJANPUR,19,451,0,451
RAJANPUR DISTRICT,DE-EXCLUDED AREA RAJANPUR,20,694,0,694
RAJANPUR DISTRICT,DE-EXCLUDED AREA RAJANPUR,21,406,0,406
RAJANPUR DISTRICT,DE-EXCLUDED AREA RAJANPUR,22,389,0,389
RAJANPUR DISTRICT,DE-EXCLUDED AREA RAJANPUR,23,336,0,336
RAJANPUR DISTRICT,DE-EXCLUDED AREA RAJANPUR,24,313,0,313
RAJANPUR DISTRICT,DE-EXCLUDED AREA RAJANPUR,25,549,0,549
RAJANPUR DISTRICT,DE-EXCLUDED AREA RAJANPUR,26,316,0,316
RAJANPUR DISTRICT,DE-EXCLUDED AREA RAJANPUR,27,322,0,322
RAJANPUR DISTRICT,DE-EXCLUDED AREA RAJANPUR,28,460,0,460
RAJANPUR DISTRICT,DE-EXCLUDED AREA RAJANPUR,29,357,0,357
RAJANPUR DISTRICT,DE-EXCLUDED AREA RAJANPUR,30,642,0,642
RAJANPUR DISTRICT,DE-EXCLUDED AREA RAJANPUR,31,377,0,377
RAJANPUR DISTRICT,DE-EXCLUDED AREA RAJANPUR,32,381,0,381
RAJANPUR DISTRICT,DE-EXCLUDED AREA RAJANPUR,33,368,0,368
RAJANPUR DISTRICT,DE-EXCLUDED AREA RAJANPUR,34,288,0,288
RAJANPUR DISTRICT,DE-EXCLUDED AREA RAJANPUR,35,529,0,529
RAJANPUR DISTRICT,DE-EXCLUDED AREA RAJANPUR,36,268,0,268
RAJANPUR DISTRICT,DE-EXCLUDED AREA RAJANPUR,37,439,0,439
RAJANPUR DISTRICT,DE-EXCLUDED AREA RAJANPUR,38,386,0,386
RAJANPUR DISTRICT,DE-EXCLUDED AREA RAJANPUR,39,366,0,366
RAJANPUR DISTRICT,DE-EXCLUDED AREA RAJANPUR,40,481,0,481
RAJANPUR DISTRICT,DE-EXCLUDED AREA RAJANPUR,41,300,0,300
RAJANPUR DISTRICT,DE-EXCLUDED AREA RAJANPUR,42,276,0,276
RAJANPUR DISTRICT,DE-EXCLUDED AREA RAJANPUR,43,261,0,261
RAJANPUR DISTRICT,DE-EXCLUDED AREA RAJANPUR,44,185,0,185
RAJANPUR DISTRICT,DE-EXCLUDED AREA RAJANPUR,45,341,0,341
RAJANPUR DISTRICT,DE-EXCLUDED AREA RAJANPUR,46,170,0,170
RAJANPUR DISTRICT,DE-EXCLUDED AREA RAJANPUR,47,227,0,227
RAJANPUR DISTRICT,DE-EXCLUDED AREA RAJANPUR,48,179,0,179
RAJANPUR DISTRICT,DE-EXCLUDED AREA RAJANPUR,49,160,0,160
RAJANPUR DISTRICT,DE-EXCLUDED AREA RAJANPUR,50,338,0,338
RAJANPUR DISTRICT,DE-EXCLUDED AREA RAJANPUR,51,146,0,146
RAJANPUR DISTRICT,DE-EXCLUDED AREA RAJANPUR,52,159,0,159
RAJANPUR DISTRICT,DE-EXCLUDED AREA RAJANPUR,53,183,0,183
RAJANPUR DISTRICT,DE-EXCLUDED AREA RAJANPUR,54,162,0,162
RAJANPUR DISTRICT,DE-EXCLUDED AREA RAJANPUR,55,180,0,180
RAJANPUR DISTRICT,DE-EXCLUDED AREA RAJANPUR,56,101,0,101
RAJANPUR DISTRICT,DE-EXCLUDED AREA RAJANPUR,57,168,0,168
RAJANPUR DISTRICT,DE-EXCLUDED AREA RAJANPUR,58,134,0,134
RAJANPUR DISTRICT,DE-EXCLUDED AREA RAJANPUR,59,101,0,101
RAJANPUR DISTRICT,DE-EXCLUDED AREA RAJANPUR,60,181,0,181
RAJANPUR DISTRICT,DE-EXCLUDED AREA RAJANPUR,61,115,0,115
RAJANPUR DISTRICT,DE-EXCLUDED AREA RAJANPUR,62,114,0,114
RAJANPUR DISTRICT,DE-EXCLUDED AREA RAJANPUR,63,108,0,108
RAJANPUR DISTRICT,DE-EXCLUDED AREA RAJANPUR,64,100,0,100
RAJANPUR DISTRICT,DE-EXCLUDED AREA RAJANPUR,65,122,0,122
RAJANPUR DISTRICT,DE-EXCLUDED AREA RAJANPUR,66,62,0,62
RAJANPUR DISTRICT,DE-EXCLUDED AREA RAJANPUR,67,137,0,137
RAJANPUR DISTRICT,DE-EXCLUDED AREA RAJANPUR,68,80,0,80
RAJANPUR DISTRICT,DE-EXCLUDED AREA RAJANPUR,69,78,0,78
RAJANPUR DISTRICT,DE-EXCLUDED AREA RAJANPUR,70,111,0,111
RAJANPUR DISTRICT,DE-EXCLUDED AREA RAJANPUR,71,70,0,70
RAJANPUR DISTRICT,DE-EXCLUDED AREA RAJANPUR,72,88,0,88
RAJANPUR DISTRICT,DE-EXCLUDED AREA RAJANPUR,73,61,0,61
RAJANPUR DISTRICT,DE-EXCLUDED AREA RAJANPUR,74,71,0,71
RAJANPUR DISTRICT,DE-EXCLUDED AREA RAJANPUR,>=75,549,0,549
RAJANPUR DISTRICT,JAMPUR TEHSIL,<1,17983,2654,20637
RAJANPUR DISTRICT,JAMPUR TEHSIL,1,21462,2655,24117
RAJANPUR DISTRICT,JAMPUR TEHSIL,2,25428,2929,28357
RAJANPUR DISTRICT,JAMPUR TEHSIL,3,27232,3260,30492
RAJANPUR DISTRICT,JAMPUR TEHSIL,4,29091,3082,32173
RAJANPUR DISTRICT,JAMPUR TEHSIL,5,26974,3157,30131
RAJANPUR DISTRICT,JAMPUR TEHSIL,6,27532,2922,30454
RAJANPUR DISTRICT,JAMPUR TEHSIL,7,27589,3301,30890
RAJANPUR DISTRICT,JAMPUR TEHSIL,8,29710,2930,32640
RAJANPUR DISTRICT,JAMPUR TEHSIL,9,24252,3130,27382
RAJANPUR DISTRICT,JAMPUR TEHSIL,10,25943,2750,28693
RAJANPUR DISTRICT,JAMPUR TEHSIL,11,18052,3012,21064
RAJANPUR DISTRICT,JAMPUR TEHSIL,12,20947,2737,23684
RAJANPUR DISTRICT,JAMPUR TEHSIL,13,15934,2800,18734
RAJANPUR DISTRICT,JAMPUR TEHSIL,14,17320,2661,19981
RAJANPUR DISTRICT,JAMPUR TEHSIL,15,14618,2578,17196
RAJANPUR DISTRICT,JAMPUR TEHSIL,16,15261,2519,17780
RAJANPUR DISTRICT,JAMPUR TEHSIL,17,12165,2553,14718
RAJANPUR DISTRICT,JAMPUR TEHSIL,18,16191,2388,18579
RAJANPUR DISTRICT,JAMPUR TEHSIL,19,13125,2522,15647
RAJANPUR DISTRICT,JAMPUR TEHSIL,20,14502,2241,16743
RAJANPUR DISTRICT,JAMPUR TEHSIL,21,11055,2364,13419
RAJANPUR DISTRICT,JAMPUR TEHSIL,22,10985,2049,13034
RAJANPUR DISTRICT,JAMPUR TEHSIL,23,9774,2032,11806
RAJANPUR DISTRICT,JAMPUR TEHSIL,24,9198,1912,11110
RAJANPUR DISTRICT,JAMPUR TEHSIL,25,10969,1731,12700
RAJANPUR DISTRICT,JAMPUR TEHSIL,26,9527,1879,11406
RAJANPUR DISTRICT,JAMPUR TEHSIL,27,9473,1748,11221
RAJANPUR DISTRICT,JAMPUR TEHSIL,28,9873,1721,11594
RAJANPUR DISTRICT,JAMPUR TEHSIL,29,10419,1723,12142
RAJANPUR DISTRICT,JAMPUR TEHSIL,30,9554,1492,11046
RAJANPUR DISTRICT,JAMPUR TEHSIL,31,9358,1619,10977
RAJANPUR DISTRICT,JAMPUR TEHSIL,32,8852,1455,10307
RAJANPUR DISTRICT,JAMPUR TEHSIL,33,7709,1316,9025
RAJANPUR DISTRICT,JAMPUR TEHSIL,34,7349,1322,8671
RAJANPUR DISTRICT,JAMPUR TEHSIL,35,7875,1184,9059
RAJANPUR DISTRICT,JAMPUR TEHSIL,36,7617,1438,9055
RAJANPUR DISTRICT,JAMPUR TEHSIL,37,9479,1224,10703
RAJANPUR DISTRICT,JAMPUR TEHSIL,38,6760,1224,7984
RAJANPUR DISTRICT,JAMPUR TEHSIL,39,7199,1177,8376
RAJANPUR DISTRICT,JAMPUR TEHSIL,40,6061,928,6989
RAJANPUR DISTRICT,JAMPUR TEHSIL,41,6497,1153,7650
RAJANPUR DISTRICT,JAMPUR TEHSIL,42,6474,1045,7519
RAJANPUR DISTRICT,JAMPUR TEHSIL,43,4804,891,5695
RAJANPUR DISTRICT,JAMPUR TEHSIL,44,4643,860,5503
RAJANPUR DISTRICT,JAMPUR TEHSIL,45,4553,806,5359
RAJANPUR DISTRICT,JAMPUR TEHSIL,46,4827,929,5756
RAJANPUR DISTRICT,JAMPUR TEHSIL,47,5818,895,6713
RAJANPUR DISTRICT,JAMPUR TEHSIL,48,4288,874,5162
RAJANPUR DISTRICT,JAMPUR TEHSIL,49,4654,819,5473
RAJANPUR DISTRICT,JAMPUR TEHSIL,50,4258,741,4999
RAJANPUR DISTRICT,JAMPUR TEHSIL,51,4395,790,5185
RAJANPUR DISTRICT,JAMPUR TEHSIL,52,4160,700,4860
RAJANPUR DISTRICT,JAMPUR TEHSIL,53,3323,678,4001
RAJANPUR DISTRICT,JAMPUR TEHSIL,54,2964,626,3590
RAJANPUR DISTRICT,JAMPUR TEHSIL,55,2773,484,3257
RAJANPUR DISTRICT,JAMPUR TEHSIL,56,2668,542,3210
RAJANPUR DISTRICT,JAMPUR TEHSIL,57,3363,466,3829
RAJANPUR DISTRICT,JAMPUR TEHSIL,58,2129,431,2560
RAJANPUR DISTRICT,JAMPUR TEHSIL,59,2286,422,2708
RAJANPUR DISTRICT,JAMPUR TEHSIL,60,2631,422,3053
RAJANPUR DISTRICT,JAMPUR TEHSIL,61,2659,447,3106
RAJANPUR DISTRICT,JAMPUR TEHSIL,62,2755,470,3225
RAJANPUR DISTRICT,JAMPUR TEHSIL,63,2262,400,2662
RAJANPUR DISTRICT,JAMPUR TEHSIL,64,2084,348,2432
RAJANPUR DISTRICT,JAMPUR TEHSIL,65,2083,303,2386
RAJANPUR DISTRICT,JAMPUR TEHSIL,66,2404,301,2705
RAJANPUR DISTRICT,JAMPUR TEHSIL,67,2713,342,3055
RAJANPUR DISTRICT,JAMPUR TEHSIL,68,1644,260,1904
RAJANPUR DISTRICT,JAMPUR TEHSIL,69,1750,236,1986
RAJANPUR DISTRICT,JAMPUR TEHSIL,70,1663,230,1893
RAJANPUR DISTRICT,JAMPUR TEHSIL,71,1803,210,2013
RAJANPUR DISTRICT,JAMPUR TEHSIL,72,1612,202,1814
RAJANPUR DISTRICT,JAMPUR TEHSIL,73,1097,163,1260
RAJANPUR DISTRICT,JAMPUR TEHSIL,74,1028,139,1167
RAJANPUR DISTRICT,JAMPUR TEHSIL,>=75,9837,1146,10983
RAJANPUR DISTRICT,RAJANPUR TEHSIL,<1,13177,4968,18145
RAJANPUR DISTRICT,RAJANPUR TEHSIL,1,14891,5895,20786
RAJANPUR DISTRICT,RAJANPUR TEHSIL,2,17759,6448,24207
RAJANPUR DISTRICT,RAJANPUR TEHSIL,3,19096,7071,26167
RAJANPUR DISTRICT,RAJANPUR TEHSIL,4,19402,6528,25930
RAJANPUR DISTRICT,RAJANPUR TEHSIL,5,18341,6854,25195
RAJANPUR DISTRICT,RAJANPUR TEHSIL,6,18104,6205,24309
RAJANPUR DISTRICT,RAJANPUR TEHSIL,7,18621,7100,25721
RAJANPUR DISTRICT,RAJANPUR TEHSIL,8,19259,6547,25806
RAJANPUR DISTRICT,RAJANPUR TEHSIL,9,15867,6541,22408
RAJANPUR DISTRICT,RAJANPUR TEHSIL,10,16458,5863,22321
RAJANPUR DISTRICT,RAJANPUR TEHSIL,11,11807,5565,17372
RAJANPUR DISTRICT,RAJANPUR TEHSIL,12,13583,5589,19172
RAJANPUR DISTRICT,RAJANPUR TEHSIL,13,10582,5208,15790
RAJANPUR DISTRICT,RAJANPUR TEHSIL,14,11008,4992,16000
RAJANPUR DISTRICT,RAJANPUR TEHSIL,15,9885,4699,14584
RAJANPUR DISTRICT,RAJANPUR TEHSIL,16,9720,4560,14280
RAJANPUR DISTRICT,RAJANPUR TEHSIL,17,7941,4281,12222
RAJANPUR DISTRICT,RAJANPUR TEHSIL,18,11021,4502,15523
RAJANPUR DISTRICT,RAJANPUR TEHSIL,19,8380,4413,12793
RAJANPUR DISTRICT,RAJANPUR TEHSIL,20,9332,3972,13304
RAJANPUR DISTRICT,RAJANPUR TEHSIL,21,6613,3774,10387
RAJANPUR DISTRICT,RAJANPUR TEHSIL,22,6647,3417,10064
RAJANPUR DISTRICT,RAJANPUR TEHSIL,23,5742,3514,9256
RAJANPUR DISTRICT,RAJANPUR TEHSIL,24,5529,3056,8585
RAJANPUR DISTRICT,RAJANPUR TEHSIL,25,7244,3264,10508
RAJANPUR DISTRICT,RAJANPUR TEHSIL,26,5435,2924,8359
RAJANPUR DISTRICT,RAJANPUR TEHSIL,27,6815,3514,10329
RAJANPUR DISTRICT,RAJANPUR TEHSIL,28,5939,2876,8815
RAJANPUR DISTRICT,RAJANPUR TEHSIL,29,6779,3393,10172
RAJANPUR DISTRICT,RAJANPUR TEHSIL,30,6238,2586,8824
RAJANPUR DISTRICT,RAJANPUR TEHSIL,31,6230,3028,9258
RAJANPUR DISTRICT,RAJANPUR TEHSIL,32,6605,2888,9493
RAJANPUR DISTRICT,RAJANPUR TEHSIL,33,4964,2555,7519
RAJANPUR DISTRICT,RAJANPUR TEHSIL,34,4844,2359,7203
RAJANPUR DISTRICT,RAJANPUR TEHSIL,35,5742,2527,8269
RAJANPUR DISTRICT,RAJANPUR TEHSIL,36,5396,2326,7722
RAJANPUR DISTRICT,RAJANPUR TEHSIL,37,8197,3402,11599
RAJANPUR DISTRICT,RAJANPUR TEHSIL,38,4400,2077,6477
RAJANPUR DISTRICT,RAJANPUR TEHSIL,39,5798,2684,8482
RAJANPUR DISTRICT,RAJANPUR TEHSIL,40,4095,1729,5824
RAJANPUR DISTRICT,RAJANPUR TEHSIL,41,4352,2009,6361
RAJANPUR DISTRICT,RAJANPUR TEHSIL,42,4962,2237,7199
RAJANPUR DISTRICT,RAJANPUR TEHSIL,43,3019,1654,4673
RAJANPUR DISTRICT,RAJANPUR TEHSIL,44,2896,1458,4354
RAJANPUR DISTRICT,RAJANPUR TEHSIL,45,2930,1387,4317
RAJANPUR DISTRICT,RAJANPUR TEHSIL,46,3110,1389,4499
RAJANPUR DISTRICT,RAJANPUR TEHSIL,47,4469,1898,6367
RAJANPUR DISTRICT,RAJANPUR TEHSIL,48,2713,1386,4099
RAJANPUR DISTRICT,RAJANPUR TEHSIL,49,3394,1653,5047
RAJANPUR DISTRICT,RAJANPUR TEHSIL,50,2585,1176,3761
RAJANPUR DISTRICT,RAJANPUR TEHSIL,51,2997,1537,4534
RAJANPUR DISTRICT,RAJANPUR TEHSIL,52,3094,1478,4572
RAJANPUR DISTRICT,RAJANPUR TEHSIL,53,2226,1261,3487
RAJANPUR DISTRICT,RAJANPUR TEHSIL,54,2037,1063,3100
RAJANPUR DISTRICT,RAJANPUR TEHSIL,55,1804,888,2692
RAJANPUR DISTRICT,RAJANPUR TEHSIL,56,1902,898,2800
RAJANPUR DISTRICT,RAJANPUR TEHSIL,57,2587,1070,3657
RAJANPUR DISTRICT,RAJANPUR TEHSIL,58,1311,694,2005
RAJANPUR DISTRICT,RAJANPUR TEHSIL,59,1616,831,2447
RAJANPUR DISTRICT,RAJANPUR TEHSIL,60,1549,635,2184
RAJANPUR DISTRICT,RAJANPUR TEHSIL,61,1682,809,2491
RAJANPUR DISTRICT,RAJANPUR TEHSIL,62,1887,825,2712
RAJANPUR DISTRICT,RAJANPUR TEHSIL,63,1393,705,2098
RAJANPUR DISTRICT,RAJANPUR TEHSIL,64,1389,623,2012
RAJANPUR DISTRICT,RAJANPUR TEHSIL,65,1277,563,1840
RAJANPUR DISTRICT,RAJANPUR TEHSIL,66,1675,626,2301
RAJANPUR DISTRICT,RAJANPUR TEHSIL,67,1922,714,2636
RAJANPUR DISTRICT,RAJANPUR TEHSIL,68,1092,545,1637
RAJANPUR DISTRICT,RAJANPUR TEHSIL,69,1139,492,1631
RAJANPUR DISTRICT,RAJANPUR TEHSIL,70,1020,380,1400
RAJANPUR DISTRICT,RAJANPUR TEHSIL,71,1267,496,1763
RAJANPUR DISTRICT,RAJANPUR TEHSIL,72,1165,409,1574
RAJANPUR DISTRICT,RAJANPUR TEHSIL,73,834,367,1201
RAJANPUR DISTRICT,RAJANPUR TEHSIL,74,671,236,907
RAJANPUR DISTRICT,RAJANPUR TEHSIL,>=75,6657,2575,9232
RAJANPUR DISTRICT,ROJHAN TEHSIL,<1,11456,302,11758
RAJANPUR DISTRICT,ROJHAN TEHSIL,1,12559,347,12906
RAJANPUR DISTRICT,ROJHAN TEHSIL,2,16075,387,16462
RAJANPUR DISTRICT,ROJHAN TEHSIL,3,16609,446,17055
RAJANPUR DISTRICT,ROJHAN TEHSIL,4,17065,444,17509
RAJANPUR DISTRICT,ROJHAN TEHSIL,5,15955,478,16433
RAJANPUR DISTRICT,ROJHAN TEHSIL,6,16112,449,16561
RAJANPUR DISTRICT,ROJHAN TEHSIL,7,16251,472,16723
RAJANPUR DISTRICT,ROJHAN TEHSIL,8,16791,482,17273
RAJANPUR DISTRICT,ROJHAN TEHSIL,9,13887,407,14294
RAJANPUR DISTRICT,ROJHAN TEHSIL,10,14714,452,15166
RAJANPUR DISTRICT,ROJHAN TEHSIL,11,9650,383,10033
RAJANPUR DISTRICT,ROJHAN TEHSIL,12,10803,388,11191
RAJANPUR DISTRICT,ROJHAN TEHSIL,13,7877,363,8240
RAJANPUR DISTRICT,ROJHAN TEHSIL,14,7848,366,8214
RAJANPUR DISTRICT,ROJHAN TEHSIL,15,6711,366,7077
RAJANPUR DISTRICT,ROJHAN TEHSIL,16,6469,360,6829
RAJANPUR DISTRICT,ROJHAN TEHSIL,17,4956,316,5272
RAJANPUR DISTRICT,ROJHAN TEHSIL,18,7869,322,8191
RAJANPUR DISTRICT,ROJHAN TEHSIL,19,5833,279,6112
RAJANPUR DISTRICT,ROJHAN TEHSIL,20,7180,254,7434
RAJANPUR DISTRICT,ROJHAN TEHSIL,21,4752,254,5006
RAJANPUR DISTRICT,ROJHAN TEHSIL,22,4928,223,5151
RAJANPUR DISTRICT,ROJHAN TEHSIL,23,4170,238,4408
RAJANPUR DISTRICT,ROJHAN TEHSIL,24,3983,200,4183
RAJANPUR DISTRICT,ROJHAN TEHSIL,25,5544,211,5755
RAJANPUR DISTRICT,ROJHAN TEHSIL,26,3970,182,4152
RAJANPUR DISTRICT,ROJHAN TEHSIL,27,5418,246,5664
RAJANPUR DISTRICT,ROJHAN TEHSIL,28,4568,198,4766
RAJANPUR DISTRICT,ROJHAN TEHSIL,29,5535,257,5792
RAJANPUR DISTRICT,ROJHAN TEHSIL,30,5050,194,5244
RAJANPUR DISTRICT,ROJHAN TEHSIL,31,4644,255,4899
RAJANPUR DISTRICT,ROJHAN TEHSIL,32,5118,216,5334
RAJANPUR DISTRICT,ROJHAN TEHSIL,33,3908,156,4064
RAJANPUR DISTRICT,ROJHAN TEHSIL,34,3324,149,3473
RAJANPUR DISTRICT,ROJHAN TEHSIL,35,4433,168,4601
RAJANPUR DISTRICT,ROJHAN TEHSIL,36,3526,167,3693
RAJANPUR DISTRICT,ROJHAN TEHSIL,37,6222,211,6433
RAJANPUR DISTRICT,ROJHAN TEHSIL,38,3248,135,3383
RAJANPUR DISTRICT,ROJHAN TEHSIL,39,4200,164,4364
RAJANPUR DISTRICT,ROJHAN TEHSIL,40,3338,105,3443
RAJANPUR DISTRICT,ROJHAN TEHSIL,41,3052,130,3182
RAJANPUR DISTRICT,ROJHAN TEHSIL,42,3834,131,3965
RAJANPUR DISTRICT,ROJHAN TEHSIL,43,2215,130,2345
RAJANPUR DISTRICT,ROJHAN TEHSIL,44,2127,106,2233
RAJANPUR DISTRICT,ROJHAN TEHSIL,45,2338,82,2420
RAJANPUR DISTRICT,ROJHAN TEHSIL,46,1954,103,2057
RAJANPUR DISTRICT,ROJHAN TEHSIL,47,3603,138,3741
RAJANPUR DISTRICT,ROJHAN TEHSIL,48,1814,115,1929
RAJANPUR DISTRICT,ROJHAN TEHSIL,49,2284,97,2381
RAJANPUR DISTRICT,ROJHAN TEHSIL,50,2018,87,2105
RAJANPUR DISTRICT,ROJHAN TEHSIL,51,1924,115,2039
RAJANPUR DISTRICT,ROJHAN TEHSIL,52,2383,111,2494
RAJANPUR DISTRICT,ROJHAN TEHSIL,53,1420,82,1502
RAJANPUR DISTRICT,ROJHAN TEHSIL,54,1354,62,1416
RAJANPUR DISTRICT,ROJHAN TEHSIL,55,1313,69,1382
RAJANPUR DISTRICT,ROJHAN TEHSIL,56,1280,67,1347
RAJANPUR DISTRICT,ROJHAN TEHSIL,57,2272,70,2342
RAJANPUR DISTRICT,ROJHAN TEHSIL,58,864,43,907
RAJANPUR DISTRICT,ROJHAN TEHSIL,59,1161,56,1217
RAJANPUR DISTRICT,ROJHAN TEHSIL,60,1233,36,1269
RAJANPUR DISTRICT,ROJHAN TEHSIL,61,1149,63,1212
RAJANPUR DISTRICT,ROJHAN TEHSIL,62,1522,60,1582
RAJANPUR DISTRICT,ROJHAN TEHSIL,63,969,59,1028
RAJANPUR DISTRICT,ROJHAN TEHSIL,64,964,38,1002
RAJANPUR DISTRICT,ROJHAN TEHSIL,65,925,43,968
RAJANPUR DISTRICT,ROJHAN TEHSIL,66,1054,50,1104
RAJANPUR DISTRICT,ROJHAN TEHSIL,67,1613,48,1661
RAJANPUR DISTRICT,ROJHAN TEHSIL,68,695,44,739
RAJANPUR DISTRICT,ROJHAN TEHSIL,69,836,34,870
RAJANPUR DISTRICT,ROJHAN TEHSIL,70,737,15,752
RAJANPUR DISTRICT,ROJHAN TEHSIL,71,868,38,906
RAJANPUR DISTRICT,ROJHAN TEHSIL,72,807,35,842
RAJANPUR DISTRICT,ROJHAN TEHSIL,73,555,19,574
RAJANPUR DISTRICT,ROJHAN TEHSIL,74,510,15,525
RAJANPUR DISTRICT,ROJHAN TEHSIL,>=75,4948,162,5110
RAWALPINDI DISTRICT,GUJJAR KHAN TEHSIL,<1,12074,2290,14364
RAWALPINDI DISTRICT,GUJJAR KHAN TEHSIL,1,13366,2553,15919
RAWALPINDI DISTRICT,GUJJAR KHAN TEHSIL,2,12569,2590,15159
RAWALPINDI DISTRICT,GUJJAR KHAN TEHSIL,3,13444,2745,16189
RAWALPINDI DISTRICT,GUJJAR KHAN TEHSIL,4,12441,2519,14960
RAWALPINDI DISTRICT,GUJJAR KHAN TEHSIL,5,12362,2698,15060
RAWALPINDI DISTRICT,GUJJAR KHAN TEHSIL,6,12500,2585,15085
RAWALPINDI DISTRICT,GUJJAR KHAN TEHSIL,7,13136,2655,15791
RAWALPINDI DISTRICT,GUJJAR KHAN TEHSIL,8,11480,2382,13862
RAWALPINDI DISTRICT,GUJJAR KHAN TEHSIL,9,13778,2816,16594
RAWALPINDI DISTRICT,GUJJAR KHAN TEHSIL,10,10621,2232,12853
RAWALPINDI DISTRICT,GUJJAR KHAN TEHSIL,11,13745,2858,16603
RAWALPINDI DISTRICT,GUJJAR KHAN TEHSIL,12,10446,2189,12635
RAWALPINDI DISTRICT,GUJJAR KHAN TEHSIL,13,12487,2532,15019
RAWALPINDI DISTRICT,GUJJAR KHAN TEHSIL,14,10938,2240,13178
RAWALPINDI DISTRICT,GUJJAR KHAN TEHSIL,15,11582,2367,13949
RAWALPINDI DISTRICT,GUJJAR KHAN TEHSIL,16,11800,2354,14154
RAWALPINDI DISTRICT,GUJJAR KHAN TEHSIL,17,12413,2555,14968
RAWALPINDI DISTRICT,GUJJAR KHAN TEHSIL,18,9291,1965,11256
RAWALPINDI DISTRICT,GUJJAR KHAN TEHSIL,19,12090,2480,14570
RAWALPINDI DISTRICT,GUJJAR KHAN TEHSIL,20,8885,1876,10761
RAWALPINDI DISTRICT,GUJJAR KHAN TEHSIL,21,12064,2461,14525
RAWALPINDI DISTRICT,GUJJAR KHAN TEHSIL,22,9085,2016,11101
RAWALPINDI DISTRICT,GUJJAR KHAN TEHSIL,23,10795,2143,12938
RAWALPINDI DISTRICT,GUJJAR KHAN TEHSIL,24,9929,2013,11942
RAWALPINDI DISTRICT,GUJJAR KHAN TEHSIL,25,7408,1650,9058
RAWALPINDI DISTRICT,GUJJAR KHAN TEHSIL,26,9561,1969,11530
RAWALPINDI DISTRICT,GUJJAR KHAN TEHSIL,27,9482,2121,11603
RAWALPINDI DISTRICT,GUJJAR KHAN TEHSIL,28,8068,1670,9738
RAWALPINDI DISTRICT,GUJJAR KHAN TEHSIL,29,9468,2014,11482
RAWALPINDI DISTRICT,GUJJAR KHAN TEHSIL,30,6820,1569,8389
RAWALPINDI DISTRICT,GUJJAR KHAN TEHSIL,31,9404,1909,11313
RAWALPINDI DISTRICT,GUJJAR KHAN TEHSIL,32,7938,1773,9711
RAWALPINDI DISTRICT,GUJJAR KHAN TEHSIL,33,8511,1769,10280
RAWALPINDI DISTRICT,GUJJAR KHAN TEHSIL,34,7775,1669,9444
RAWALPINDI DISTRICT,GUJJAR KHAN TEHSIL,35,5533,1297,6830
RAWALPINDI DISTRICT,GUJJAR KHAN TEHSIL,36,7110,1475,8585
RAWALPINDI DISTRICT,GUJJAR KHAN TEHSIL,37,6537,1423,7960
RAWALPINDI DISTRICT,GUJJAR KHAN TEHSIL,38,6948,1561,8509
RAWALPINDI DISTRICT,GUJJAR KHAN TEHSIL,39,6944,1501,8445
RAWALPINDI DISTRICT,GUJJAR KHAN TEHSIL,40,5252,1189,6441
RAWALPINDI DISTRICT,GUJJAR KHAN TEHSIL,41,6444,1226,7670
RAWALPINDI DISTRICT,GUJJAR KHAN TEHSIL,42,5659,1172,6831
RAWALPINDI DISTRICT,GUJJAR KHAN TEHSIL,43,6109,1213,7322
RAWALPINDI DISTRICT,GUJJAR KHAN TEHSIL,44,5594,1115,6709
RAWALPINDI DISTRICT,GUJJAR KHAN TEHSIL,45,4014,922,4936
RAWALPINDI DISTRICT,GUJJAR KHAN TEHSIL,46,5496,940,6436
RAWALPINDI DISTRICT,GUJJAR KHAN TEHSIL,47,4867,948,5815
RAWALPINDI DISTRICT,GUJJAR KHAN TEHSIL,48,5539,1065,6604
RAWALPINDI DISTRICT,GUJJAR KHAN TEHSIL,49,5523,974,6497
RAWALPINDI DISTRICT,GUJJAR KHAN TEHSIL,50,4188,826,5014
RAWALPINDI DISTRICT,GUJJAR KHAN TEHSIL,51,5383,982,6365
RAWALPINDI DISTRICT,GUJJAR KHAN TEHSIL,52,4868,962,5830
RAWALPINDI DISTRICT,GUJJAR KHAN TEHSIL,53,5272,903,6175
RAWALPINDI DISTRICT,GUJJAR KHAN TEHSIL,54,4972,851,5823
RAWALPINDI DISTRICT,GUJJAR KHAN TEHSIL,55,3577,681,4258
RAWALPINDI DISTRICT,GUJJAR KHAN TEHSIL,56,4157,705,4862
RAWALPINDI DISTRICT,GUJJAR KHAN TEHSIL,57,3480,642,4122
RAWALPINDI DISTRICT,GUJJAR KHAN TEHSIL,58,3925,651,4576
RAWALPINDI DISTRICT,GUJJAR KHAN TEHSIL,59,3875,644,4519
RAWALPINDI DISTRICT,GUJJAR KHAN TEHSIL,60,2903,512,3415
RAWALPINDI DISTRICT,GUJJAR KHAN TEHSIL,61,4029,673,4702
RAWALPINDI DISTRICT,GUJJAR KHAN TEHSIL,62,3807,634,4441
RAWALPINDI DISTRICT,GUJJAR KHAN TEHSIL,63,3941,622,4563
RAWALPINDI DISTRICT,GUJJAR KHAN TEHSIL,64,3658,513,4171
RAWALPINDI DISTRICT,GUJJAR KHAN TEHSIL,65,2617,449,3066
RAWALPINDI DISTRICT,GUJJAR KHAN TEHSIL,66,2869,368,3237
RAWALPINDI DISTRICT,GUJJAR KHAN TEHSIL,67,2984,435,3419
RAWALPINDI DISTRICT,GUJJAR KHAN TEHSIL,68,3035,398,3433
RAWALPINDI DISTRICT,GUJJAR KHAN TEHSIL,69,2669,372,3041
RAWALPINDI DISTRICT,GUJJAR KHAN TEHSIL,70,1862,282,2144
RAWALPINDI DISTRICT,GUJJAR KHAN TEHSIL,71,2311,307,2618
RAWALPINDI DISTRICT,GUJJAR KHAN TEHSIL,72,2333,292,2625
RAWALPINDI DISTRICT,GUJJAR KHAN TEHSIL,73,2228,290,2518
RAWALPINDI DISTRICT,GUJJAR KHAN TEHSIL,74,1750,206,1956
RAWALPINDI DISTRICT,GUJJAR KHAN TEHSIL,>=75,14000,1596,15596
RAWALPINDI DISTRICT,KAHUTA TEHSIL,<1,3266,1319,4585
RAWALPINDI DISTRICT,KAHUTA TEHSIL,1,3317,1267,4584
RAWALPINDI DISTRICT,KAHUTA TEHSIL,2,3554,1383,4937
RAWALPINDI DISTRICT,KAHUTA TEHSIL,3,3615,1422,5037
RAWALPINDI DISTRICT,KAHUTA TEHSIL,4,3365,1370,4735
RAWALPINDI DISTRICT,KAHUTA TEHSIL,5,3365,1374,4739
RAWALPINDI DISTRICT,KAHUTA TEHSIL,6,3341,1362,4703
RAWALPINDI DISTRICT,KAHUTA TEHSIL,7,3558,1454,5012
RAWALPINDI DISTRICT,KAHUTA TEHSIL,8,3051,1285,4336
RAWALPINDI DISTRICT,KAHUTA TEHSIL,9,3661,1520,5181
RAWALPINDI DISTRICT,KAHUTA TEHSIL,10,2930,1276,4206
RAWALPINDI DISTRICT,KAHUTA TEHSIL,11,3707,1602,5309
RAWALPINDI DISTRICT,KAHUTA TEHSIL,12,2899,1220,4119
RAWALPINDI DISTRICT,KAHUTA TEHSIL,13,3492,1462,4954
RAWALPINDI DISTRICT,KAHUTA TEHSIL,14,2960,1230,4190
RAWALPINDI DISTRICT,KAHUTA TEHSIL,15,3317,1292,4609
RAWALPINDI DISTRICT,KAHUTA TEHSIL,16,3268,1217,4485
RAWALPINDI DISTRICT,KAHUTA TEHSIL,17,3300,1367,4667
RAWALPINDI DISTRICT,KAHUTA TEHSIL,18,2570,974,3544
RAWALPINDI DISTRICT,KAHUTA TEHSIL,19,3431,1285,4716
RAWALPINDI DISTRICT,KAHUTA TEHSIL,20,2480,931,3411
RAWALPINDI DISTRICT,KAHUTA TEHSIL,21,3385,1262,4647
RAWALPINDI DISTRICT,KAHUTA TEHSIL,22,2748,1018,3766
RAWALPINDI DISTRICT,KAHUTA TEHSIL,23,3022,1149,4171
RAWALPINDI DISTRICT,KAHUTA TEHSIL,24,2886,1155,4041
RAWALPINDI DISTRICT,KAHUTA TEHSIL,25,2245,816,3061
RAWALPINDI DISTRICT,KAHUTA TEHSIL,26,2805,1040,3845
RAWALPINDI DISTRICT,KAHUTA TEHSIL,27,2656,1090,3746
RAWALPINDI DISTRICT,KAHUTA TEHSIL,28,2567,936,3503
RAWALPINDI DISTRICT,KAHUTA TEHSIL,29,2857,973,3830
RAWALPINDI DISTRICT,KAHUTA TEHSIL,30,2186,804,2990
RAWALPINDI DISTRICT,KAHUTA TEHSIL,31,2596,973,3569
RAWALPINDI DISTRICT,KAHUTA TEHSIL,32,2411,926,3337
RAWALPINDI DISTRICT,KAHUTA TEHSIL,33,2397,949,3346
RAWALPINDI DISTRICT,KAHUTA TEHSIL,34,2330,964,3294
RAWALPINDI DISTRICT,KAHUTA TEHSIL,35,1713,716,2429
RAWALPINDI DISTRICT,KAHUTA TEHSIL,36,2136,827,2963
RAWALPINDI DISTRICT,KAHUTA TEHSIL,37,1944,750,2694
RAWALPINDI DISTRICT,KAHUTA TEHSIL,38,2183,869,3052
RAWALPINDI DISTRICT,KAHUTA TEHSIL,39,1941,791,2732
RAWALPINDI DISTRICT,KAHUTA TEHSIL,40,1609,678,2287
RAWALPINDI DISTRICT,KAHUTA TEHSIL,41,1765,759,2524
RAWALPINDI DISTRICT,KAHUTA TEHSIL,42,1645,722,2367
RAWALPINDI DISTRICT,KAHUTA TEHSIL,43,1709,692,2401
RAWALPINDI DISTRICT,KAHUTA TEHSIL,44,1614,640,2254
RAWALPINDI DISTRICT,KAHUTA TEHSIL,45,1289,572,1861
RAWALPINDI DISTRICT,KAHUTA TEHSIL,46,1548,607,2155
RAWALPINDI DISTRICT,KAHUTA TEHSIL,47,1403,488,1891
RAWALPINDI DISTRICT,KAHUTA TEHSIL,48,1659,669,2328
RAWALPINDI DISTRICT,KAHUTA TEHSIL,49,1578,552,2130
RAWALPINDI DISTRICT,KAHUTA TEHSIL,50,1344,495,1839
RAWALPINDI DISTRICT,KAHUTA TEHSIL,51,1459,533,1992
RAWALPINDI DISTRICT,KAHUTA TEHSIL,52,1464,566,2030
RAWALPINDI DISTRICT,KAHUTA TEHSIL,53,1476,481,1957
RAWALPINDI DISTRICT,KAHUTA TEHSIL,54,1422,494,1916
RAWALPINDI DISTRICT,KAHUTA TEHSIL,55,1108,443,1551
RAWALPINDI DISTRICT,KAHUTA TEHSIL,56,1228,419,1647
RAWALPINDI DISTRICT,KAHUTA TEHSIL,57,1086,357,1443
RAWALPINDI DISTRICT,KAHUTA TEHSIL,58,1232,365,1597
RAWALPINDI DISTRICT,KAHUTA TEHSIL,59,1137,358,1495
RAWALPINDI DISTRICT,KAHUTA TEHSIL,60,898,306,1204
RAWALPINDI DISTRICT,KAHUTA TEHSIL,61,1132,300,1432
RAWALPINDI DISTRICT,KAHUTA TEHSIL,62,1114,326,1440
RAWALPINDI DISTRICT,KAHUTA TEHSIL,63,1165,301,1466
RAWALPINDI DISTRICT,KAHUTA TEHSIL,64,981,290,1271
RAWALPINDI DISTRICT,KAHUTA TEHSIL,65,800,235,1035
RAWALPINDI DISTRICT,KAHUTA TEHSIL,66,741,209,950
RAWALPINDI DISTRICT,KAHUTA TEHSIL,67,722,193,915
RAWALPINDI DISTRICT,KAHUTA TEHSIL,68,885,193,1078
RAWALPINDI DISTRICT,KAHUTA TEHSIL,69,697,183,880
RAWALPINDI DISTRICT,KAHUTA TEHSIL,70,560,157,717
RAWALPINDI DISTRICT,KAHUTA TEHSIL,71,650,139,789
RAWALPINDI DISTRICT,KAHUTA TEHSIL,72,584,157,741
RAWALPINDI DISTRICT,KAHUTA TEHSIL,73,617,132,749
RAWALPINDI DISTRICT,KAHUTA TEHSIL,74,452,113,565
RAWALPINDI DISTRICT,KAHUTA TEHSIL,>=75,3908,866,4774
RAWALPINDI DISTRICT,KALLAR SAYADDAN TEHSIL,<1,3417,1348,4765
RAWALPINDI DISTRICT,KALLAR SAYADDAN TEHSIL,1,3727,1378,5105
RAWALPINDI DISTRICT,KALLAR SAYADDAN TEHSIL,2,3566,1154,4720
RAWALPINDI DISTRICT,KALLAR SAYADDAN TEHSIL,3,3688,1254,4942
RAWALPINDI DISTRICT,KALLAR SAYADDAN TEHSIL,4,3483,1235,4718
RAWALPINDI DISTRICT,KALLAR SAYADDAN TEHSIL,5,3502,1144,4646
RAWALPINDI DISTRICT,KALLAR SAYADDAN TEHSIL,6,3555,1193,4748
RAWALPINDI DISTRICT,KALLAR SAYADDAN TEHSIL,7,3807,1299,5106
RAWALPINDI DISTRICT,KALLAR SAYADDAN TEHSIL,8,3167,1065,4232
RAWALPINDI DISTRICT,KALLAR SAYADDAN TEHSIL,9,3881,1304,5185
RAWALPINDI DISTRICT,KALLAR SAYADDAN TEHSIL,10,3026,1002,4028
RAWALPINDI DISTRICT,KALLAR SAYADDAN TEHSIL,11,3937,1293,5230
RAWALPINDI DISTRICT,KALLAR SAYADDAN TEHSIL,12,2963,998,3961
RAWALPINDI DISTRICT,KALLAR SAYADDAN TEHSIL,13,3590,1226,4816
RAWALPINDI DISTRICT,KALLAR SAYADDAN TEHSIL,14,3245,1039,4284
RAWALPINDI DISTRICT,KALLAR SAYADDAN TEHSIL,15,3247,1090,4337
RAWALPINDI DISTRICT,KALLAR SAYADDAN TEHSIL,16,3456,1180,4636
RAWALPINDI DISTRICT,KALLAR SAYADDAN TEHSIL,17,3493,1197,4690
RAWALPINDI DISTRICT,KALLAR SAYADDAN TEHSIL,18,2640,948,3588
RAWALPINDI DISTRICT,KALLAR SAYADDAN TEHSIL,19,3653,1196,4849
RAWALPINDI DISTRICT,KALLAR SAYADDAN TEHSIL,20,2591,869,3460
RAWALPINDI DISTRICT,KALLAR SAYADDAN TEHSIL,21,3507,1171,4678
RAWALPINDI DISTRICT,KALLAR SAYADDAN TEHSIL,22,2706,917,3623
RAWALPINDI DISTRICT,KALLAR SAYADDAN TEHSIL,23,3061,1060,4121
RAWALPINDI DISTRICT,KALLAR SAYADDAN TEHSIL,24,3005,1000,4005
RAWALPINDI DISTRICT,KALLAR SAYADDAN TEHSIL,25,2120,736,2856
RAWALPINDI DISTRICT,KALLAR SAYADDAN TEHSIL,26,2737,1003,3740
RAWALPINDI DISTRICT,KALLAR SAYADDAN TEHSIL,27,2669,880,3549
RAWALPINDI DISTRICT,KALLAR SAYADDAN TEHSIL,28,2386,820,3206
RAWALPINDI DISTRICT,KALLAR SAYADDAN TEHSIL,29,2713,938,3651
RAWALPINDI DISTRICT,KALLAR SAYADDAN TEHSIL,30,1932,652,2584
RAWALPINDI DISTRICT,KALLAR SAYADDAN TEHSIL,31,2704,1020,3724
RAWALPINDI DISTRICT,KALLAR SAYADDAN TEHSIL,32,2330,754,3084
RAWALPINDI DISTRICT,KALLAR SAYADDAN TEHSIL,33,2306,838,3144
RAWALPINDI DISTRICT,KALLAR SAYADDAN TEHSIL,34,2285,758,3043
RAWALPINDI DISTRICT,KALLAR SAYADDAN TEHSIL,35,1567,485,2052
RAWALPINDI DISTRICT,KALLAR SAYADDAN TEHSIL,36,2046,713,2759
RAWALPINDI DISTRICT,KALLAR SAYADDAN TEHSIL,37,1869,622,2491
RAWALPINDI DISTRICT,KALLAR SAYADDAN TEHSIL,38,1972,683,2655
RAWALPINDI DISTRICT,KALLAR SAYADDAN TEHSIL,39,2017,640,2657
RAWALPINDI DISTRICT,KALLAR SAYADDAN TEHSIL,40,1394,456,1850
RAWALPINDI DISTRICT,KALLAR SAYADDAN TEHSIL,41,1862,683,2545
RAWALPINDI DISTRICT,KALLAR SAYADDAN TEHSIL,42,1606,518,2124
RAWALPINDI DISTRICT,KALLAR SAYADDAN TEHSIL,43,1738,564,2302
RAWALPINDI DISTRICT,KALLAR SAYADDAN TEHSIL,44,1670,583,2253
RAWALPINDI DISTRICT,KALLAR SAYADDAN TEHSIL,45,1135,360,1495
RAWALPINDI DISTRICT,KALLAR SAYADDAN TEHSIL,46,1607,549,2156
RAWALPINDI DISTRICT,KALLAR SAYADDAN TEHSIL,47,1456,511,1967
RAWALPINDI DISTRICT,KALLAR SAYADDAN TEHSIL,48,1641,546,2187
RAWALPINDI DISTRICT,KALLAR SAYADDAN TEHSIL,49,1668,508,2176
RAWALPINDI DISTRICT,KALLAR SAYADDAN TEHSIL,50,1176,363,1539
RAWALPINDI DISTRICT,KALLAR SAYADDAN TEHSIL,51,1567,525,2092
RAWALPINDI DISTRICT,KALLAR SAYADDAN TEHSIL,52,1415,469,1884
RAWALPINDI DISTRICT,KALLAR SAYADDAN TEHSIL,53,1605,490,2095
RAWALPINDI DISTRICT,KALLAR SAYADDAN TEHSIL,54,1487,489,1976
RAWALPINDI DISTRICT,KALLAR SAYADDAN TEHSIL,55,1022,297,1319
RAWALPINDI DISTRICT,KALLAR SAYADDAN TEHSIL,56,1198,431,1629
RAWALPINDI DISTRICT,KALLAR SAYADDAN TEHSIL,57,1116,320,1436
RAWALPINDI DISTRICT,KALLAR SAYADDAN TEHSIL,58,1136,371,1507
RAWALPINDI DISTRICT,KALLAR SAYADDAN TEHSIL,59,1110,326,1436
RAWALPINDI DISTRICT,KALLAR SAYADDAN TEHSIL,60,779,245,1024
RAWALPINDI DISTRICT,KALLAR SAYADDAN TEHSIL,61,1231,391,1622
RAWALPINDI DISTRICT,KALLAR SAYADDAN TEHSIL,62,1177,377,1554
RAWALPINDI DISTRICT,KALLAR SAYADDAN TEHSIL,63,1092,372,1464
RAWALPINDI DISTRICT,KALLAR SAYADDAN TEHSIL,64,1030,346,1376
RAWALPINDI DISTRICT,KALLAR SAYADDAN TEHSIL,65,654,163,817
RAWALPINDI DISTRICT,KALLAR SAYADDAN TEHSIL,66,847,269,1116
RAWALPINDI DISTRICT,KALLAR SAYADDAN TEHSIL,67,908,278,1186
RAWALPINDI DISTRICT,KALLAR SAYADDAN TEHSIL,68,953,252,1205
RAWALPINDI DISTRICT,KALLAR SAYADDAN TEHSIL,69,785,208,993
RAWALPINDI DISTRICT,KALLAR SAYADDAN TEHSIL,70,518,130,648
RAWALPINDI DISTRICT,KALLAR SAYADDAN TEHSIL,71,685,192,877
RAWALPINDI DISTRICT,KALLAR SAYADDAN TEHSIL,72,740,217,957
RAWALPINDI DISTRICT,KALLAR SAYADDAN TEHSIL,73,644,155,799
RAWALPINDI DISTRICT,KALLAR SAYADDAN TEHSIL,74,463,142,605
RAWALPINDI DISTRICT,KALLAR SAYADDAN TEHSIL,>=75,4141,1041,5182
RAWALPINDI DISTRICT,KOTLI SATTIAN TEHSIL,<1,2241,502,2743
RAWALPINDI DISTRICT,KOTLI SATTIAN TEHSIL,1,2251,536,2787
RAWALPINDI DISTRICT,KOTLI SATTIAN TEHSIL,2,2244,529,2773
RAWALPINDI DISTRICT,KOTLI SATTIAN TEHSIL,3,2257,522,2779
RAWALPINDI DISTRICT,KOTLI SATTIAN TEHSIL,4,2022,468,2490
RAWALPINDI DISTRICT,KOTLI SATTIAN TEHSIL,5,2128,509,2637
RAWALPINDI DISTRICT,KOTLI SATTIAN TEHSIL,6,2219,512,2731
RAWALPINDI DISTRICT,KOTLI SATTIAN TEHSIL,7,2385,567,2952
RAWALPINDI DISTRICT,KOTLI SATTIAN TEHSIL,8,2007,487,2494
RAWALPINDI DISTRICT,KOTLI SATTIAN TEHSIL,9,2426,552,2978
RAWALPINDI DISTRICT,KOTLI SATTIAN TEHSIL,10,1869,418,2287
RAWALPINDI DISTRICT,KOTLI SATTIAN TEHSIL,11,2343,539,2882
RAWALPINDI DISTRICT,KOTLI SATTIAN TEHSIL,12,1782,396,2178
RAWALPINDI DISTRICT,KOTLI SATTIAN TEHSIL,13,2032,435,2467
RAWALPINDI DISTRICT,KOTLI SATTIAN TEHSIL,14,1729,396,2125
RAWALPINDI DISTRICT,KOTLI SATTIAN TEHSIL,15,1773,407,2180
RAWALPINDI DISTRICT,KOTLI SATTIAN TEHSIL,16,2042,422,2464
RAWALPINDI DISTRICT,KOTLI SATTIAN TEHSIL,17,1986,477,2463
RAWALPINDI DISTRICT,KOTLI SATTIAN TEHSIL,18,1417,351,1768
RAWALPINDI DISTRICT,KOTLI SATTIAN TEHSIL,19,1957,403,2360
RAWALPINDI DISTRICT,KOTLI SATTIAN TEHSIL,20,1485,329,1814
RAWALPINDI DISTRICT,KOTLI SATTIAN TEHSIL,21,2108,432,2540
RAWALPINDI DISTRICT,KOTLI SATTIAN TEHSIL,22,1689,382,2071
RAWALPINDI DISTRICT,KOTLI SATTIAN TEHSIL,23,1950,477,2427
RAWALPINDI DISTRICT,KOTLI SATTIAN TEHSIL,24,2026,444,2470
RAWALPINDI DISTRICT,KOTLI SATTIAN TEHSIL,25,1385,327,1712
RAWALPINDI DISTRICT,KOTLI SATTIAN TEHSIL,26,1886,410,2296
RAWALPINDI DISTRICT,KOTLI SATTIAN TEHSIL,27,1752,395,2147
RAWALPINDI DISTRICT,KOTLI SATTIAN TEHSIL,28,1647,395,2042
RAWALPINDI DISTRICT,KOTLI SATTIAN TEHSIL,29,1691,445,2136
RAWALPINDI DISTRICT,KOTLI SATTIAN TEHSIL,30,1368,330,1698
RAWALPINDI DISTRICT,KOTLI SATTIAN TEHSIL,31,1729,402,2131
RAWALPINDI DISTRICT,KOTLI SATTIAN TEHSIL,32,1631,406,2037
RAWALPINDI DISTRICT,KOTLI SATTIAN TEHSIL,33,1626,362,1988
RAWALPINDI DISTRICT,KOTLI SATTIAN TEHSIL,34,1507,367,1874
RAWALPINDI DISTRICT,KOTLI SATTIAN TEHSIL,35,1057,281,1338
RAWALPINDI DISTRICT,KOTLI SATTIAN TEHSIL,36,1428,352,1780
RAWALPINDI DISTRICT,KOTLI SATTIAN TEHSIL,37,1235,272,1507
RAWALPINDI DISTRICT,KOTLI SATTIAN TEHSIL,38,1386,303,1689
RAWALPINDI DISTRICT,KOTLI SATTIAN TEHSIL,39,1225,284,1509
RAWALPINDI DISTRICT,KOTLI SATTIAN TEHSIL,40,971,234,1205
RAWALPINDI DISTRICT,KOTLI SATTIAN TEHSIL,41,1067,226,1293
RAWALPINDI DISTRICT,KOTLI SATTIAN TEHSIL,42,929,216,1145
RAWALPINDI DISTRICT,KOTLI SATTIAN TEHSIL,43,935,227,1162
RAWALPINDI DISTRICT,KOTLI SATTIAN TEHSIL,44,892,216,1108
RAWALPINDI DISTRICT,KOTLI SATTIAN TEHSIL,45,705,167,872
RAWALPINDI DISTRICT,KOTLI SATTIAN TEHSIL,46,923,186,1109
RAWALPINDI DISTRICT,KOTLI SATTIAN TEHSIL,47,798,170,968
RAWALPINDI DISTRICT,KOTLI SATTIAN TEHSIL,48,942,227,1169
RAWALPINDI DISTRICT,KOTLI SATTIAN TEHSIL,49,808,214,1022
RAWALPINDI DISTRICT,KOTLI SATTIAN TEHSIL,50,702,170,872
RAWALPINDI DISTRICT,KOTLI SATTIAN TEHSIL,51,820,181,1001
RAWALPINDI DISTRICT,KOTLI SATTIAN TEHSIL,52,868,193,1061
RAWALPINDI DISTRICT,KOTLI SATTIAN TEHSIL,53,880,198,1078
RAWALPINDI DISTRICT,KOTLI SATTIAN TEHSIL,54,844,161,1005
RAWALPINDI DISTRICT,KOTLI SATTIAN TEHSIL,55,575,161,736
RAWALPINDI DISTRICT,KOTLI SATTIAN TEHSIL,56,737,146,883
RAWALPINDI DISTRICT,KOTLI SATTIAN TEHSIL,57,571,132,703
RAWALPINDI DISTRICT,KOTLI SATTIAN TEHSIL,58,711,188,899
RAWALPINDI DISTRICT,KOTLI SATTIAN TEHSIL,59,634,130,764
RAWALPINDI DISTRICT,KOTLI SATTIAN TEHSIL,60,486,119,605
RAWALPINDI DISTRICT,KOTLI SATTIAN TEHSIL,61,559,131,690
RAWALPINDI DISTRICT,KOTLI SATTIAN TEHSIL,62,616,140,756
RAWALPINDI DISTRICT,KOTLI SATTIAN TEHSIL,63,624,139,763
RAWALPINDI DISTRICT,KOTLI SATTIAN TEHSIL,64,510,112,622
RAWALPINDI DISTRICT,KOTLI SATTIAN TEHSIL,65,433,121,554
RAWALPINDI DISTRICT,KOTLI SATTIAN TEHSIL,66,420,103,523
RAWALPINDI DISTRICT,KOTLI SATTIAN TEHSIL,67,411,79,490
RAWALPINDI DISTRICT,KOTLI SATTIAN TEHSIL,68,431,120,551
RAWALPINDI DISTRICT,KOTLI SATTIAN TEHSIL,69,343,101,444
RAWALPINDI DISTRICT,KOTLI SATTIAN TEHSIL,70,256,63,319
RAWALPINDI DISTRICT,KOTLI SATTIAN TEHSIL,71,274,72,346
RAWALPINDI DISTRICT,KOTLI SATTIAN TEHSIL,72,285,68,353
RAWALPINDI DISTRICT,KOTLI SATTIAN TEHSIL,73,248,62,310
RAWALPINDI DISTRICT,KOTLI SATTIAN TEHSIL,74,204,49,253
RAWALPINDI DISTRICT,KOTLI SATTIAN TEHSIL,>=75,1561,356,1917
RAWALPINDI DISTRICT,MURREE TEHSIL,<1,1627,3443,5070
RAWALPINDI DISTRICT,MURREE TEHSIL,1,1840,3665,5505
RAWALPINDI DISTRICT,MURREE TEHSIL,2,1725,3647,5372
RAWALPINDI DISTRICT,MURREE TEHSIL,3,1746,3626,5372
RAWALPINDI DISTRICT,MURREE TEHSIL,4,1556,3447,5003
RAWALPINDI DISTRICT,MURREE TEHSIL,5,1591,3329,4920
RAWALPINDI DISTRICT,MURREE TEHSIL,6,1798,3597,5395
RAWALPINDI DISTRICT,MURREE TEHSIL,7,1804,3884,5688
RAWALPINDI DISTRICT,MURREE TEHSIL,8,1544,3202,4746
RAWALPINDI DISTRICT,MURREE TEHSIL,9,1911,3913,5824
RAWALPINDI DISTRICT,MURREE TEHSIL,10,1453,2932,4385
RAWALPINDI DISTRICT,MURREE TEHSIL,11,1768,3760,5528
RAWALPINDI DISTRICT,MURREE TEHSIL,12,1311,2857,4168
RAWALPINDI DISTRICT,MURREE TEHSIL,13,1526,3185,4711
RAWALPINDI DISTRICT,MURREE TEHSIL,14,1393,2821,4214
RAWALPINDI DISTRICT,MURREE TEHSIL,15,1365,2787,4152
RAWALPINDI DISTRICT,MURREE TEHSIL,16,1349,2928,4277
RAWALPINDI DISTRICT,MURREE TEHSIL,17,1488,2977,4465
RAWALPINDI DISTRICT,MURREE TEHSIL,18,1067,2365,3432
RAWALPINDI DISTRICT,MURREE TEHSIL,19,1468,3150,4618
RAWALPINDI DISTRICT,MURREE TEHSIL,20,1125,2473,3598
RAWALPINDI DISTRICT,MURREE TEHSIL,21,1586,3226,4812
RAWALPINDI DISTRICT,MURREE TEHSIL,22,1269,2687,3956
RAWALPINDI DISTRICT,MURREE TEHSIL,23,1460,3072,4532
RAWALPINDI DISTRICT,MURREE TEHSIL,24,1512,3080,4592
RAWALPINDI DISTRICT,MURREE TEHSIL,25,1072,2283,3355
RAWALPINDI DISTRICT,MURREE TEHSIL,26,1434,2889,4323
RAWALPINDI DISTRICT,MURREE TEHSIL,27,1395,2859,4254
RAWALPINDI DISTRICT,MURREE TEHSIL,28,1289,2742,4031
RAWALPINDI DISTRICT,MURREE TEHSIL,29,1467,3145,4612
RAWALPINDI DISTRICT,MURREE TEHSIL,30,1072,2246,3318
RAWALPINDI DISTRICT,MURREE TEHSIL,31,1447,3089,4536
RAWALPINDI DISTRICT,MURREE TEHSIL,32,1161,2666,3827
RAWALPINDI DISTRICT,MURREE TEHSIL,33,1233,2850,4083
RAWALPINDI DISTRICT,MURREE TEHSIL,34,1172,2718,3890
RAWALPINDI DISTRICT,MURREE TEHSIL,35,864,1891,2755
RAWALPINDI DISTRICT,MURREE TEHSIL,36,1063,2373,3436
RAWALPINDI DISTRICT,MURREE TEHSIL,37,1065,2323,3388
RAWALPINDI DISTRICT,MURREE TEHSIL,38,1072,2397,3469
RAWALPINDI DISTRICT,MURREE TEHSIL,39,1106,2405,3511
RAWALPINDI DISTRICT,MURREE TEHSIL,40,681,1507,2188
RAWALPINDI DISTRICT,MURREE TEHSIL,41,917,1948,2865
RAWALPINDI DISTRICT,MURREE TEHSIL,42,710,1701,2411
RAWALPINDI DISTRICT,MURREE TEHSIL,43,796,1668,2464
RAWALPINDI DISTRICT,MURREE TEHSIL,44,798,1689,2487
RAWALPINDI DISTRICT,MURREE TEHSIL,45,572,1159,1731
RAWALPINDI DISTRICT,MURREE TEHSIL,46,672,1405,2077
RAWALPINDI DISTRICT,MURREE TEHSIL,47,608,1308,1916
RAWALPINDI DISTRICT,MURREE TEHSIL,48,780,1531,2311
RAWALPINDI DISTRICT,MURREE TEHSIL,49,783,1546,2329
RAWALPINDI DISTRICT,MURREE TEHSIL,50,558,1085,1643
RAWALPINDI DISTRICT,MURREE TEHSIL,51,715,1445,2160
RAWALPINDI DISTRICT,MURREE TEHSIL,52,672,1330,2002
RAWALPINDI DISTRICT,MURREE TEHSIL,53,713,1374,2087
RAWALPINDI DISTRICT,MURREE TEHSIL,54,693,1330,2023
RAWALPINDI DISTRICT,MURREE TEHSIL,55,499,936,1435
RAWALPINDI DISTRICT,MURREE TEHSIL,56,525,977,1502
RAWALPINDI DISTRICT,MURREE TEHSIL,57,481,849,1330
RAWALPINDI DISTRICT,MURREE TEHSIL,58,505,917,1422
RAWALPINDI DISTRICT,MURREE TEHSIL,59,523,895,1418
RAWALPINDI DISTRICT,MURREE TEHSIL,60,363,616,979
RAWALPINDI DISTRICT,MURREE TEHSIL,61,535,912,1447
RAWALPINDI DISTRICT,MURREE TEHSIL,62,489,975,1464
RAWALPINDI DISTRICT,MURREE TEHSIL,63,536,921,1457
RAWALPINDI DISTRICT,MURREE TEHSIL,64,448,802,1250
RAWALPINDI DISTRICT,MURREE TEHSIL,65,311,584,895
RAWALPINDI DISTRICT,MURREE TEHSIL,66,426,576,1002
RAWALPINDI DISTRICT,MURREE TEHSIL,67,344,680,1024
RAWALPINDI DISTRICT,MURREE TEHSIL,68,376,661,1037
RAWALPINDI DISTRICT,MURREE TEHSIL,69,318,596,914
RAWALPINDI DISTRICT,MURREE TEHSIL,70,223,360,583
RAWALPINDI DISTRICT,MURREE TEHSIL,71,260,485,745
RAWALPINDI DISTRICT,MURREE TEHSIL,72,279,484,763
RAWALPINDI DISTRICT,MURREE TEHSIL,73,265,442,707
RAWALPINDI DISTRICT,MURREE TEHSIL,74,186,303,489
RAWALPINDI DISTRICT,MURREE TEHSIL,>=75,1220,2117,3337
RAWALPINDI DISTRICT,RAWALPINDI TEHSIL,<1,25937,42498,68435
RAWALPINDI DISTRICT,RAWALPINDI TEHSIL,1,27911,47741,75652
RAWALPINDI DISTRICT,RAWALPINDI TEHSIL,2,27865,47751,75616
RAWALPINDI DISTRICT,RAWALPINDI TEHSIL,3,29593,51721,81314
RAWALPINDI DISTRICT,RAWALPINDI TEHSIL,4,26783,47189,73972
RAWALPINDI DISTRICT,RAWALPINDI TEHSIL,5,27417,47969,75386
RAWALPINDI DISTRICT,RAWALPINDI TEHSIL,6,27136,47319,74455
RAWALPINDI DISTRICT,RAWALPINDI TEHSIL,7,28717,50444,79161
RAWALPINDI DISTRICT,RAWALPINDI TEHSIL,8,24985,43474,68459
RAWALPINDI DISTRICT,RAWALPINDI TEHSIL,9,29095,51533,80628
RAWALPINDI DISTRICT,RAWALPINDI TEHSIL,10,22904,40491,63395
RAWALPINDI DISTRICT,RAWALPINDI TEHSIL,11,28184,49737,77921
RAWALPINDI DISTRICT,RAWALPINDI TEHSIL,12,22098,40088,62186
RAWALPINDI DISTRICT,RAWALPINDI TEHSIL,13,24845,44844,69689
RAWALPINDI DISTRICT,RAWALPINDI TEHSIL,14,21732,39894,61626
RAWALPINDI DISTRICT,RAWALPINDI TEHSIL,15,22073,40323,62396
RAWALPINDI DISTRICT,RAWALPINDI TEHSIL,16,22648,40628,63276
RAWALPINDI DISTRICT,RAWALPINDI TEHSIL,17,23599,44529,68128
RAWALPINDI DISTRICT,RAWALPINDI TEHSIL,18,19255,36177,55432
RAWALPINDI DISTRICT,RAWALPINDI TEHSIL,19,23973,43899,67872
RAWALPINDI DISTRICT,RAWALPINDI TEHSIL,20,18396,34404,52800
RAWALPINDI DISTRICT,RAWALPINDI TEHSIL,21,24200,45227,69427
RAWALPINDI DISTRICT,RAWALPINDI TEHSIL,22,20196,38680,58876
RAWALPINDI DISTRICT,RAWALPINDI TEHSIL,23,22961,41869,64830
RAWALPINDI DISTRICT,RAWALPINDI TEHSIL,24,22203,40645,62848
RAWALPINDI DISTRICT,RAWALPINDI TEHSIL,25,17668,32695,50363
RAWALPINDI DISTRICT,RAWALPINDI TEHSIL,26,21923,39228,61151
RAWALPINDI DISTRICT,RAWALPINDI TEHSIL,27,21629,39624,61253
RAWALPINDI DISTRICT,RAWALPINDI TEHSIL,28,19854,37289,57143
RAWALPINDI DISTRICT,RAWALPINDI TEHSIL,29,21275,37672,58947
RAWALPINDI DISTRICT,RAWALPINDI TEHSIL,30,17465,33173,50638
RAWALPINDI DISTRICT,RAWALPINDI TEHSIL,31,20346,36397,56743
RAWALPINDI DISTRICT,RAWALPINDI TEHSIL,32,19123,35952,55075
RAWALPINDI DISTRICT,RAWALPINDI TEHSIL,33,18751,34451,53202
RAWALPINDI DISTRICT,RAWALPINDI TEHSIL,34,17433,31991,49424
RAWALPINDI DISTRICT,RAWALPINDI TEHSIL,35,14187,27647,41834
RAWALPINDI DISTRICT,RAWALPINDI TEHSIL,36,15824,29985,45809
RAWALPINDI DISTRICT,RAWALPINDI TEHSIL,37,14822,27885,42707
RAWALPINDI DISTRICT,RAWALPINDI TEHSIL,38,16051,31698,47749
RAWALPINDI DISTRICT,RAWALPINDI TEHSIL,39,15038,27978,43016
RAWALPINDI DISTRICT,RAWALPINDI TEHSIL,40,12750,26721,39471
RAWALPINDI DISTRICT,RAWALPINDI TEHSIL,41,13023,25156,38179
RAWALPINDI DISTRICT,RAWALPINDI TEHSIL,42,12221,24501,36722
RAWALPINDI DISTRICT,RAWALPINDI TEHSIL,43,12353,24035,36388
RAWALPINDI DISTRICT,RAWALPINDI TEHSIL,44,10916,21447,32363
RAWALPINDI DISTRICT,RAWALPINDI TEHSIL,45,9403,19890,29293
RAWALPINDI DISTRICT,RAWALPINDI TEHSIL,46,10126,18901,29027
RAWALPINDI DISTRICT,RAWALPINDI TEHSIL,47,9231,17475,26706
RAWALPINDI DISTRICT,RAWALPINDI TEHSIL,48,10560,20521,31081
RAWALPINDI DISTRICT,RAWALPINDI TEHSIL,49,10038,18785,28823
RAWALPINDI DISTRICT,RAWALPINDI TEHSIL,50,9489,19024,28513
RAWALPINDI DISTRICT,RAWALPINDI TEHSIL,51,9603,17027,26630
RAWALPINDI DISTRICT,RAWALPINDI TEHSIL,52,9542,17639,27181
RAWALPINDI DISTRICT,RAWALPINDI TEHSIL,53,9422,17412,26834
RAWALPINDI DISTRICT,RAWALPINDI TEHSIL,54,8846,15736,24582
RAWALPINDI DISTRICT,RAWALPINDI TEHSIL,55,7372,14707,22079
RAWALPINDI DISTRICT,RAWALPINDI TEHSIL,56,7246,12663,19909
RAWALPINDI DISTRICT,RAWALPINDI TEHSIL,57,6303,10871,17174
RAWALPINDI DISTRICT,RAWALPINDI TEHSIL,58,6896,12153,19049
RAWALPINDI DISTRICT,RAWALPINDI TEHSIL,59,6604,11213,17817
RAWALPINDI DISTRICT,RAWALPINDI TEHSIL,60,5717,10416,16133
RAWALPINDI DISTRICT,RAWALPINDI TEHSIL,61,6492,10268,16760
RAWALPINDI DISTRICT,RAWALPINDI TEHSIL,62,6454,10601,17055
RAWALPINDI DISTRICT,RAWALPINDI TEHSIL,63,6297,10581,16878
RAWALPINDI DISTRICT,RAWALPINDI TEHSIL,64,5427,8629,14056
RAWALPINDI DISTRICT,RAWALPINDI TEHSIL,65,4570,8233,12803
RAWALPINDI DISTRICT,RAWALPINDI TEHSIL,66,4289,6064,10353
RAWALPINDI DISTRICT,RAWALPINDI TEHSIL,67,3686,5744,9430
RAWALPINDI DISTRICT,RAWALPINDI TEHSIL,68,4100,6514,10614
RAWALPINDI DISTRICT,RAWALPINDI TEHSIL,69,3652,5631,9283
RAWALPINDI DISTRICT,RAWALPINDI TEHSIL,70,3084,4843,7927
RAWALPINDI DISTRICT,RAWALPINDI TEHSIL,71,2923,4584,7507
RAWALPINDI DISTRICT,RAWALPINDI TEHSIL,72,2797,4508,7305
RAWALPINDI DISTRICT,RAWALPINDI TEHSIL,73,2662,4271,6933
RAWALPINDI DISTRICT,RAWALPINDI TEHSIL,74,2148,3387,5535
RAWALPINDI DISTRICT,RAWALPINDI TEHSIL,>=75,16480,24934,41414
RAWALPINDI DISTRICT,TAXILA TEHSIL,<1,4100,9979,14079
RAWALPINDI DISTRICT,TAXILA TEHSIL,1,4564,11003,15567
RAWALPINDI DISTRICT,TAXILA TEHSIL,2,4827,11370,16197
RAWALPINDI DISTRICT,TAXILA TEHSIL,3,4950,12099,17049
RAWALPINDI DISTRICT,TAXILA TEHSIL,4,4621,11487,16108
RAWALPINDI DISTRICT,TAXILA TEHSIL,5,4607,11808,16415
RAWALPINDI DISTRICT,TAXILA TEHSIL,6,4475,11550,16025
RAWALPINDI DISTRICT,TAXILA TEHSIL,7,4786,12345,17131
RAWALPINDI DISTRICT,TAXILA TEHSIL,8,4216,10690,14906
RAWALPINDI DISTRICT,TAXILA TEHSIL,9,4702,12706,17408
RAWALPINDI DISTRICT,TAXILA TEHSIL,10,3635,10081,13716
RAWALPINDI DISTRICT,TAXILA TEHSIL,11,4395,12501,16896
RAWALPINDI DISTRICT,TAXILA TEHSIL,12,3487,9688,13175
RAWALPINDI DISTRICT,TAXILA TEHSIL,13,3725,11175,14900
RAWALPINDI DISTRICT,TAXILA TEHSIL,14,3310,9762,13072
RAWALPINDI DISTRICT,TAXILA TEHSIL,15,3456,9868,13324
RAWALPINDI DISTRICT,TAXILA TEHSIL,16,3298,9737,13035
RAWALPINDI DISTRICT,TAXILA TEHSIL,17,3581,10438,14019
RAWALPINDI DISTRICT,TAXILA TEHSIL,18,2848,8246,11094
RAWALPINDI DISTRICT,TAXILA TEHSIL,19,3583,10102,13685
RAWALPINDI DISTRICT,TAXILA TEHSIL,20,3025,7994,11019
RAWALPINDI DISTRICT,TAXILA TEHSIL,21,3505,10659,14164
RAWALPINDI DISTRICT,TAXILA TEHSIL,22,3090,8925,12015
RAWALPINDI DISTRICT,TAXILA TEHSIL,23,3274,9720,12994
RAWALPINDI DISTRICT,TAXILA TEHSIL,24,3167,9261,12428
RAWALPINDI DISTRICT,TAXILA TEHSIL,25,2811,7460,10271
RAWALPINDI DISTRICT,TAXILA TEHSIL,26,3076,8752,11828
RAWALPINDI DISTRICT,TAXILA TEHSIL,27,3142,8683,11825
RAWALPINDI DISTRICT,TAXILA TEHSIL,28,2826,7939,10765
RAWALPINDI DISTRICT,TAXILA TEHSIL,29,3028,8246,11274
RAWALPINDI DISTRICT,TAXILA TEHSIL,30,2714,7336,10050
RAWALPINDI DISTRICT,TAXILA TEHSIL,31,2880,8277,11157
RAWALPINDI DISTRICT,TAXILA TEHSIL,32,2718,7925,10643
RAWALPINDI DISTRICT,TAXILA TEHSIL,33,2718,7807,10525
RAWALPINDI DISTRICT,TAXILA TEHSIL,34,2409,7489,9898
RAWALPINDI DISTRICT,TAXILA TEHSIL,35,2263,6261,8524
RAWALPINDI DISTRICT,TAXILA TEHSIL,36,2319,7104,9423
RAWALPINDI DISTRICT,TAXILA TEHSIL,37,2203,6865,9068
RAWALPINDI DISTRICT,TAXILA TEHSIL,38,2260,7470,9730
RAWALPINDI DISTRICT,TAXILA TEHSIL,39,2126,6921,9047
RAWALPINDI DISTRICT,TAXILA TEHSIL,40,2047,6551,8598
RAWALPINDI DISTRICT,TAXILA TEHSIL,41,1899,6625,8524
RAWALPINDI DISTRICT,TAXILA TEHSIL,42,1672,6009,7681
RAWALPINDI DISTRICT,TAXILA TEHSIL,43,1820,6292,8112
RAWALPINDI DISTRICT,TAXILA TEHSIL,44,1565,5438,7003
RAWALPINDI DISTRICT,TAXILA TEHSIL,45,1537,4658,6195
RAWALPINDI DISTRICT,TAXILA TEHSIL,46,1401,4586,5987
RAWALPINDI DISTRICT,TAXILA TEHSIL,47,1318,4354,5672
RAWALPINDI DISTRICT,TAXILA TEHSIL,48,1571,4830,6401
RAWALPINDI DISTRICT,TAXILA TEHSIL,49,1465,4822,6287
RAWALPINDI DISTRICT,TAXILA TEHSIL,50,1511,4494,6005
RAWALPINDI DISTRICT,TAXILA TEHSIL,51,1375,4202,5577
RAWALPINDI DISTRICT,TAXILA TEHSIL,52,1187,4089,5276
RAWALPINDI DISTRICT,TAXILA TEHSIL,53,1204,4435,5639
RAWALPINDI DISTRICT,TAXILA TEHSIL,54,1179,3926,5105
RAWALPINDI DISTRICT,TAXILA TEHSIL,55,1085,3263,4348
RAWALPINDI DISTRICT,TAXILA TEHSIL,56,971,3235,4206
RAWALPINDI DISTRICT,TAXILA TEHSIL,57,949,2888,3837
RAWALPINDI DISTRICT,TAXILA TEHSIL,58,908,2906,3814
RAWALPINDI DISTRICT,TAXILA TEHSIL,59,935,2978,3913
RAWALPINDI DISTRICT,TAXILA TEHSIL,60,889,2430,3319
RAWALPINDI DISTRICT,TAXILA TEHSIL,61,959,2591,3550
RAWALPINDI DISTRICT,TAXILA TEHSIL,62,938,2523,3461
RAWALPINDI DISTRICT,TAXILA TEHSIL,63,837,2656,3493
RAWALPINDI DISTRICT,TAXILA TEHSIL,64,744,2182,2926
RAWALPINDI DISTRICT,TAXILA TEHSIL,65,652,1895,2547
RAWALPINDI DISTRICT,TAXILA TEHSIL,66,601,1556,2157
RAWALPINDI DISTRICT,TAXILA TEHSIL,67,565,1574,2139
RAWALPINDI DISTRICT,TAXILA TEHSIL,68,552,1698,2250
RAWALPINDI DISTRICT,TAXILA TEHSIL,69,531,1411,1942
RAWALPINDI DISTRICT,TAXILA TEHSIL,70,465,1251,1716
RAWALPINDI DISTRICT,TAXILA TEHSIL,71,418,1261,1679
RAWALPINDI DISTRICT,TAXILA TEHSIL,72,443,1321,1764
RAWALPINDI DISTRICT,TAXILA TEHSIL,73,432,1246,1678
RAWALPINDI DISTRICT,TAXILA TEHSIL,74,294,910,1204
RAWALPINDI DISTRICT,TAXILA TEHSIL,>=75,2372,6732,9104
SAHIWAL DISTRICT,CHICHAWATNI TEHSIL,<1,20305,2084,22389
SAHIWAL DISTRICT,CHICHAWATNI TEHSIL,1,22642,2221,24863
SAHIWAL DISTRICT,CHICHAWATNI TEHSIL,2,23580,2146,25726
SAHIWAL DISTRICT,CHICHAWATNI TEHSIL,3,25017,2330,27347
SAHIWAL DISTRICT,CHICHAWATNI TEHSIL,4,25613,2257,27870
SAHIWAL DISTRICT,CHICHAWATNI TEHSIL,5,24741,2330,27071
SAHIWAL DISTRICT,CHICHAWATNI TEHSIL,6,24183,2241,26424
SAHIWAL DISTRICT,CHICHAWATNI TEHSIL,7,25751,2392,28143
SAHIWAL DISTRICT,CHICHAWATNI TEHSIL,8,23741,2106,25847
SAHIWAL DISTRICT,CHICHAWATNI TEHSIL,9,23922,2380,26302
SAHIWAL DISTRICT,CHICHAWATNI TEHSIL,10,22120,1984,24104
SAHIWAL DISTRICT,CHICHAWATNI TEHSIL,11,21649,2345,23994
SAHIWAL DISTRICT,CHICHAWATNI TEHSIL,12,19767,1885,21652
SAHIWAL DISTRICT,CHICHAWATNI TEHSIL,13,19561,2075,21636
SAHIWAL DISTRICT,CHICHAWATNI TEHSIL,14,18726,1941,20667
SAHIWAL DISTRICT,CHICHAWATNI TEHSIL,15,19097,2008,21105
SAHIWAL DISTRICT,CHICHAWATNI TEHSIL,16,18808,1859,20667
SAHIWAL DISTRICT,CHICHAWATNI TEHSIL,17,19167,2120,21287
SAHIWAL DISTRICT,CHICHAWATNI TEHSIL,18,17434,1599,19033
SAHIWAL DISTRICT,CHICHAWATNI TEHSIL,19,18185,1898,20083
SAHIWAL DISTRICT,CHICHAWATNI TEHSIL,20,17840,1724,19564
SAHIWAL DISTRICT,CHICHAWATNI TEHSIL,21,17371,2054,19425
SAHIWAL DISTRICT,CHICHAWATNI TEHSIL,22,17257,1795,19052
SAHIWAL DISTRICT,CHICHAWATNI TEHSIL,23,16051,1870,17921
SAHIWAL DISTRICT,CHICHAWATNI TEHSIL,24,15175,1803,16978
SAHIWAL DISTRICT,CHICHAWATNI TEHSIL,25,15347,1500,16847
SAHIWAL DISTRICT,CHICHAWATNI TEHSIL,26,14564,1652,16216
SAHIWAL DISTRICT,CHICHAWATNI TEHSIL,27,14215,1698,15913
SAHIWAL DISTRICT,CHICHAWATNI TEHSIL,28,14344,1617,15961
SAHIWAL DISTRICT,CHICHAWATNI TEHSIL,29,14086,1655,15741
SAHIWAL DISTRICT,CHICHAWATNI TEHSIL,30,14375,1469,15844
SAHIWAL DISTRICT,CHICHAWATNI TEHSIL,31,13275,1459,14734
SAHIWAL DISTRICT,CHICHAWATNI TEHSIL,32,12740,1490,14230
SAHIWAL DISTRICT,CHICHAWATNI TEHSIL,33,11745,1410,13155
SAHIWAL DISTRICT,CHICHAWATNI TEHSIL,34,11375,1325,12700
SAHIWAL DISTRICT,CHICHAWATNI TEHSIL,35,12089,1277,13366
SAHIWAL DISTRICT,CHICHAWATNI TEHSIL,36,11430,1283,12713
SAHIWAL DISTRICT,CHICHAWATNI TEHSIL,37,11334,1137,12471
SAHIWAL DISTRICT,CHICHAWATNI TEHSIL,38,10919,1366,12285
SAHIWAL DISTRICT,CHICHAWATNI TEHSIL,39,11341,1188,12529
SAHIWAL DISTRICT,CHICHAWATNI TEHSIL,40,10607,1135,11742
SAHIWAL DISTRICT,CHICHAWATNI TEHSIL,41,9895,1004,10899
SAHIWAL DISTRICT,CHICHAWATNI TEHSIL,42,9444,1095,10539
SAHIWAL DISTRICT,CHICHAWATNI TEHSIL,43,8443,1046,9489
SAHIWAL DISTRICT,CHICHAWATNI TEHSIL,44,7845,916,8761
SAHIWAL DISTRICT,CHICHAWATNI TEHSIL,45,8153,943,9096
SAHIWAL DISTRICT,CHICHAWATNI TEHSIL,46,7320,748,8068
SAHIWAL DISTRICT,CHICHAWATNI TEHSIL,47,8080,769,8849
SAHIWAL DISTRICT,CHICHAWATNI TEHSIL,48,7489,834,8323
SAHIWAL DISTRICT,CHICHAWATNI TEHSIL,49,8072,853,8925
SAHIWAL DISTRICT,CHICHAWATNI TEHSIL,50,7961,823,8784
SAHIWAL DISTRICT,CHICHAWATNI TEHSIL,51,7934,839,8773
SAHIWAL DISTRICT,CHICHAWATNI TEHSIL,52,7855,834,8689
SAHIWAL DISTRICT,CHICHAWATNI TEHSIL,53,7260,783,8043
SAHIWAL DISTRICT,CHICHAWATNI TEHSIL,54,6649,733,7382
SAHIWAL DISTRICT,CHICHAWATNI TEHSIL,55,6437,614,7051
SAHIWAL DISTRICT,CHICHAWATNI TEHSIL,56,5861,577,6438
SAHIWAL DISTRICT,CHICHAWATNI TEHSIL,57,5726,500,6226
SAHIWAL DISTRICT,CHICHAWATNI TEHSIL,58,5080,510,5590
SAHIWAL DISTRICT,CHICHAWATNI TEHSIL,59,5208,555,5763
SAHIWAL DISTRICT,CHICHAWATNI TEHSIL,60,5033,484,5517
SAHIWAL DISTRICT,CHICHAWATNI TEHSIL,61,4850,438,5288
SAHIWAL DISTRICT,CHICHAWATNI TEHSIL,62,4761,469,5230
SAHIWAL DISTRICT,CHICHAWATNI TEHSIL,63,4563,458,5021
SAHIWAL DISTRICT,CHICHAWATNI TEHSIL,64,4142,324,4466
SAHIWAL DISTRICT,CHICHAWATNI TEHSIL,65,3782,336,4118
SAHIWAL DISTRICT,CHICHAWATNI TEHSIL,66,3134,259,3393
SAHIWAL DISTRICT,CHICHAWATNI TEHSIL,67,3082,209,3291
SAHIWAL DISTRICT,CHICHAWATNI TEHSIL,68,2853,243,3096
SAHIWAL DISTRICT,CHICHAWATNI TEHSIL,69,3079,226,3305
SAHIWAL DISTRICT,CHICHAWATNI TEHSIL,70,2902,229,3131
SAHIWAL DISTRICT,CHICHAWATNI TEHSIL,71,2605,202,2807
SAHIWAL DISTRICT,CHICHAWATNI TEHSIL,72,2435,187,2622
SAHIWAL DISTRICT,CHICHAWATNI TEHSIL,73,2294,221,2515
SAHIWAL DISTRICT,CHICHAWATNI TEHSIL,74,2156,139,2295
SAHIWAL DISTRICT,CHICHAWATNI TEHSIL,>=75,15575,1225,16800
SAHIWAL DISTRICT,SAHIWAL TEHSIL,<1,24219,9039,33258
SAHIWAL DISTRICT,SAHIWAL TEHSIL,1,26782,9495,36277
SAHIWAL DISTRICT,SAHIWAL TEHSIL,2,27430,9733,37163
SAHIWAL DISTRICT,SAHIWAL TEHSIL,3,30236,10321,40557
SAHIWAL DISTRICT,SAHIWAL TEHSIL,4,29826,9948,39774
SAHIWAL DISTRICT,SAHIWAL TEHSIL,5,29903,9704,39607
SAHIWAL DISTRICT,SAHIWAL TEHSIL,6,28107,9606,37713
SAHIWAL DISTRICT,SAHIWAL TEHSIL,7,30867,10284,41151
SAHIWAL DISTRICT,SAHIWAL TEHSIL,8,28722,9196,37918
SAHIWAL DISTRICT,SAHIWAL TEHSIL,9,28180,9936,38116
SAHIWAL DISTRICT,SAHIWAL TEHSIL,10,26155,8712,34867
SAHIWAL DISTRICT,SAHIWAL TEHSIL,11,24844,9843,34687
SAHIWAL DISTRICT,SAHIWAL TEHSIL,12,23775,8528,32303
SAHIWAL DISTRICT,SAHIWAL TEHSIL,13,22020,8996,31016
SAHIWAL DISTRICT,SAHIWAL TEHSIL,14,21688,8368,30056
SAHIWAL DISTRICT,SAHIWAL TEHSIL,15,21499,8504,30003
SAHIWAL DISTRICT,SAHIWAL TEHSIL,16,21666,8613,30279
SAHIWAL DISTRICT,SAHIWAL TEHSIL,17,21126,9271,30397
SAHIWAL DISTRICT,SAHIWAL TEHSIL,18,21255,7798,29053
SAHIWAL DISTRICT,SAHIWAL TEHSIL,19,20479,8803,29282
SAHIWAL DISTRICT,SAHIWAL TEHSIL,20,20592,7717,28309
SAHIWAL DISTRICT,SAHIWAL TEHSIL,21,19355,8980,28335
SAHIWAL DISTRICT,SAHIWAL TEHSIL,22,19785,8232,28017
SAHIWAL DISTRICT,SAHIWAL TEHSIL,23,18550,8461,27011
SAHIWAL DISTRICT,SAHIWAL TEHSIL,24,17600,8079,25679
SAHIWAL DISTRICT,SAHIWAL TEHSIL,25,18707,7053,25760
SAHIWAL DISTRICT,SAHIWAL TEHSIL,26,16763,7892,24655
SAHIWAL DISTRICT,SAHIWAL TEHSIL,27,16212,7800,24012
SAHIWAL DISTRICT,SAHIWAL TEHSIL,28,16330,7397,23727
SAHIWAL DISTRICT,SAHIWAL TEHSIL,29,16093,7009,23102
SAHIWAL DISTRICT,SAHIWAL TEHSIL,30,17168,6979,24147
SAHIWAL DISTRICT,SAHIWAL TEHSIL,31,14951,6603,21554
SAHIWAL DISTRICT,SAHIWAL TEHSIL,32,14912,6878,21790
SAHIWAL DISTRICT,SAHIWAL TEHSIL,33,13538,6276,19814
SAHIWAL DISTRICT,SAHIWAL TEHSIL,34,13053,5810,18863
SAHIWAL DISTRICT,SAHIWAL TEHSIL,35,14487,5606,20093
SAHIWAL DISTRICT,SAHIWAL TEHSIL,36,12824,5480,18304
SAHIWAL DISTRICT,SAHIWAL TEHSIL,37,12491,4932,17423
SAHIWAL DISTRICT,SAHIWAL TEHSIL,38,12385,5797,18182
SAHIWAL DISTRICT,SAHIWAL TEHSIL,39,12754,5206,17960
SAHIWAL DISTRICT,SAHIWAL TEHSIL,40,12319,5579,17898
SAHIWAL DISTRICT,SAHIWAL TEHSIL,41,11303,4595,15898
SAHIWAL DISTRICT,SAHIWAL TEHSIL,42,10733,4532,15265
SAHIWAL DISTRICT,SAHIWAL TEHSIL,43,9265,4343,13608
SAHIWAL DISTRICT,SAHIWAL TEHSIL,44,8763,3984,12747
SAHIWAL DISTRICT,SAHIWAL TEHSIL,45,9718,4196,13914
SAHIWAL DISTRICT,SAHIWAL TEHSIL,46,8264,3587,11851
SAHIWAL DISTRICT,SAHIWAL TEHSIL,47,8652,3353,12005
SAHIWAL DISTRICT,SAHIWAL TEHSIL,48,8397,3988,12385
SAHIWAL DISTRICT,SAHIWAL TEHSIL,49,8914,3853,12767
SAHIWAL DISTRICT,SAHIWAL TEHSIL,50,9128,4045,13173
SAHIWAL DISTRICT,SAHIWAL TEHSIL,51,8681,3512,12193
SAHIWAL DISTRICT,SAHIWAL TEHSIL,52,8422,3651,12073
SAHIWAL DISTRICT,SAHIWAL TEHSIL,53,7631,3479,11110
SAHIWAL DISTRICT,SAHIWAL TEHSIL,54,6991,3173,10164
SAHIWAL DISTRICT,SAHIWAL TEHSIL,55,7048,3050,10098
SAHIWAL DISTRICT,SAHIWAL TEHSIL,56,6081,2513,8594
SAHIWAL DISTRICT,SAHIWAL TEHSIL,57,6103,2241,8344
SAHIWAL DISTRICT,SAHIWAL TEHSIL,58,5410,2317,7727
SAHIWAL DISTRICT,SAHIWAL TEHSIL,59,5563,2239,7802
SAHIWAL DISTRICT,SAHIWAL TEHSIL,60,5292,2227,7519
SAHIWAL DISTRICT,SAHIWAL TEHSIL,61,5010,1953,6963
SAHIWAL DISTRICT,SAHIWAL TEHSIL,62,4859,1954,6813
SAHIWAL DISTRICT,SAHIWAL TEHSIL,63,4593,1949,6542
SAHIWAL DISTRICT,SAHIWAL TEHSIL,64,4388,1662,6050
SAHIWAL DISTRICT,SAHIWAL TEHSIL,65,4374,1631,6005
SAHIWAL DISTRICT,SAHIWAL TEHSIL,66,3304,1210,4514
SAHIWAL DISTRICT,SAHIWAL TEHSIL,67,3352,1078,4430
SAHIWAL DISTRICT,SAHIWAL TEHSIL,68,3303,1142,4445
SAHIWAL DISTRICT,SAHIWAL TEHSIL,69,3454,1056,4510
SAHIWAL DISTRICT,SAHIWAL TEHSIL,70,3499,1067,4566
SAHIWAL DISTRICT,SAHIWAL TEHSIL,71,2892,884,3776
SAHIWAL DISTRICT,SAHIWAL TEHSIL,72,2701,972,3673
SAHIWAL DISTRICT,SAHIWAL TEHSIL,73,2485,890,3375
SAHIWAL DISTRICT,SAHIWAL TEHSIL,74,2494,731,3225
SAHIWAL DISTRICT,SAHIWAL TEHSIL,>=75,17165,5430,22595
SANGHAR DISTRICT,JAM NAWAZ ALI TALUKA,<1,2905,557,3462
SANGHAR DISTRICT,JAM NAWAZ ALI TALUKA,1,4121,777,4898
SANGHAR DISTRICT,JAM NAWAZ ALI TALUKA,2,4495,826,5321
SANGHAR DISTRICT,JAM NAWAZ ALI TALUKA,3,4875,899,5774
SANGHAR DISTRICT,JAM NAWAZ ALI TALUKA,4,4756,862,5618
SANGHAR DISTRICT,JAM NAWAZ ALI TALUKA,5,4849,947,5796
SANGHAR DISTRICT,JAM NAWAZ ALI TALUKA,6,4833,847,5680
SANGHAR DISTRICT,JAM NAWAZ ALI TALUKA,7,4173,865,5038
SANGHAR DISTRICT,JAM NAWAZ ALI TALUKA,8,4937,940,5877
SANGHAR DISTRICT,JAM NAWAZ ALI TALUKA,9,3594,698,4292
SANGHAR DISTRICT,JAM NAWAZ ALI TALUKA,10,4293,874,5167
SANGHAR DISTRICT,JAM NAWAZ ALI TALUKA,11,2934,628,3562
SANGHAR DISTRICT,JAM NAWAZ ALI TALUKA,12,3203,725,3928
SANGHAR DISTRICT,JAM NAWAZ ALI TALUKA,13,2494,601,3095
SANGHAR DISTRICT,JAM NAWAZ ALI TALUKA,14,2463,612,3075
SANGHAR DISTRICT,JAM NAWAZ ALI TALUKA,15,2696,680,3376
SANGHAR DISTRICT,JAM NAWAZ ALI TALUKA,16,2553,561,3114
SANGHAR DISTRICT,JAM NAWAZ ALI TALUKA,17,2033,580,2613
SANGHAR DISTRICT,JAM NAWAZ ALI TALUKA,18,2874,619,3493
SANGHAR DISTRICT,JAM NAWAZ ALI TALUKA,19,2158,569,2727
SANGHAR DISTRICT,JAM NAWAZ ALI TALUKA,20,2589,662,3251
SANGHAR DISTRICT,JAM NAWAZ ALI TALUKA,21,1731,490,2221
SANGHAR DISTRICT,JAM NAWAZ ALI TALUKA,22,1818,434,2252
SANGHAR DISTRICT,JAM NAWAZ ALI TALUKA,23,1568,374,1942
SANGHAR DISTRICT,JAM NAWAZ ALI TALUKA,24,1532,357,1889
SANGHAR DISTRICT,JAM NAWAZ ALI TALUKA,25,1917,384,2301
SANGHAR DISTRICT,JAM NAWAZ ALI TALUKA,26,1400,330,1730
SANGHAR DISTRICT,JAM NAWAZ ALI TALUKA,27,1768,390,2158
SANGHAR DISTRICT,JAM NAWAZ ALI TALUKA,28,1606,370,1976
SANGHAR DISTRICT,JAM NAWAZ ALI TALUKA,29,1958,457,2415
SANGHAR DISTRICT,JAM NAWAZ ALI TALUKA,30,1698,400,2098
SANGHAR DISTRICT,JAM NAWAZ ALI TALUKA,31,1732,365,2097
SANGHAR DISTRICT,JAM NAWAZ ALI TALUKA,32,1653,416,2069
SANGHAR DISTRICT,JAM NAWAZ ALI TALUKA,33,1556,339,1895
SANGHAR DISTRICT,JAM NAWAZ ALI TALUKA,34,1447,314,1761
SANGHAR DISTRICT,JAM NAWAZ ALI TALUKA,35,1576,374,1950
SANGHAR DISTRICT,JAM NAWAZ ALI TALUKA,36,1361,289,1650
SANGHAR DISTRICT,JAM NAWAZ ALI TALUKA,37,2177,423,2600
SANGHAR DISTRICT,JAM NAWAZ ALI TALUKA,38,1211,283,1494
SANGHAR DISTRICT,JAM NAWAZ ALI TALUKA,39,1648,360,2008
SANGHAR DISTRICT,JAM NAWAZ ALI TALUKA,40,1089,322,1411
SANGHAR DISTRICT,JAM NAWAZ ALI TALUKA,41,1066,261,1327
SANGHAR DISTRICT,JAM NAWAZ ALI TALUKA,42,1200,302,1502
SANGHAR DISTRICT,JAM NAWAZ ALI TALUKA,43,989,225,1214
SANGHAR DISTRICT,JAM NAWAZ ALI TALUKA,44,914,201,1115
SANGHAR DISTRICT,JAM NAWAZ ALI TALUKA,45,843,201,1044
SANGHAR DISTRICT,JAM NAWAZ ALI TALUKA,46,794,177,971
SANGHAR DISTRICT,JAM NAWAZ ALI TALUKA,47,1275,264,1539
SANGHAR DISTRICT,JAM NAWAZ ALI TALUKA,48,823,180,1003
SANGHAR DISTRICT,JAM NAWAZ ALI TALUKA,49,916,180,1096
SANGHAR DISTRICT,JAM NAWAZ ALI TALUKA,50,664,191,855
SANGHAR DISTRICT,JAM NAWAZ ALI TALUKA,51,688,176,864
SANGHAR DISTRICT,JAM NAWAZ ALI TALUKA,52,739,156,895
SANGHAR DISTRICT,JAM NAWAZ ALI TALUKA,53,540,143,683
SANGHAR DISTRICT,JAM NAWAZ ALI TALUKA,54,493,112,605
SANGHAR DISTRICT,JAM NAWAZ ALI TALUKA,55,460,117,577
SANGHAR DISTRICT,JAM NAWAZ ALI TALUKA,56,371,75,446
SANGHAR DISTRICT,JAM NAWAZ ALI TALUKA,57,572,108,680
SANGHAR DISTRICT,JAM NAWAZ ALI TALUKA,58,396,78,474
SANGHAR DISTRICT,JAM NAWAZ ALI TALUKA,59,413,120,533
SANGHAR DISTRICT,JAM NAWAZ ALI TALUKA,60,393,98,491
SANGHAR DISTRICT,JAM NAWAZ ALI TALUKA,61,405,92,497
SANGHAR DISTRICT,JAM NAWAZ ALI TALUKA,62,464,83,547
SANGHAR DISTRICT,JAM NAWAZ ALI TALUKA,63,382,86,468
SANGHAR DISTRICT,JAM NAWAZ ALI TALUKA,64,396,89,485
SANGHAR DISTRICT,JAM NAWAZ ALI TALUKA,65,329,66,395
SANGHAR DISTRICT,JAM NAWAZ ALI TALUKA,66,255,53,308
SANGHAR DISTRICT,JAM NAWAZ ALI TALUKA,67,355,51,406
SANGHAR DISTRICT,JAM NAWAZ ALI TALUKA,68,268,47,315
SANGHAR DISTRICT,JAM NAWAZ ALI TALUKA,69,259,46,305
SANGHAR DISTRICT,JAM NAWAZ ALI TALUKA,70,220,48,268
SANGHAR DISTRICT,JAM NAWAZ ALI TALUKA,71,226,46,272
SANGHAR DISTRICT,JAM NAWAZ ALI TALUKA,72,141,40,181
SANGHAR DISTRICT,JAM NAWAZ ALI TALUKA,73,174,41,215
SANGHAR DISTRICT,JAM NAWAZ ALI TALUKA,74,146,26,172
SANGHAR DISTRICT,JAM NAWAZ ALI TALUKA,>=75,1142,229,1371
SANGHAR DISTRICT,KHIPRO TALUKA,<1,6494,1138,7632
SANGHAR DISTRICT,KHIPRO TALUKA,1,8369,1279,9648
SANGHAR DISTRICT,KHIPRO TALUKA,2,9958,1479,11437
SANGHAR DISTRICT,KHIPRO TALUKA,3,9995,1541,11536
SANGHAR DISTRICT,KHIPRO TALUKA,4,10439,1580,12019
SANGHAR DISTRICT,KHIPRO TALUKA,5,10010,1567,11577
SANGHAR DISTRICT,KHIPRO TALUKA,6,10640,1512,12152
SANGHAR DISTRICT,KHIPRO TALUKA,7,8146,1444,9590
SANGHAR DISTRICT,KHIPRO TALUKA,8,11399,1579,12978
SANGHAR DISTRICT,KHIPRO TALUKA,9,7622,1356,8978
SANGHAR DISTRICT,KHIPRO TALUKA,10,9771,1458,11229
SANGHAR DISTRICT,KHIPRO TALUKA,11,5998,1214,7212
SANGHAR DISTRICT,KHIPRO TALUKA,12,7760,1351,9111
SANGHAR DISTRICT,KHIPRO TALUKA,13,5483,1163,6646
SANGHAR DISTRICT,KHIPRO TALUKA,14,6058,1129,7187
SANGHAR DISTRICT,KHIPRO TALUKA,15,5946,1181,7127
SANGHAR DISTRICT,KHIPRO TALUKA,16,5430,1143,6573
SANGHAR DISTRICT,KHIPRO TALUKA,17,4347,1154,5501
SANGHAR DISTRICT,KHIPRO TALUKA,18,6250,1052,7302
SANGHAR DISTRICT,KHIPRO TALUKA,19,4988,937,5925
SANGHAR DISTRICT,KHIPRO TALUKA,20,5875,1103,6978
SANGHAR DISTRICT,KHIPRO TALUKA,21,4447,932,5379
SANGHAR DISTRICT,KHIPRO TALUKA,22,4184,866,5050
SANGHAR DISTRICT,KHIPRO TALUKA,23,3809,840,4649
SANGHAR DISTRICT,KHIPRO TALUKA,24,3418,708,4126
SANGHAR DISTRICT,KHIPRO TALUKA,25,4068,872,4940
SANGHAR DISTRICT,KHIPRO TALUKA,26,3232,722,3954
SANGHAR DISTRICT,KHIPRO TALUKA,27,4246,823,5069
SANGHAR DISTRICT,KHIPRO TALUKA,28,3887,747,4634
SANGHAR DISTRICT,KHIPRO TALUKA,29,4277,791,5068
SANGHAR DISTRICT,KHIPRO TALUKA,30,3574,764,4338
SANGHAR DISTRICT,KHIPRO TALUKA,31,3797,764,4561
SANGHAR DISTRICT,KHIPRO TALUKA,32,3748,772,4520
SANGHAR DISTRICT,KHIPRO TALUKA,33,3461,688,4149
SANGHAR DISTRICT,KHIPRO TALUKA,34,3436,667,4103
SANGHAR DISTRICT,KHIPRO TALUKA,35,3612,742,4354
SANGHAR DISTRICT,KHIPRO TALUKA,36,3350,566,3916
SANGHAR DISTRICT,KHIPRO TALUKA,37,5453,849,6302
SANGHAR DISTRICT,KHIPRO TALUKA,38,2922,561,3483
SANGHAR DISTRICT,KHIPRO TALUKA,39,3857,693,4550
SANGHAR DISTRICT,KHIPRO TALUKA,40,2283,548,2831
SANGHAR DISTRICT,KHIPRO TALUKA,41,2497,498,2995
SANGHAR DISTRICT,KHIPRO TALUKA,42,2705,567,3272
SANGHAR DISTRICT,KHIPRO TALUKA,43,1979,447,2426
SANGHAR DISTRICT,KHIPRO TALUKA,44,1880,404,2284
SANGHAR DISTRICT,KHIPRO TALUKA,45,1682,413,2095
SANGHAR DISTRICT,KHIPRO TALUKA,46,1699,340,2039
SANGHAR DISTRICT,KHIPRO TALUKA,47,2753,497,3250
SANGHAR DISTRICT,KHIPRO TALUKA,48,1738,347,2085
SANGHAR DISTRICT,KHIPRO TALUKA,49,1959,408,2367
SANGHAR DISTRICT,KHIPRO TALUKA,50,1435,323,1758
SANGHAR DISTRICT,KHIPRO TALUKA,51,1686,326,2012
SANGHAR DISTRICT,KHIPRO TALUKA,52,1689,326,2015
SANGHAR DISTRICT,KHIPRO TALUKA,53,1313,258,1571
SANGHAR DISTRICT,KHIPRO TALUKA,54,1035,221,1256
SANGHAR DISTRICT,KHIPRO TALUKA,55,1026,252,1278
SANGHAR DISTRICT,KHIPRO TALUKA,56,836,173,1009
SANGHAR DISTRICT,KHIPRO TALUKA,57,1453,220,1673
SANGHAR DISTRICT,KHIPRO TALUKA,58,736,161,897
SANGHAR DISTRICT,KHIPRO TALUKA,59,959,182,1141
SANGHAR DISTRICT,KHIPRO TALUKA,60,817,162,979
SANGHAR DISTRICT,KHIPRO TALUKA,61,962,171,1133
SANGHAR DISTRICT,KHIPRO TALUKA,62,1027,183,1210
SANGHAR DISTRICT,KHIPRO TALUKA,63,868,181,1049
SANGHAR DISTRICT,KHIPRO TALUKA,64,805,165,970
SANGHAR DISTRICT,KHIPRO TALUKA,65,805,151,956
SANGHAR DISTRICT,KHIPRO TALUKA,66,817,108,925
SANGHAR DISTRICT,KHIPRO TALUKA,67,1028,154,1182
SANGHAR DISTRICT,KHIPRO TALUKA,68,698,113,811
SANGHAR DISTRICT,KHIPRO TALUKA,69,651,94,745
SANGHAR DISTRICT,KHIPRO TALUKA,70,549,96,645
SANGHAR DISTRICT,KHIPRO TALUKA,71,643,76,719
SANGHAR DISTRICT,KHIPRO TALUKA,72,617,93,710
SANGHAR DISTRICT,KHIPRO TALUKA,73,536,78,614
SANGHAR DISTRICT,KHIPRO TALUKA,74,391,38,429
SANGHAR DISTRICT,KHIPRO TALUKA,>=75,3524,495,4019
SANGHAR DISTRICT,SANGHAR TALUKA,<1,7593,1993,9586
SANGHAR DISTRICT,SANGHAR TALUKA,1,9922,2117,12039
SANGHAR DISTRICT,SANGHAR TALUKA,2,11459,2333,13792
SANGHAR DISTRICT,SANGHAR TALUKA,3,12054,2737,14791
SANGHAR DISTRICT,SANGHAR TALUKA,4,12754,2579,15333
SANGHAR DISTRICT,SANGHAR TALUKA,5,12159,2736,14895
SANGHAR DISTRICT,SANGHAR TALUKA,6,12632,2483,15115
SANGHAR DISTRICT,SANGHAR TALUKA,7,10671,2582,13253
SANGHAR DISTRICT,SANGHAR TALUKA,8,12950,2421,15371
SANGHAR DISTRICT,SANGHAR TALUKA,9,9760,2453,12213
SANGHAR DISTRICT,SANGHAR TALUKA,10,11766,2254,14020
SANGHAR DISTRICT,SANGHAR TALUKA,11,8106,2335,10441
SANGHAR DISTRICT,SANGHAR TALUKA,12,9423,2178,11601
SANGHAR DISTRICT,SANGHAR TALUKA,13,7350,2167,9517
SANGHAR DISTRICT,SANGHAR TALUKA,14,7761,1983,9744
SANGHAR DISTRICT,SANGHAR TALUKA,15,7397,2204,9601
SANGHAR DISTRICT,SANGHAR TALUKA,16,7200,2017,9217
SANGHAR DISTRICT,SANGHAR TALUKA,17,5991,2232,8223
SANGHAR DISTRICT,SANGHAR TALUKA,18,7535,2079,9614
SANGHAR DISTRICT,SANGHAR TALUKA,19,5805,2015,7820
SANGHAR DISTRICT,SANGHAR TALUKA,20,7086,1796,8882
SANGHAR DISTRICT,SANGHAR TALUKA,21,5006,1875,6881
SANGHAR DISTRICT,SANGHAR TALUKA,22,5172,1703,6875
SANGHAR DISTRICT,SANGHAR TALUKA,23,4548,1688,6236
SANGHAR DISTRICT,SANGHAR TALUKA,24,4300,1573,5873
SANGHAR DISTRICT,SANGHAR TALUKA,25,5246,1571,6817
SANGHAR DISTRICT,SANGHAR TALUKA,26,4084,1439,5523
SANGHAR DISTRICT,SANGHAR TALUKA,27,4239,1518,5757
SANGHAR DISTRICT,SANGHAR TALUKA,28,4709,1481,6190
SANGHAR DISTRICT,SANGHAR TALUKA,29,4722,1585,6307
SANGHAR DISTRICT,SANGHAR TALUKA,30,5126,1263,6389
SANGHAR DISTRICT,SANGHAR TALUKA,31,4591,1387,5978
SANGHAR DISTRICT,SANGHAR TALUKA,32,4701,1484,6185
SANGHAR DISTRICT,SANGHAR TALUKA,33,4293,1446,5739
SANGHAR DISTRICT,SANGHAR TALUKA,34,4115,1312,5427
SANGHAR DISTRICT,SANGHAR TALUKA,35,4342,1091,5433
SANGHAR DISTRICT,SANGHAR TALUKA,36,3729,1061,4790
SANGHAR DISTRICT,SANGHAR TALUKA,37,4727,1321,6048
SANGHAR DISTRICT,SANGHAR TALUKA,38,3582,1164,4746
SANGHAR DISTRICT,SANGHAR TALUKA,39,3694,1218,4912
SANGHAR DISTRICT,SANGHAR TALUKA,40,3288,921,4209
SANGHAR DISTRICT,SANGHAR TALUKA,41,2879,992,3871
SANGHAR DISTRICT,SANGHAR TALUKA,42,2923,1034,3957
SANGHAR DISTRICT,SANGHAR TALUKA,43,2480,914,3394
SANGHAR DISTRICT,SANGHAR TALUKA,44,2614,923,3537
SANGHAR DISTRICT,SANGHAR TALUKA,45,2456,832,3288
SANGHAR DISTRICT,SANGHAR TALUKA,46,2394,825,3219
SANGHAR DISTRICT,SANGHAR TALUKA,47,2604,918,3522
SANGHAR DISTRICT,SANGHAR TALUKA,48,2190,785,2975
SANGHAR DISTRICT,SANGHAR TALUKA,49,2466,854,3320
SANGHAR DISTRICT,SANGHAR TALUKA,50,2071,672,2743
SANGHAR DISTRICT,SANGHAR TALUKA,51,1928,720,2648
SANGHAR DISTRICT,SANGHAR TALUKA,52,1746,654,2400
SANGHAR DISTRICT,SANGHAR TALUKA,53,1627,637,2264
SANGHAR DISTRICT,SANGHAR TALUKA,54,1354,544,1898
SANGHAR DISTRICT,SANGHAR TALUKA,55,1435,434,1869
SANGHAR DISTRICT,SANGHAR TALUKA,56,1137,421,1558
SANGHAR DISTRICT,SANGHAR TALUKA,57,1371,387,1758
SANGHAR DISTRICT,SANGHAR TALUKA,58,996,316,1312
SANGHAR DISTRICT,SANGHAR TALUKA,59,1055,383,1438
SANGHAR DISTRICT,SANGHAR TALUKA,60,1268,276,1544
SANGHAR DISTRICT,SANGHAR TALUKA,61,1093,368,1461
SANGHAR DISTRICT,SANGHAR TALUKA,62,1116,366,1482
SANGHAR DISTRICT,SANGHAR TALUKA,63,1030,351,1381
SANGHAR DISTRICT,SANGHAR TALUKA,64,1016,294,1310
SANGHAR DISTRICT,SANGHAR TALUKA,65,955,267,1222
SANGHAR DISTRICT,SANGHAR TALUKA,66,916,229,1145
SANGHAR DISTRICT,SANGHAR TALUKA,67,982,237,1219
SANGHAR DISTRICT,SANGHAR TALUKA,68,809,267,1076
SANGHAR DISTRICT,SANGHAR TALUKA,69,717,203,920
SANGHAR DISTRICT,SANGHAR TALUKA,70,607,151,758
SANGHAR DISTRICT,SANGHAR TALUKA,71,591,169,760
SANGHAR DISTRICT,SANGHAR TALUKA,72,564,150,714
SANGHAR DISTRICT,SANGHAR TALUKA,73,562,200,762
SANGHAR DISTRICT,SANGHAR TALUKA,74,382,103,485
SANGHAR DISTRICT,SANGHAR TALUKA,>=75,3385,814,4199
SANGHAR DISTRICT,SHAHDADPUR TALUKA,<1,5733,4155,9888
SANGHAR DISTRICT,SHAHDADPUR TALUKA,1,7673,4603,12276
SANGHAR DISTRICT,SHAHDADPUR TALUKA,2,8618,4930,13548
SANGHAR DISTRICT,SHAHDADPUR TALUKA,3,8936,5754,14690
SANGHAR DISTRICT,SHAHDADPUR TALUKA,4,9867,5541,15408
SANGHAR DISTRICT,SHAHDADPUR TALUKA,5,9352,5727,15079
SANGHAR DISTRICT,SHAHDADPUR TALUKA,6,9784,5545,15329
SANGHAR DISTRICT,SHAHDADPUR TALUKA,7,8189,5571,13760
SANGHAR DISTRICT,SHAHDADPUR TALUKA,8,9911,5527,15438
SANGHAR DISTRICT,SHAHDADPUR TALUKA,9,7465,5134,12599
SANGHAR DISTRICT,SHAHDADPUR TALUKA,10,8872,5016,13888
SANGHAR DISTRICT,SHAHDADPUR TALUKA,11,6182,4709,10891
SANGHAR DISTRICT,SHAHDADPUR TALUKA,12,7438,4674,12112
SANGHAR DISTRICT,SHAHDADPUR TALUKA,13,5416,4463,9879
SANGHAR DISTRICT,SHAHDADPUR TALUKA,14,5985,4222,10207
SANGHAR DISTRICT,SHAHDADPUR TALUKA,15,5736,4458,10194
SANGHAR DISTRICT,SHAHDADPUR TALUKA,16,5819,4264,10083
SANGHAR DISTRICT,SHAHDADPUR TALUKA,17,4803,4252,9055
SANGHAR DISTRICT,SHAHDADPUR TALUKA,18,5877,4288,10165
SANGHAR DISTRICT,SHAHDADPUR TALUKA,19,4623,4022,8645
SANGHAR DISTRICT,SHAHDADPUR TALUKA,20,5470,3942,9412
SANGHAR DISTRICT,SHAHDADPUR TALUKA,21,4051,3724,7775
SANGHAR DISTRICT,SHAHDADPUR TALUKA,22,4286,3466,7752
SANGHAR DISTRICT,SHAHDADPUR TALUKA,23,3709,3217,6926
SANGHAR DISTRICT,SHAHDADPUR TALUKA,24,3558,2968,6526
SANGHAR DISTRICT,SHAHDADPUR TALUKA,25,3975,3040,7015
SANGHAR DISTRICT,SHAHDADPUR TALUKA,26,3679,2951,6630
SANGHAR DISTRICT,SHAHDADPUR TALUKA,27,4065,3168,7233
SANGHAR DISTRICT,SHAHDADPUR TALUKA,28,4021,2946,6967
SANGHAR DISTRICT,SHAHDADPUR TALUKA,29,4042,3116,7158
SANGHAR DISTRICT,SHAHDADPUR TALUKA,30,3875,2764,6639
SANGHAR DISTRICT,SHAHDADPUR TALUKA,31,3743,2924,6667
SANGHAR DISTRICT,SHAHDADPUR TALUKA,32,3623,2808,6431
SANGHAR DISTRICT,SHAHDADPUR TALUKA,33,3316,2672,5988
SANGHAR DISTRICT,SHAHDADPUR TALUKA,34,3159,2468,5627
SANGHAR DISTRICT,SHAHDADPUR TALUKA,35,3111,2380,5491
SANGHAR DISTRICT,SHAHDADPUR TALUKA,36,3296,2243,5539
SANGHAR DISTRICT,SHAHDADPUR TALUKA,37,3981,2877,6858
SANGHAR DISTRICT,SHAHDADPUR TALUKA,38,2848,2164,5012
SANGHAR DISTRICT,SHAHDADPUR TALUKA,39,3023,2440,5463
SANGHAR DISTRICT,SHAHDADPUR TALUKA,40,2428,1900,4328
SANGHAR DISTRICT,SHAHDADPUR TALUKA,41,2505,1891,4396
SANGHAR DISTRICT,SHAHDADPUR TALUKA,42,2596,2105,4701
SANGHAR DISTRICT,SHAHDADPUR TALUKA,43,2011,1753,3764
SANGHAR DISTRICT,SHAHDADPUR TALUKA,44,2110,1617,3727
SANGHAR DISTRICT,SHAHDADPUR TALUKA,45,1819,1436,3255
SANGHAR DISTRICT,SHAHDADPUR TALUKA,46,2085,1467,3552
SANGHAR DISTRICT,SHAHDADPUR TALUKA,47,2243,1807,4050
SANGHAR DISTRICT,SHAHDADPUR TALUKA,48,1876,1399,3275
SANGHAR DISTRICT,SHAHDADPUR TALUKA,49,1841,1530,3371
SANGHAR DISTRICT,SHAHDADPUR TALUKA,50,1533,1315,2848
SANGHAR DISTRICT,SHAHDADPUR TALUKA,51,1626,1332,2958
SANGHAR DISTRICT,SHAHDADPUR TALUKA,52,1478,1383,2861
SANGHAR DISTRICT,SHAHDADPUR TALUKA,53,1142,1156,2298
SANGHAR DISTRICT,SHAHDADPUR TALUKA,54,1026,953,1979
SANGHAR DISTRICT,SHAHDADPUR TALUKA,55,949,896,1845
SANGHAR DISTRICT,SHAHDADPUR TALUKA,56,959,722,1681
SANGHAR DISTRICT,SHAHDADPUR TALUKA,57,1233,948,2181
SANGHAR DISTRICT,SHAHDADPUR TALUKA,58,833,698,1531
SANGHAR DISTRICT,SHAHDADPUR TALUKA,59,905,757,1662
SANGHAR DISTRICT,SHAHDADPUR TALUKA,60,883,664,1547
SANGHAR DISTRICT,SHAHDADPUR TALUKA,61,938,746,1684
SANGHAR DISTRICT,SHAHDADPUR TALUKA,62,967,753,1720
SANGHAR DISTRICT,SHAHDADPUR TALUKA,63,802,680,1482
SANGHAR DISTRICT,SHAHDADPUR TALUKA,64,818,594,1412
SANGHAR DISTRICT,SHAHDADPUR TALUKA,65,701,493,1194
SANGHAR DISTRICT,SHAHDADPUR TALUKA,66,700,452,1152
SANGHAR DISTRICT,SHAHDADPUR TALUKA,67,671,485,1156
SANGHAR DISTRICT,SHAHDADPUR TALUKA,68,555,455,1010
SANGHAR DISTRICT,SHAHDADPUR TALUKA,69,598,416,1014
SANGHAR DISTRICT,SHAHDADPUR TALUKA,70,458,277,735
SANGHAR DISTRICT,SHAHDADPUR TALUKA,71,434,360,794
SANGHAR DISTRICT,SHAHDADPUR TALUKA,72,341,279,620
SANGHAR DISTRICT,SHAHDADPUR TALUKA,73,323,286,609
SANGHAR DISTRICT,SHAHDADPUR TALUKA,74,281,210,491
SANGHAR DISTRICT,SHAHDADPUR TALUKA,>=75,2167,1735,3902
SANGHAR DISTRICT,SINJHORO TALUKA,<1,5611,1173,6784
SANGHAR DISTRICT,SINJHORO TALUKA,1,7635,1299,8934
SANGHAR DISTRICT,SINJHORO TALUKA,2,8876,1471,10347
SANGHAR DISTRICT,SINJHORO TALUKA,3,9687,1670,11357
SANGHAR DISTRICT,SINJHORO TALUKA,4,9551,1757,11308
SANGHAR DISTRICT,SINJHORO TALUKA,5,9803,1767,11570
SANGHAR DISTRICT,SINJHORO TALUKA,6,9481,1793,11274
SANGHAR DISTRICT,SINJHORO TALUKA,7,8330,1597,9927
SANGHAR DISTRICT,SINJHORO TALUKA,8,9897,1835,11732
SANGHAR DISTRICT,SINJHORO TALUKA,9,7537,1523,9060
SANGHAR DISTRICT,SINJHORO TALUKA,10,8436,1666,10102
SANGHAR DISTRICT,SINJHORO TALUKA,11,6099,1393,7492
SANGHAR DISTRICT,SINJHORO TALUKA,12,7107,1496,8603
SANGHAR DISTRICT,SINJHORO TALUKA,13,5589,1283,6872
SANGHAR DISTRICT,SINJHORO TALUKA,14,5440,1359,6799
SANGHAR DISTRICT,SINJHORO TALUKA,15,6024,1418,7442
SANGHAR DISTRICT,SINJHORO TALUKA,16,5533,1263,6796
SANGHAR DISTRICT,SINJHORO TALUKA,17,4766,1252,6018
SANGHAR DISTRICT,SINJHORO TALUKA,18,5906,1362,7268
SANGHAR DISTRICT,SINJHORO TALUKA,19,4449,1183,5632
SANGHAR DISTRICT,SINJHORO TALUKA,20,5358,1271,6629
SANGHAR DISTRICT,SINJHORO TALUKA,21,3852,1031,4883
SANGHAR DISTRICT,SINJHORO TALUKA,22,4180,1028,5208
SANGHAR DISTRICT,SINJHORO TALUKA,23,3487,963,4450
SANGHAR DISTRICT,SINJHORO TALUKA,24,3199,867,4066
SANGHAR DISTRICT,SINJHORO TALUKA,25,4448,997,5445
SANGHAR DISTRICT,SINJHORO TALUKA,26,3087,832,3919
SANGHAR DISTRICT,SINJHORO TALUKA,27,3481,870,4351
SANGHAR DISTRICT,SINJHORO TALUKA,28,3480,861,4341
SANGHAR DISTRICT,SINJHORO TALUKA,29,3640,772,4412
SANGHAR DISTRICT,SINJHORO TALUKA,30,3789,924,4713
SANGHAR DISTRICT,SINJHORO TALUKA,31,3160,748,3908
SANGHAR DISTRICT,SINJHORO TALUKA,32,3457,769,4226
SANGHAR DISTRICT,SINJHORO TALUKA,33,3146,686,3832
SANGHAR DISTRICT,SINJHORO TALUKA,34,2845,722,3567
SANGHAR DISTRICT,SINJHORO TALUKA,35,3493,808,4301
SANGHAR DISTRICT,SINJHORO TALUKA,36,2746,669,3415
SANGHAR DISTRICT,SINJHORO TALUKA,37,4094,733,4827
SANGHAR DISTRICT,SINJHORO TALUKA,38,2718,616,3334
SANGHAR DISTRICT,SINJHORO TALUKA,39,3174,696,3870
SANGHAR DISTRICT,SINJHORO TALUKA,40,2658,665,3323
SANGHAR DISTRICT,SINJHORO TALUKA,41,2274,522,2796
SANGHAR DISTRICT,SINJHORO TALUKA,42,2326,496,2822
SANGHAR DISTRICT,SINJHORO TALUKA,43,1931,475,2406
SANGHAR DISTRICT,SINJHORO TALUKA,44,1885,421,2306
SANGHAR DISTRICT,SINJHORO TALUKA,45,1931,505,2436
SANGHAR DISTRICT,SINJHORO TALUKA,46,1628,399,2027
SANGHAR DISTRICT,SINJHORO TALUKA,47,2072,404,2476
SANGHAR DISTRICT,SINJHORO TALUKA,48,1618,409,2027
SANGHAR DISTRICT,SINJHORO TALUKA,49,1787,409,2196
SANGHAR DISTRICT,SINJHORO TALUKA,50,1762,456,2218
SANGHAR DISTRICT,SINJHORO TALUKA,51,1500,382,1882
SANGHAR DISTRICT,SINJHORO TALUKA,52,1323,347,1670
SANGHAR DISTRICT,SINJHORO TALUKA,53,1229,372,1601
SANGHAR DISTRICT,SINJHORO TALUKA,54,1066,289,1355
SANGHAR DISTRICT,SINJHORO TALUKA,55,1111,291,1402
SANGHAR DISTRICT,SINJHORO TALUKA,56,830,212,1042
SANGHAR DISTRICT,SINJHORO TALUKA,57,1157,235,1392
SANGHAR DISTRICT,SINJHORO TALUKA,58,757,201,958
SANGHAR DISTRICT,SINJHORO TALUKA,59,836,208,1044
SANGHAR DISTRICT,SINJHORO TALUKA,60,951,220,1171
SANGHAR DISTRICT,SINJHORO TALUKA,61,796,209,1005
SANGHAR DISTRICT,SINJHORO TALUKA,62,919,226,1145
SANGHAR DISTRICT,SINJHORO TALUKA,63,757,222,979
SANGHAR DISTRICT,SINJHORO TALUKA,64,837,191,1028
SANGHAR DISTRICT,SINJHORO TALUKA,65,724,183,907
SANGHAR DISTRICT,SINJHORO TALUKA,66,579,125,704
SANGHAR DISTRICT,SINJHORO TALUKA,67,653,111,764
SANGHAR DISTRICT,SINJHORO TALUKA,68,613,150,763
SANGHAR DISTRICT,SINJHORO TALUKA,69,520,117,637
SANGHAR DISTRICT,SINJHORO TALUKA,70,496,123,619
SANGHAR DISTRICT,SINJHORO TALUKA,71,409,106,515
SANGHAR DISTRICT,SINJHORO TALUKA,72,375,87,462
SANGHAR DISTRICT,SINJHORO TALUKA,73,475,119,594
SANGHAR DISTRICT,SINJHORO TALUKA,74,279,74,353
SANGHAR DISTRICT,SINJHORO TALUKA,>=75,2427,538,2965
SANGHAR DISTRICT,TANDO ADAM TALUKA,<1,4651,3073,7724
SANGHAR DISTRICT,TANDO ADAM TALUKA,1,5372,3343,8715
SANGHAR DISTRICT,TANDO ADAM TALUKA,2,6460,3742,10202
SANGHAR DISTRICT,TANDO ADAM TALUKA,3,6929,4066,10995
SANGHAR DISTRICT,TANDO ADAM TALUKA,4,7335,3990,11325
SANGHAR DISTRICT,TANDO ADAM TALUKA,5,7376,4097,11473
SANGHAR DISTRICT,TANDO ADAM TALUKA,6,7407,3850,11257
SANGHAR DISTRICT,TANDO ADAM TALUKA,7,6656,4174,10830
SANGHAR DISTRICT,TANDO ADAM TALUKA,8,7617,3781,11398
SANGHAR DISTRICT,TANDO ADAM TALUKA,9,5971,3956,9927
SANGHAR DISTRICT,TANDO ADAM TALUKA,10,6694,3647,10341
SANGHAR DISTRICT,TANDO ADAM TALUKA,11,4967,3918,8885
SANGHAR DISTRICT,TANDO ADAM TALUKA,12,5564,3519,9083
SANGHAR DISTRICT,TANDO ADAM TALUKA,13,4491,3493,7984
SANGHAR DISTRICT,TANDO ADAM TALUKA,14,4615,3286,7901
SANGHAR DISTRICT,TANDO ADAM TALUKA,15,4616,3494,8110
SANGHAR DISTRICT,TANDO ADAM TALUKA,16,4513,3379,7892
SANGHAR DISTRICT,TANDO ADAM TALUKA,17,3828,3685,7513
SANGHAR DISTRICT,TANDO ADAM TALUKA,18,4590,3381,7971
SANGHAR DISTRICT,TANDO ADAM TALUKA,19,3575,3371,6946
SANGHAR DISTRICT,TANDO ADAM TALUKA,20,4116,3003,7119
SANGHAR DISTRICT,TANDO ADAM TALUKA,21,2935,3184,6119
SANGHAR DISTRICT,TANDO ADAM TALUKA,22,2975,2916,5891
SANGHAR DISTRICT,TANDO ADAM TALUKA,23,2728,2759,5487
SANGHAR DISTRICT,TANDO ADAM TALUKA,24,2581,2624,5205
SANGHAR DISTRICT,TANDO ADAM TALUKA,25,3057,2536,5593
SANGHAR DISTRICT,TANDO ADAM TALUKA,26,2746,2510,5256
SANGHAR DISTRICT,TANDO ADAM TALUKA,27,2877,2624,5501
SANGHAR DISTRICT,TANDO ADAM TALUKA,28,2941,2530,5471
SANGHAR DISTRICT,TANDO ADAM TALUKA,29,3015,2511,5526
SANGHAR DISTRICT,TANDO ADAM TALUKA,30,2862,2490,5352
SANGHAR DISTRICT,TANDO ADAM TALUKA,31,3156,2541,5697
SANGHAR DISTRICT,TANDO ADAM TALUKA,32,2558,2302,4860
SANGHAR DISTRICT,TANDO ADAM TALUKA,33,2480,2172,4652
SANGHAR DISTRICT,TANDO ADAM TALUKA,34,2555,2012,4567
SANGHAR DISTRICT,TANDO ADAM TALUKA,35,2214,1942,4156
SANGHAR DISTRICT,TANDO ADAM TALUKA,36,3158,1821,4979
SANGHAR DISTRICT,TANDO ADAM TALUKA,37,3177,2084,5261
SANGHAR DISTRICT,TANDO ADAM TALUKA,38,2248,1766,4014
SANGHAR DISTRICT,TANDO ADAM TALUKA,39,2310,2030,4340
SANGHAR DISTRICT,TANDO ADAM TALUKA,40,1663,1793,3456
SANGHAR DISTRICT,TANDO ADAM TALUKA,41,2220,1652,3872
SANGHAR DISTRICT,TANDO ADAM TALUKA,42,1971,1679,3650
SANGHAR DISTRICT,TANDO ADAM TALUKA,43,1648,1627,3275
SANGHAR DISTRICT,TANDO ADAM TALUKA,44,1714,1432,3146
SANGHAR DISTRICT,TANDO ADAM TALUKA,45,1249,1307,2556
SANGHAR DISTRICT,TANDO ADAM TALUKA,46,1851,1188,3039
SANGHAR DISTRICT,TANDO ADAM TALUKA,47,1840,1308,3148
SANGHAR DISTRICT,TANDO ADAM TALUKA,48,1323,1196,2519
SANGHAR DISTRICT,TANDO ADAM TALUKA,49,1424,1343,2767
SANGHAR DISTRICT,TANDO ADAM TALUKA,50,1020,1121,2141
SANGHAR DISTRICT,TANDO ADAM TALUKA,51,1371,1193,2564
SANGHAR DISTRICT,TANDO ADAM TALUKA,52,1102,989,2091
SANGHAR DISTRICT,TANDO ADAM TALUKA,53,881,992,1873
SANGHAR DISTRICT,TANDO ADAM TALUKA,54,732,758,1490
SANGHAR DISTRICT,TANDO ADAM TALUKA,55,620,751,1371
SANGHAR DISTRICT,TANDO ADAM TALUKA,56,874,602,1476
SANGHAR DISTRICT,TANDO ADAM TALUKA,57,890,686,1576
SANGHAR DISTRICT,TANDO ADAM TALUKA,58,705,605,1310
SANGHAR DISTRICT,TANDO ADAM TALUKA,59,745,641,1386
SANGHAR DISTRICT,TANDO ADAM TALUKA,60,662,545,1207
SANGHAR DISTRICT,TANDO ADAM TALUKA,61,779,653,1432
SANGHAR DISTRICT,TANDO ADAM TALUKA,62,695,555,1250
SANGHAR DISTRICT,TANDO ADAM TALUKA,63,647,607,1254
SANGHAR DISTRICT,TANDO ADAM TALUKA,64,669,464,1133
SANGHAR DISTRICT,TANDO ADAM TALUKA,65,433,454,887
SANGHAR DISTRICT,TANDO ADAM TALUKA,66,602,394,996
SANGHAR DISTRICT,TANDO ADAM TALUKA,67,513,362,875
SANGHAR DISTRICT,TANDO ADAM TALUKA,68,404,348,752
SANGHAR DISTRICT,TANDO ADAM TALUKA,69,464,385,849
SANGHAR DISTRICT,TANDO ADAM TALUKA,70,328,261,589
SANGHAR DISTRICT,TANDO ADAM TALUKA,71,380,328,708
SANGHAR DISTRICT,TANDO ADAM TALUKA,72,248,260,508
SANGHAR DISTRICT,TANDO ADAM TALUKA,73,285,289,574
SANGHAR DISTRICT,TANDO ADAM TALUKA,74,246,185,431
SANGHAR DISTRICT,TANDO ADAM TALUKA,>=75,1884,1470,3354
SARGODHA DISTRICT,BHALWAL TEHSIL,<1,5049,2662,7711
SARGODHA DISTRICT,BHALWAL TEHSIL,1,5960,2920,8880
SARGODHA DISTRICT,BHALWAL TEHSIL,2,5822,2949,8771
SARGODHA DISTRICT,BHALWAL TEHSIL,3,6263,3092,9355
SARGODHA DISTRICT,BHALWAL TEHSIL,4,6165,3044,9209
SARGODHA DISTRICT,BHALWAL TEHSIL,5,6207,3038,9245
SARGODHA DISTRICT,BHALWAL TEHSIL,6,5857,2934,8791
SARGODHA DISTRICT,BHALWAL TEHSIL,7,6273,3139,9412
SARGODHA DISTRICT,BHALWAL TEHSIL,8,5776,2817,8593
SARGODHA DISTRICT,BHALWAL TEHSIL,9,6151,3231,9382
SARGODHA DISTRICT,BHALWAL TEHSIL,10,5442,2730,8172
SARGODHA DISTRICT,BHALWAL TEHSIL,11,5848,3061,8909
SARGODHA DISTRICT,BHALWAL TEHSIL,12,5035,2575,7610
SARGODHA DISTRICT,BHALWAL TEHSIL,13,5327,2844,8171
SARGODHA DISTRICT,BHALWAL TEHSIL,14,4847,2544,7391
SARGODHA DISTRICT,BHALWAL TEHSIL,15,5111,2610,7721
SARGODHA DISTRICT,BHALWAL TEHSIL,16,4989,2561,7550
SARGODHA DISTRICT,BHALWAL TEHSIL,17,5073,2789,7862
SARGODHA DISTRICT,BHALWAL TEHSIL,18,4244,2295,6539
SARGODHA DISTRICT,BHALWAL TEHSIL,19,4688,2627,7315
SARGODHA DISTRICT,BHALWAL TEHSIL,20,4200,2035,6235
SARGODHA DISTRICT,BHALWAL TEHSIL,21,4561,2577,7138
SARGODHA DISTRICT,BHALWAL TEHSIL,22,4037,2197,6234
SARGODHA DISTRICT,BHALWAL TEHSIL,23,3850,2249,6099
SARGODHA DISTRICT,BHALWAL TEHSIL,24,3843,2309,6152
SARGODHA DISTRICT,BHALWAL TEHSIL,25,3574,1791,5365
SARGODHA DISTRICT,BHALWAL TEHSIL,26,3534,2138,5672
SARGODHA DISTRICT,BHALWAL TEHSIL,27,3695,2050,5745
SARGODHA DISTRICT,BHALWAL TEHSIL,28,3416,1983,5399
SARGODHA DISTRICT,BHALWAL TEHSIL,29,3650,2059,5709
SARGODHA DISTRICT,BHALWAL TEHSIL,30,3272,1739,5011
SARGODHA DISTRICT,BHALWAL TEHSIL,31,3289,2034,5323
SARGODHA DISTRICT,BHALWAL TEHSIL,32,2975,1748,4723
SARGODHA DISTRICT,BHALWAL TEHSIL,33,2982,1814,4796
SARGODHA DISTRICT,BHALWAL TEHSIL,34,3046,1817,4863
SARGODHA DISTRICT,BHALWAL TEHSIL,35,2854,1428,4282
SARGODHA DISTRICT,BHALWAL TEHSIL,36,2814,1669,4483
SARGODHA DISTRICT,BHALWAL TEHSIL,37,2719,1430,4149
SARGODHA DISTRICT,BHALWAL TEHSIL,38,2495,1580,4075
SARGODHA DISTRICT,BHALWAL TEHSIL,39,2702,1459,4161
SARGODHA DISTRICT,BHALWAL TEHSIL,40,2365,1202,3567
SARGODHA DISTRICT,BHALWAL TEHSIL,41,2486,1360,3846
SARGODHA DISTRICT,BHALWAL TEHSIL,42,2125,1206,3331
SARGODHA DISTRICT,BHALWAL TEHSIL,43,1974,1239,3213
SARGODHA DISTRICT,BHALWAL TEHSIL,44,2094,1164,3258
SARGODHA DISTRICT,BHALWAL TEHSIL,45,1995,1051,3046
SARGODHA DISTRICT,BHALWAL TEHSIL,46,1930,1113,3043
SARGODHA DISTRICT,BHALWAL TEHSIL,47,2115,1076,3191
SARGODHA DISTRICT,BHALWAL TEHSIL,48,2028,1152,3180
SARGODHA DISTRICT,BHALWAL TEHSIL,49,2183,1146,3329
SARGODHA DISTRICT,BHALWAL TEHSIL,50,1973,980,2953
SARGODHA DISTRICT,BHALWAL TEHSIL,51,2079,1071,3150
SARGODHA DISTRICT,BHALWAL TEHSIL,52,2051,1025,3076
SARGODHA DISTRICT,BHALWAL TEHSIL,53,1828,969,2797
SARGODHA DISTRICT,BHALWAL TEHSIL,54,1804,925,2729
SARGODHA DISTRICT,BHALWAL TEHSIL,55,1480,696,2176
SARGODHA DISTRICT,BHALWAL TEHSIL,56,1426,773,2199
SARGODHA DISTRICT,BHALWAL TEHSIL,57,1346,569,1915
SARGODHA DISTRICT,BHALWAL TEHSIL,58,1254,630,1884
SARGODHA DISTRICT,BHALWAL TEHSIL,59,1297,606,1903
SARGODHA DISTRICT,BHALWAL TEHSIL,60,1311,535,1846
SARGODHA DISTRICT,BHALWAL TEHSIL,61,1304,652,1956
SARGODHA DISTRICT,BHALWAL TEHSIL,62,1235,579,1814
SARGODHA DISTRICT,BHALWAL TEHSIL,63,1213,530,1743
SARGODHA DISTRICT,BHALWAL TEHSIL,64,1158,517,1675
SARGODHA DISTRICT,BHALWAL TEHSIL,65,1009,429,1438
SARGODHA DISTRICT,BHALWAL TEHSIL,66,910,411,1321
SARGODHA DISTRICT,BHALWAL TEHSIL,67,995,364,1359
SARGODHA DISTRICT,BHALWAL TEHSIL,68,819,310,1129
SARGODHA DISTRICT,BHALWAL TEHSIL,69,764,322,1086
SARGODHA DISTRICT,BHALWAL TEHSIL,70,840,252,1092
SARGODHA DISTRICT,BHALWAL TEHSIL,71,783,310,1093
SARGODHA DISTRICT,BHALWAL TEHSIL,72,747,265,1012
SARGODHA DISTRICT,BHALWAL TEHSIL,73,598,248,846
SARGODHA DISTRICT,BHALWAL TEHSIL,74,554,205,759
SARGODHA DISTRICT,BHALWAL TEHSIL,>=75,4541,1507,6048
SARGODHA DISTRICT,BHERA TEHSIL,<1,5549,1252,6801
SARGODHA DISTRICT,BHERA TEHSIL,1,6315,1420,7735
SARGODHA DISTRICT,BHERA TEHSIL,2,6217,1273,7490
SARGODHA DISTRICT,BHERA TEHSIL,3,6949,1514,8463
SARGODHA DISTRICT,BHERA TEHSIL,4,6554,1382,7936
SARGODHA DISTRICT,BHERA TEHSIL,5,6692,1432,8124
SARGODHA DISTRICT,BHERA TEHSIL,6,6347,1308,7655
SARGODHA DISTRICT,BHERA TEHSIL,7,6704,1393,8097
SARGODHA DISTRICT,BHERA TEHSIL,8,5990,1326,7316
SARGODHA DISTRICT,BHERA TEHSIL,9,6713,1406,8119
SARGODHA DISTRICT,BHERA TEHSIL,10,5696,1179,6875
SARGODHA DISTRICT,BHERA TEHSIL,11,6573,1438,8011
SARGODHA DISTRICT,BHERA TEHSIL,12,5375,1247,6622
SARGODHA DISTRICT,BHERA TEHSIL,13,5796,1347,7143
SARGODHA DISTRICT,BHERA TEHSIL,14,5174,1198,6372
SARGODHA DISTRICT,BHERA TEHSIL,15,5472,1258,6730
SARGODHA DISTRICT,BHERA TEHSIL,16,5234,1296,6530
SARGODHA DISTRICT,BHERA TEHSIL,17,5537,1500,7037
SARGODHA DISTRICT,BHERA TEHSIL,18,4553,1153,5706
SARGODHA DISTRICT,BHERA TEHSIL,19,5268,1526,6794
SARGODHA DISTRICT,BHERA TEHSIL,20,4350,1097,5447
SARGODHA DISTRICT,BHERA TEHSIL,21,4960,1444,6404
SARGODHA DISTRICT,BHERA TEHSIL,22,4214,1170,5384
SARGODHA DISTRICT,BHERA TEHSIL,23,4215,1198,5413
SARGODHA DISTRICT,BHERA TEHSIL,24,4111,1191,5302
SARGODHA DISTRICT,BHERA TEHSIL,25,4091,1005,5096
SARGODHA DISTRICT,BHERA TEHSIL,26,3869,1053,4922
SARGODHA DISTRICT,BHERA TEHSIL,27,4369,1105,5474
SARGODHA DISTRICT,BHERA TEHSIL,28,3456,957,4413
SARGODHA DISTRICT,BHERA TEHSIL,29,4155,1003,5158
SARGODHA DISTRICT,BHERA TEHSIL,30,3442,776,4218
SARGODHA DISTRICT,BHERA TEHSIL,31,3712,1014,4726
SARGODHA DISTRICT,BHERA TEHSIL,32,3284,775,4059
SARGODHA DISTRICT,BHERA TEHSIL,33,3300,816,4116
SARGODHA DISTRICT,BHERA TEHSIL,34,3312,842,4154
SARGODHA DISTRICT,BHERA TEHSIL,35,2915,702,3617
SARGODHA DISTRICT,BHERA TEHSIL,36,2678,677,3355
SARGODHA DISTRICT,BHERA TEHSIL,37,3218,789,4007
SARGODHA DISTRICT,BHERA TEHSIL,38,2554,637,3191
SARGODHA DISTRICT,BHERA TEHSIL,39,2869,730,3599
SARGODHA DISTRICT,BHERA TEHSIL,40,2263,515,2778
SARGODHA DISTRICT,BHERA TEHSIL,41,2523,672,3195
SARGODHA DISTRICT,BHERA TEHSIL,42,2366,557,2923
SARGODHA DISTRICT,BHERA TEHSIL,43,2171,564,2735
SARGODHA DISTRICT,BHERA TEHSIL,44,2102,559,2661
SARGODHA DISTRICT,BHERA TEHSIL,45,1938,476,2414
SARGODHA DISTRICT,BHERA TEHSIL,46,2045,548,2593
SARGODHA DISTRICT,BHERA TEHSIL,47,2415,571,2986
SARGODHA DISTRICT,BHERA TEHSIL,48,2110,516,2626
SARGODHA DISTRICT,BHERA TEHSIL,49,2396,564,2960
SARGODHA DISTRICT,BHERA TEHSIL,50,2103,435,2538
SARGODHA DISTRICT,BHERA TEHSIL,51,2393,569,2962
SARGODHA DISTRICT,BHERA TEHSIL,52,2325,543,2868
SARGODHA DISTRICT,BHERA TEHSIL,53,2066,488,2554
SARGODHA DISTRICT,BHERA TEHSIL,54,2022,458,2480
SARGODHA DISTRICT,BHERA TEHSIL,55,1597,397,1994
SARGODHA DISTRICT,BHERA TEHSIL,56,1655,428,2083
SARGODHA DISTRICT,BHERA TEHSIL,57,1690,424,2114
SARGODHA DISTRICT,BHERA TEHSIL,58,1418,365,1783
SARGODHA DISTRICT,BHERA TEHSIL,59,1580,348,1928
SARGODHA DISTRICT,BHERA TEHSIL,60,1394,260,1654
SARGODHA DISTRICT,BHERA TEHSIL,61,1527,321,1848
SARGODHA DISTRICT,BHERA TEHSIL,62,1604,358,1962
SARGODHA DISTRICT,BHERA TEHSIL,63,1320,281,1601
SARGODHA DISTRICT,BHERA TEHSIL,64,1242,284,1526
SARGODHA DISTRICT,BHERA TEHSIL,65,1143,213,1356
SARGODHA DISTRICT,BHERA TEHSIL,66,1071,212,1283
SARGODHA DISTRICT,BHERA TEHSIL,67,1321,217,1538
SARGODHA DISTRICT,BHERA TEHSIL,68,912,177,1089
SARGODHA DISTRICT,BHERA TEHSIL,69,864,169,1033
SARGODHA DISTRICT,BHERA TEHSIL,70,801,134,935
SARGODHA DISTRICT,BHERA TEHSIL,71,872,151,1023
SARGODHA DISTRICT,BHERA TEHSIL,72,968,172,1140
SARGODHA DISTRICT,BHERA TEHSIL,73,652,162,814
SARGODHA DISTRICT,BHERA TEHSIL,74,598,89,687
SARGODHA DISTRICT,BHERA TEHSIL,>=75,5167,927,6094
SARGODHA DISTRICT,KOT MOMIN TEHSIL,<1,8942,1582,10524
SARGODHA DISTRICT,KOT MOMIN TEHSIL,1,10004,1528,11532
SARGODHA DISTRICT,KOT MOMIN TEHSIL,2,10057,1648,11705
SARGODHA DISTRICT,KOT MOMIN TEHSIL,3,10770,1725,12495
SARGODHA DISTRICT,KOT MOMIN TEHSIL,4,11642,1823,13465
SARGODHA DISTRICT,KOT MOMIN TEHSIL,5,10791,1700,12491
SARGODHA DISTRICT,KOT MOMIN TEHSIL,6,10732,1707,12439
SARGODHA DISTRICT,KOT MOMIN TEHSIL,7,10724,1774,12498
SARGODHA DISTRICT,KOT MOMIN TEHSIL,8,10526,1623,12149
SARGODHA DISTRICT,KOT MOMIN TEHSIL,9,10437,1927,12364
SARGODHA DISTRICT,KOT MOMIN TEHSIL,10,9353,1468,10821
SARGODHA DISTRICT,KOT MOMIN TEHSIL,11,9258,1841,11099
SARGODHA DISTRICT,KOT MOMIN TEHSIL,12,8234,1416,9650
SARGODHA DISTRICT,KOT MOMIN TEHSIL,13,8180,1545,9725
SARGODHA DISTRICT,KOT MOMIN TEHSIL,14,7661,1337,8998
SARGODHA DISTRICT,KOT MOMIN TEHSIL,15,7557,1340,8897
SARGODHA DISTRICT,KOT MOMIN TEHSIL,16,7566,1419,8985
SARGODHA DISTRICT,KOT MOMIN TEHSIL,17,7936,1300,9236
SARGODHA DISTRICT,KOT MOMIN TEHSIL,18,6824,1251,8075
SARGODHA DISTRICT,KOT MOMIN TEHSIL,19,7066,1343,8409
SARGODHA DISTRICT,KOT MOMIN TEHSIL,20,6732,1149,7881
SARGODHA DISTRICT,KOT MOMIN TEHSIL,21,6826,1297,8123
SARGODHA DISTRICT,KOT MOMIN TEHSIL,22,6325,1173,7498
SARGODHA DISTRICT,KOT MOMIN TEHSIL,23,5926,1095,7021
SARGODHA DISTRICT,KOT MOMIN TEHSIL,24,5878,1040,6918
SARGODHA DISTRICT,KOT MOMIN TEHSIL,25,6183,960,7143
SARGODHA DISTRICT,KOT MOMIN TEHSIL,26,6039,1075,7114
SARGODHA DISTRICT,KOT MOMIN TEHSIL,27,5825,1105,6930
SARGODHA DISTRICT,KOT MOMIN TEHSIL,28,5584,1010,6594
SARGODHA DISTRICT,KOT MOMIN TEHSIL,29,5810,1124,6934
SARGODHA DISTRICT,KOT MOMIN TEHSIL,30,5256,914,6170
SARGODHA DISTRICT,KOT MOMIN TEHSIL,31,5787,1006,6793
SARGODHA DISTRICT,KOT MOMIN TEHSIL,32,5121,921,6042
SARGODHA DISTRICT,KOT MOMIN TEHSIL,33,5057,879,5936
SARGODHA DISTRICT,KOT MOMIN TEHSIL,34,5174,938,6112
SARGODHA DISTRICT,KOT MOMIN TEHSIL,35,4468,686,5154
SARGODHA DISTRICT,KOT MOMIN TEHSIL,36,4962,825,5787
SARGODHA DISTRICT,KOT MOMIN TEHSIL,37,5067,823,5890
SARGODHA DISTRICT,KOT MOMIN TEHSIL,38,4359,741,5100
SARGODHA DISTRICT,KOT MOMIN TEHSIL,39,4345,799,5144
SARGODHA DISTRICT,KOT MOMIN TEHSIL,40,3542,618,4160
SARGODHA DISTRICT,KOT MOMIN TEHSIL,41,4323,728,5051
SARGODHA DISTRICT,KOT MOMIN TEHSIL,42,3575,605,4180
SARGODHA DISTRICT,KOT MOMIN TEHSIL,43,3306,559,3865
SARGODHA DISTRICT,KOT MOMIN TEHSIL,44,3300,605,3905
SARGODHA DISTRICT,KOT MOMIN TEHSIL,45,2828,487,3315
SARGODHA DISTRICT,KOT MOMIN TEHSIL,46,3545,659,4204
SARGODHA DISTRICT,KOT MOMIN TEHSIL,47,3560,535,4095
SARGODHA DISTRICT,KOT MOMIN TEHSIL,48,3091,576,3667
SARGODHA DISTRICT,KOT MOMIN TEHSIL,49,3210,634,3844
SARGODHA DISTRICT,KOT MOMIN TEHSIL,50,2730,488,3218
SARGODHA DISTRICT,KOT MOMIN TEHSIL,51,3599,594,4193
SARGODHA DISTRICT,KOT MOMIN TEHSIL,52,3311,516,3827
SARGODHA DISTRICT,KOT MOMIN TEHSIL,53,2682,473,3155
SARGODHA DISTRICT,KOT MOMIN TEHSIL,54,2555,428,2983
SARGODHA DISTRICT,KOT MOMIN TEHSIL,55,2079,377,2456
SARGODHA DISTRICT,KOT MOMIN TEHSIL,56,2486,370,2856
SARGODHA DISTRICT,KOT MOMIN TEHSIL,57,2214,367,2581
SARGODHA DISTRICT,KOT MOMIN TEHSIL,58,1825,280,2105
SARGODHA DISTRICT,KOT MOMIN TEHSIL,59,1964,317,2281
SARGODHA DISTRICT,KOT MOMIN TEHSIL,60,1871,282,2153
SARGODHA DISTRICT,KOT MOMIN TEHSIL,61,2328,378,2706
SARGODHA DISTRICT,KOT MOMIN TEHSIL,62,2027,272,2299
SARGODHA DISTRICT,KOT MOMIN TEHSIL,63,1849,262,2111
SARGODHA DISTRICT,KOT MOMIN TEHSIL,64,1864,249,2113
SARGODHA DISTRICT,KOT MOMIN TEHSIL,65,1674,206,1880
SARGODHA DISTRICT,KOT MOMIN TEHSIL,66,1961,308,2269
SARGODHA DISTRICT,KOT MOMIN TEHSIL,67,1762,229,1991
SARGODHA DISTRICT,KOT MOMIN TEHSIL,68,1272,163,1435
SARGODHA DISTRICT,KOT MOMIN TEHSIL,69,1367,184,1551
SARGODHA DISTRICT,KOT MOMIN TEHSIL,70,1256,176,1432
SARGODHA DISTRICT,KOT MOMIN TEHSIL,71,1512,218,1730
SARGODHA DISTRICT,KOT MOMIN TEHSIL,72,1280,167,1447
SARGODHA DISTRICT,KOT MOMIN TEHSIL,73,1003,148,1151
SARGODHA DISTRICT,KOT MOMIN TEHSIL,74,831,128,959
SARGODHA DISTRICT,KOT MOMIN TEHSIL,>=75,7913,1056,8969
SARGODHA DISTRICT,SAHIWAL TEHSIL,<1,5880,1712,7592
SARGODHA DISTRICT,SAHIWAL TEHSIL,1,6213,1707,7920
SARGODHA DISTRICT,SAHIWAL TEHSIL,2,6358,1729,8087
SARGODHA DISTRICT,SAHIWAL TEHSIL,3,6909,1876,8785
SARGODHA DISTRICT,SAHIWAL TEHSIL,4,7115,1912,9027
SARGODHA DISTRICT,SAHIWAL TEHSIL,5,6975,1786,8761
SARGODHA DISTRICT,SAHIWAL TEHSIL,6,6572,1700,8272
SARGODHA DISTRICT,SAHIWAL TEHSIL,7,7100,1911,9011
SARGODHA DISTRICT,SAHIWAL TEHSIL,8,6852,1708,8560
SARGODHA DISTRICT,SAHIWAL TEHSIL,9,6879,1868,8747
SARGODHA DISTRICT,SAHIWAL TEHSIL,10,6325,1626,7951
SARGODHA DISTRICT,SAHIWAL TEHSIL,11,6349,1977,8326
SARGODHA DISTRICT,SAHIWAL TEHSIL,12,5848,1593,7441
SARGODHA DISTRICT,SAHIWAL TEHSIL,13,5803,1666,7469
SARGODHA DISTRICT,SAHIWAL TEHSIL,14,5542,1624,7166
SARGODHA DISTRICT,SAHIWAL TEHSIL,15,5698,1697,7395
SARGODHA DISTRICT,SAHIWAL TEHSIL,16,5672,1733,7405
SARGODHA DISTRICT,SAHIWAL TEHSIL,17,6963,2057,9020
SARGODHA DISTRICT,SAHIWAL TEHSIL,18,4371,1288,5659
SARGODHA DISTRICT,SAHIWAL TEHSIL,19,4870,1573,6443
SARGODHA DISTRICT,SAHIWAL TEHSIL,20,4872,1434,6306
SARGODHA DISTRICT,SAHIWAL TEHSIL,21,4779,1557,6336
SARGODHA DISTRICT,SAHIWAL TEHSIL,22,4512,1375,5887
SARGODHA DISTRICT,SAHIWAL TEHSIL,23,4547,1503,6050
SARGODHA DISTRICT,SAHIWAL TEHSIL,24,4064,1355,5419
SARGODHA DISTRICT,SAHIWAL TEHSIL,25,4499,1349,5848
SARGODHA DISTRICT,SAHIWAL TEHSIL,26,3921,1224,5145
SARGODHA DISTRICT,SAHIWAL TEHSIL,27,4186,1353,5539
SARGODHA DISTRICT,SAHIWAL TEHSIL,28,4024,1249,5273
SARGODHA DISTRICT,SAHIWAL TEHSIL,29,4114,1276,5390
SARGODHA DISTRICT,SAHIWAL TEHSIL,30,4093,1145,5238
SARGODHA DISTRICT,SAHIWAL TEHSIL,31,3663,1165,4828
SARGODHA DISTRICT,SAHIWAL TEHSIL,32,3518,1109,4627
SARGODHA DISTRICT,SAHIWAL TEHSIL,33,3505,1055,4560
SARGODHA DISTRICT,SAHIWAL TEHSIL,34,3444,1034,4478
SARGODHA DISTRICT,SAHIWAL TEHSIL,35,3324,1011,4335
SARGODHA DISTRICT,SAHIWAL TEHSIL,36,2950,843,3793
SARGODHA DISTRICT,SAHIWAL TEHSIL,37,3021,993,4014
SARGODHA DISTRICT,SAHIWAL TEHSIL,38,2944,918,3862
SARGODHA DISTRICT,SAHIWAL TEHSIL,39,3012,967,3979
SARGODHA DISTRICT,SAHIWAL TEHSIL,40,2964,801,3765
SARGODHA DISTRICT,SAHIWAL TEHSIL,41,2762,788,3550
SARGODHA DISTRICT,SAHIWAL TEHSIL,42,2532,711,3243
SARGODHA DISTRICT,SAHIWAL TEHSIL,43,2418,722,3140
SARGODHA DISTRICT,SAHIWAL TEHSIL,44,2399,710,3109
SARGODHA DISTRICT,SAHIWAL TEHSIL,45,2421,717,3138
SARGODHA DISTRICT,SAHIWAL TEHSIL,46,2230,627,2857
SARGODHA DISTRICT,SAHIWAL TEHSIL,47,2398,701,3099
SARGODHA DISTRICT,SAHIWAL TEHSIL,48,2431,742,3173
SARGODHA DISTRICT,SAHIWAL TEHSIL,49,2451,729,3180
SARGODHA DISTRICT,SAHIWAL TEHSIL,50,2437,682,3119
SARGODHA DISTRICT,SAHIWAL TEHSIL,51,2454,693,3147
SARGODHA DISTRICT,SAHIWAL TEHSIL,52,2227,648,2875
SARGODHA DISTRICT,SAHIWAL TEHSIL,53,2208,630,2838
SARGODHA DISTRICT,SAHIWAL TEHSIL,54,1871,611,2482
SARGODHA DISTRICT,SAHIWAL TEHSIL,55,1684,492,2176
SARGODHA DISTRICT,SAHIWAL TEHSIL,56,1522,429,1951
SARGODHA DISTRICT,SAHIWAL TEHSIL,57,1501,387,1888
SARGODHA DISTRICT,SAHIWAL TEHSIL,58,1212,382,1594
SARGODHA DISTRICT,SAHIWAL TEHSIL,59,1293,354,1647
SARGODHA DISTRICT,SAHIWAL TEHSIL,60,1397,375,1772
SARGODHA DISTRICT,SAHIWAL TEHSIL,61,1386,418,1804
SARGODHA DISTRICT,SAHIWAL TEHSIL,62,1230,373,1603
SARGODHA DISTRICT,SAHIWAL TEHSIL,63,1307,333,1640
SARGODHA DISTRICT,SAHIWAL TEHSIL,64,1039,351,1390
SARGODHA DISTRICT,SAHIWAL TEHSIL,65,1147,283,1430
SARGODHA DISTRICT,SAHIWAL TEHSIL,66,1063,208,1271
SARGODHA DISTRICT,SAHIWAL TEHSIL,67,929,275,1204
SARGODHA DISTRICT,SAHIWAL TEHSIL,68,851,219,1070
SARGODHA DISTRICT,SAHIWAL TEHSIL,69,818,180,998
SARGODHA DISTRICT,SAHIWAL TEHSIL,70,885,197,1082
SARGODHA DISTRICT,SAHIWAL TEHSIL,71,902,193,1095
SARGODHA DISTRICT,SAHIWAL TEHSIL,72,702,230,932
SARGODHA DISTRICT,SAHIWAL TEHSIL,73,688,174,862
SARGODHA DISTRICT,SAHIWAL TEHSIL,74,500,131,631
SARGODHA DISTRICT,SAHIWAL TEHSIL,>=75,4943,1053,5996
SARGODHA DISTRICT,SARGODHA TEHSIL,<1,20459,13661,34120
SARGODHA DISTRICT,SARGODHA TEHSIL,1,21085,14593,35678
SARGODHA DISTRICT,SARGODHA TEHSIL,2,21865,14900,36765
SARGODHA DISTRICT,SARGODHA TEHSIL,3,23590,16080,39670
SARGODHA DISTRICT,SARGODHA TEHSIL,4,23004,15074,38078
SARGODHA DISTRICT,SARGODHA TEHSIL,5,23368,15148,38516
SARGODHA DISTRICT,SARGODHA TEHSIL,6,22305,15134,37439
SARGODHA DISTRICT,SARGODHA TEHSIL,7,23877,15954,39831
SARGODHA DISTRICT,SARGODHA TEHSIL,8,21846,14256,36102
SARGODHA DISTRICT,SARGODHA TEHSIL,9,22596,15824,38420
SARGODHA DISTRICT,SARGODHA TEHSIL,10,20150,13461,33611
SARGODHA DISTRICT,SARGODHA TEHSIL,11,21394,15775,37169
SARGODHA DISTRICT,SARGODHA TEHSIL,12,18996,13107,32103
SARGODHA DISTRICT,SARGODHA TEHSIL,13,19304,14159,33463
SARGODHA DISTRICT,SARGODHA TEHSIL,14,17534,12979,30513
SARGODHA DISTRICT,SARGODHA TEHSIL,15,18112,13430,31542
SARGODHA DISTRICT,SARGODHA TEHSIL,16,18193,13380,31573
SARGODHA DISTRICT,SARGODHA TEHSIL,17,18814,15805,34619
SARGODHA DISTRICT,SARGODHA TEHSIL,18,17130,11594,28724
SARGODHA DISTRICT,SARGODHA TEHSIL,19,17881,14012,31893
SARGODHA DISTRICT,SARGODHA TEHSIL,20,16518,11849,28367
SARGODHA DISTRICT,SARGODHA TEHSIL,21,17642,14875,32517
SARGODHA DISTRICT,SARGODHA TEHSIL,22,16411,13467,29878
SARGODHA DISTRICT,SARGODHA TEHSIL,23,15894,13360,29254
SARGODHA DISTRICT,SARGODHA TEHSIL,24,14911,13228,28139
SARGODHA DISTRICT,SARGODHA TEHSIL,25,14704,11019,25723
SARGODHA DISTRICT,SARGODHA TEHSIL,26,14408,12099,26507
SARGODHA DISTRICT,SARGODHA TEHSIL,27,14766,11989,26755
SARGODHA DISTRICT,SARGODHA TEHSIL,28,13980,11451,25431
SARGODHA DISTRICT,SARGODHA TEHSIL,29,14466,11302,25768
SARGODHA DISTRICT,SARGODHA TEHSIL,30,13435,10171,23606
SARGODHA DISTRICT,SARGODHA TEHSIL,31,12959,10502,23461
SARGODHA DISTRICT,SARGODHA TEHSIL,32,12460,10462,22922
SARGODHA DISTRICT,SARGODHA TEHSIL,33,11873,9786,21659
SARGODHA DISTRICT,SARGODHA TEHSIL,34,10944,9040,19984
SARGODHA DISTRICT,SARGODHA TEHSIL,35,10793,8607,19400
SARGODHA DISTRICT,SARGODHA TEHSIL,36,9877,8134,18011
SARGODHA DISTRICT,SARGODHA TEHSIL,37,10240,7845,18085
SARGODHA DISTRICT,SARGODHA TEHSIL,38,10157,8847,19004
SARGODHA DISTRICT,SARGODHA TEHSIL,39,10092,8026,18118
SARGODHA DISTRICT,SARGODHA TEHSIL,40,9189,8235,17424
SARGODHA DISTRICT,SARGODHA TEHSIL,41,8520,7047,15567
SARGODHA DISTRICT,SARGODHA TEHSIL,42,8015,7038,15053
SARGODHA DISTRICT,SARGODHA TEHSIL,43,7976,6925,14901
SARGODHA DISTRICT,SARGODHA TEHSIL,44,7361,6168,13529
SARGODHA DISTRICT,SARGODHA TEHSIL,45,7256,6410,13666
SARGODHA DISTRICT,SARGODHA TEHSIL,46,6856,5520,12376
SARGODHA DISTRICT,SARGODHA TEHSIL,47,7430,5143,12573
SARGODHA DISTRICT,SARGODHA TEHSIL,48,7133,6075,13208
SARGODHA DISTRICT,SARGODHA TEHSIL,49,7561,5929,13490
SARGODHA DISTRICT,SARGODHA TEHSIL,50,7128,6198,13326
SARGODHA DISTRICT,SARGODHA TEHSIL,51,7088,5733,12821
SARGODHA DISTRICT,SARGODHA TEHSIL,52,7042,5738,12780
SARGODHA DISTRICT,SARGODHA TEHSIL,53,6812,5625,12437
SARGODHA DISTRICT,SARGODHA TEHSIL,54,6160,5198,11358
SARGODHA DISTRICT,SARGODHA TEHSIL,55,5685,4924,10609
SARGODHA DISTRICT,SARGODHA TEHSIL,56,5096,4048,9144
SARGODHA DISTRICT,SARGODHA TEHSIL,57,4838,3379,8217
SARGODHA DISTRICT,SARGODHA TEHSIL,58,4458,3909,8367
SARGODHA DISTRICT,SARGODHA TEHSIL,59,4456,3572,8028
SARGODHA DISTRICT,SARGODHA TEHSIL,60,4563,3507,8070
SARGODHA DISTRICT,SARGODHA TEHSIL,61,4521,3285,7806
SARGODHA DISTRICT,SARGODHA TEHSIL,62,4301,3177,7478
SARGODHA DISTRICT,SARGODHA TEHSIL,63,4364,3202,7566
SARGODHA DISTRICT,SARGODHA TEHSIL,64,3683,2680,6363
SARGODHA DISTRICT,SARGODHA TEHSIL,65,3542,2582,6124
SARGODHA DISTRICT,SARGODHA TEHSIL,66,3082,1828,4910
SARGODHA DISTRICT,SARGODHA TEHSIL,67,3120,1742,4862
SARGODHA DISTRICT,SARGODHA TEHSIL,68,2698,1837,4535
SARGODHA DISTRICT,SARGODHA TEHSIL,69,2541,1618,4159
SARGODHA DISTRICT,SARGODHA TEHSIL,70,2732,1631,4363
SARGODHA DISTRICT,SARGODHA TEHSIL,71,2639,1500,4139
SARGODHA DISTRICT,SARGODHA TEHSIL,72,2482,1451,3933
SARGODHA DISTRICT,SARGODHA TEHSIL,73,2072,1345,3417
SARGODHA DISTRICT,SARGODHA TEHSIL,74,1627,1092,2719
SARGODHA DISTRICT,SARGODHA TEHSIL,>=75,14884,8532,23416
SARGODHA DISTRICT,SHAHPUR TEHSIL,<1,6890,1481,8371
SARGODHA DISTRICT,SHAHPUR TEHSIL,1,6771,1664,8435
SARGODHA DISTRICT,SHAHPUR TEHSIL,2,7022,1617,8639
SARGODHA DISTRICT,SHAHPUR TEHSIL,3,7494,1733,9227
SARGODHA DISTRICT,SHAHPUR TEHSIL,4,7674,1675,9349
SARGODHA DISTRICT,SHAHPUR TEHSIL,5,7158,1613,8771
SARGODHA DISTRICT,SHAHPUR TEHSIL,6,6846,1541,8387
SARGODHA DISTRICT,SHAHPUR TEHSIL,7,7250,1620,8870
SARGODHA DISTRICT,SHAHPUR TEHSIL,8,6685,1463,8148
SARGODHA DISTRICT,SHAHPUR TEHSIL,9,7299,1606,8905
SARGODHA DISTRICT,SHAHPUR TEHSIL,10,6248,1396,7644
SARGODHA DISTRICT,SHAHPUR TEHSIL,11,7045,1672,8717
SARGODHA DISTRICT,SHAHPUR TEHSIL,12,5851,1274,7125
SARGODHA DISTRICT,SHAHPUR TEHSIL,13,6332,1474,7806
SARGODHA DISTRICT,SHAHPUR TEHSIL,14,5910,1280,7190
SARGODHA DISTRICT,SHAHPUR TEHSIL,15,6107,1294,7401
SARGODHA DISTRICT,SHAHPUR TEHSIL,16,6194,1363,7557
SARGODHA DISTRICT,SHAHPUR TEHSIL,17,7437,1595,9032
SARGODHA DISTRICT,SHAHPUR TEHSIL,18,4471,1056,5527
SARGODHA DISTRICT,SHAHPUR TEHSIL,19,5789,1367,7156
SARGODHA DISTRICT,SHAHPUR TEHSIL,20,4912,1131,6043
SARGODHA DISTRICT,SHAHPUR TEHSIL,21,5559,1441,7000
SARGODHA DISTRICT,SHAHPUR TEHSIL,22,4590,1184,5774
SARGODHA DISTRICT,SHAHPUR TEHSIL,23,4864,1372,6236
SARGODHA DISTRICT,SHAHPUR TEHSIL,24,4686,1381,6067
SARGODHA DISTRICT,SHAHPUR TEHSIL,25,4147,1039,5186
SARGODHA DISTRICT,SHAHPUR TEHSIL,26,4492,1268,5760
SARGODHA DISTRICT,SHAHPUR TEHSIL,27,4998,1270,6268
SARGODHA DISTRICT,SHAHPUR TEHSIL,28,4334,1135,5469
SARGODHA DISTRICT,SHAHPUR TEHSIL,29,4858,1250,6108
SARGODHA DISTRICT,SHAHPUR TEHSIL,30,3401,952,4353
SARGODHA DISTRICT,SHAHPUR TEHSIL,31,4240,1271,5511
SARGODHA DISTRICT,SHAHPUR TEHSIL,32,3589,1007,4596
SARGODHA DISTRICT,SHAHPUR TEHSIL,33,3742,1058,4800
SARGODHA DISTRICT,SHAHPUR TEHSIL,34,4077,1032,5109
SARGODHA DISTRICT,SHAHPUR TEHSIL,35,2845,666,3511
SARGODHA DISTRICT,SHAHPUR TEHSIL,36,3527,966,4493
SARGODHA DISTRICT,SHAHPUR TEHSIL,37,3500,873,4373
SARGODHA DISTRICT,SHAHPUR TEHSIL,38,2950,820,3770
SARGODHA DISTRICT,SHAHPUR TEHSIL,39,3194,852,4046
SARGODHA DISTRICT,SHAHPUR TEHSIL,40,2267,571,2838
SARGODHA DISTRICT,SHAHPUR TEHSIL,41,3128,767,3895
SARGODHA DISTRICT,SHAHPUR TEHSIL,42,2711,701,3412
SARGODHA DISTRICT,SHAHPUR TEHSIL,43,2484,654,3138
SARGODHA DISTRICT,SHAHPUR TEHSIL,44,2738,660,3398
SARGODHA DISTRICT,SHAHPUR TEHSIL,45,1919,495,2414
SARGODHA DISTRICT,SHAHPUR TEHSIL,46,2888,712,3600
SARGODHA DISTRICT,SHAHPUR TEHSIL,47,2776,639,3415
SARGODHA DISTRICT,SHAHPUR TEHSIL,48,2627,632,3259
SARGODHA DISTRICT,SHAHPUR TEHSIL,49,2967,816,3783
SARGODHA DISTRICT,SHAHPUR TEHSIL,50,1981,528,2509
SARGODHA DISTRICT,SHAHPUR TEHSIL,51,3148,770,3918
SARGODHA DISTRICT,SHAHPUR TEHSIL,52,2556,631,3187
SARGODHA DISTRICT,SHAHPUR TEHSIL,53,2503,681,3184
SARGODHA DISTRICT,SHAHPUR TEHSIL,54,2288,595,2883
SARGODHA DISTRICT,SHAHPUR TEHSIL,55,1520,390,1910
SARGODHA DISTRICT,SHAHPUR TEHSIL,56,1921,550,2471
SARGODHA DISTRICT,SHAHPUR TEHSIL,57,1766,408,2174
SARGODHA DISTRICT,SHAHPUR TEHSIL,58,1505,418,1923
SARGODHA DISTRICT,SHAHPUR TEHSIL,59,1620,360,1980
SARGODHA DISTRICT,SHAHPUR TEHSIL,60,1152,296,1448
SARGODHA DISTRICT,SHAHPUR TEHSIL,61,1804,472,2276
SARGODHA DISTRICT,SHAHPUR TEHSIL,62,1532,388,1920
SARGODHA DISTRICT,SHAHPUR TEHSIL,63,1466,363,1829
SARGODHA DISTRICT,SHAHPUR TEHSIL,64,1427,338,1765
SARGODHA DISTRICT,SHAHPUR TEHSIL,65,1011,218,1229
SARGODHA DISTRICT,SHAHPUR TEHSIL,66,1420,255,1675
SARGODHA DISTRICT,SHAHPUR TEHSIL,67,1245,277,1522
SARGODHA DISTRICT,SHAHPUR TEHSIL,68,1038,219,1257
SARGODHA DISTRICT,SHAHPUR TEHSIL,69,1037,206,1243
SARGODHA DISTRICT,SHAHPUR TEHSIL,70,701,183,884
SARGODHA DISTRICT,SHAHPUR TEHSIL,71,1002,212,1214
SARGODHA DISTRICT,SHAHPUR TEHSIL,72,889,189,1078
SARGODHA DISTRICT,SHAHPUR TEHSIL,73,741,147,888
SARGODHA DISTRICT,SHAHPUR TEHSIL,74,613,122,735
SARGODHA DISTRICT,SHAHPUR TEHSIL,>=75,5294,1047,6341
SARGODHA DISTRICT,SILLANWALI TEHSIL,<1,7715,872,8587
SARGODHA DISTRICT,SILLANWALI TEHSIL,1,7669,1007,8676
SARGODHA DISTRICT,SILLANWALI TEHSIL,2,7961,968,8929
SARGODHA DISTRICT,SILLANWALI TEHSIL,3,8847,974,9821
SARGODHA DISTRICT,SILLANWALI TEHSIL,4,8742,952,9694
SARGODHA DISTRICT,SILLANWALI TEHSIL,5,8785,942,9727
SARGODHA DISTRICT,SILLANWALI TEHSIL,6,8084,927,9011
SARGODHA DISTRICT,SILLANWALI TEHSIL,7,8842,1044,9886
SARGODHA DISTRICT,SILLANWALI TEHSIL,8,8185,905,9090
SARGODHA DISTRICT,SILLANWALI TEHSIL,9,8498,1017,9515
SARGODHA DISTRICT,SILLANWALI TEHSIL,10,7493,864,8357
SARGODHA DISTRICT,SILLANWALI TEHSIL,11,7766,1042,8808
SARGODHA DISTRICT,SILLANWALI TEHSIL,12,6800,804,7604
SARGODHA DISTRICT,SILLANWALI TEHSIL,13,6770,876,7646
SARGODHA DISTRICT,SILLANWALI TEHSIL,14,6276,824,7100
SARGODHA DISTRICT,SILLANWALI TEHSIL,15,6358,776,7134
SARGODHA DISTRICT,SILLANWALI TEHSIL,16,6162,819,6981
SARGODHA DISTRICT,SILLANWALI TEHSIL,17,7290,898,8188
SARGODHA DISTRICT,SILLANWALI TEHSIL,18,5316,603,5919
SARGODHA DISTRICT,SILLANWALI TEHSIL,19,5849,751,6600
SARGODHA DISTRICT,SILLANWALI TEHSIL,20,5535,699,6234
SARGODHA DISTRICT,SILLANWALI TEHSIL,21,5758,767,6525
SARGODHA DISTRICT,SILLANWALI TEHSIL,22,5368,689,6057
SARGODHA DISTRICT,SILLANWALI TEHSIL,23,5355,711,6066
SARGODHA DISTRICT,SILLANWALI TEHSIL,24,5010,654,5664
SARGODHA DISTRICT,SILLANWALI TEHSIL,25,4928,561,5489
SARGODHA DISTRICT,SILLANWALI TEHSIL,26,4851,657,5508
SARGODHA DISTRICT,SILLANWALI TEHSIL,27,5048,633,5681
SARGODHA DISTRICT,SILLANWALI TEHSIL,28,4627,668,5295
SARGODHA DISTRICT,SILLANWALI TEHSIL,29,4917,644,5561
SARGODHA DISTRICT,SILLANWALI TEHSIL,30,4315,517,4832
SARGODHA DISTRICT,SILLANWALI TEHSIL,31,4299,607,4906
SARGODHA DISTRICT,SILLANWALI TEHSIL,32,4230,591,4821
SARGODHA DISTRICT,SILLANWALI TEHSIL,33,3928,565,4493
SARGODHA DISTRICT,SILLANWALI TEHSIL,34,3921,541,4462
SARGODHA DISTRICT,SILLANWALI TEHSIL,35,3595,413,4008
SARGODHA DISTRICT,SILLANWALI TEHSIL,36,3351,470,3821
SARGODHA DISTRICT,SILLANWALI TEHSIL,37,3434,439,3873
SARGODHA DISTRICT,SILLANWALI TEHSIL,38,3518,448,3966
SARGODHA DISTRICT,SILLANWALI TEHSIL,39,3415,424,3839
SARGODHA DISTRICT,SILLANWALI TEHSIL,40,2893,373,3266
SARGODHA DISTRICT,SILLANWALI TEHSIL,41,3015,406,3421
SARGODHA DISTRICT,SILLANWALI TEHSIL,42,2862,366,3228
SARGODHA DISTRICT,SILLANWALI TEHSIL,43,2558,376,2934
SARGODHA DISTRICT,SILLANWALI TEHSIL,44,2460,333,2793
SARGODHA DISTRICT,SILLANWALI TEHSIL,45,2240,296,2536
SARGODHA DISTRICT,SILLANWALI TEHSIL,46,2494,341,2835
SARGODHA DISTRICT,SILLANWALI TEHSIL,47,2732,298,3030
SARGODHA DISTRICT,SILLANWALI TEHSIL,48,2582,360,2942
SARGODHA DISTRICT,SILLANWALI TEHSIL,49,2774,340,3114
SARGODHA DISTRICT,SILLANWALI TEHSIL,50,2316,298,2614
SARGODHA DISTRICT,SILLANWALI TEHSIL,51,2667,355,3022
SARGODHA DISTRICT,SILLANWALI TEHSIL,52,2465,300,2765
SARGODHA DISTRICT,SILLANWALI TEHSIL,53,2348,312,2660
SARGODHA DISTRICT,SILLANWALI TEHSIL,54,2060,274,2334
SARGODHA DISTRICT,SILLANWALI TEHSIL,55,1673,189,1862
SARGODHA DISTRICT,SILLANWALI TEHSIL,56,1740,194,1934
SARGODHA DISTRICT,SILLANWALI TEHSIL,57,1544,166,1710
SARGODHA DISTRICT,SILLANWALI TEHSIL,58,1376,179,1555
SARGODHA DISTRICT,SILLANWALI TEHSIL,59,1453,177,1630
SARGODHA DISTRICT,SILLANWALI TEHSIL,60,1321,150,1471
SARGODHA DISTRICT,SILLANWALI TEHSIL,61,1585,194,1779
SARGODHA DISTRICT,SILLANWALI TEHSIL,62,1469,161,1630
SARGODHA DISTRICT,SILLANWALI TEHSIL,63,1383,163,1546
SARGODHA DISTRICT,SILLANWALI TEHSIL,64,1152,152,1304
SARGODHA DISTRICT,SILLANWALI TEHSIL,65,1090,119,1209
SARGODHA DISTRICT,SILLANWALI TEHSIL,66,1208,118,1326
SARGODHA DISTRICT,SILLANWALI TEHSIL,67,1138,112,1250
SARGODHA DISTRICT,SILLANWALI TEHSIL,68,968,86,1054
SARGODHA DISTRICT,SILLANWALI TEHSIL,69,886,82,968
SARGODHA DISTRICT,SILLANWALI TEHSIL,70,893,85,978
SARGODHA DISTRICT,SILLANWALI TEHSIL,71,1060,96,1156
SARGODHA DISTRICT,SILLANWALI TEHSIL,72,962,84,1046
SARGODHA DISTRICT,SILLANWALI TEHSIL,73,756,75,831
SARGODHA DISTRICT,SILLANWALI TEHSIL,74,555,50,605
SARGODHA DISTRICT,SILLANWALI TEHSIL,>=75,5279,496,5775
SHAHEED BENAZIRABAD DISTRICT,DAUR TALUKA,<1,9145,1925,11070
SHAHEED BENAZIRABAD DISTRICT,DAUR TALUKA,1,11313,2444,13757
SHAHEED BENAZIRABAD DISTRICT,DAUR TALUKA,2,13457,2771,16228
SHAHEED BENAZIRABAD DISTRICT,DAUR TALUKA,3,14490,3064,17554
SHAHEED BENAZIRABAD DISTRICT,DAUR TALUKA,4,15525,3121,18646
SHAHEED BENAZIRABAD DISTRICT,DAUR TALUKA,5,14560,3246,17806
SHAHEED BENAZIRABAD DISTRICT,DAUR TALUKA,6,13942,3003,16945
SHAHEED BENAZIRABAD DISTRICT,DAUR TALUKA,7,12872,2926,15798
SHAHEED BENAZIRABAD DISTRICT,DAUR TALUKA,8,14162,3097,17259
SHAHEED BENAZIRABAD DISTRICT,DAUR TALUKA,9,10950,2608,13558
SHAHEED BENAZIRABAD DISTRICT,DAUR TALUKA,10,12277,2781,15058
SHAHEED BENAZIRABAD DISTRICT,DAUR TALUKA,11,8705,2252,10957
SHAHEED BENAZIRABAD DISTRICT,DAUR TALUKA,12,10181,2412,12593
SHAHEED BENAZIRABAD DISTRICT,DAUR TALUKA,13,7639,2110,9749
SHAHEED BENAZIRABAD DISTRICT,DAUR TALUKA,14,8359,2161,10520
SHAHEED BENAZIRABAD DISTRICT,DAUR TALUKA,15,8043,2110,10153
SHAHEED BENAZIRABAD DISTRICT,DAUR TALUKA,16,7978,2166,10144
SHAHEED BENAZIRABAD DISTRICT,DAUR TALUKA,17,6508,1858,8366
SHAHEED BENAZIRABAD DISTRICT,DAUR TALUKA,18,8258,2080,10338
SHAHEED BENAZIRABAD DISTRICT,DAUR TALUKA,19,6343,1896,8239
SHAHEED BENAZIRABAD DISTRICT,DAUR TALUKA,20,7845,1881,9726
SHAHEED BENAZIRABAD DISTRICT,DAUR TALUKA,21,5455,1604,7059
SHAHEED BENAZIRABAD DISTRICT,DAUR TALUKA,22,5479,1578,7057
SHAHEED BENAZIRABAD DISTRICT,DAUR TALUKA,23,4792,1355,6147
SHAHEED BENAZIRABAD DISTRICT,DAUR TALUKA,24,4802,1313,6115
SHAHEED BENAZIRABAD DISTRICT,DAUR TALUKA,25,5579,1439,7018
SHAHEED BENAZIRABAD DISTRICT,DAUR TALUKA,26,4873,1304,6177
SHAHEED BENAZIRABAD DISTRICT,DAUR TALUKA,27,4930,1359,6289
SHAHEED BENAZIRABAD DISTRICT,DAUR TALUKA,28,5638,1463,7101
SHAHEED BENAZIRABAD DISTRICT,DAUR TALUKA,29,5639,1584,7223
SHAHEED BENAZIRABAD DISTRICT,DAUR TALUKA,30,5533,1424,6957
SHAHEED BENAZIRABAD DISTRICT,DAUR TALUKA,31,5717,1411,7128
SHAHEED BENAZIRABAD DISTRICT,DAUR TALUKA,32,5143,1337,6480
SHAHEED BENAZIRABAD DISTRICT,DAUR TALUKA,33,4863,1238,6101
SHAHEED BENAZIRABAD DISTRICT,DAUR TALUKA,34,4800,1119,5919
SHAHEED BENAZIRABAD DISTRICT,DAUR TALUKA,35,4331,1101,5432
SHAHEED BENAZIRABAD DISTRICT,DAUR TALUKA,36,4668,1046,5714
SHAHEED BENAZIRABAD DISTRICT,DAUR TALUKA,37,4738,1147,5885
SHAHEED BENAZIRABAD DISTRICT,DAUR TALUKA,38,3998,1019,5017
SHAHEED BENAZIRABAD DISTRICT,DAUR TALUKA,39,3949,1044,4993
SHAHEED BENAZIRABAD DISTRICT,DAUR TALUKA,40,3490,895,4385
SHAHEED BENAZIRABAD DISTRICT,DAUR TALUKA,41,3795,878,4673
SHAHEED BENAZIRABAD DISTRICT,DAUR TALUKA,42,3257,887,4144
SHAHEED BENAZIRABAD DISTRICT,DAUR TALUKA,43,3148,809,3957
SHAHEED BENAZIRABAD DISTRICT,DAUR TALUKA,44,3048,766,3814
SHAHEED BENAZIRABAD DISTRICT,DAUR TALUKA,45,2734,734,3468
SHAHEED BENAZIRABAD DISTRICT,DAUR TALUKA,46,3197,754,3951
SHAHEED BENAZIRABAD DISTRICT,DAUR TALUKA,47,3251,765,4016
SHAHEED BENAZIRABAD DISTRICT,DAUR TALUKA,48,2692,707,3399
SHAHEED BENAZIRABAD DISTRICT,DAUR TALUKA,49,2839,672,3511
SHAHEED BENAZIRABAD DISTRICT,DAUR TALUKA,50,2343,581,2924
SHAHEED BENAZIRABAD DISTRICT,DAUR TALUKA,51,2477,632,3109
SHAHEED BENAZIRABAD DISTRICT,DAUR TALUKA,52,1959,530,2489
SHAHEED BENAZIRABAD DISTRICT,DAUR TALUKA,53,1731,439,2170
SHAHEED BENAZIRABAD DISTRICT,DAUR TALUKA,54,1482,433,1915
SHAHEED BENAZIRABAD DISTRICT,DAUR TALUKA,55,1424,379,1803
SHAHEED BENAZIRABAD DISTRICT,DAUR TALUKA,56,1452,363,1815
SHAHEED BENAZIRABAD DISTRICT,DAUR TALUKA,57,1636,395,2031
SHAHEED BENAZIRABAD DISTRICT,DAUR TALUKA,58,1296,277,1573
SHAHEED BENAZIRABAD DISTRICT,DAUR TALUKA,59,1205,317,1522
SHAHEED BENAZIRABAD DISTRICT,DAUR TALUKA,60,1324,322,1646
SHAHEED BENAZIRABAD DISTRICT,DAUR TALUKA,61,1461,355,1816
SHAHEED BENAZIRABAD DISTRICT,DAUR TALUKA,62,1352,346,1698
SHAHEED BENAZIRABAD DISTRICT,DAUR TALUKA,63,1325,337,1662
SHAHEED BENAZIRABAD DISTRICT,DAUR TALUKA,64,1252,283,1535
SHAHEED BENAZIRABAD DISTRICT,DAUR TALUKA,65,1045,233,1278
SHAHEED BENAZIRABAD DISTRICT,DAUR TALUKA,66,1239,241,1480
SHAHEED BENAZIRABAD DISTRICT,DAUR TALUKA,67,1063,235,1298
SHAHEED BENAZIRABAD DISTRICT,DAUR TALUKA,68,874,199,1073
SHAHEED BENAZIRABAD DISTRICT,DAUR TALUKA,69,794,158,952
SHAHEED BENAZIRABAD DISTRICT,DAUR TALUKA,70,702,161,863
SHAHEED BENAZIRABAD DISTRICT,DAUR TALUKA,71,792,196,988
SHAHEED BENAZIRABAD DISTRICT,DAUR TALUKA,72,707,143,850
SHAHEED BENAZIRABAD DISTRICT,DAUR TALUKA,73,552,167,719
SHAHEED BENAZIRABAD DISTRICT,DAUR TALUKA,74,458,95,553
SHAHEED BENAZIRABAD DISTRICT,DAUR TALUKA,>=75,3777,860,4637
SHAHEED BENAZIRABAD DISTRICT,KAZI AHMED TALUKA,<1,5959,1165,7124
SHAHEED BENAZIRABAD DISTRICT,KAZI AHMED TALUKA,1,8083,1264,9347
SHAHEED BENAZIRABAD DISTRICT,KAZI AHMED TALUKA,2,9246,1424,10670
SHAHEED BENAZIRABAD DISTRICT,KAZI AHMED TALUKA,3,11011,1740,12751
SHAHEED BENAZIRABAD DISTRICT,KAZI AHMED TALUKA,4,11188,1653,12841
SHAHEED BENAZIRABAD DISTRICT,KAZI AHMED TALUKA,5,11569,1757,13326
SHAHEED BENAZIRABAD DISTRICT,KAZI AHMED TALUKA,6,10553,1604,12157
SHAHEED BENAZIRABAD DISTRICT,KAZI AHMED TALUKA,7,9310,1621,10931
SHAHEED BENAZIRABAD DISTRICT,KAZI AHMED TALUKA,8,10418,1543,11961
SHAHEED BENAZIRABAD DISTRICT,KAZI AHMED TALUKA,9,8054,1416,9470
SHAHEED BENAZIRABAD DISTRICT,KAZI AHMED TALUKA,10,9081,1327,10408
SHAHEED BENAZIRABAD DISTRICT,KAZI AHMED TALUKA,11,6346,1187,7533
SHAHEED BENAZIRABAD DISTRICT,KAZI AHMED TALUKA,12,7467,1165,8632
SHAHEED BENAZIRABAD DISTRICT,KAZI AHMED TALUKA,13,5769,1132,6901
SHAHEED BENAZIRABAD DISTRICT,KAZI AHMED TALUKA,14,6068,1083,7151
SHAHEED BENAZIRABAD DISTRICT,KAZI AHMED TALUKA,15,6494,1207,7701
SHAHEED BENAZIRABAD DISTRICT,KAZI AHMED TALUKA,16,6030,1109,7139
SHAHEED BENAZIRABAD DISTRICT,KAZI AHMED TALUKA,17,5354,1067,6421
SHAHEED BENAZIRABAD DISTRICT,KAZI AHMED TALUKA,18,6953,1177,8130
SHAHEED BENAZIRABAD DISTRICT,KAZI AHMED TALUKA,19,5004,1016,6020
SHAHEED BENAZIRABAD DISTRICT,KAZI AHMED TALUKA,20,6193,1080,7273
SHAHEED BENAZIRABAD DISTRICT,KAZI AHMED TALUKA,21,4359,876,5235
SHAHEED BENAZIRABAD DISTRICT,KAZI AHMED TALUKA,22,4478,797,5275
SHAHEED BENAZIRABAD DISTRICT,KAZI AHMED TALUKA,23,3801,850,4651
SHAHEED BENAZIRABAD DISTRICT,KAZI AHMED TALUKA,24,3548,715,4263
SHAHEED BENAZIRABAD DISTRICT,KAZI AHMED TALUKA,25,5229,844,6073
SHAHEED BENAZIRABAD DISTRICT,KAZI AHMED TALUKA,26,3708,780,4488
SHAHEED BENAZIRABAD DISTRICT,KAZI AHMED TALUKA,27,4112,761,4873
SHAHEED BENAZIRABAD DISTRICT,KAZI AHMED TALUKA,28,4574,822,5396
SHAHEED BENAZIRABAD DISTRICT,KAZI AHMED TALUKA,29,4745,839,5584
SHAHEED BENAZIRABAD DISTRICT,KAZI AHMED TALUKA,30,4670,779,5449
SHAHEED BENAZIRABAD DISTRICT,KAZI AHMED TALUKA,31,4714,865,5579
SHAHEED BENAZIRABAD DISTRICT,KAZI AHMED TALUKA,32,4083,763,4846
SHAHEED BENAZIRABAD DISTRICT,KAZI AHMED TALUKA,33,3789,687,4476
SHAHEED BENAZIRABAD DISTRICT,KAZI AHMED TALUKA,34,3259,685,3944
SHAHEED BENAZIRABAD DISTRICT,KAZI AHMED TALUKA,35,3900,601,4501
SHAHEED BENAZIRABAD DISTRICT,KAZI AHMED TALUKA,36,3292,546,3838
SHAHEED BENAZIRABAD DISTRICT,KAZI AHMED TALUKA,37,4021,676,4697
SHAHEED BENAZIRABAD DISTRICT,KAZI AHMED TALUKA,38,3044,555,3599
SHAHEED BENAZIRABAD DISTRICT,KAZI AHMED TALUKA,39,3318,619,3937
SHAHEED BENAZIRABAD DISTRICT,KAZI AHMED TALUKA,40,3127,516,3643
SHAHEED BENAZIRABAD DISTRICT,KAZI AHMED TALUKA,41,2819,563,3382
SHAHEED BENAZIRABAD DISTRICT,KAZI AHMED TALUKA,42,2827,510,3337
SHAHEED BENAZIRABAD DISTRICT,KAZI AHMED TALUKA,43,2407,449,2856
SHAHEED BENAZIRABAD DISTRICT,KAZI AHMED TALUKA,44,2253,447,2700
SHAHEED BENAZIRABAD DISTRICT,KAZI AHMED TALUKA,45,2468,422,2890
SHAHEED BENAZIRABAD DISTRICT,KAZI AHMED TALUKA,46,2163,405,2568
SHAHEED BENAZIRABAD DISTRICT,KAZI AHMED TALUKA,47,2821,440,3261
SHAHEED BENAZIRABAD DISTRICT,KAZI AHMED TALUKA,48,1940,387,2327
SHAHEED BENAZIRABAD DISTRICT,KAZI AHMED TALUKA,49,2308,365,2673
SHAHEED BENAZIRABAD DISTRICT,KAZI AHMED TALUKA,50,2027,328,2355
SHAHEED BENAZIRABAD DISTRICT,KAZI AHMED TALUKA,51,1843,341,2184
SHAHEED BENAZIRABAD DISTRICT,KAZI AHMED TALUKA,52,1658,315,1973
SHAHEED BENAZIRABAD DISTRICT,KAZI AHMED TALUKA,53,1359,257,1616
SHAHEED BENAZIRABAD DISTRICT,KAZI AHMED TALUKA,54,1141,255,1396
SHAHEED BENAZIRABAD DISTRICT,KAZI AHMED TALUKA,55,1313,213,1526
SHAHEED BENAZIRABAD DISTRICT,KAZI AHMED TALUKA,56,1135,198,1333
SHAHEED BENAZIRABAD DISTRICT,KAZI AHMED TALUKA,57,1659,242,1901
SHAHEED BENAZIRABAD DISTRICT,KAZI AHMED TALUKA,58,1014,195,1209
SHAHEED BENAZIRABAD DISTRICT,KAZI AHMED TALUKA,59,1096,191,1287
SHAHEED BENAZIRABAD DISTRICT,KAZI AHMED TALUKA,60,1231,176,1407
SHAHEED BENAZIRABAD DISTRICT,KAZI AHMED TALUKA,61,1147,212,1359
SHAHEED BENAZIRABAD DISTRICT,KAZI AHMED TALUKA,62,1148,224,1372
SHAHEED BENAZIRABAD DISTRICT,KAZI AHMED TALUKA,63,1017,167,1184
SHAHEED BENAZIRABAD DISTRICT,KAZI AHMED TALUKA,64,1071,187,1258
SHAHEED BENAZIRABAD DISTRICT,KAZI AHMED TALUKA,65,907,134,1041
SHAHEED BENAZIRABAD DISTRICT,KAZI AHMED TALUKA,66,766,147,913
SHAHEED BENAZIRABAD DISTRICT,KAZI AHMED TALUKA,67,996,151,1147
SHAHEED BENAZIRABAD DISTRICT,KAZI AHMED TALUKA,68,622,120,742
SHAHEED BENAZIRABAD DISTRICT,KAZI AHMED TALUKA,69,765,103,868
SHAHEED BENAZIRABAD DISTRICT,KAZI AHMED TALUKA,70,639,88,727
SHAHEED BENAZIRABAD DISTRICT,KAZI AHMED TALUKA,71,587,93,680
SHAHEED BENAZIRABAD DISTRICT,KAZI AHMED TALUKA,72,535,97,632
SHAHEED BENAZIRABAD DISTRICT,KAZI AHMED TALUKA,73,445,74,519
SHAHEED BENAZIRABAD DISTRICT,KAZI AHMED TALUKA,74,436,53,489
SHAHEED BENAZIRABAD DISTRICT,KAZI AHMED TALUKA,>=75,3154,444,3598
SHAHEED BENAZIRABAD DISTRICT,NAWABSHAH TALUKA,<1,3157,5951,9108
SHAHEED BENAZIRABAD DISTRICT,NAWABSHAH TALUKA,1,3419,6608,10027
SHAHEED BENAZIRABAD DISTRICT,NAWABSHAH TALUKA,2,4472,7128,11600
SHAHEED BENAZIRABAD DISTRICT,NAWABSHAH TALUKA,3,4725,8152,12877
SHAHEED BENAZIRABAD DISTRICT,NAWABSHAH TALUKA,4,4941,7572,12513
SHAHEED BENAZIRABAD DISTRICT,NAWABSHAH TALUKA,5,4956,8013,12969
SHAHEED BENAZIRABAD DISTRICT,NAWABSHAH TALUKA,6,4873,7428,12301
SHAHEED BENAZIRABAD DISTRICT,NAWABSHAH TALUKA,7,4285,7814,12099
SHAHEED BENAZIRABAD DISTRICT,NAWABSHAH TALUKA,8,4956,7303,12259
SHAHEED BENAZIRABAD DISTRICT,NAWABSHAH TALUKA,9,3651,7082,10733
SHAHEED BENAZIRABAD DISTRICT,NAWABSHAH TALUKA,10,4248,6506,10754
SHAHEED BENAZIRABAD DISTRICT,NAWABSHAH TALUKA,11,2847,6396,9243
SHAHEED BENAZIRABAD DISTRICT,NAWABSHAH TALUKA,12,3580,6161,9741
SHAHEED BENAZIRABAD DISTRICT,NAWABSHAH TALUKA,13,2519,5876,8395
SHAHEED BENAZIRABAD DISTRICT,NAWABSHAH TALUKA,14,2924,5642,8566
SHAHEED BENAZIRABAD DISTRICT,NAWABSHAH TALUKA,15,2860,6188,9048
SHAHEED BENAZIRABAD DISTRICT,NAWABSHAH TALUKA,16,2862,5835,8697
SHAHEED BENAZIRABAD DISTRICT,NAWABSHAH TALUKA,17,2205,6311,8516
SHAHEED BENAZIRABAD DISTRICT,NAWABSHAH TALUKA,18,3150,5993,9143
SHAHEED BENAZIRABAD DISTRICT,NAWABSHAH TALUKA,19,2267,6142,8409
SHAHEED BENAZIRABAD DISTRICT,NAWABSHAH TALUKA,20,2897,6159,9056
SHAHEED BENAZIRABAD DISTRICT,NAWABSHAH TALUKA,21,1792,6131,7923
SHAHEED BENAZIRABAD DISTRICT,NAWABSHAH TALUKA,22,2072,5814,7886
SHAHEED BENAZIRABAD DISTRICT,NAWABSHAH TALUKA,23,1703,5472,7175
SHAHEED BENAZIRABAD DISTRICT,NAWABSHAH TALUKA,24,1638,4734,6372
SHAHEED BENAZIRABAD DISTRICT,NAWABSHAH TALUKA,25,2190,4881,7071
SHAHEED BENAZIRABAD DISTRICT,NAWABSHAH TALUKA,26,1706,4781,6487
SHAHEED BENAZIRABAD DISTRICT,NAWABSHAH TALUKA,27,1869,4760,6629
SHAHEED BENAZIRABAD DISTRICT,NAWABSHAH TALUKA,28,2056,4759,6815
SHAHEED BENAZIRABAD DISTRICT,NAWABSHAH TALUKA,29,2104,4597,6701
SHAHEED BENAZIRABAD DISTRICT,NAWABSHAH TALUKA,30,2024,4638,6662
SHAHEED BENAZIRABAD DISTRICT,NAWABSHAH TALUKA,31,1868,4395,6263
SHAHEED BENAZIRABAD DISTRICT,NAWABSHAH TALUKA,32,1939,4298,6237
SHAHEED BENAZIRABAD DISTRICT,NAWABSHAH TALUKA,33,1771,4087,5858
SHAHEED BENAZIRABAD DISTRICT,NAWABSHAH TALUKA,34,1567,3592,5159
SHAHEED BENAZIRABAD DISTRICT,NAWABSHAH TALUKA,35,1703,3649,5352
SHAHEED BENAZIRABAD DISTRICT,NAWABSHAH TALUKA,36,1490,3230,4720
SHAHEED BENAZIRABAD DISTRICT,NAWABSHAH TALUKA,37,1810,3243,5053
SHAHEED BENAZIRABAD DISTRICT,NAWABSHAH TALUKA,38,1381,3528,4909
SHAHEED BENAZIRABAD DISTRICT,NAWABSHAH TALUKA,39,1440,3418,4858
SHAHEED BENAZIRABAD DISTRICT,NAWABSHAH TALUKA,40,1359,3373,4732
SHAHEED BENAZIRABAD DISTRICT,NAWABSHAH TALUKA,41,1213,2917,4130
SHAHEED BENAZIRABAD DISTRICT,NAWABSHAH TALUKA,42,1221,2955,4176
SHAHEED BENAZIRABAD DISTRICT,NAWABSHAH TALUKA,43,1074,2762,3836
SHAHEED BENAZIRABAD DISTRICT,NAWABSHAH TALUKA,44,1047,2441,3488
SHAHEED BENAZIRABAD DISTRICT,NAWABSHAH TALUKA,45,1165,2573,3738
SHAHEED BENAZIRABAD DISTRICT,NAWABSHAH TALUKA,46,995,2167,3162
SHAHEED BENAZIRABAD DISTRICT,NAWABSHAH TALUKA,47,1268,2220,3488
SHAHEED BENAZIRABAD DISTRICT,NAWABSHAH TALUKA,48,986,2331,3317
SHAHEED BENAZIRABAD DISTRICT,NAWABSHAH TALUKA,49,970,2294,3264
SHAHEED BENAZIRABAD DISTRICT,NAWABSHAH TALUKA,50,939,2096,3035
SHAHEED BENAZIRABAD DISTRICT,NAWABSHAH TALUKA,51,876,2012,2888
SHAHEED BENAZIRABAD DISTRICT,NAWABSHAH TALUKA,52,738,1902,2640
SHAHEED BENAZIRABAD DISTRICT,NAWABSHAH TALUKA,53,614,1772,2386
SHAHEED BENAZIRABAD DISTRICT,NAWABSHAH TALUKA,54,549,1507,2056
SHAHEED BENAZIRABAD DISTRICT,NAWABSHAH TALUKA,55,559,1529,2088
SHAHEED BENAZIRABAD DISTRICT,NAWABSHAH TALUKA,56,549,1288,1837
SHAHEED BENAZIRABAD DISTRICT,NAWABSHAH TALUKA,57,667,1305,1972
SHAHEED BENAZIRABAD DISTRICT,NAWABSHAH TALUKA,58,410,1119,1529
SHAHEED BENAZIRABAD DISTRICT,NAWABSHAH TALUKA,59,489,1130,1619
SHAHEED BENAZIRABAD DISTRICT,NAWABSHAH TALUKA,60,507,1122,1629
SHAHEED BENAZIRABAD DISTRICT,NAWABSHAH TALUKA,61,488,1064,1552
SHAHEED BENAZIRABAD DISTRICT,NAWABSHAH TALUKA,62,504,1012,1516
SHAHEED BENAZIRABAD DISTRICT,NAWABSHAH TALUKA,63,471,1061,1532
SHAHEED BENAZIRABAD DISTRICT,NAWABSHAH TALUKA,64,408,845,1253
SHAHEED BENAZIRABAD DISTRICT,NAWABSHAH TALUKA,65,334,847,1181
SHAHEED BENAZIRABAD DISTRICT,NAWABSHAH TALUKA,66,411,677,1088
SHAHEED BENAZIRABAD DISTRICT,NAWABSHAH TALUKA,67,360,626,986
SHAHEED BENAZIRABAD DISTRICT,NAWABSHAH TALUKA,68,304,652,956
SHAHEED BENAZIRABAD DISTRICT,NAWABSHAH TALUKA,69,303,570,873
SHAHEED BENAZIRABAD DISTRICT,NAWABSHAH TALUKA,70,241,532,773
SHAHEED BENAZIRABAD DISTRICT,NAWABSHAH TALUKA,71,243,515,758
SHAHEED BENAZIRABAD DISTRICT,NAWABSHAH TALUKA,72,219,409,628
SHAHEED BENAZIRABAD DISTRICT,NAWABSHAH TALUKA,73,216,471,687
SHAHEED BENAZIRABAD DISTRICT,NAWABSHAH TALUKA,74,165,315,480
SHAHEED BENAZIRABAD DISTRICT,NAWABSHAH TALUKA,>=75,1285,2660,3945
SHAHEED BENAZIRABAD DISTRICT,SAKRAND TALUKA,<1,7477,1356,8833
SHAHEED BENAZIRABAD DISTRICT,SAKRAND TALUKA,1,7986,1777,9763
SHAHEED BENAZIRABAD DISTRICT,SAKRAND TALUKA,2,10062,1925,11987
SHAHEED BENAZIRABAD DISTRICT,SAKRAND TALUKA,3,11106,2177,13283
SHAHEED BENAZIRABAD DISTRICT,SAKRAND TALUKA,4,11665,2172,13837
SHAHEED BENAZIRABAD DISTRICT,SAKRAND TALUKA,5,11872,2207,14079
SHAHEED BENAZIRABAD DISTRICT,SAKRAND TALUKA,6,11225,2031,13256
SHAHEED BENAZIRABAD DISTRICT,SAKRAND TALUKA,7,9661,2043,11704
SHAHEED BENAZIRABAD DISTRICT,SAKRAND TALUKA,8,10929,2032,12961
SHAHEED BENAZIRABAD DISTRICT,SAKRAND TALUKA,9,8525,1695,10220
SHAHEED BENAZIRABAD DISTRICT,SAKRAND TALUKA,10,9705,1777,11482
SHAHEED BENAZIRABAD DISTRICT,SAKRAND TALUKA,11,7017,1531,8548
SHAHEED BENAZIRABAD DISTRICT,SAKRAND TALUKA,12,7895,1533,9428
SHAHEED BENAZIRABAD DISTRICT,SAKRAND TALUKA,13,6287,1435,7722
SHAHEED BENAZIRABAD DISTRICT,SAKRAND TALUKA,14,6741,1416,8157
SHAHEED BENAZIRABAD DISTRICT,SAKRAND TALUKA,15,6889,1575,8464
SHAHEED BENAZIRABAD DISTRICT,SAKRAND TALUKA,16,6555,1429,7984
SHAHEED BENAZIRABAD DISTRICT,SAKRAND TALUKA,17,5444,1403,6847
SHAHEED BENAZIRABAD DISTRICT,SAKRAND TALUKA,18,6713,1493,8206
SHAHEED BENAZIRABAD DISTRICT,SAKRAND TALUKA,19,4915,1322,6237
SHAHEED BENAZIRABAD DISTRICT,SAKRAND TALUKA,20,5933,1327,7260
SHAHEED BENAZIRABAD DISTRICT,SAKRAND TALUKA,21,4299,1149,5448
SHAHEED BENAZIRABAD DISTRICT,SAKRAND TALUKA,22,4377,1072,5449
SHAHEED BENAZIRABAD DISTRICT,SAKRAND TALUKA,23,3668,1010,4678
SHAHEED BENAZIRABAD DISTRICT,SAKRAND TALUKA,24,3736,881,4617
SHAHEED BENAZIRABAD DISTRICT,SAKRAND TALUKA,25,4486,1107,5593
SHAHEED BENAZIRABAD DISTRICT,SAKRAND TALUKA,26,4146,948,5094
SHAHEED BENAZIRABAD DISTRICT,SAKRAND TALUKA,27,4526,1203,5729
SHAHEED BENAZIRABAD DISTRICT,SAKRAND TALUKA,28,4735,984,5719
SHAHEED BENAZIRABAD DISTRICT,SAKRAND TALUKA,29,5016,1171,6187
SHAHEED BENAZIRABAD DISTRICT,SAKRAND TALUKA,30,4406,944,5350
SHAHEED BENAZIRABAD DISTRICT,SAKRAND TALUKA,31,4829,1073,5902
SHAHEED BENAZIRABAD DISTRICT,SAKRAND TALUKA,32,4235,998,5233
SHAHEED BENAZIRABAD DISTRICT,SAKRAND TALUKA,33,3854,863,4717
SHAHEED BENAZIRABAD DISTRICT,SAKRAND TALUKA,34,3690,809,4499
SHAHEED BENAZIRABAD DISTRICT,SAKRAND TALUKA,35,3301,698,3999
SHAHEED BENAZIRABAD DISTRICT,SAKRAND TALUKA,36,3662,708,4370
SHAHEED BENAZIRABAD DISTRICT,SAKRAND TALUKA,37,4207,929,5136
SHAHEED BENAZIRABAD DISTRICT,SAKRAND TALUKA,38,3023,696,3719
SHAHEED BENAZIRABAD DISTRICT,SAKRAND TALUKA,39,3355,792,4147
SHAHEED BENAZIRABAD DISTRICT,SAKRAND TALUKA,40,2935,635,3570
SHAHEED BENAZIRABAD DISTRICT,SAKRAND TALUKA,41,3185,706,3891
SHAHEED BENAZIRABAD DISTRICT,SAKRAND TALUKA,42,2921,674,3595
SHAHEED BENAZIRABAD DISTRICT,SAKRAND TALUKA,43,2492,599,3091
SHAHEED BENAZIRABAD DISTRICT,SAKRAND TALUKA,44,2582,538,3120
SHAHEED BENAZIRABAD DISTRICT,SAKRAND TALUKA,45,2188,526,2714
SHAHEED BENAZIRABAD DISTRICT,SAKRAND TALUKA,46,2700,495,3195
SHAHEED BENAZIRABAD DISTRICT,SAKRAND TALUKA,47,2979,691,3670
SHAHEED BENAZIRABAD DISTRICT,SAKRAND TALUKA,48,2122,470,2592
SHAHEED BENAZIRABAD DISTRICT,SAKRAND TALUKA,49,2239,580,2819
SHAHEED BENAZIRABAD DISTRICT,SAKRAND TALUKA,50,1858,399,2257
SHAHEED BENAZIRABAD DISTRICT,SAKRAND TALUKA,51,1986,470,2456
SHAHEED BENAZIRABAD DISTRICT,SAKRAND TALUKA,52,1733,461,2194
SHAHEED BENAZIRABAD DISTRICT,SAKRAND TALUKA,53,1389,343,1732
SHAHEED BENAZIRABAD DISTRICT,SAKRAND TALUKA,54,1154,320,1474
SHAHEED BENAZIRABAD DISTRICT,SAKRAND TALUKA,55,1099,278,1377
SHAHEED BENAZIRABAD DISTRICT,SAKRAND TALUKA,56,1298,229,1527
SHAHEED BENAZIRABAD DISTRICT,SAKRAND TALUKA,57,1588,397,1985
SHAHEED BENAZIRABAD DISTRICT,SAKRAND TALUKA,58,1064,226,1290
SHAHEED BENAZIRABAD DISTRICT,SAKRAND TALUKA,59,1088,246,1334
SHAHEED BENAZIRABAD DISTRICT,SAKRAND TALUKA,60,1073,188,1261
SHAHEED BENAZIRABAD DISTRICT,SAKRAND TALUKA,61,1125,254,1379
SHAHEED BENAZIRABAD DISTRICT,SAKRAND TALUKA,62,1168,280,1448
SHAHEED BENAZIRABAD DISTRICT,SAKRAND TALUKA,63,1002,212,1214
SHAHEED BENAZIRABAD DISTRICT,SAKRAND TALUKA,64,992,174,1166
SHAHEED BENAZIRABAD DISTRICT,SAKRAND TALUKA,65,789,160,949
SHAHEED BENAZIRABAD DISTRICT,SAKRAND TALUKA,66,919,151,1070
SHAHEED BENAZIRABAD DISTRICT,SAKRAND TALUKA,67,965,188,1153
SHAHEED BENAZIRABAD DISTRICT,SAKRAND TALUKA,68,666,116,782
SHAHEED BENAZIRABAD DISTRICT,SAKRAND TALUKA,69,670,117,787
SHAHEED BENAZIRABAD DISTRICT,SAKRAND TALUKA,70,485,92,577
SHAHEED BENAZIRABAD DISTRICT,SAKRAND TALUKA,71,514,101,615
SHAHEED BENAZIRABAD DISTRICT,SAKRAND TALUKA,72,522,119,641
SHAHEED BENAZIRABAD DISTRICT,SAKRAND TALUKA,73,435,85,520
SHAHEED BENAZIRABAD DISTRICT,SAKRAND TALUKA,74,366,69,435
SHAHEED BENAZIRABAD DISTRICT,SAKRAND TALUKA,>=75,2898,545,3443
SHAHRIG TEHSIL,GRISANI SUB-TEHSIL,<1,1160,0,1160
SHAHRIG TEHSIL,GRISANI SUB-TEHSIL,1,481,0,481
SHAHRIG TEHSIL,GRISANI SUB-TEHSIL,2,1039,0,1039
SHAHRIG TEHSIL,GRISANI SUB-TEHSIL,3,520,0,520
SHAHRIG TEHSIL,GRISANI SUB-TEHSIL,4,931,0,931
SHAHRIG TEHSIL,GRISANI SUB-TEHSIL,5,538,0,538
SHAHRIG TEHSIL,GRISANI SUB-TEHSIL,6,907,0,907
SHAHRIG TEHSIL,GRISANI SUB-TEHSIL,7,636,0,636
SHAHRIG TEHSIL,GRISANI SUB-TEHSIL,8,823,0,823
SHAHRIG TEHSIL,GRISANI SUB-TEHSIL,9,664,0,664
SHAHRIG TEHSIL,GRISANI SUB-TEHSIL,10,790,0,790
SHAHRIG TEHSIL,GRISANI SUB-TEHSIL,11,608,0,608
SHAHRIG TEHSIL,GRISANI SUB-TEHSIL,12,581,0,581
SHAHRIG TEHSIL,GRISANI SUB-TEHSIL,13,427,0,427
SHAHRIG TEHSIL,GRISANI SUB-TEHSIL,14,384,0,384
SHAHRIG TEHSIL,GRISANI SUB-TEHSIL,15,301,0,301
SHAHRIG TEHSIL,GRISANI SUB-TEHSIL,16,328,0,328
SHAHRIG TEHSIL,GRISANI SUB-TEHSIL,17,207,0,207
SHAHRIG TEHSIL,GRISANI SUB-TEHSIL,18,231,0,231
SHAHRIG TEHSIL,GRISANI SUB-TEHSIL,19,155,0,155
SHAHRIG TEHSIL,GRISANI SUB-TEHSIL,20,232,0,232
SHAHRIG TEHSIL,GRISANI SUB-TEHSIL,21,138,0,138
SHAHRIG TEHSIL,GRISANI SUB-TEHSIL,22,141,0,141
SHAHRIG TEHSIL,GRISANI SUB-TEHSIL,23,110,0,110
SHAHRIG TEHSIL,GRISANI SUB-TEHSIL,24,98,0,98
SHAHRIG TEHSIL,GRISANI SUB-TEHSIL,25,187,0,187
SHAHRIG TEHSIL,GRISANI SUB-TEHSIL,26,130,0,130
SHAHRIG TEHSIL,GRISANI SUB-TEHSIL,27,112,0,112
SHAHRIG TEHSIL,GRISANI SUB-TEHSIL,28,177,0,177
SHAHRIG TEHSIL,GRISANI SUB-TEHSIL,29,200,0,200
SHAHRIG TEHSIL,GRISANI SUB-TEHSIL,30,315,0,315
SHAHRIG TEHSIL,GRISANI SUB-TEHSIL,31,192,0,192
SHAHRIG TEHSIL,GRISANI SUB-TEHSIL,32,205,0,205
SHAHRIG TEHSIL,GRISANI SUB-TEHSIL,33,184,0,184
SHAHRIG TEHSIL,GRISANI SUB-TEHSIL,34,102,0,102
SHAHRIG TEHSIL,GRISANI SUB-TEHSIL,35,243,0,243
SHAHRIG TEHSIL,GRISANI SUB-TEHSIL,36,182,0,182
SHAHRIG TEHSIL,GRISANI SUB-TEHSIL,37,121,0,121
SHAHRIG TEHSIL,GRISANI SUB-TEHSIL,38,191,0,191
SHAHRIG TEHSIL,GRISANI SUB-TEHSIL,39,176,0,176
SHAHRIG TEHSIL,GRISANI SUB-TEHSIL,40,310,0,310
SHAHRIG TEHSIL,GRISANI SUB-TEHSIL,41,123,0,123
SHAHRIG TEHSIL,GRISANI SUB-TEHSIL,42,73,0,73
SHAHRIG TEHSIL,GRISANI SUB-TEHSIL,43,108,0,108
SHAHRIG TEHSIL,GRISANI SUB-TEHSIL,44,74,0,74
SHAHRIG TEHSIL,GRISANI SUB-TEHSIL,45,101,0,101
SHAHRIG TEHSIL,GRISANI SUB-TEHSIL,46,38,0,38
SHAHRIG TEHSIL,GRISANI SUB-TEHSIL,47,56,0,56
SHAHRIG TEHSIL,GRISANI SUB-TEHSIL,48,51,0,51
SHAHRIG TEHSIL,GRISANI SUB-TEHSIL,49,57,0,57
SHAHRIG TEHSIL,GRISANI SUB-TEHSIL,50,112,0,112
SHAHRIG TEHSIL,GRISANI SUB-TEHSIL,51,32,0,32
SHAHRIG TEHSIL,GRISANI SUB-TEHSIL,52,32,0,32
SHAHRIG TEHSIL,GRISANI SUB-TEHSIL,53,47,0,47
SHAHRIG TEHSIL,GRISANI SUB-TEHSIL,54,41,0,41
SHAHRIG TEHSIL,GRISANI SUB-TEHSIL,55,76,0,76
SHAHRIG TEHSIL,GRISANI SUB-TEHSIL,56,28,0,28
SHAHRIG TEHSIL,GRISANI SUB-TEHSIL,57,29,0,29
SHAHRIG TEHSIL,GRISANI SUB-TEHSIL,58,19,0,19
SHAHRIG TEHSIL,GRISANI SUB-TEHSIL,59,33,0,33
SHAHRIG TEHSIL,GRISANI SUB-TEHSIL,60,92,0,92
SHAHRIG TEHSIL,GRISANI SUB-TEHSIL,61,30,0,30
SHAHRIG TEHSIL,GRISANI SUB-TEHSIL,62,17,0,17
SHAHRIG TEHSIL,GRISANI SUB-TEHSIL,63,37,0,37
SHAHRIG TEHSIL,GRISANI SUB-TEHSIL,64,29,0,29
SHAHRIG TEHSIL,GRISANI SUB-TEHSIL,65,17,0,17
SHAHRIG TEHSIL,GRISANI SUB-TEHSIL,66,30,0,30
SHAHRIG TEHSIL,GRISANI SUB-TEHSIL,67,17,0,17
SHAHRIG TEHSIL,GRISANI SUB-TEHSIL,68,11,0,11
SHAHRIG TEHSIL,GRISANI SUB-TEHSIL,69,14,0,14
SHAHRIG TEHSIL,GRISANI SUB-TEHSIL,70,26,0,26
SHAHRIG TEHSIL,GRISANI SUB-TEHSIL,71,7,0,7
SHAHRIG TEHSIL,GRISANI SUB-TEHSIL,72,11,0,11
SHAHRIG TEHSIL,GRISANI SUB-TEHSIL,73,10,0,10
SHAHRIG TEHSIL,GRISANI SUB-TEHSIL,74,13,0,13
SHAHRIG TEHSIL,GRISANI SUB-TEHSIL,>=75,79,0,79
SHAHRIG TEHSIL,KAHAN TEHSIL,<1,1717,0,1717
SHAHRIG TEHSIL,KAHAN TEHSIL,1,1309,0,1309
SHAHRIG TEHSIL,KAHAN TEHSIL,2,1601,0,1601
SHAHRIG TEHSIL,KAHAN TEHSIL,3,1803,0,1803
SHAHRIG TEHSIL,KAHAN TEHSIL,4,1584,0,1584
SHAHRIG TEHSIL,KAHAN TEHSIL,5,1957,0,1957
SHAHRIG TEHSIL,KAHAN TEHSIL,6,1912,0,1912
SHAHRIG TEHSIL,KAHAN TEHSIL,7,2049,0,2049
SHAHRIG TEHSIL,KAHAN TEHSIL,8,2082,0,2082
SHAHRIG TEHSIL,KAHAN TEHSIL,9,2665,0,2665
SHAHRIG TEHSIL,KAHAN TEHSIL,10,2580,0,2580
SHAHRIG TEHSIL,KAHAN TEHSIL,11,2779,0,2779
SHAHRIG TEHSIL,KAHAN TEHSIL,12,2001,0,2001
SHAHRIG TEHSIL,KAHAN TEHSIL,13,2480,0,2480
SHAHRIG TEHSIL,KAHAN TEHSIL,14,2156,0,2156
SHAHRIG TEHSIL,KAHAN TEHSIL,15,2422,0,2422
SHAHRIG TEHSIL,KAHAN TEHSIL,16,2010,0,2010
SHAHRIG TEHSIL,KAHAN TEHSIL,17,1920,0,1920
SHAHRIG TEHSIL,KAHAN TEHSIL,18,2132,0,2132
SHAHRIG TEHSIL,KAHAN TEHSIL,19,1616,0,1616
SHAHRIG TEHSIL,KAHAN TEHSIL,20,2005,0,2005
SHAHRIG TEHSIL,KAHAN TEHSIL,21,1586,0,1586
SHAHRIG TEHSIL,KAHAN TEHSIL,22,1130,0,1130
SHAHRIG TEHSIL,KAHAN TEHSIL,23,1113,0,1113
SHAHRIG TEHSIL,KAHAN TEHSIL,24,924,0,924
SHAHRIG TEHSIL,KAHAN TEHSIL,25,1356,0,1356
SHAHRIG TEHSIL,KAHAN TEHSIL,26,827,0,827
SHAHRIG TEHSIL,KAHAN TEHSIL,27,847,0,847
SHAHRIG TEHSIL,KAHAN TEHSIL,28,807,0,807
SHAHRIG TEHSIL,KAHAN TEHSIL,29,689,0,689
SHAHRIG TEHSIL,KAHAN TEHSIL,30,1485,0,1485
SHAHRIG TEHSIL,KAHAN TEHSIL,31,819,0,819
SHAHRIG TEHSIL,KAHAN TEHSIL,32,440,0,440
SHAHRIG TEHSIL,KAHAN TEHSIL,33,846,0,846
SHAHRIG TEHSIL,KAHAN TEHSIL,34,422,0,422
SHAHRIG TEHSIL,KAHAN TEHSIL,35,864,0,864
SHAHRIG TEHSIL,KAHAN TEHSIL,36,591,0,591
SHAHRIG TEHSIL,KAHAN TEHSIL,37,401,0,401
SHAHRIG TEHSIL,KAHAN TEHSIL,38,767,0,767
SHAHRIG TEHSIL,KAHAN TEHSIL,39,627,0,627
SHAHRIG TEHSIL,KAHAN TEHSIL,40,1627,0,1627
SHAHRIG TEHSIL,KAHAN TEHSIL,41,645,0,645
SHAHRIG TEHSIL,KAHAN TEHSIL,42,308,0,308
SHAHRIG TEHSIL,KAHAN TEHSIL,43,788,0,788
SHAHRIG TEHSIL,KAHAN TEHSIL,44,438,0,438
SHAHRIG TEHSIL,KAHAN TEHSIL,45,633,0,633
SHAHRIG TEHSIL,KAHAN TEHSIL,46,258,0,258
SHAHRIG TEHSIL,KAHAN TEHSIL,47,201,0,201
SHAHRIG TEHSIL,KAHAN TEHSIL,48,407,0,407
SHAHRIG TEHSIL,KAHAN TEHSIL,49,418,0,418
SHAHRIG TEHSIL,KAHAN TEHSIL,50,1057,0,1057
SHAHRIG TEHSIL,KAHAN TEHSIL,51,337,0,337
SHAHRIG TEHSIL,KAHAN TEHSIL,52,169,0,169
SHAHRIG TEHSIL,KAHAN TEHSIL,53,445,0,445
SHAHRIG TEHSIL,KAHAN TEHSIL,54,352,0,352
SHAHRIG TEHSIL,KAHAN TEHSIL,55,496,0,496
SHAHRIG TEHSIL,KAHAN TEHSIL,56,288,0,288
SHAHRIG TEHSIL,KAHAN TEHSIL,57,132,0,132
SHAHRIG TEHSIL,KAHAN TEHSIL,58,267,0,267
SHAHRIG TEHSIL,KAHAN TEHSIL,59,233,0,233
SHAHRIG TEHSIL,KAHAN TEHSIL,60,712,0,712
SHAHRIG TEHSIL,KAHAN TEHSIL,61,296,0,296
SHAHRIG TEHSIL,KAHAN TEHSIL,62,200,0,200
SHAHRIG TEHSIL,KAHAN TEHSIL,63,339,0,339
SHAHRIG TEHSIL,KAHAN TEHSIL,64,226,0,226
SHAHRIG TEHSIL,KAHAN TEHSIL,65,261,0,261
SHAHRIG TEHSIL,KAHAN TEHSIL,66,204,0,204
SHAHRIG TEHSIL,KAHAN TEHSIL,67,79,0,79
SHAHRIG TEHSIL,KAHAN TEHSIL,68,165,0,165
SHAHRIG TEHSIL,KAHAN TEHSIL,69,138,0,138
SHAHRIG TEHSIL,KAHAN TEHSIL,70,389,0,389
SHAHRIG TEHSIL,KAHAN TEHSIL,71,132,0,132
SHAHRIG TEHSIL,KAHAN TEHSIL,72,81,0,81
SHAHRIG TEHSIL,KAHAN TEHSIL,73,170,0,170
SHAHRIG TEHSIL,KAHAN TEHSIL,74,109,0,109
SHAHRIG TEHSIL,KAHAN TEHSIL,>=75,1512,0,1512
SHAHRIG TEHSIL,KOHLU TEHSIL,<1,988,566,1554
SHAHRIG TEHSIL,KOHLU TEHSIL,1,1224,1104,2328
SHAHRIG TEHSIL,KOHLU TEHSIL,2,1336,721,2057
SHAHRIG TEHSIL,KOHLU TEHSIL,3,1196,734,1930
SHAHRIG TEHSIL,KOHLU TEHSIL,4,1362,620,1982
SHAHRIG TEHSIL,KOHLU TEHSIL,5,1046,712,1758
SHAHRIG TEHSIL,KOHLU TEHSIL,6,1285,582,1867
SHAHRIG TEHSIL,KOHLU TEHSIL,7,1001,733,1734
SHAHRIG TEHSIL,KOHLU TEHSIL,8,1169,530,1699
SHAHRIG TEHSIL,KOHLU TEHSIL,9,919,562,1481
SHAHRIG TEHSIL,KOHLU TEHSIL,10,886,552,1438
SHAHRIG TEHSIL,KOHLU TEHSIL,11,650,479,1129
SHAHRIG TEHSIL,KOHLU TEHSIL,12,638,427,1065
SHAHRIG TEHSIL,KOHLU TEHSIL,13,538,405,943
SHAHRIG TEHSIL,KOHLU TEHSIL,14,518,366,884
SHAHRIG TEHSIL,KOHLU TEHSIL,15,420,318,738
SHAHRIG TEHSIL,KOHLU TEHSIL,16,416,304,720
SHAHRIG TEHSIL,KOHLU TEHSIL,17,423,331,754
SHAHRIG TEHSIL,KOHLU TEHSIL,18,521,336,857
SHAHRIG TEHSIL,KOHLU TEHSIL,19,428,312,740
SHAHRIG TEHSIL,KOHLU TEHSIL,20,488,315,803
SHAHRIG TEHSIL,KOHLU TEHSIL,21,412,292,704
SHAHRIG TEHSIL,KOHLU TEHSIL,22,367,255,622
SHAHRIG TEHSIL,KOHLU TEHSIL,23,319,249,568
SHAHRIG TEHSIL,KOHLU TEHSIL,24,358,218,576
SHAHRIG TEHSIL,KOHLU TEHSIL,25,440,285,725
SHAHRIG TEHSIL,KOHLU TEHSIL,26,380,200,580
SHAHRIG TEHSIL,KOHLU TEHSIL,27,370,256,626
SHAHRIG TEHSIL,KOHLU TEHSIL,28,332,203,535
SHAHRIG TEHSIL,KOHLU TEHSIL,29,397,202,599
SHAHRIG TEHSIL,KOHLU TEHSIL,30,352,226,578
SHAHRIG TEHSIL,KOHLU TEHSIL,31,349,168,517
SHAHRIG TEHSIL,KOHLU TEHSIL,32,325,201,526
SHAHRIG TEHSIL,KOHLU TEHSIL,33,276,199,475
SHAHRIG TEHSIL,KOHLU TEHSIL,34,242,162,404
SHAHRIG TEHSIL,KOHLU TEHSIL,35,254,166,420
SHAHRIG TEHSIL,KOHLU TEHSIL,36,281,136,417
SHAHRIG TEHSIL,KOHLU TEHSIL,37,297,190,487
SHAHRIG TEHSIL,KOHLU TEHSIL,38,256,153,409
SHAHRIG TEHSIL,KOHLU TEHSIL,39,232,163,395
SHAHRIG TEHSIL,KOHLU TEHSIL,40,243,203,446
SHAHRIG TEHSIL,KOHLU TEHSIL,41,197,123,320
SHAHRIG TEHSIL,KOHLU TEHSIL,42,197,113,310
SHAHRIG TEHSIL,KOHLU TEHSIL,43,174,114,288
SHAHRIG TEHSIL,KOHLU TEHSIL,44,127,76,203
SHAHRIG TEHSIL,KOHLU TEHSIL,45,151,97,248
SHAHRIG TEHSIL,KOHLU TEHSIL,46,154,59,213
SHAHRIG TEHSIL,KOHLU TEHSIL,47,183,117,300
SHAHRIG TEHSIL,KOHLU TEHSIL,48,135,78,213
SHAHRIG TEHSIL,KOHLU TEHSIL,49,145,96,241
SHAHRIG TEHSIL,KOHLU TEHSIL,50,162,105,267
SHAHRIG TEHSIL,KOHLU TEHSIL,51,176,99,275
SHAHRIG TEHSIL,KOHLU TEHSIL,52,147,81,228
SHAHRIG TEHSIL,KOHLU TEHSIL,53,120,91,211
SHAHRIG TEHSIL,KOHLU TEHSIL,54,123,73,196
SHAHRIG TEHSIL,KOHLU TEHSIL,55,117,60,177
SHAHRIG TEHSIL,KOHLU TEHSIL,56,111,47,158
SHAHRIG TEHSIL,KOHLU TEHSIL,57,135,82,217
SHAHRIG TEHSIL,KOHLU TEHSIL,58,80,54,134
SHAHRIG TEHSIL,KOHLU TEHSIL,59,87,61,148
SHAHRIG TEHSIL,KOHLU TEHSIL,60,109,72,181
SHAHRIG TEHSIL,KOHLU TEHSIL,61,71,56,127
SHAHRIG TEHSIL,KOHLU TEHSIL,62,68,41,109
SHAHRIG TEHSIL,KOHLU TEHSIL,63,56,50,106
SHAHRIG TEHSIL,KOHLU TEHSIL,64,63,33,96
SHAHRIG TEHSIL,KOHLU TEHSIL,65,58,29,87
SHAHRIG TEHSIL,KOHLU TEHSIL,66,55,34,89
SHAHRIG TEHSIL,KOHLU TEHSIL,67,61,41,102
SHAHRIG TEHSIL,KOHLU TEHSIL,68,38,25,63
SHAHRIG TEHSIL,KOHLU TEHSIL,69,36,36,72
SHAHRIG TEHSIL,KOHLU TEHSIL,70,45,30,75
SHAHRIG TEHSIL,KOHLU TEHSIL,71,47,23,70
SHAHRIG TEHSIL,KOHLU TEHSIL,72,40,22,62
SHAHRIG TEHSIL,KOHLU TEHSIL,73,30,14,44
SHAHRIG TEHSIL,KOHLU TEHSIL,74,26,19,45
SHAHRIG TEHSIL,KOHLU TEHSIL,>=75,251,156,407
SHAHRIG TEHSIL,MAWAND TEHSIL,<1,1907,0,1907
SHAHRIG TEHSIL,MAWAND TEHSIL,1,1638,0,1638
SHAHRIG TEHSIL,MAWAND TEHSIL,2,1732,0,1732
SHAHRIG TEHSIL,MAWAND TEHSIL,3,2061,0,2061
SHAHRIG TEHSIL,MAWAND TEHSIL,4,1699,0,1699
SHAHRIG TEHSIL,MAWAND TEHSIL,5,1874,0,1874
SHAHRIG TEHSIL,MAWAND TEHSIL,6,1589,0,1589
SHAHRIG TEHSIL,MAWAND TEHSIL,7,1839,0,1839
SHAHRIG TEHSIL,MAWAND TEHSIL,8,1620,0,1620
SHAHRIG TEHSIL,MAWAND TEHSIL,9,1675,0,1675
SHAHRIG TEHSIL,MAWAND TEHSIL,10,1446,0,1446
SHAHRIG TEHSIL,MAWAND TEHSIL,11,1143,0,1143
SHAHRIG TEHSIL,MAWAND TEHSIL,12,1057,0,1057
SHAHRIG TEHSIL,MAWAND TEHSIL,13,899,0,899
SHAHRIG TEHSIL,MAWAND TEHSIL,14,633,0,633
SHAHRIG TEHSIL,MAWAND TEHSIL,15,764,0,764
SHAHRIG TEHSIL,MAWAND TEHSIL,16,616,0,616
SHAHRIG TEHSIL,MAWAND TEHSIL,17,561,0,561
SHAHRIG TEHSIL,MAWAND TEHSIL,18,847,0,847
SHAHRIG TEHSIL,MAWAND TEHSIL,19,624,0,624
SHAHRIG TEHSIL,MAWAND TEHSIL,20,825,0,825
SHAHRIG TEHSIL,MAWAND TEHSIL,21,552,0,552
SHAHRIG TEHSIL,MAWAND TEHSIL,22,431,0,431
SHAHRIG TEHSIL,MAWAND TEHSIL,23,402,0,402
SHAHRIG TEHSIL,MAWAND TEHSIL,24,378,0,378
SHAHRIG TEHSIL,MAWAND TEHSIL,25,767,0,767
SHAHRIG TEHSIL,MAWAND TEHSIL,26,354,0,354
SHAHRIG TEHSIL,MAWAND TEHSIL,27,473,0,473
SHAHRIG TEHSIL,MAWAND TEHSIL,28,459,0,459
SHAHRIG TEHSIL,MAWAND TEHSIL,29,515,0,515
SHAHRIG TEHSIL,MAWAND TEHSIL,30,767,0,767
SHAHRIG TEHSIL,MAWAND TEHSIL,31,455,0,455
SHAHRIG TEHSIL,MAWAND TEHSIL,32,377,0,377
SHAHRIG TEHSIL,MAWAND TEHSIL,33,461,0,461
SHAHRIG TEHSIL,MAWAND TEHSIL,34,289,0,289
SHAHRIG TEHSIL,MAWAND TEHSIL,35,527,0,527
SHAHRIG TEHSIL,MAWAND TEHSIL,36,334,0,334
SHAHRIG TEHSIL,MAWAND TEHSIL,37,381,0,381
SHAHRIG TEHSIL,MAWAND TEHSIL,38,404,0,404
SHAHRIG TEHSIL,MAWAND TEHSIL,39,417,0,417
SHAHRIG TEHSIL,MAWAND TEHSIL,40,594,0,594
SHAHRIG TEHSIL,MAWAND TEHSIL,41,373,0,373
SHAHRIG TEHSIL,MAWAND TEHSIL,42,260,0,260
SHAHRIG TEHSIL,MAWAND TEHSIL,43,293,0,293
SHAHRIG TEHSIL,MAWAND TEHSIL,44,198,0,198
SHAHRIG TEHSIL,MAWAND TEHSIL,45,300,0,300
SHAHRIG TEHSIL,MAWAND TEHSIL,46,156,0,156
SHAHRIG TEHSIL,MAWAND TEHSIL,47,201,0,201
SHAHRIG TEHSIL,MAWAND TEHSIL,48,213,0,213
SHAHRIG TEHSIL,MAWAND TEHSIL,49,220,0,220
SHAHRIG TEHSIL,MAWAND TEHSIL,50,295,0,295
SHAHRIG TEHSIL,MAWAND TEHSIL,51,185,0,185
SHAHRIG TEHSIL,MAWAND TEHSIL,52,151,0,151
SHAHRIG TEHSIL,MAWAND TEHSIL,53,149,0,149
SHAHRIG TEHSIL,MAWAND TEHSIL,54,148,0,148
SHAHRIG TEHSIL,MAWAND TEHSIL,55,162,0,162
SHAHRIG TEHSIL,MAWAND TEHSIL,56,112,0,112
SHAHRIG TEHSIL,MAWAND TEHSIL,57,126,0,126
SHAHRIG TEHSIL,MAWAND TEHSIL,58,117,0,117
SHAHRIG TEHSIL,MAWAND TEHSIL,59,128,0,128
SHAHRIG TEHSIL,MAWAND TEHSIL,60,153,0,153
SHAHRIG TEHSIL,MAWAND TEHSIL,61,97,0,97
SHAHRIG TEHSIL,MAWAND TEHSIL,62,84,0,84
SHAHRIG TEHSIL,MAWAND TEHSIL,63,99,0,99
SHAHRIG TEHSIL,MAWAND TEHSIL,64,102,0,102
SHAHRIG TEHSIL,MAWAND TEHSIL,65,78,0,78
SHAHRIG TEHSIL,MAWAND TEHSIL,66,69,0,69
SHAHRIG TEHSIL,MAWAND TEHSIL,67,72,0,72
SHAHRIG TEHSIL,MAWAND TEHSIL,68,55,0,55
SHAHRIG TEHSIL,MAWAND TEHSIL,69,48,0,48
SHAHRIG TEHSIL,MAWAND TEHSIL,70,65,0,65
SHAHRIG TEHSIL,MAWAND TEHSIL,71,32,0,32
SHAHRIG TEHSIL,MAWAND TEHSIL,72,43,0,43
SHAHRIG TEHSIL,MAWAND TEHSIL,73,38,0,38
SHAHRIG TEHSIL,MAWAND TEHSIL,74,42,0,42
SHAHRIG TEHSIL,MAWAND TEHSIL,>=75,266,0,266
SHAHRIG TEHSIL,TAMBOO TEHSIL,<1,1444,0,1444
SHAHRIG TEHSIL,TAMBOO TEHSIL,1,1611,0,1611
SHAHRIG TEHSIL,TAMBOO TEHSIL,2,1616,0,1616
SHAHRIG TEHSIL,TAMBOO TEHSIL,3,1539,0,1539
SHAHRIG TEHSIL,TAMBOO TEHSIL,4,1575,0,1575
SHAHRIG TEHSIL,TAMBOO TEHSIL,5,1515,0,1515
SHAHRIG TEHSIL,TAMBOO TEHSIL,6,1522,0,1522
SHAHRIG TEHSIL,TAMBOO TEHSIL,7,1547,0,1547
SHAHRIG TEHSIL,TAMBOO TEHSIL,8,1532,0,1532
SHAHRIG TEHSIL,TAMBOO TEHSIL,9,1432,0,1432
SHAHRIG TEHSIL,TAMBOO TEHSIL,10,1366,0,1366
SHAHRIG TEHSIL,TAMBOO TEHSIL,11,995,0,995
SHAHRIG TEHSIL,TAMBOO TEHSIL,12,1024,0,1024
SHAHRIG TEHSIL,TAMBOO TEHSIL,13,844,0,844
SHAHRIG TEHSIL,TAMBOO TEHSIL,14,731,0,731
SHAHRIG TEHSIL,TAMBOO TEHSIL,15,830,0,830
SHAHRIG TEHSIL,TAMBOO TEHSIL,16,615,0,615
SHAHRIG TEHSIL,TAMBOO TEHSIL,17,628,0,628
SHAHRIG TEHSIL,TAMBOO TEHSIL,18,588,0,588
SHAHRIG TEHSIL,TAMBOO TEHSIL,19,533,0,533
SHAHRIG TEHSIL,TAMBOO TEHSIL,20,687,0,687
SHAHRIG TEHSIL,TAMBOO TEHSIL,21,480,0,480
SHAHRIG TEHSIL,TAMBOO TEHSIL,22,465,0,465
SHAHRIG TEHSIL,TAMBOO TEHSIL,23,375,0,375
SHAHRIG TEHSIL,TAMBOO TEHSIL,24,403,0,403
SHAHRIG TEHSIL,TAMBOO TEHSIL,25,546,0,546
SHAHRIG TEHSIL,TAMBOO TEHSIL,26,345,0,345
SHAHRIG TEHSIL,TAMBOO TEHSIL,27,481,0,481
SHAHRIG TEHSIL,TAMBOO TEHSIL,28,396,0,396
SHAHRIG TEHSIL,TAMBOO TEHSIL,29,424,0,424
SHAHRIG TEHSIL,TAMBOO TEHSIL,30,597,0,597
SHAHRIG TEHSIL,TAMBOO TEHSIL,31,381,0,381
SHAHRIG TEHSIL,TAMBOO TEHSIL,32,341,0,341
SHAHRIG TEHSIL,TAMBOO TEHSIL,33,394,0,394
SHAHRIG TEHSIL,TAMBOO TEHSIL,34,358,0,358
SHAHRIG TEHSIL,TAMBOO TEHSIL,35,393,0,393
SHAHRIG TEHSIL,TAMBOO TEHSIL,36,252,0,252
SHAHRIG TEHSIL,TAMBOO TEHSIL,37,337,0,337
SHAHRIG TEHSIL,TAMBOO TEHSIL,38,298,0,298
SHAHRIG TEHSIL,TAMBOO TEHSIL,39,306,0,306
SHAHRIG TEHSIL,TAMBOO TEHSIL,40,429,0,429
SHAHRIG TEHSIL,TAMBOO TEHSIL,41,262,0,262
SHAHRIG TEHSIL,TAMBOO TEHSIL,42,224,0,224
SHAHRIG TEHSIL,TAMBOO TEHSIL,43,191,0,191
SHAHRIG TEHSIL,TAMBOO TEHSIL,44,177,0,177
SHAHRIG TEHSIL,TAMBOO TEHSIL,45,231,0,231
SHAHRIG TEHSIL,TAMBOO TEHSIL,46,128,0,128
SHAHRIG TEHSIL,TAMBOO TEHSIL,47,183,0,183
SHAHRIG TEHSIL,TAMBOO TEHSIL,48,169,0,169
SHAHRIG TEHSIL,TAMBOO TEHSIL,49,175,0,175
SHAHRIG TEHSIL,TAMBOO TEHSIL,50,247,0,247
SHAHRIG TEHSIL,TAMBOO TEHSIL,51,136,0,136
SHAHRIG TEHSIL,TAMBOO TEHSIL,52,132,0,132
SHAHRIG TEHSIL,TAMBOO TEHSIL,53,122,0,122
SHAHRIG TEHSIL,TAMBOO TEHSIL,54,141,0,141
SHAHRIG TEHSIL,TAMBOO TEHSIL,55,128,0,128
SHAHRIG TEHSIL,TAMBOO TEHSIL,56,83,0,83
SHAHRIG TEHSIL,TAMBOO TEHSIL,57,129,0,129
SHAHRIG TEHSIL,TAMBOO TEHSIL,58,95,0,95
SHAHRIG TEHSIL,TAMBOO TEHSIL,59,97,0,97
SHAHRIG TEHSIL,TAMBOO TEHSIL,60,120,0,120
SHAHRIG TEHSIL,TAMBOO TEHSIL,61,82,0,82
SHAHRIG TEHSIL,TAMBOO TEHSIL,62,81,0,81
SHAHRIG TEHSIL,TAMBOO TEHSIL,63,75,0,75
SHAHRIG TEHSIL,TAMBOO TEHSIL,64,86,0,86
SHAHRIG TEHSIL,TAMBOO TEHSIL,65,63,0,63
SHAHRIG TEHSIL,TAMBOO TEHSIL,66,46,0,46
SHAHRIG TEHSIL,TAMBOO TEHSIL,67,82,0,82
SHAHRIG TEHSIL,TAMBOO TEHSIL,68,46,0,46
SHAHRIG TEHSIL,TAMBOO TEHSIL,69,44,0,44
SHAHRIG TEHSIL,TAMBOO TEHSIL,70,54,0,54
SHAHRIG TEHSIL,TAMBOO TEHSIL,71,40,0,40
SHAHRIG TEHSIL,TAMBOO TEHSIL,72,26,0,26
SHAHRIG TEHSIL,TAMBOO TEHSIL,73,31,0,31
SHAHRIG TEHSIL,TAMBOO TEHSIL,74,36,0,36
SHAHRIG TEHSIL,TAMBOO TEHSIL,>=75,268,0,268
SHANGLA DISTRICT,ALPURI TEHSIL,<1,15547,0,15547
SHANGLA DISTRICT,ALPURI TEHSIL,1,16496,0,16496
SHANGLA DISTRICT,ALPURI TEHSIL,2,18970,0,18970
SHANGLA DISTRICT,ALPURI TEHSIL,3,19447,0,19447
SHANGLA DISTRICT,ALPURI TEHSIL,4,20483,0,20483
SHANGLA DISTRICT,ALPURI TEHSIL,5,19036,0,19036
SHANGLA DISTRICT,ALPURI TEHSIL,6,18911,0,18911
SHANGLA DISTRICT,ALPURI TEHSIL,7,18033,0,18033
SHANGLA DISTRICT,ALPURI TEHSIL,8,18625,0,18625
SHANGLA DISTRICT,ALPURI TEHSIL,9,16883,0,16883
SHANGLA DISTRICT,ALPURI TEHSIL,10,16138,0,16138
SHANGLA DISTRICT,ALPURI TEHSIL,11,13889,0,13889
SHANGLA DISTRICT,ALPURI TEHSIL,12,13774,0,13774
SHANGLA DISTRICT,ALPURI TEHSIL,13,12506,0,12506
SHANGLA DISTRICT,ALPURI TEHSIL,14,11343,0,11343
SHANGLA DISTRICT,ALPURI TEHSIL,15,10988,0,10988
SHANGLA DISTRICT,ALPURI TEHSIL,16,9572,0,9572
SHANGLA DISTRICT,ALPURI TEHSIL,17,9427,0,9427
SHANGLA DISTRICT,ALPURI TEHSIL,18,10263,0,10263
SHANGLA DISTRICT,ALPURI TEHSIL,19,9369,0,9369
SHANGLA DISTRICT,ALPURI TEHSIL,20,9942,0,9942
SHANGLA DISTRICT,ALPURI TEHSIL,21,8197,0,8197
SHANGLA DISTRICT,ALPURI TEHSIL,22,7812,0,7812
SHANGLA DISTRICT,ALPURI TEHSIL,23,7273,0,7273
SHANGLA DISTRICT,ALPURI TEHSIL,24,6907,0,6907
SHANGLA DISTRICT,ALPURI TEHSIL,25,8623,0,8623
SHANGLA DISTRICT,ALPURI TEHSIL,26,7350,0,7350
SHANGLA DISTRICT,ALPURI TEHSIL,27,7393,0,7393
SHANGLA DISTRICT,ALPURI TEHSIL,28,7035,0,7035
SHANGLA DISTRICT,ALPURI TEHSIL,29,7239,0,7239
SHANGLA DISTRICT,ALPURI TEHSIL,30,7123,0,7123
SHANGLA DISTRICT,ALPURI TEHSIL,31,6558,0,6558
SHANGLA DISTRICT,ALPURI TEHSIL,32,5303,0,5303
SHANGLA DISTRICT,ALPURI TEHSIL,33,5112,0,5112
SHANGLA DISTRICT,ALPURI TEHSIL,34,4410,0,4410
SHANGLA DISTRICT,ALPURI TEHSIL,35,5321,0,5321
SHANGLA DISTRICT,ALPURI TEHSIL,36,4638,0,4638
SHANGLA DISTRICT,ALPURI TEHSIL,37,4986,0,4986
SHANGLA DISTRICT,ALPURI TEHSIL,38,3973,0,3973
SHANGLA DISTRICT,ALPURI TEHSIL,39,4099,0,4099
SHANGLA DISTRICT,ALPURI TEHSIL,40,4644,0,4644
SHANGLA DISTRICT,ALPURI TEHSIL,41,4072,0,4072
SHANGLA DISTRICT,ALPURI TEHSIL,42,3534,0,3534
SHANGLA DISTRICT,ALPURI TEHSIL,43,3505,0,3505
SHANGLA DISTRICT,ALPURI TEHSIL,44,2961,0,2961
SHANGLA DISTRICT,ALPURI TEHSIL,45,3289,0,3289
SHANGLA DISTRICT,ALPURI TEHSIL,46,2913,0,2913
SHANGLA DISTRICT,ALPURI TEHSIL,47,3112,0,3112
SHANGLA DISTRICT,ALPURI TEHSIL,48,2693,0,2693
SHANGLA DISTRICT,ALPURI TEHSIL,49,2658,0,2658
SHANGLA DISTRICT,ALPURI TEHSIL,50,3152,0,3152
SHANGLA DISTRICT,ALPURI TEHSIL,51,2589,0,2589
SHANGLA DISTRICT,ALPURI TEHSIL,52,2112,0,2112
SHANGLA DISTRICT,ALPURI TEHSIL,53,2300,0,2300
SHANGLA DISTRICT,ALPURI TEHSIL,54,1964,0,1964
SHANGLA DISTRICT,ALPURI TEHSIL,55,2217,0,2217
SHANGLA DISTRICT,ALPURI TEHSIL,56,1719,0,1719
SHANGLA DISTRICT,ALPURI TEHSIL,57,1652,0,1652
SHANGLA DISTRICT,ALPURI TEHSIL,58,1776,0,1776
SHANGLA DISTRICT,ALPURI TEHSIL,59,1790,0,1790
SHANGLA DISTRICT,ALPURI TEHSIL,60,2083,0,2083
SHANGLA DISTRICT,ALPURI TEHSIL,61,1756,0,1756
SHANGLA DISTRICT,ALPURI TEHSIL,62,1551,0,1551
SHANGLA DISTRICT,ALPURI TEHSIL,63,1680,0,1680
SHANGLA DISTRICT,ALPURI TEHSIL,64,1641,0,1641
SHANGLA DISTRICT,ALPURI TEHSIL,65,1365,0,1365
SHANGLA DISTRICT,ALPURI TEHSIL,66,1135,0,1135
SHANGLA DISTRICT,ALPURI TEHSIL,67,1149,0,1149
SHANGLA DISTRICT,ALPURI TEHSIL,68,1182,0,1182
SHANGLA DISTRICT,ALPURI TEHSIL,69,1303,0,1303
SHANGLA DISTRICT,ALPURI TEHSIL,70,1127,0,1127
SHANGLA DISTRICT,ALPURI TEHSIL,71,899,0,899
SHANGLA DISTRICT,ALPURI TEHSIL,72,817,0,817
SHANGLA DISTRICT,ALPURI TEHSIL,73,806,0,806
SHANGLA DISTRICT,ALPURI TEHSIL,74,773,0,773
SHANGLA DISTRICT,ALPURI TEHSIL,>=75,5448,0,5448
SHANGLA DISTRICT,BISHAM TEHSIL,<1,2996,0,2996
SHANGLA DISTRICT,BISHAM TEHSIL,1,3288,0,3288
SHANGLA DISTRICT,BISHAM TEHSIL,2,3984,0,3984
SHANGLA DISTRICT,BISHAM TEHSIL,3,3968,0,3968
SHANGLA DISTRICT,BISHAM TEHSIL,4,4216,0,4216
SHANGLA DISTRICT,BISHAM TEHSIL,5,4037,0,4037
SHANGLA DISTRICT,BISHAM TEHSIL,6,4006,0,4006
SHANGLA DISTRICT,BISHAM TEHSIL,7,3760,0,3760
SHANGLA DISTRICT,BISHAM TEHSIL,8,4121,0,4121
SHANGLA DISTRICT,BISHAM TEHSIL,9,3679,0,3679
SHANGLA DISTRICT,BISHAM TEHSIL,10,3447,0,3447
SHANGLA DISTRICT,BISHAM TEHSIL,11,2971,0,2971
SHANGLA DISTRICT,BISHAM TEHSIL,12,3165,0,3165
SHANGLA DISTRICT,BISHAM TEHSIL,13,2694,0,2694
SHANGLA DISTRICT,BISHAM TEHSIL,14,2603,0,2603
SHANGLA DISTRICT,BISHAM TEHSIL,15,2395,0,2395
SHANGLA DISTRICT,BISHAM TEHSIL,16,2230,0,2230
SHANGLA DISTRICT,BISHAM TEHSIL,17,2005,0,2005
SHANGLA DISTRICT,BISHAM TEHSIL,18,2212,0,2212
SHANGLA DISTRICT,BISHAM TEHSIL,19,1839,0,1839
SHANGLA DISTRICT,BISHAM TEHSIL,20,2051,0,2051
SHANGLA DISTRICT,BISHAM TEHSIL,21,1543,0,1543
SHANGLA DISTRICT,BISHAM TEHSIL,22,1603,0,1603
SHANGLA DISTRICT,BISHAM TEHSIL,23,1329,0,1329
SHANGLA DISTRICT,BISHAM TEHSIL,24,1447,0,1447
SHANGLA DISTRICT,BISHAM TEHSIL,25,1765,0,1765
SHANGLA DISTRICT,BISHAM TEHSIL,26,1396,0,1396
SHANGLA DISTRICT,BISHAM TEHSIL,27,1371,0,1371
SHANGLA DISTRICT,BISHAM TEHSIL,28,1472,0,1472
SHANGLA DISTRICT,BISHAM TEHSIL,29,1311,0,1311
SHANGLA DISTRICT,BISHAM TEHSIL,30,1635,0,1635
SHANGLA DISTRICT,BISHAM TEHSIL,31,1233,0,1233
SHANGLA DISTRICT,BISHAM TEHSIL,32,1101,0,1101
SHANGLA DISTRICT,BISHAM TEHSIL,33,1132,0,1132
SHANGLA DISTRICT,BISHAM TEHSIL,34,1033,0,1033
SHANGLA DISTRICT,BISHAM TEHSIL,35,1178,0,1178
SHANGLA DISTRICT,BISHAM TEHSIL,36,950,0,950
SHANGLA DISTRICT,BISHAM TEHSIL,37,959,0,959
SHANGLA DISTRICT,BISHAM TEHSIL,38,980,0,980
SHANGLA DISTRICT,BISHAM TEHSIL,39,858,0,858
SHANGLA DISTRICT,BISHAM TEHSIL,40,1165,0,1165
SHANGLA DISTRICT,BISHAM TEHSIL,41,844,0,844
SHANGLA DISTRICT,BISHAM TEHSIL,42,711,0,711
SHANGLA DISTRICT,BISHAM TEHSIL,43,723,0,723
SHANGLA DISTRICT,BISHAM TEHSIL,44,614,0,614
SHANGLA DISTRICT,BISHAM TEHSIL,45,696,0,696
SHANGLA DISTRICT,BISHAM TEHSIL,46,515,0,515
SHANGLA DISTRICT,BISHAM TEHSIL,47,530,0,530
SHANGLA DISTRICT,BISHAM TEHSIL,48,537,0,537
SHANGLA DISTRICT,BISHAM TEHSIL,49,503,0,503
SHANGLA DISTRICT,BISHAM TEHSIL,50,648,0,648
SHANGLA DISTRICT,BISHAM TEHSIL,51,469,0,469
SHANGLA DISTRICT,BISHAM TEHSIL,52,404,0,404
SHANGLA DISTRICT,BISHAM TEHSIL,53,423,0,423
SHANGLA DISTRICT,BISHAM TEHSIL,54,402,0,402
SHANGLA DISTRICT,BISHAM TEHSIL,55,535,0,535
SHANGLA DISTRICT,BISHAM TEHSIL,56,304,0,304
SHANGLA DISTRICT,BISHAM TEHSIL,57,325,0,325
SHANGLA DISTRICT,BISHAM TEHSIL,58,364,0,364
SHANGLA DISTRICT,BISHAM TEHSIL,59,379,0,379
SHANGLA DISTRICT,BISHAM TEHSIL,60,471,0,471
SHANGLA DISTRICT,BISHAM TEHSIL,61,294,0,294
SHANGLA DISTRICT,BISHAM TEHSIL,62,279,0,279
SHANGLA DISTRICT,BISHAM TEHSIL,63,344,0,344
SHANGLA DISTRICT,BISHAM TEHSIL,64,319,0,319
SHANGLA DISTRICT,BISHAM TEHSIL,65,340,0,340
SHANGLA DISTRICT,BISHAM TEHSIL,66,193,0,193
SHANGLA DISTRICT,BISHAM TEHSIL,67,175,0,175
SHANGLA DISTRICT,BISHAM TEHSIL,68,207,0,207
SHANGLA DISTRICT,BISHAM TEHSIL,69,252,0,252
SHANGLA DISTRICT,BISHAM TEHSIL,70,228,0,228
SHANGLA DISTRICT,BISHAM TEHSIL,71,146,0,146
SHANGLA DISTRICT,BISHAM TEHSIL,72,137,0,137
SHANGLA DISTRICT,BISHAM TEHSIL,73,152,0,152
SHANGLA DISTRICT,BISHAM TEHSIL,74,165,0,165
SHANGLA DISTRICT,BISHAM TEHSIL,>=75,1194,0,1194
SHANGLA DISTRICT,PURAN TEHSIL,<1,4501,0,4501
SHANGLA DISTRICT,PURAN TEHSIL,1,4719,0,4719
SHANGLA DISTRICT,PURAN TEHSIL,2,5648,0,5648
SHANGLA DISTRICT,PURAN TEHSIL,3,5474,0,5474
SHANGLA DISTRICT,PURAN TEHSIL,4,5981,0,5981
SHANGLA DISTRICT,PURAN TEHSIL,5,5062,0,5062
SHANGLA DISTRICT,PURAN TEHSIL,6,5301,0,5301
SHANGLA DISTRICT,PURAN TEHSIL,7,4885,0,4885
SHANGLA DISTRICT,PURAN TEHSIL,8,5203,0,5203
SHANGLA DISTRICT,PURAN TEHSIL,9,4735,0,4735
SHANGLA DISTRICT,PURAN TEHSIL,10,4404,0,4404
SHANGLA DISTRICT,PURAN TEHSIL,11,4089,0,4089
SHANGLA DISTRICT,PURAN TEHSIL,12,3756,0,3756
SHANGLA DISTRICT,PURAN TEHSIL,13,3578,0,3578
SHANGLA DISTRICT,PURAN TEHSIL,14,3302,0,3302
SHANGLA DISTRICT,PURAN TEHSIL,15,3349,0,3349
SHANGLA DISTRICT,PURAN TEHSIL,16,3095,0,3095
SHANGLA DISTRICT,PURAN TEHSIL,17,3067,0,3067
SHANGLA DISTRICT,PURAN TEHSIL,18,2769,0,2769
SHANGLA DISTRICT,PURAN TEHSIL,19,2632,0,2632
SHANGLA DISTRICT,PURAN TEHSIL,20,2907,0,2907
SHANGLA DISTRICT,PURAN TEHSIL,21,2267,0,2267
SHANGLA DISTRICT,PURAN TEHSIL,22,2101,0,2101
SHANGLA DISTRICT,PURAN TEHSIL,23,1959,0,1959
SHANGLA DISTRICT,PURAN TEHSIL,24,1838,0,1838
SHANGLA DISTRICT,PURAN TEHSIL,25,2449,0,2449
SHANGLA DISTRICT,PURAN TEHSIL,26,2140,0,2140
SHANGLA DISTRICT,PURAN TEHSIL,27,2185,0,2185
SHANGLA DISTRICT,PURAN TEHSIL,28,1734,0,1734
SHANGLA DISTRICT,PURAN TEHSIL,29,2166,0,2166
SHANGLA DISTRICT,PURAN TEHSIL,30,2032,0,2032
SHANGLA DISTRICT,PURAN TEHSIL,31,1906,0,1906
SHANGLA DISTRICT,PURAN TEHSIL,32,1536,0,1536
SHANGLA DISTRICT,PURAN TEHSIL,33,1576,0,1576
SHANGLA DISTRICT,PURAN TEHSIL,34,1261,0,1261
SHANGLA DISTRICT,PURAN TEHSIL,35,1527,0,1527
SHANGLA DISTRICT,PURAN TEHSIL,36,1270,0,1270
SHANGLA DISTRICT,PURAN TEHSIL,37,1620,0,1620
SHANGLA DISTRICT,PURAN TEHSIL,38,1042,0,1042
SHANGLA DISTRICT,PURAN TEHSIL,39,1246,0,1246
SHANGLA DISTRICT,PURAN TEHSIL,40,1384,0,1384
SHANGLA DISTRICT,PURAN TEHSIL,41,1198,0,1198
SHANGLA DISTRICT,PURAN TEHSIL,42,1124,0,1124
SHANGLA DISTRICT,PURAN TEHSIL,43,1087,0,1087
SHANGLA DISTRICT,PURAN TEHSIL,44,899,0,899
SHANGLA DISTRICT,PURAN TEHSIL,45,946,0,946
SHANGLA DISTRICT,PURAN TEHSIL,46,830,0,830
SHANGLA DISTRICT,PURAN TEHSIL,47,1006,0,1006
SHANGLA DISTRICT,PURAN TEHSIL,48,702,0,702
SHANGLA DISTRICT,PURAN TEHSIL,49,829,0,829
SHANGLA DISTRICT,PURAN TEHSIL,50,910,0,910
SHANGLA DISTRICT,PURAN TEHSIL,51,781,0,781
SHANGLA DISTRICT,PURAN TEHSIL,52,606,0,606
SHANGLA DISTRICT,PURAN TEHSIL,53,676,0,676
SHANGLA DISTRICT,PURAN TEHSIL,54,547,0,547
SHANGLA DISTRICT,PURAN TEHSIL,55,514,0,514
SHANGLA DISTRICT,PURAN TEHSIL,56,451,0,451
SHANGLA DISTRICT,PURAN TEHSIL,57,524,0,524
SHANGLA DISTRICT,PURAN TEHSIL,58,415,0,415
SHANGLA DISTRICT,PURAN TEHSIL,59,526,0,526
SHANGLA DISTRICT,PURAN TEHSIL,60,618,0,618
SHANGLA DISTRICT,PURAN TEHSIL,61,476,0,476
SHANGLA DISTRICT,PURAN TEHSIL,62,379,0,379
SHANGLA DISTRICT,PURAN TEHSIL,63,444,0,444
SHANGLA DISTRICT,PURAN TEHSIL,64,477,0,477
SHANGLA DISTRICT,PURAN TEHSIL,65,363,0,363
SHANGLA DISTRICT,PURAN TEHSIL,66,357,0,357
SHANGLA DISTRICT,PURAN TEHSIL,67,360,0,360
SHANGLA DISTRICT,PURAN TEHSIL,68,289,0,289
SHANGLA DISTRICT,PURAN TEHSIL,69,339,0,339
SHANGLA DISTRICT,PURAN TEHSIL,70,352,0,352
SHANGLA DISTRICT,PURAN TEHSIL,71,389,0,389
SHANGLA DISTRICT,PURAN TEHSIL,72,230,0,230
SHANGLA DISTRICT,PURAN TEHSIL,73,237,0,237
SHANGLA DISTRICT,PURAN TEHSIL,74,226,0,226
SHANGLA DISTRICT,PURAN TEHSIL,>=75,1495,0,1495
SHEIKHUPURA DISTRICT,FEROZEWALA TEHSIL,<1,12010,6583,18593
SHEIKHUPURA DISTRICT,FEROZEWALA TEHSIL,1,13333,7371,20704
SHEIKHUPURA DISTRICT,FEROZEWALA TEHSIL,2,13534,7658,21192
SHEIKHUPURA DISTRICT,FEROZEWALA TEHSIL,3,14876,8248,23124
SHEIKHUPURA DISTRICT,FEROZEWALA TEHSIL,4,13902,7673,21575
SHEIKHUPURA DISTRICT,FEROZEWALA TEHSIL,5,14283,7815,22098
SHEIKHUPURA DISTRICT,FEROZEWALA TEHSIL,6,13667,7297,20964
SHEIKHUPURA DISTRICT,FEROZEWALA TEHSIL,7,14393,8016,22409
SHEIKHUPURA DISTRICT,FEROZEWALA TEHSIL,8,13606,7156,20762
SHEIKHUPURA DISTRICT,FEROZEWALA TEHSIL,9,13335,7301,20636
SHEIKHUPURA DISTRICT,FEROZEWALA TEHSIL,10,12777,6854,19631
SHEIKHUPURA DISTRICT,FEROZEWALA TEHSIL,11,12569,6972,19541
SHEIKHUPURA DISTRICT,FEROZEWALA TEHSIL,12,12125,6567,18692
SHEIKHUPURA DISTRICT,FEROZEWALA TEHSIL,13,11752,6484,18236
SHEIKHUPURA DISTRICT,FEROZEWALA TEHSIL,14,11220,6071,17291
SHEIKHUPURA DISTRICT,FEROZEWALA TEHSIL,15,10986,6031,17017
SHEIKHUPURA DISTRICT,FEROZEWALA TEHSIL,16,11319,6101,17420
SHEIKHUPURA DISTRICT,FEROZEWALA TEHSIL,17,10911,6122,17033
SHEIKHUPURA DISTRICT,FEROZEWALA TEHSIL,18,10979,6231,17210
SHEIKHUPURA DISTRICT,FEROZEWALA TEHSIL,19,10516,5883,16399
SHEIKHUPURA DISTRICT,FEROZEWALA TEHSIL,20,10915,5823,16738
SHEIKHUPURA DISTRICT,FEROZEWALA TEHSIL,21,10401,5847,16248
SHEIKHUPURA DISTRICT,FEROZEWALA TEHSIL,22,10825,6253,17078
SHEIKHUPURA DISTRICT,FEROZEWALA TEHSIL,23,9770,5402,15172
SHEIKHUPURA DISTRICT,FEROZEWALA TEHSIL,24,9421,5367,14788
SHEIKHUPURA DISTRICT,FEROZEWALA TEHSIL,25,9343,5231,14574
SHEIKHUPURA DISTRICT,FEROZEWALA TEHSIL,26,8969,4991,13960
SHEIKHUPURA DISTRICT,FEROZEWALA TEHSIL,27,8026,4637,12663
SHEIKHUPURA DISTRICT,FEROZEWALA TEHSIL,28,8842,5146,13988
SHEIKHUPURA DISTRICT,FEROZEWALA TEHSIL,29,7343,4272,11615
SHEIKHUPURA DISTRICT,FEROZEWALA TEHSIL,30,8970,5255,14225
SHEIKHUPURA DISTRICT,FEROZEWALA TEHSIL,31,6880,3891,10771
SHEIKHUPURA DISTRICT,FEROZEWALA TEHSIL,32,7466,4400,11866
SHEIKHUPURA DISTRICT,FEROZEWALA TEHSIL,33,6812,3895,10707
SHEIKHUPURA DISTRICT,FEROZEWALA TEHSIL,34,5790,3302,9092
SHEIKHUPURA DISTRICT,FEROZEWALA TEHSIL,35,7693,4513,12206
SHEIKHUPURA DISTRICT,FEROZEWALA TEHSIL,36,5702,3145,8847
SHEIKHUPURA DISTRICT,FEROZEWALA TEHSIL,37,5232,2724,7956
SHEIKHUPURA DISTRICT,FEROZEWALA TEHSIL,38,6247,3653,9900
SHEIKHUPURA DISTRICT,FEROZEWALA TEHSIL,39,5584,3004,8588
SHEIKHUPURA DISTRICT,FEROZEWALA TEHSIL,40,7044,4173,11217
SHEIKHUPURA DISTRICT,FEROZEWALA TEHSIL,41,4771,2679,7450
SHEIKHUPURA DISTRICT,FEROZEWALA TEHSIL,42,4817,2776,7593
SHEIKHUPURA DISTRICT,FEROZEWALA TEHSIL,43,4485,2645,7130
SHEIKHUPURA DISTRICT,FEROZEWALA TEHSIL,44,3968,2112,6080
SHEIKHUPURA DISTRICT,FEROZEWALA TEHSIL,45,5243,3048,8291
SHEIKHUPURA DISTRICT,FEROZEWALA TEHSIL,46,3339,1851,5190
SHEIKHUPURA DISTRICT,FEROZEWALA TEHSIL,47,3226,1767,4993
SHEIKHUPURA DISTRICT,FEROZEWALA TEHSIL,48,3884,2159,6043
SHEIKHUPURA DISTRICT,FEROZEWALA TEHSIL,49,3437,1949,5386
SHEIKHUPURA DISTRICT,FEROZEWALA TEHSIL,50,4853,2868,7721
SHEIKHUPURA DISTRICT,FEROZEWALA TEHSIL,51,2978,1698,4676
SHEIKHUPURA DISTRICT,FEROZEWALA TEHSIL,52,3212,1757,4969
SHEIKHUPURA DISTRICT,FEROZEWALA TEHSIL,53,3132,1728,4860
SHEIKHUPURA DISTRICT,FEROZEWALA TEHSIL,54,2764,1511,4275
SHEIKHUPURA DISTRICT,FEROZEWALA TEHSIL,55,3339,2111,5450
SHEIKHUPURA DISTRICT,FEROZEWALA TEHSIL,56,2179,1112,3291
SHEIKHUPURA DISTRICT,FEROZEWALA TEHSIL,57,1860,966,2826
SHEIKHUPURA DISTRICT,FEROZEWALA TEHSIL,58,2062,1100,3162
SHEIKHUPURA DISTRICT,FEROZEWALA TEHSIL,59,1871,1057,2928
SHEIKHUPURA DISTRICT,FEROZEWALA TEHSIL,60,2691,1645,4336
SHEIKHUPURA DISTRICT,FEROZEWALA TEHSIL,61,1641,916,2557
SHEIKHUPURA DISTRICT,FEROZEWALA TEHSIL,62,1713,969,2682
SHEIKHUPURA DISTRICT,FEROZEWALA TEHSIL,63,1710,1011,2721
SHEIKHUPURA DISTRICT,FEROZEWALA TEHSIL,64,1427,787,2214
SHEIKHUPURA DISTRICT,FEROZEWALA TEHSIL,65,2011,1146,3157
SHEIKHUPURA DISTRICT,FEROZEWALA TEHSIL,66,999,546,1545
SHEIKHUPURA DISTRICT,FEROZEWALA TEHSIL,67,807,500,1307
SHEIKHUPURA DISTRICT,FEROZEWALA TEHSIL,68,1107,598,1705
SHEIKHUPURA DISTRICT,FEROZEWALA TEHSIL,69,996,544,1540
SHEIKHUPURA DISTRICT,FEROZEWALA TEHSIL,70,1466,812,2278
SHEIKHUPURA DISTRICT,FEROZEWALA TEHSIL,71,846,420,1266
SHEIKHUPURA DISTRICT,FEROZEWALA TEHSIL,72,767,412,1179
SHEIKHUPURA DISTRICT,FEROZEWALA TEHSIL,73,807,434,1241
SHEIKHUPURA DISTRICT,FEROZEWALA TEHSIL,74,702,367,1069
SHEIKHUPURA DISTRICT,FEROZEWALA TEHSIL,>=75,5731,2921,8652
SHEIKHUPURA DISTRICT,MURIDKE TEHSIL,<1,10172,4828,15000
SHEIKHUPURA DISTRICT,MURIDKE TEHSIL,1,10631,5183,15814
SHEIKHUPURA DISTRICT,MURIDKE TEHSIL,2,11422,5240,16662
SHEIKHUPURA DISTRICT,MURIDKE TEHSIL,3,12215,5622,17837
SHEIKHUPURA DISTRICT,MURIDKE TEHSIL,4,12064,5446,17510
SHEIKHUPURA DISTRICT,MURIDKE TEHSIL,5,12114,5404,17518
SHEIKHUPURA DISTRICT,MURIDKE TEHSIL,6,12110,5387,17497
SHEIKHUPURA DISTRICT,MURIDKE TEHSIL,7,12353,5740,18093
SHEIKHUPURA DISTRICT,MURIDKE TEHSIL,8,12185,5201,17386
SHEIKHUPURA DISTRICT,MURIDKE TEHSIL,9,11499,5533,17032
SHEIKHUPURA DISTRICT,MURIDKE TEHSIL,10,11630,4824,16454
SHEIKHUPURA DISTRICT,MURIDKE TEHSIL,11,10982,5398,16380
SHEIKHUPURA DISTRICT,MURIDKE TEHSIL,12,10749,4847,15596
SHEIKHUPURA DISTRICT,MURIDKE TEHSIL,13,10276,4936,15212
SHEIKHUPURA DISTRICT,MURIDKE TEHSIL,14,10235,4824,15059
SHEIKHUPURA DISTRICT,MURIDKE TEHSIL,15,9866,4680,14546
SHEIKHUPURA DISTRICT,MURIDKE TEHSIL,16,9846,4813,14659
SHEIKHUPURA DISTRICT,MURIDKE TEHSIL,17,9213,5023,14236
SHEIKHUPURA DISTRICT,MURIDKE TEHSIL,18,9463,4293,13756
SHEIKHUPURA DISTRICT,MURIDKE TEHSIL,19,8766,4458,13224
SHEIKHUPURA DISTRICT,MURIDKE TEHSIL,20,8855,4253,13108
SHEIKHUPURA DISTRICT,MURIDKE TEHSIL,21,8358,4446,12804
SHEIKHUPURA DISTRICT,MURIDKE TEHSIL,22,8205,4642,12847
SHEIKHUPURA DISTRICT,MURIDKE TEHSIL,23,7493,4215,11708
SHEIKHUPURA DISTRICT,MURIDKE TEHSIL,24,7344,4138,11482
SHEIKHUPURA DISTRICT,MURIDKE TEHSIL,25,7198,3655,10853
SHEIKHUPURA DISTRICT,MURIDKE TEHSIL,26,6634,3953,10587
SHEIKHUPURA DISTRICT,MURIDKE TEHSIL,27,6208,3555,9763
SHEIKHUPURA DISTRICT,MURIDKE TEHSIL,28,6527,3730,10257
SHEIKHUPURA DISTRICT,MURIDKE TEHSIL,29,5933,3047,8980
SHEIKHUPURA DISTRICT,MURIDKE TEHSIL,30,6902,3563,10465
SHEIKHUPURA DISTRICT,MURIDKE TEHSIL,31,5388,2825,8213
SHEIKHUPURA DISTRICT,MURIDKE TEHSIL,32,5753,3271,9024
SHEIKHUPURA DISTRICT,MURIDKE TEHSIL,33,5133,2912,8045
SHEIKHUPURA DISTRICT,MURIDKE TEHSIL,34,4712,2585,7297
SHEIKHUPURA DISTRICT,MURIDKE TEHSIL,35,5680,3086,8766
SHEIKHUPURA DISTRICT,MURIDKE TEHSIL,36,4672,2481,7153
SHEIKHUPURA DISTRICT,MURIDKE TEHSIL,37,4421,2074,6495
SHEIKHUPURA DISTRICT,MURIDKE TEHSIL,38,4995,2824,7819
SHEIKHUPURA DISTRICT,MURIDKE TEHSIL,39,4636,2271,6907
SHEIKHUPURA DISTRICT,MURIDKE TEHSIL,40,5152,2865,8017
SHEIKHUPURA DISTRICT,MURIDKE TEHSIL,41,4104,2114,6218
SHEIKHUPURA DISTRICT,MURIDKE TEHSIL,42,3708,2058,5766
SHEIKHUPURA DISTRICT,MURIDKE TEHSIL,43,3656,1993,5649
SHEIKHUPURA DISTRICT,MURIDKE TEHSIL,44,3130,1856,4986
SHEIKHUPURA DISTRICT,MURIDKE TEHSIL,45,3763,2184,5947
SHEIKHUPURA DISTRICT,MURIDKE TEHSIL,46,2749,1569,4318
SHEIKHUPURA DISTRICT,MURIDKE TEHSIL,47,2936,1413,4349
SHEIKHUPURA DISTRICT,MURIDKE TEHSIL,48,3144,1735,4879
SHEIKHUPURA DISTRICT,MURIDKE TEHSIL,49,3034,1635,4669
SHEIKHUPURA DISTRICT,MURIDKE TEHSIL,50,3477,1929,5406
SHEIKHUPURA DISTRICT,MURIDKE TEHSIL,51,2839,1456,4295
SHEIKHUPURA DISTRICT,MURIDKE TEHSIL,52,2774,1526,4300
SHEIKHUPURA DISTRICT,MURIDKE TEHSIL,53,2705,1460,4165
SHEIKHUPURA DISTRICT,MURIDKE TEHSIL,54,2375,1314,3689
SHEIKHUPURA DISTRICT,MURIDKE TEHSIL,55,2522,1467,3989
SHEIKHUPURA DISTRICT,MURIDKE TEHSIL,56,1773,978,2751
SHEIKHUPURA DISTRICT,MURIDKE TEHSIL,57,1655,778,2433
SHEIKHUPURA DISTRICT,MURIDKE TEHSIL,58,1835,989,2824
SHEIKHUPURA DISTRICT,MURIDKE TEHSIL,59,1666,871,2537
SHEIKHUPURA DISTRICT,MURIDKE TEHSIL,60,2048,1064,3112
SHEIKHUPURA DISTRICT,MURIDKE TEHSIL,61,1498,725,2223
SHEIKHUPURA DISTRICT,MURIDKE TEHSIL,62,1474,810,2284
SHEIKHUPURA DISTRICT,MURIDKE TEHSIL,63,1584,795,2379
SHEIKHUPURA DISTRICT,MURIDKE TEHSIL,64,1368,688,2056
SHEIKHUPURA DISTRICT,MURIDKE TEHSIL,65,1671,844,2515
SHEIKHUPURA DISTRICT,MURIDKE TEHSIL,66,968,457,1425
SHEIKHUPURA DISTRICT,MURIDKE TEHSIL,67,882,418,1300
SHEIKHUPURA DISTRICT,MURIDKE TEHSIL,68,1108,522,1630
SHEIKHUPURA DISTRICT,MURIDKE TEHSIL,69,1025,470,1495
SHEIKHUPURA DISTRICT,MURIDKE TEHSIL,70,1403,664,2067
SHEIKHUPURA DISTRICT,MURIDKE TEHSIL,71,911,376,1287
SHEIKHUPURA DISTRICT,MURIDKE TEHSIL,72,919,385,1304
SHEIKHUPURA DISTRICT,MURIDKE TEHSIL,73,884,382,1266
SHEIKHUPURA DISTRICT,MURIDKE TEHSIL,74,800,328,1128
SHEIKHUPURA DISTRICT,MURIDKE TEHSIL,>=75,6359,2528,8887
SHEIKHUPURA DISTRICT,SAFDARABAD TEHSIL,<1,4799,1309,6108
SHEIKHUPURA DISTRICT,SAFDARABAD TEHSIL,1,5087,1332,6419
SHEIKHUPURA DISTRICT,SAFDARABAD TEHSIL,2,5261,1313,6574
SHEIKHUPURA DISTRICT,SAFDARABAD TEHSIL,3,5659,1377,7036
SHEIKHUPURA DISTRICT,SAFDARABAD TEHSIL,4,5578,1331,6909
SHEIKHUPURA DISTRICT,SAFDARABAD TEHSIL,5,5796,1340,7136
SHEIKHUPURA DISTRICT,SAFDARABAD TEHSIL,6,5463,1366,6829
SHEIKHUPURA DISTRICT,SAFDARABAD TEHSIL,7,5847,1429,7276
SHEIKHUPURA DISTRICT,SAFDARABAD TEHSIL,8,5643,1278,6921
SHEIKHUPURA DISTRICT,SAFDARABAD TEHSIL,9,5543,1386,6929
SHEIKHUPURA DISTRICT,SAFDARABAD TEHSIL,10,5419,1212,6631
SHEIKHUPURA DISTRICT,SAFDARABAD TEHSIL,11,5268,1308,6576
SHEIKHUPURA DISTRICT,SAFDARABAD TEHSIL,12,5171,1171,6342
SHEIKHUPURA DISTRICT,SAFDARABAD TEHSIL,13,4958,1205,6163
SHEIKHUPURA DISTRICT,SAFDARABAD TEHSIL,14,4999,1213,6212
SHEIKHUPURA DISTRICT,SAFDARABAD TEHSIL,15,4838,1205,6043
SHEIKHUPURA DISTRICT,SAFDARABAD TEHSIL,16,5009,1176,6185
SHEIKHUPURA DISTRICT,SAFDARABAD TEHSIL,17,4780,1052,5832
SHEIKHUPURA DISTRICT,SAFDARABAD TEHSIL,18,4924,1109,6033
SHEIKHUPURA DISTRICT,SAFDARABAD TEHSIL,19,4637,1188,5825
SHEIKHUPURA DISTRICT,SAFDARABAD TEHSIL,20,4600,1103,5703
SHEIKHUPURA DISTRICT,SAFDARABAD TEHSIL,21,4453,1105,5558
SHEIKHUPURA DISTRICT,SAFDARABAD TEHSIL,22,4542,1078,5620
SHEIKHUPURA DISTRICT,SAFDARABAD TEHSIL,23,4029,1043,5072
SHEIKHUPURA DISTRICT,SAFDARABAD TEHSIL,24,3666,989,4655
SHEIKHUPURA DISTRICT,SAFDARABAD TEHSIL,25,3922,897,4819
SHEIKHUPURA DISTRICT,SAFDARABAD TEHSIL,26,3468,954,4422
SHEIKHUPURA DISTRICT,SAFDARABAD TEHSIL,27,3141,942,4083
SHEIKHUPURA DISTRICT,SAFDARABAD TEHSIL,28,3437,898,4335
SHEIKHUPURA DISTRICT,SAFDARABAD TEHSIL,29,2866,868,3734
SHEIKHUPURA DISTRICT,SAFDARABAD TEHSIL,30,3787,868,4655
SHEIKHUPURA DISTRICT,SAFDARABAD TEHSIL,31,2610,722,3332
SHEIKHUPURA DISTRICT,SAFDARABAD TEHSIL,32,2974,792,3766
SHEIKHUPURA DISTRICT,SAFDARABAD TEHSIL,33,2638,731,3369
SHEIKHUPURA DISTRICT,SAFDARABAD TEHSIL,34,2342,579,2921
SHEIKHUPURA DISTRICT,SAFDARABAD TEHSIL,35,3184,693,3877
SHEIKHUPURA DISTRICT,SAFDARABAD TEHSIL,36,2178,590,2768
SHEIKHUPURA DISTRICT,SAFDARABAD TEHSIL,37,2230,647,2877
SHEIKHUPURA DISTRICT,SAFDARABAD TEHSIL,38,2457,633,3090
SHEIKHUPURA DISTRICT,SAFDARABAD TEHSIL,39,2401,666,3067
SHEIKHUPURA DISTRICT,SAFDARABAD TEHSIL,40,2917,650,3567
SHEIKHUPURA DISTRICT,SAFDARABAD TEHSIL,41,2048,532,2580
SHEIKHUPURA DISTRICT,SAFDARABAD TEHSIL,42,1998,541,2539
SHEIKHUPURA DISTRICT,SAFDARABAD TEHSIL,43,1881,485,2366
SHEIKHUPURA DISTRICT,SAFDARABAD TEHSIL,44,1677,453,2130
SHEIKHUPURA DISTRICT,SAFDARABAD TEHSIL,45,2310,499,2809
SHEIKHUPURA DISTRICT,SAFDARABAD TEHSIL,46,1368,406,1774
SHEIKHUPURA DISTRICT,SAFDARABAD TEHSIL,47,1605,434,2039
SHEIKHUPURA DISTRICT,SAFDARABAD TEHSIL,48,1742,436,2178
SHEIKHUPURA DISTRICT,SAFDARABAD TEHSIL,49,1747,485,2232
SHEIKHUPURA DISTRICT,SAFDARABAD TEHSIL,50,2266,492,2758
SHEIKHUPURA DISTRICT,SAFDARABAD TEHSIL,51,1561,444,2005
SHEIKHUPURA DISTRICT,SAFDARABAD TEHSIL,52,1715,442,2157
SHEIKHUPURA DISTRICT,SAFDARABAD TEHSIL,53,1547,437,1984
SHEIKHUPURA DISTRICT,SAFDARABAD TEHSIL,54,1449,396,1845
SHEIKHUPURA DISTRICT,SAFDARABAD TEHSIL,55,1598,370,1968
SHEIKHUPURA DISTRICT,SAFDARABAD TEHSIL,56,1070,291,1361
SHEIKHUPURA DISTRICT,SAFDARABAD TEHSIL,57,996,257,1253
SHEIKHUPURA DISTRICT,SAFDARABAD TEHSIL,58,1008,263,1271
SHEIKHUPURA DISTRICT,SAFDARABAD TEHSIL,59,1022,279,1301
SHEIKHUPURA DISTRICT,SAFDARABAD TEHSIL,60,1419,280,1699
SHEIKHUPURA DISTRICT,SAFDARABAD TEHSIL,61,887,232,1119
SHEIKHUPURA DISTRICT,SAFDARABAD TEHSIL,62,920,239,1159
SHEIKHUPURA DISTRICT,SAFDARABAD TEHSIL,63,892,212,1104
SHEIKHUPURA DISTRICT,SAFDARABAD TEHSIL,64,808,185,993
SHEIKHUPURA DISTRICT,SAFDARABAD TEHSIL,65,1037,197,1234
SHEIKHUPURA DISTRICT,SAFDARABAD TEHSIL,66,606,137,743
SHEIKHUPURA DISTRICT,SAFDARABAD TEHSIL,67,503,137,640
SHEIKHUPURA DISTRICT,SAFDARABAD TEHSIL,68,546,120,666
SHEIKHUPURA DISTRICT,SAFDARABAD TEHSIL,69,535,93,628
SHEIKHUPURA DISTRICT,SAFDARABAD TEHSIL,70,926,174,1100
SHEIKHUPURA DISTRICT,SAFDARABAD TEHSIL,71,604,123,727
SHEIKHUPURA DISTRICT,SAFDARABAD TEHSIL,72,580,146,726
SHEIKHUPURA DISTRICT,SAFDARABAD TEHSIL,73,559,103,662
SHEIKHUPURA DISTRICT,SAFDARABAD TEHSIL,74,499,82,581
SHEIKHUPURA DISTRICT,SAFDARABAD TEHSIL,>=75,4301,906,5207
SHEIKHUPURA DISTRICT,SHARAK PUR TEHSIL,<1,3684,894,4578
SHEIKHUPURA DISTRICT,SHARAK PUR TEHSIL,1,3788,1015,4803
SHEIKHUPURA DISTRICT,SHARAK PUR TEHSIL,2,4096,977,5073
SHEIKHUPURA DISTRICT,SHARAK PUR TEHSIL,3,4396,1028,5424
SHEIKHUPURA DISTRICT,SHARAK PUR TEHSIL,4,4120,987,5107
SHEIKHUPURA DISTRICT,SHARAK PUR TEHSIL,5,4212,1014,5226
SHEIKHUPURA DISTRICT,SHARAK PUR TEHSIL,6,4017,1008,5025
SHEIKHUPURA DISTRICT,SHARAK PUR TEHSIL,7,4449,1049,5498
SHEIKHUPURA DISTRICT,SHARAK PUR TEHSIL,8,4275,970,5245
SHEIKHUPURA DISTRICT,SHARAK PUR TEHSIL,9,4047,1008,5055
SHEIKHUPURA DISTRICT,SHARAK PUR TEHSIL,10,4058,947,5005
SHEIKHUPURA DISTRICT,SHARAK PUR TEHSIL,11,3669,1064,4733
SHEIKHUPURA DISTRICT,SHARAK PUR TEHSIL,12,3779,997,4776
SHEIKHUPURA DISTRICT,SHARAK PUR TEHSIL,13,3498,1035,4533
SHEIKHUPURA DISTRICT,SHARAK PUR TEHSIL,14,3535,940,4475
SHEIKHUPURA DISTRICT,SHARAK PUR TEHSIL,15,3265,907,4172
SHEIKHUPURA DISTRICT,SHARAK PUR TEHSIL,16,3367,922,4289
SHEIKHUPURA DISTRICT,SHARAK PUR TEHSIL,17,3154,901,4055
SHEIKHUPURA DISTRICT,SHARAK PUR TEHSIL,18,3408,839,4247
SHEIKHUPURA DISTRICT,SHARAK PUR TEHSIL,19,3037,898,3935
SHEIKHUPURA DISTRICT,SHARAK PUR TEHSIL,20,3381,770,4151
SHEIKHUPURA DISTRICT,SHARAK PUR TEHSIL,21,2865,823,3688
SHEIKHUPURA DISTRICT,SHARAK PUR TEHSIL,22,3227,790,4017
SHEIKHUPURA DISTRICT,SHARAK PUR TEHSIL,23,2568,783,3351
SHEIKHUPURA DISTRICT,SHARAK PUR TEHSIL,24,2580,731,3311
SHEIKHUPURA DISTRICT,SHARAK PUR TEHSIL,25,2836,646,3482
SHEIKHUPURA DISTRICT,SHARAK PUR TEHSIL,26,2467,740,3207
SHEIKHUPURA DISTRICT,SHARAK PUR TEHSIL,27,2151,646,2797
SHEIKHUPURA DISTRICT,SHARAK PUR TEHSIL,28,2381,695,3076
SHEIKHUPURA DISTRICT,SHARAK PUR TEHSIL,29,1953,608,2561
SHEIKHUPURA DISTRICT,SHARAK PUR TEHSIL,30,2813,660,3473
SHEIKHUPURA DISTRICT,SHARAK PUR TEHSIL,31,1846,578,2424
SHEIKHUPURA DISTRICT,SHARAK PUR TEHSIL,32,2135,642,2777
SHEIKHUPURA DISTRICT,SHARAK PUR TEHSIL,33,1860,572,2432
SHEIKHUPURA DISTRICT,SHARAK PUR TEHSIL,34,1731,534,2265
SHEIKHUPURA DISTRICT,SHARAK PUR TEHSIL,35,2394,545,2939
SHEIKHUPURA DISTRICT,SHARAK PUR TEHSIL,36,1754,610,2364
SHEIKHUPURA DISTRICT,SHARAK PUR TEHSIL,37,1572,442,2014
SHEIKHUPURA DISTRICT,SHARAK PUR TEHSIL,38,1935,570,2505
SHEIKHUPURA DISTRICT,SHARAK PUR TEHSIL,39,1748,525,2273
SHEIKHUPURA DISTRICT,SHARAK PUR TEHSIL,40,2239,530,2769
SHEIKHUPURA DISTRICT,SHARAK PUR TEHSIL,41,1526,519,2045
SHEIKHUPURA DISTRICT,SHARAK PUR TEHSIL,42,1397,451,1848
SHEIKHUPURA DISTRICT,SHARAK PUR TEHSIL,43,1349,443,1792
SHEIKHUPURA DISTRICT,SHARAK PUR TEHSIL,44,1223,463,1686
SHEIKHUPURA DISTRICT,SHARAK PUR TEHSIL,45,1639,389,2028
SHEIKHUPURA DISTRICT,SHARAK PUR TEHSIL,46,1021,400,1421
SHEIKHUPURA DISTRICT,SHARAK PUR TEHSIL,47,1004,280,1284
SHEIKHUPURA DISTRICT,SHARAK PUR TEHSIL,48,1144,400,1544
SHEIKHUPURA DISTRICT,SHARAK PUR TEHSIL,49,1053,341,1394
SHEIKHUPURA DISTRICT,SHARAK PUR TEHSIL,50,1600,431,2031
SHEIKHUPURA DISTRICT,SHARAK PUR TEHSIL,51,966,356,1322
SHEIKHUPURA DISTRICT,SHARAK PUR TEHSIL,52,1022,284,1306
SHEIKHUPURA DISTRICT,SHARAK PUR TEHSIL,53,945,314,1259
SHEIKHUPURA DISTRICT,SHARAK PUR TEHSIL,54,921,282,1203
SHEIKHUPURA DISTRICT,SHARAK PUR TEHSIL,55,1096,270,1366
SHEIKHUPURA DISTRICT,SHARAK PUR TEHSIL,56,726,249,975
SHEIKHUPURA DISTRICT,SHARAK PUR TEHSIL,57,612,195,807
SHEIKHUPURA DISTRICT,SHARAK PUR TEHSIL,58,671,211,882
SHEIKHUPURA DISTRICT,SHARAK PUR TEHSIL,59,635,211,846
SHEIKHUPURA DISTRICT,SHARAK PUR TEHSIL,60,1082,247,1329
SHEIKHUPURA DISTRICT,SHARAK PUR TEHSIL,61,613,209,822
SHEIKHUPURA DISTRICT,SHARAK PUR TEHSIL,62,617,178,795
SHEIKHUPURA DISTRICT,SHARAK PUR TEHSIL,63,586,180,766
SHEIKHUPURA DISTRICT,SHARAK PUR TEHSIL,64,637,187,824
SHEIKHUPURA DISTRICT,SHARAK PUR TEHSIL,65,808,163,971
SHEIKHUPURA DISTRICT,SHARAK PUR TEHSIL,66,379,120,499
SHEIKHUPURA DISTRICT,SHARAK PUR TEHSIL,67,317,77,394
SHEIKHUPURA DISTRICT,SHARAK PUR TEHSIL,68,439,127,566
SHEIKHUPURA DISTRICT,SHARAK PUR TEHSIL,69,417,94,511
SHEIKHUPURA DISTRICT,SHARAK PUR TEHSIL,70,709,122,831
SHEIKHUPURA DISTRICT,SHARAK PUR TEHSIL,71,355,91,446
SHEIKHUPURA DISTRICT,SHARAK PUR TEHSIL,72,350,79,429
SHEIKHUPURA DISTRICT,SHARAK PUR TEHSIL,73,337,73,410
SHEIKHUPURA DISTRICT,SHARAK PUR TEHSIL,74,355,71,426
SHEIKHUPURA DISTRICT,SHARAK PUR TEHSIL,>=75,2733,538,3271
SHEIKHUPURA DISTRICT,SHEIKHUPURA TEHSIL,<1,21258,12952,34210
SHEIKHUPURA DISTRICT,SHEIKHUPURA TEHSIL,1,23494,14118,37612
SHEIKHUPURA DISTRICT,SHEIKHUPURA TEHSIL,2,23499,14083,37582
SHEIKHUPURA DISTRICT,SHEIKHUPURA TEHSIL,3,25691,15296,40987
SHEIKHUPURA DISTRICT,SHEIKHUPURA TEHSIL,4,24537,14208,38745
SHEIKHUPURA DISTRICT,SHEIKHUPURA TEHSIL,5,25522,14480,40002
SHEIKHUPURA DISTRICT,SHEIKHUPURA TEHSIL,6,24766,14085,38851
SHEIKHUPURA DISTRICT,SHEIKHUPURA TEHSIL,7,25894,15433,41327
SHEIKHUPURA DISTRICT,SHEIKHUPURA TEHSIL,8,24412,13593,38005
SHEIKHUPURA DISTRICT,SHEIKHUPURA TEHSIL,9,24410,14679,39089
SHEIKHUPURA DISTRICT,SHEIKHUPURA TEHSIL,10,23118,13177,36295
SHEIKHUPURA DISTRICT,SHEIKHUPURA TEHSIL,11,23315,14452,37767
SHEIKHUPURA DISTRICT,SHEIKHUPURA TEHSIL,12,22012,12977,34989
SHEIKHUPURA DISTRICT,SHEIKHUPURA TEHSIL,13,21841,13625,35466
SHEIKHUPURA DISTRICT,SHEIKHUPURA TEHSIL,14,21331,12980,34311
SHEIKHUPURA DISTRICT,SHEIKHUPURA TEHSIL,15,21114,12933,34047
SHEIKHUPURA DISTRICT,SHEIKHUPURA TEHSIL,16,21534,13142,34676
SHEIKHUPURA DISTRICT,SHEIKHUPURA TEHSIL,17,20652,13676,34328
SHEIKHUPURA DISTRICT,SHEIKHUPURA TEHSIL,18,20879,12490,33369
SHEIKHUPURA DISTRICT,SHEIKHUPURA TEHSIL,19,20572,13397,33969
SHEIKHUPURA DISTRICT,SHEIKHUPURA TEHSIL,20,20239,12170,32409
SHEIKHUPURA DISTRICT,SHEIKHUPURA TEHSIL,21,19763,13521,33284
SHEIKHUPURA DISTRICT,SHEIKHUPURA TEHSIL,22,19789,12825,32614
SHEIKHUPURA DISTRICT,SHEIKHUPURA TEHSIL,23,17793,12210,30003
SHEIKHUPURA DISTRICT,SHEIKHUPURA TEHSIL,24,16914,12021,28935
SHEIKHUPURA DISTRICT,SHEIKHUPURA TEHSIL,25,16889,10671,27560
SHEIKHUPURA DISTRICT,SHEIKHUPURA TEHSIL,26,15761,11539,27300
SHEIKHUPURA DISTRICT,SHEIKHUPURA TEHSIL,27,14367,10537,24904
SHEIKHUPURA DISTRICT,SHEIKHUPURA TEHSIL,28,15615,10959,26574
SHEIKHUPURA DISTRICT,SHEIKHUPURA TEHSIL,29,13478,9594,23072
SHEIKHUPURA DISTRICT,SHEIKHUPURA TEHSIL,30,15506,10094,25600
SHEIKHUPURA DISTRICT,SHEIKHUPURA TEHSIL,31,12686,8982,21668
SHEIKHUPURA DISTRICT,SHEIKHUPURA TEHSIL,32,13209,9426,22635
SHEIKHUPURA DISTRICT,SHEIKHUPURA TEHSIL,33,12206,8600,20806
SHEIKHUPURA DISTRICT,SHEIKHUPURA TEHSIL,34,11416,7926,19342
SHEIKHUPURA DISTRICT,SHEIKHUPURA TEHSIL,35,13093,8490,21583
SHEIKHUPURA DISTRICT,SHEIKHUPURA TEHSIL,36,10745,7546,18291
SHEIKHUPURA DISTRICT,SHEIKHUPURA TEHSIL,37,10258,6902,17160
SHEIKHUPURA DISTRICT,SHEIKHUPURA TEHSIL,38,11476,8294,19770
SHEIKHUPURA DISTRICT,SHEIKHUPURA TEHSIL,39,10392,7214,17606
SHEIKHUPURA DISTRICT,SHEIKHUPURA TEHSIL,40,11776,7701,19477
SHEIKHUPURA DISTRICT,SHEIKHUPURA TEHSIL,41,9268,6656,15924
SHEIKHUPURA DISTRICT,SHEIKHUPURA TEHSIL,42,8948,6280,15228
SHEIKHUPURA DISTRICT,SHEIKHUPURA TEHSIL,43,8373,5907,14280
SHEIKHUPURA DISTRICT,SHEIKHUPURA TEHSIL,44,7820,5504,13324
SHEIKHUPURA DISTRICT,SHEIKHUPURA TEHSIL,45,8679,5886,14565
SHEIKHUPURA DISTRICT,SHEIKHUPURA TEHSIL,46,6618,4875,11493
SHEIKHUPURA DISTRICT,SHEIKHUPURA TEHSIL,47,6858,4629,11487
SHEIKHUPURA DISTRICT,SHEIKHUPURA TEHSIL,48,7631,5413,13044
SHEIKHUPURA DISTRICT,SHEIKHUPURA TEHSIL,49,7376,5248,12624
SHEIKHUPURA DISTRICT,SHEIKHUPURA TEHSIL,50,8448,5774,14222
SHEIKHUPURA DISTRICT,SHEIKHUPURA TEHSIL,51,6734,4774,11508
SHEIKHUPURA DISTRICT,SHEIKHUPURA TEHSIL,52,6629,4920,11549
SHEIKHUPURA DISTRICT,SHEIKHUPURA TEHSIL,53,6461,4562,11023
SHEIKHUPURA DISTRICT,SHEIKHUPURA TEHSIL,54,5730,4321,10051
SHEIKHUPURA DISTRICT,SHEIKHUPURA TEHSIL,55,6041,4263,10304
SHEIKHUPURA DISTRICT,SHEIKHUPURA TEHSIL,56,4398,3304,7702
SHEIKHUPURA DISTRICT,SHEIKHUPURA TEHSIL,57,3907,2722,6629
SHEIKHUPURA DISTRICT,SHEIKHUPURA TEHSIL,58,4285,3214,7499
SHEIKHUPURA DISTRICT,SHEIKHUPURA TEHSIL,59,3982,2932,6914
SHEIKHUPURA DISTRICT,SHEIKHUPURA TEHSIL,60,4903,3064,7967
SHEIKHUPURA DISTRICT,SHEIKHUPURA TEHSIL,61,3635,2548,6183
SHEIKHUPURA DISTRICT,SHEIKHUPURA TEHSIL,62,3403,2425,5828
SHEIKHUPURA DISTRICT,SHEIKHUPURA TEHSIL,63,3359,2512,5871
SHEIKHUPURA DISTRICT,SHEIKHUPURA TEHSIL,64,3033,2130,5163
SHEIKHUPURA DISTRICT,SHEIKHUPURA TEHSIL,65,3559,2185,5744
SHEIKHUPURA DISTRICT,SHEIKHUPURA TEHSIL,66,2146,1442,3588
SHEIKHUPURA DISTRICT,SHEIKHUPURA TEHSIL,67,1890,1188,3078
SHEIKHUPURA DISTRICT,SHEIKHUPURA TEHSIL,68,2257,1423,3680
SHEIKHUPURA DISTRICT,SHEIKHUPURA TEHSIL,69,1999,1255,3254
SHEIKHUPURA DISTRICT,SHEIKHUPURA TEHSIL,70,3103,1613,4716
SHEIKHUPURA DISTRICT,SHEIKHUPURA TEHSIL,71,2079,1203,3282
SHEIKHUPURA DISTRICT,SHEIKHUPURA TEHSIL,72,2023,1179,3202
SHEIKHUPURA DISTRICT,SHEIKHUPURA TEHSIL,73,1828,1159,2987
SHEIKHUPURA DISTRICT,SHEIKHUPURA TEHSIL,74,1765,961,2726
SHEIKHUPURA DISTRICT,SHEIKHUPURA TEHSIL,>=75,14830,7971,22801
SHERANI DISTRICT,SHERANI SUB-DIVISION,<1,7231,0,7231
SHERANI DISTRICT,SHERANI SUB-DIVISION,1,6945,0,6945
SHERANI DISTRICT,SHERANI SUB-DIVISION,2,7956,0,7956
SHERANI DISTRICT,SHERANI SUB-DIVISION,3,6861,0,6861
SHERANI DISTRICT,SHERANI SUB-DIVISION,4,7401,0,7401
SHERANI DISTRICT,SHERANI SUB-DIVISION,5,6333,0,6333
SHERANI DISTRICT,SHERANI SUB-DIVISION,6,6954,0,6954
SHERANI DISTRICT,SHERANI SUB-DIVISION,7,6004,0,6004
SHERANI DISTRICT,SHERANI SUB-DIVISION,8,6470,0,6470
SHERANI DISTRICT,SHERANI SUB-DIVISION,9,6255,0,6255
SHERANI DISTRICT,SHERANI SUB-DIVISION,10,5485,0,5485
SHERANI DISTRICT,SHERANI SUB-DIVISION,11,4922,0,4922
SHERANI DISTRICT,SHERANI SUB-DIVISION,12,4347,0,4347
SHERANI DISTRICT,SHERANI SUB-DIVISION,13,4219,0,4219
SHERANI DISTRICT,SHERANI SUB-DIVISION,14,3809,0,3809
SHERANI DISTRICT,SHERANI SUB-DIVISION,15,3591,0,3591
SHERANI DISTRICT,SHERANI SUB-DIVISION,16,3074,0,3074
SHERANI DISTRICT,SHERANI SUB-DIVISION,17,3234,0,3234
SHERANI DISTRICT,SHERANI SUB-DIVISION,18,2520,0,2520
SHERANI DISTRICT,SHERANI SUB-DIVISION,19,2617,0,2617
SHERANI DISTRICT,SHERANI SUB-DIVISION,20,2173,0,2173
SHERANI DISTRICT,SHERANI SUB-DIVISION,21,2222,0,2222
SHERANI DISTRICT,SHERANI SUB-DIVISION,22,1751,0,1751
SHERANI DISTRICT,SHERANI SUB-DIVISION,23,1861,0,1861
SHERANI DISTRICT,SHERANI SUB-DIVISION,24,1739,0,1739
SHERANI DISTRICT,SHERANI SUB-DIVISION,25,1798,0,1798
SHERANI DISTRICT,SHERANI SUB-DIVISION,26,1888,0,1888
SHERANI DISTRICT,SHERANI SUB-DIVISION,27,2046,0,2046
SHERANI DISTRICT,SHERANI SUB-DIVISION,28,1589,0,1589
SHERANI DISTRICT,SHERANI SUB-DIVISION,29,1894,0,1894
SHERANI DISTRICT,SHERANI SUB-DIVISION,30,1302,0,1302
SHERANI DISTRICT,SHERANI SUB-DIVISION,31,1434,0,1434
SHERANI DISTRICT,SHERANI SUB-DIVISION,32,1257,0,1257
SHERANI DISTRICT,SHERANI SUB-DIVISION,33,1254,0,1254
SHERANI DISTRICT,SHERANI SUB-DIVISION,34,957,0,957
SHERANI DISTRICT,SHERANI SUB-DIVISION,35,968,0,968
SHERANI DISTRICT,SHERANI SUB-DIVISION,36,848,0,848
SHERANI DISTRICT,SHERANI SUB-DIVISION,37,1221,0,1221
SHERANI DISTRICT,SHERANI SUB-DIVISION,38,1016,0,1016
SHERANI DISTRICT,SHERANI SUB-DIVISION,39,979,0,979
SHERANI DISTRICT,SHERANI SUB-DIVISION,40,899,0,899
SHERANI DISTRICT,SHERANI SUB-DIVISION,41,770,0,770
SHERANI DISTRICT,SHERANI SUB-DIVISION,42,784,0,784
SHERANI DISTRICT,SHERANI SUB-DIVISION,43,658,0,658
SHERANI DISTRICT,SHERANI SUB-DIVISION,44,653,0,653
SHERANI DISTRICT,SHERANI SUB-DIVISION,45,591,0,591
SHERANI DISTRICT,SHERANI SUB-DIVISION,46,539,0,539
SHERANI DISTRICT,SHERANI SUB-DIVISION,47,845,0,845
SHERANI DISTRICT,SHERANI SUB-DIVISION,48,580,0,580
SHERANI DISTRICT,SHERANI SUB-DIVISION,49,647,0,647
SHERANI DISTRICT,SHERANI SUB-DIVISION,50,483,0,483
SHERANI DISTRICT,SHERANI SUB-DIVISION,51,540,0,540
SHERANI DISTRICT,SHERANI SUB-DIVISION,52,522,0,522
SHERANI DISTRICT,SHERANI SUB-DIVISION,53,562,0,562
SHERANI DISTRICT,SHERANI SUB-DIVISION,54,450,0,450
SHERANI DISTRICT,SHERANI SUB-DIVISION,55,332,0,332
SHERANI DISTRICT,SHERANI SUB-DIVISION,56,355,0,355
SHERANI DISTRICT,SHERANI SUB-DIVISION,57,510,0,510
SHERANI DISTRICT,SHERANI SUB-DIVISION,58,331,0,331
SHERANI DISTRICT,SHERANI SUB-DIVISION,59,429,0,429
SHERANI DISTRICT,SHERANI SUB-DIVISION,60,292,0,292
SHERANI DISTRICT,SHERANI SUB-DIVISION,61,318,0,318
SHERANI DISTRICT,SHERANI SUB-DIVISION,62,305,0,305
SHERANI DISTRICT,SHERANI SUB-DIVISION,63,315,0,315
SHERANI DISTRICT,SHERANI SUB-DIVISION,64,408,0,408
SHERANI DISTRICT,SHERANI SUB-DIVISION,65,205,0,205
SHERANI DISTRICT,SHERANI SUB-DIVISION,66,233,0,233
SHERANI DISTRICT,SHERANI SUB-DIVISION,67,351,0,351
SHERANI DISTRICT,SHERANI SUB-DIVISION,68,217,0,217
SHERANI DISTRICT,SHERANI SUB-DIVISION,69,447,0,447
SHERANI DISTRICT,SHERANI SUB-DIVISION,70,137,0,137
SHERANI DISTRICT,SHERANI SUB-DIVISION,71,193,0,193
SHERANI DISTRICT,SHERANI SUB-DIVISION,72,160,0,160
SHERANI DISTRICT,SHERANI SUB-DIVISION,73,134,0,134
SHERANI DISTRICT,SHERANI SUB-DIVISION,74,259,0,259
SHERANI DISTRICT,SHERANI SUB-DIVISION,>=75,1073,0,1073
SHIKARPUR DISTRICT,GARHI YASIN TALUKA,<1,6243,831,7074
SHIKARPUR DISTRICT,GARHI YASIN TALUKA,1,7722,738,8460
SHIKARPUR DISTRICT,GARHI YASIN TALUKA,2,9905,863,10768
SHIKARPUR DISTRICT,GARHI YASIN TALUKA,3,10626,1090,11716
SHIKARPUR DISTRICT,GARHI YASIN TALUKA,4,11059,999,12058
SHIKARPUR DISTRICT,GARHI YASIN TALUKA,5,10953,1089,12042
SHIKARPUR DISTRICT,GARHI YASIN TALUKA,6,10953,959,11912
SHIKARPUR DISTRICT,GARHI YASIN TALUKA,7,10055,1099,11154
SHIKARPUR DISTRICT,GARHI YASIN TALUKA,8,11296,970,12266
SHIKARPUR DISTRICT,GARHI YASIN TALUKA,9,8421,1000,9421
SHIKARPUR DISTRICT,GARHI YASIN TALUKA,10,9714,897,10611
SHIKARPUR DISTRICT,GARHI YASIN TALUKA,11,6637,889,7526
SHIKARPUR DISTRICT,GARHI YASIN TALUKA,12,7802,825,8627
SHIKARPUR DISTRICT,GARHI YASIN TALUKA,13,5960,862,6822
SHIKARPUR DISTRICT,GARHI YASIN TALUKA,14,6503,852,7355
SHIKARPUR DISTRICT,GARHI YASIN TALUKA,15,6173,837,7010
SHIKARPUR DISTRICT,GARHI YASIN TALUKA,16,6309,907,7216
SHIKARPUR DISTRICT,GARHI YASIN TALUKA,17,5648,880,6528
SHIKARPUR DISTRICT,GARHI YASIN TALUKA,18,6509,891,7400
SHIKARPUR DISTRICT,GARHI YASIN TALUKA,19,4942,810,5752
SHIKARPUR DISTRICT,GARHI YASIN TALUKA,20,6122,681,6803
SHIKARPUR DISTRICT,GARHI YASIN TALUKA,21,4068,681,4749
SHIKARPUR DISTRICT,GARHI YASIN TALUKA,22,4322,594,4916
SHIKARPUR DISTRICT,GARHI YASIN TALUKA,23,3571,601,4172
SHIKARPUR DISTRICT,GARHI YASIN TALUKA,24,3300,501,3801
SHIKARPUR DISTRICT,GARHI YASIN TALUKA,25,4545,524,5069
SHIKARPUR DISTRICT,GARHI YASIN TALUKA,26,3194,507,3701
SHIKARPUR DISTRICT,GARHI YASIN TALUKA,27,3226,557,3783
SHIKARPUR DISTRICT,GARHI YASIN TALUKA,28,3991,593,4584
SHIKARPUR DISTRICT,GARHI YASIN TALUKA,29,3432,608,4040
SHIKARPUR DISTRICT,GARHI YASIN TALUKA,30,4527,569,5096
SHIKARPUR DISTRICT,GARHI YASIN TALUKA,31,3357,542,3899
SHIKARPUR DISTRICT,GARHI YASIN TALUKA,32,3214,551,3765
SHIKARPUR DISTRICT,GARHI YASIN TALUKA,33,3106,528,3634
SHIKARPUR DISTRICT,GARHI YASIN TALUKA,34,2618,449,3067
SHIKARPUR DISTRICT,GARHI YASIN TALUKA,35,3601,423,4024
SHIKARPUR DISTRICT,GARHI YASIN TALUKA,36,2621,428,3049
SHIKARPUR DISTRICT,GARHI YASIN TALUKA,37,3003,427,3430
SHIKARPUR DISTRICT,GARHI YASIN TALUKA,38,3065,495,3560
SHIKARPUR DISTRICT,GARHI YASIN TALUKA,39,2809,420,3229
SHIKARPUR DISTRICT,GARHI YASIN TALUKA,40,3493,407,3900
SHIKARPUR DISTRICT,GARHI YASIN TALUKA,41,2291,388,2679
SHIKARPUR DISTRICT,GARHI YASIN TALUKA,42,2310,366,2676
SHIKARPUR DISTRICT,GARHI YASIN TALUKA,43,2071,358,2429
SHIKARPUR DISTRICT,GARHI YASIN TALUKA,44,1861,304,2165
SHIKARPUR DISTRICT,GARHI YASIN TALUKA,45,2330,265,2595
SHIKARPUR DISTRICT,GARHI YASIN TALUKA,46,1508,278,1786
SHIKARPUR DISTRICT,GARHI YASIN TALUKA,47,1752,284,2036
SHIKARPUR DISTRICT,GARHI YASIN TALUKA,48,1800,317,2117
SHIKARPUR DISTRICT,GARHI YASIN TALUKA,49,1590,265,1855
SHIKARPUR DISTRICT,GARHI YASIN TALUKA,50,2184,225,2409
SHIKARPUR DISTRICT,GARHI YASIN TALUKA,51,1361,232,1593
SHIKARPUR DISTRICT,GARHI YASIN TALUKA,52,1328,222,1550
SHIKARPUR DISTRICT,GARHI YASIN TALUKA,53,1244,211,1455
SHIKARPUR DISTRICT,GARHI YASIN TALUKA,54,1187,170,1357
SHIKARPUR DISTRICT,GARHI YASIN TALUKA,55,1497,163,1660
SHIKARPUR DISTRICT,GARHI YASIN TALUKA,56,922,174,1096
SHIKARPUR DISTRICT,GARHI YASIN TALUKA,57,1022,168,1190
SHIKARPUR DISTRICT,GARHI YASIN TALUKA,58,936,153,1089
SHIKARPUR DISTRICT,GARHI YASIN TALUKA,59,949,164,1113
SHIKARPUR DISTRICT,GARHI YASIN TALUKA,60,1328,138,1466
SHIKARPUR DISTRICT,GARHI YASIN TALUKA,61,818,176,994
SHIKARPUR DISTRICT,GARHI YASIN TALUKA,62,848,178,1026
SHIKARPUR DISTRICT,GARHI YASIN TALUKA,63,786,140,926
SHIKARPUR DISTRICT,GARHI YASIN TALUKA,64,820,120,940
SHIKARPUR DISTRICT,GARHI YASIN TALUKA,65,820,99,919
SHIKARPUR DISTRICT,GARHI YASIN TALUKA,66,565,104,669
SHIKARPUR DISTRICT,GARHI YASIN TALUKA,67,585,98,683
SHIKARPUR DISTRICT,GARHI YASIN TALUKA,68,456,67,523
SHIKARPUR DISTRICT,GARHI YASIN TALUKA,69,521,92,613
SHIKARPUR DISTRICT,GARHI YASIN TALUKA,70,574,76,650
SHIKARPUR DISTRICT,GARHI YASIN TALUKA,71,417,66,483
SHIKARPUR DISTRICT,GARHI YASIN TALUKA,72,405,66,471
SHIKARPUR DISTRICT,GARHI YASIN TALUKA,73,339,53,392
SHIKARPUR DISTRICT,GARHI YASIN TALUKA,74,324,49,373
SHIKARPUR DISTRICT,GARHI YASIN TALUKA,>=75,2272,334,2606
SHIKARPUR DISTRICT,KHANPUR TALUKA,<1,6170,499,6669
SHIKARPUR DISTRICT,KHANPUR TALUKA,1,9628,629,10257
SHIKARPUR DISTRICT,KHANPUR TALUKA,2,11593,735,12328
SHIKARPUR DISTRICT,KHANPUR TALUKA,3,11876,858,12734
SHIKARPUR DISTRICT,KHANPUR TALUKA,4,12241,847,13088
SHIKARPUR DISTRICT,KHANPUR TALUKA,5,11428,888,12316
SHIKARPUR DISTRICT,KHANPUR TALUKA,6,11650,716,12366
SHIKARPUR DISTRICT,KHANPUR TALUKA,7,10723,824,11547
SHIKARPUR DISTRICT,KHANPUR TALUKA,8,10941,798,11739
SHIKARPUR DISTRICT,KHANPUR TALUKA,9,9294,687,9981
SHIKARPUR DISTRICT,KHANPUR TALUKA,10,9315,730,10045
SHIKARPUR DISTRICT,KHANPUR TALUKA,11,6517,595,7112
SHIKARPUR DISTRICT,KHANPUR TALUKA,12,6721,616,7337
SHIKARPUR DISTRICT,KHANPUR TALUKA,13,5166,508,5674
SHIKARPUR DISTRICT,KHANPUR TALUKA,14,5042,534,5576
SHIKARPUR DISTRICT,KHANPUR TALUKA,15,4487,601,5088
SHIKARPUR DISTRICT,KHANPUR TALUKA,16,4119,576,4695
SHIKARPUR DISTRICT,KHANPUR TALUKA,17,3576,560,4136
SHIKARPUR DISTRICT,KHANPUR TALUKA,18,4319,611,4930
SHIKARPUR DISTRICT,KHANPUR TALUKA,19,3315,469,3784
SHIKARPUR DISTRICT,KHANPUR TALUKA,20,3553,514,4067
SHIKARPUR DISTRICT,KHANPUR TALUKA,21,2835,450,3285
SHIKARPUR DISTRICT,KHANPUR TALUKA,22,2780,438,3218
SHIKARPUR DISTRICT,KHANPUR TALUKA,23,2515,396,2911
SHIKARPUR DISTRICT,KHANPUR TALUKA,24,2606,331,2937
SHIKARPUR DISTRICT,KHANPUR TALUKA,25,3212,398,3610
SHIKARPUR DISTRICT,KHANPUR TALUKA,26,2651,326,2977
SHIKARPUR DISTRICT,KHANPUR TALUKA,27,2886,371,3257
SHIKARPUR DISTRICT,KHANPUR TALUKA,28,3123,389,3512
SHIKARPUR DISTRICT,KHANPUR TALUKA,29,3468,400,3868
SHIKARPUR DISTRICT,KHANPUR TALUKA,30,3219,398,3617
SHIKARPUR DISTRICT,KHANPUR TALUKA,31,3046,394,3440
SHIKARPUR DISTRICT,KHANPUR TALUKA,32,2808,367,3175
SHIKARPUR DISTRICT,KHANPUR TALUKA,33,2578,301,2879
SHIKARPUR DISTRICT,KHANPUR TALUKA,34,2339,251,2590
SHIKARPUR DISTRICT,KHANPUR TALUKA,35,2715,318,3033
SHIKARPUR DISTRICT,KHANPUR TALUKA,36,2364,239,2603
SHIKARPUR DISTRICT,KHANPUR TALUKA,37,3195,336,3531
SHIKARPUR DISTRICT,KHANPUR TALUKA,38,2720,259,2979
SHIKARPUR DISTRICT,KHANPUR TALUKA,39,2719,292,3011
SHIKARPUR DISTRICT,KHANPUR TALUKA,40,2160,248,2408
SHIKARPUR DISTRICT,KHANPUR TALUKA,41,1880,231,2111
SHIKARPUR DISTRICT,KHANPUR TALUKA,42,2069,247,2316
SHIKARPUR DISTRICT,KHANPUR TALUKA,43,1451,207,1658
SHIKARPUR DISTRICT,KHANPUR TALUKA,44,1379,172,1551
SHIKARPUR DISTRICT,KHANPUR TALUKA,45,1478,202,1680
SHIKARPUR DISTRICT,KHANPUR TALUKA,46,1314,160,1474
SHIKARPUR DISTRICT,KHANPUR TALUKA,47,1793,207,2000
SHIKARPUR DISTRICT,KHANPUR TALUKA,48,1430,173,1603
SHIKARPUR DISTRICT,KHANPUR TALUKA,49,1509,175,1684
SHIKARPUR DISTRICT,KHANPUR TALUKA,50,1385,163,1548
SHIKARPUR DISTRICT,KHANPUR TALUKA,51,1227,156,1383
SHIKARPUR DISTRICT,KHANPUR TALUKA,52,1327,176,1503
SHIKARPUR DISTRICT,KHANPUR TALUKA,53,855,139,994
SHIKARPUR DISTRICT,KHANPUR TALUKA,54,881,127,1008
SHIKARPUR DISTRICT,KHANPUR TALUKA,55,1002,132,1134
SHIKARPUR DISTRICT,KHANPUR TALUKA,56,787,113,900
SHIKARPUR DISTRICT,KHANPUR TALUKA,57,1178,114,1292
SHIKARPUR DISTRICT,KHANPUR TALUKA,58,678,80,758
SHIKARPUR DISTRICT,KHANPUR TALUKA,59,751,107,858
SHIKARPUR DISTRICT,KHANPUR TALUKA,60,808,94,902
SHIKARPUR DISTRICT,KHANPUR TALUKA,61,629,71,700
SHIKARPUR DISTRICT,KHANPUR TALUKA,62,779,107,886
SHIKARPUR DISTRICT,KHANPUR TALUKA,63,541,92,633
SHIKARPUR DISTRICT,KHANPUR TALUKA,64,598,79,677
SHIKARPUR DISTRICT,KHANPUR TALUKA,65,545,76,621
SHIKARPUR DISTRICT,KHANPUR TALUKA,66,476,43,519
SHIKARPUR DISTRICT,KHANPUR TALUKA,67,620,50,670
SHIKARPUR DISTRICT,KHANPUR TALUKA,68,380,53,433
SHIKARPUR DISTRICT,KHANPUR TALUKA,69,460,48,508
SHIKARPUR DISTRICT,KHANPUR TALUKA,70,339,48,387
SHIKARPUR DISTRICT,KHANPUR TALUKA,71,330,34,364
SHIKARPUR DISTRICT,KHANPUR TALUKA,72,359,35,394
SHIKARPUR DISTRICT,KHANPUR TALUKA,73,259,38,297
SHIKARPUR DISTRICT,KHANPUR TALUKA,74,289,34,323
SHIKARPUR DISTRICT,KHANPUR TALUKA,>=75,1822,239,2061
SHIKARPUR DISTRICT,LAKHI TALUKA,<1,4867,1054,5921
SHIKARPUR DISTRICT,LAKHI TALUKA,1,6013,1202,7215
SHIKARPUR DISTRICT,LAKHI TALUKA,2,6961,1419,8380
SHIKARPUR DISTRICT,LAKHI TALUKA,3,7606,1600,9206
SHIKARPUR DISTRICT,LAKHI TALUKA,4,7592,1586,9178
SHIKARPUR DISTRICT,LAKHI TALUKA,5,7712,1537,9249
SHIKARPUR DISTRICT,LAKHI TALUKA,6,7294,1461,8755
SHIKARPUR DISTRICT,LAKHI TALUKA,7,6819,1549,8368
SHIKARPUR DISTRICT,LAKHI TALUKA,8,7616,1505,9121
SHIKARPUR DISTRICT,LAKHI TALUKA,9,5930,1409,7339
SHIKARPUR DISTRICT,LAKHI TALUKA,10,6655,1392,8047
SHIKARPUR DISTRICT,LAKHI TALUKA,11,4925,1202,6127
SHIKARPUR DISTRICT,LAKHI TALUKA,12,5380,1195,6575
SHIKARPUR DISTRICT,LAKHI TALUKA,13,4387,1127,5514
SHIKARPUR DISTRICT,LAKHI TALUKA,14,4590,1135,5725
SHIKARPUR DISTRICT,LAKHI TALUKA,15,4859,1141,6000
SHIKARPUR DISTRICT,LAKHI TALUKA,16,4530,1112,5642
SHIKARPUR DISTRICT,LAKHI TALUKA,17,4080,1167,5247
SHIKARPUR DISTRICT,LAKHI TALUKA,18,4578,1171,5749
SHIKARPUR DISTRICT,LAKHI TALUKA,19,3605,1009,4614
SHIKARPUR DISTRICT,LAKHI TALUKA,20,4144,933,5077
SHIKARPUR DISTRICT,LAKHI TALUKA,21,3040,826,3866
SHIKARPUR DISTRICT,LAKHI TALUKA,22,2829,829,3658
SHIKARPUR DISTRICT,LAKHI TALUKA,23,2571,748,3319
SHIKARPUR DISTRICT,LAKHI TALUKA,24,2502,738,3240
SHIKARPUR DISTRICT,LAKHI TALUKA,25,3164,747,3911
SHIKARPUR DISTRICT,LAKHI TALUKA,26,2562,653,3215
SHIKARPUR DISTRICT,LAKHI TALUKA,27,2817,681,3498
SHIKARPUR DISTRICT,LAKHI TALUKA,28,2897,662,3559
SHIKARPUR DISTRICT,LAKHI TALUKA,29,2814,689,3503
SHIKARPUR DISTRICT,LAKHI TALUKA,30,3009,726,3735
SHIKARPUR DISTRICT,LAKHI TALUKA,31,2588,646,3234
SHIKARPUR DISTRICT,LAKHI TALUKA,32,2449,587,3036
SHIKARPUR DISTRICT,LAKHI TALUKA,33,2295,628,2923
SHIKARPUR DISTRICT,LAKHI TALUKA,34,1976,563,2539
SHIKARPUR DISTRICT,LAKHI TALUKA,35,2282,588,2870
SHIKARPUR DISTRICT,LAKHI TALUKA,36,1965,452,2417
SHIKARPUR DISTRICT,LAKHI TALUKA,37,2386,503,2889
SHIKARPUR DISTRICT,LAKHI TALUKA,38,2128,582,2710
SHIKARPUR DISTRICT,LAKHI TALUKA,39,2117,528,2645
SHIKARPUR DISTRICT,LAKHI TALUKA,40,1945,542,2487
SHIKARPUR DISTRICT,LAKHI TALUKA,41,1570,458,2028
SHIKARPUR DISTRICT,LAKHI TALUKA,42,1722,387,2109
SHIKARPUR DISTRICT,LAKHI TALUKA,43,1369,400,1769
SHIKARPUR DISTRICT,LAKHI TALUKA,44,1296,352,1648
SHIKARPUR DISTRICT,LAKHI TALUKA,45,1491,367,1858
SHIKARPUR DISTRICT,LAKHI TALUKA,46,1147,314,1461
SHIKARPUR DISTRICT,LAKHI TALUKA,47,1489,342,1831
SHIKARPUR DISTRICT,LAKHI TALUKA,48,1372,395,1767
SHIKARPUR DISTRICT,LAKHI TALUKA,49,1345,323,1668
SHIKARPUR DISTRICT,LAKHI TALUKA,50,1334,324,1658
SHIKARPUR DISTRICT,LAKHI TALUKA,51,1038,287,1325
SHIKARPUR DISTRICT,LAKHI TALUKA,52,1215,237,1452
SHIKARPUR DISTRICT,LAKHI TALUKA,53,936,251,1187
SHIKARPUR DISTRICT,LAKHI TALUKA,54,909,183,1092
SHIKARPUR DISTRICT,LAKHI TALUKA,55,970,244,1214
SHIKARPUR DISTRICT,LAKHI TALUKA,56,713,200,913
SHIKARPUR DISTRICT,LAKHI TALUKA,57,869,183,1052
SHIKARPUR DISTRICT,LAKHI TALUKA,58,746,180,926
SHIKARPUR DISTRICT,LAKHI TALUKA,59,763,172,935
SHIKARPUR DISTRICT,LAKHI TALUKA,60,824,196,1020
SHIKARPUR DISTRICT,LAKHI TALUKA,61,564,163,727
SHIKARPUR DISTRICT,LAKHI TALUKA,62,696,148,844
SHIKARPUR DISTRICT,LAKHI TALUKA,63,550,160,710
SHIKARPUR DISTRICT,LAKHI TALUKA,64,582,149,731
SHIKARPUR DISTRICT,LAKHI TALUKA,65,593,126,719
SHIKARPUR DISTRICT,LAKHI TALUKA,66,398,95,493
SHIKARPUR DISTRICT,LAKHI TALUKA,67,497,90,587
SHIKARPUR DISTRICT,LAKHI TALUKA,68,330,114,444
SHIKARPUR DISTRICT,LAKHI TALUKA,69,402,96,498
SHIKARPUR DISTRICT,LAKHI TALUKA,70,413,68,481
SHIKARPUR DISTRICT,LAKHI TALUKA,71,302,49,351
SHIKARPUR DISTRICT,LAKHI TALUKA,72,346,80,426
SHIKARPUR DISTRICT,LAKHI TALUKA,73,232,53,285
SHIKARPUR DISTRICT,LAKHI TALUKA,74,223,46,269
SHIKARPUR DISTRICT,LAKHI TALUKA,>=75,1604,371,1975
SHIKARPUR DISTRICT,SHIKARPUR TALUKA,<1,5027,3924,8951
SHIKARPUR DISTRICT,SHIKARPUR TALUKA,1,5634,4879,10513
SHIKARPUR DISTRICT,SHIKARPUR TALUKA,2,7485,5433,12918
SHIKARPUR DISTRICT,SHIKARPUR TALUKA,3,7761,6417,14178
SHIKARPUR DISTRICT,SHIKARPUR TALUKA,4,8479,5934,14413
SHIKARPUR DISTRICT,SHIKARPUR TALUKA,5,7560,6250,13810
SHIKARPUR DISTRICT,SHIKARPUR TALUKA,6,7628,5113,12741
SHIKARPUR DISTRICT,SHIKARPUR TALUKA,7,7407,6189,13596
SHIKARPUR DISTRICT,SHIKARPUR TALUKA,8,8364,5390,13754
SHIKARPUR DISTRICT,SHIKARPUR TALUKA,9,6067,5316,11383
SHIKARPUR DISTRICT,SHIKARPUR TALUKA,10,6959,4689,11648
SHIKARPUR DISTRICT,SHIKARPUR TALUKA,11,4449,4571,9020
SHIKARPUR DISTRICT,SHIKARPUR TALUKA,12,5339,4304,9643
SHIKARPUR DISTRICT,SHIKARPUR TALUKA,13,3828,4353,8181
SHIKARPUR DISTRICT,SHIKARPUR TALUKA,14,4124,4150,8274
SHIKARPUR DISTRICT,SHIKARPUR TALUKA,15,3985,4508,8493
SHIKARPUR DISTRICT,SHIKARPUR TALUKA,16,3836,4294,8130
SHIKARPUR DISTRICT,SHIKARPUR TALUKA,17,3563,4769,8332
SHIKARPUR DISTRICT,SHIKARPUR TALUKA,18,4258,4620,8878
SHIKARPUR DISTRICT,SHIKARPUR TALUKA,19,3296,4144,7440
SHIKARPUR DISTRICT,SHIKARPUR TALUKA,20,3755,3819,7574
SHIKARPUR DISTRICT,SHIKARPUR TALUKA,21,2659,3603,6262
SHIKARPUR DISTRICT,SHIKARPUR TALUKA,22,2579,3666,6245
SHIKARPUR DISTRICT,SHIKARPUR TALUKA,23,2091,3243,5334
SHIKARPUR DISTRICT,SHIKARPUR TALUKA,24,2013,2931,4944
SHIKARPUR DISTRICT,SHIKARPUR TALUKA,25,2887,3276,6163
SHIKARPUR DISTRICT,SHIKARPUR TALUKA,26,2122,2956,5078
SHIKARPUR DISTRICT,SHIKARPUR TALUKA,27,2563,3162,5725
SHIKARPUR DISTRICT,SHIKARPUR TALUKA,28,2351,3074,5425
SHIKARPUR DISTRICT,SHIKARPUR TALUKA,29,2955,3254,6209
SHIKARPUR DISTRICT,SHIKARPUR TALUKA,30,2562,3031,5593
SHIKARPUR DISTRICT,SHIKARPUR TALUKA,31,2635,3216,5851
SHIKARPUR DISTRICT,SHIKARPUR TALUKA,32,2680,2974,5654
SHIKARPUR DISTRICT,SHIKARPUR TALUKA,33,2222,2717,4939
SHIKARPUR DISTRICT,SHIKARPUR TALUKA,34,1975,2383,4358
SHIKARPUR DISTRICT,SHIKARPUR TALUKA,35,2254,2454,4708
SHIKARPUR DISTRICT,SHIKARPUR TALUKA,36,1994,2138,4132
SHIKARPUR DISTRICT,SHIKARPUR TALUKA,37,3256,2463,5719
SHIKARPUR DISTRICT,SHIKARPUR TALUKA,38,1858,2307,4165
SHIKARPUR DISTRICT,SHIKARPUR TALUKA,39,2325,2217,4542
SHIKARPUR DISTRICT,SHIKARPUR TALUKA,40,1660,2242,3902
SHIKARPUR DISTRICT,SHIKARPUR TALUKA,41,1627,1891,3518
SHIKARPUR DISTRICT,SHIKARPUR TALUKA,42,1877,1971,3848
SHIKARPUR DISTRICT,SHIKARPUR TALUKA,43,1233,1803,3036
SHIKARPUR DISTRICT,SHIKARPUR TALUKA,44,1197,1702,2899
SHIKARPUR DISTRICT,SHIKARPUR TALUKA,45,1197,1610,2807
SHIKARPUR DISTRICT,SHIKARPUR TALUKA,46,1224,1396,2620
SHIKARPUR DISTRICT,SHIKARPUR TALUKA,47,1799,1635,3434
SHIKARPUR DISTRICT,SHIKARPUR TALUKA,48,1068,1512,2580
SHIKARPUR DISTRICT,SHIKARPUR TALUKA,49,1329,1571,2900
SHIKARPUR DISTRICT,SHIKARPUR TALUKA,50,1040,1485,2525
SHIKARPUR DISTRICT,SHIKARPUR TALUKA,51,1009,1329,2338
SHIKARPUR DISTRICT,SHIKARPUR TALUKA,52,1162,1342,2504
SHIKARPUR DISTRICT,SHIKARPUR TALUKA,53,752,1117,1869
SHIKARPUR DISTRICT,SHIKARPUR TALUKA,54,719,1007,1726
SHIKARPUR DISTRICT,SHIKARPUR TALUKA,55,773,1087,1860
SHIKARPUR DISTRICT,SHIKARPUR TALUKA,56,686,858,1544
SHIKARPUR DISTRICT,SHIKARPUR TALUKA,57,1194,1016,2210
SHIKARPUR DISTRICT,SHIKARPUR TALUKA,58,595,894,1489
SHIKARPUR DISTRICT,SHIKARPUR TALUKA,59,750,935,1685
SHIKARPUR DISTRICT,SHIKARPUR TALUKA,60,591,802,1393
SHIKARPUR DISTRICT,SHIKARPUR TALUKA,61,587,732,1319
SHIKARPUR DISTRICT,SHIKARPUR TALUKA,62,739,736,1475
SHIKARPUR DISTRICT,SHIKARPUR TALUKA,63,510,735,1245
SHIKARPUR DISTRICT,SHIKARPUR TALUKA,64,545,695,1240
SHIKARPUR DISTRICT,SHIKARPUR TALUKA,65,445,561,1006
SHIKARPUR DISTRICT,SHIKARPUR TALUKA,66,468,514,982
SHIKARPUR DISTRICT,SHIKARPUR TALUKA,67,686,507,1193
SHIKARPUR DISTRICT,SHIKARPUR TALUKA,68,367,466,833
SHIKARPUR DISTRICT,SHIKARPUR TALUKA,69,449,440,889
SHIKARPUR DISTRICT,SHIKARPUR TALUKA,70,281,348,629
SHIKARPUR DISTRICT,SHIKARPUR TALUKA,71,325,330,655
SHIKARPUR DISTRICT,SHIKARPUR TALUKA,72,342,317,659
SHIKARPUR DISTRICT,SHIKARPUR TALUKA,73,224,283,507
SHIKARPUR DISTRICT,SHIKARPUR TALUKA,74,222,266,488
SHIKARPUR DISTRICT,SHIKARPUR TALUKA,>=75,1676,1892,3568
SIALKOT DISTRICT,DASKA TEHSIL,<1,15923,4784,20707
SIALKOT DISTRICT,DASKA TEHSIL,1,16756,5106,21862
SIALKOT DISTRICT,DASKA TEHSIL,2,16240,4910,21150
SIALKOT DISTRICT,DASKA TEHSIL,3,17458,5111,22569
SIALKOT DISTRICT,DASKA TEHSIL,4,16804,4882,21686
SIALKOT DISTRICT,DASKA TEHSIL,5,16411,4789,21200
SIALKOT DISTRICT,DASKA TEHSIL,6,16629,5020,21649
SIALKOT DISTRICT,DASKA TEHSIL,7,17421,5106,22527
SIALKOT DISTRICT,DASKA TEHSIL,8,15895,4729,20624
SIALKOT DISTRICT,DASKA TEHSIL,9,17326,5385,22711
SIALKOT DISTRICT,DASKA TEHSIL,10,15306,4363,19669
SIALKOT DISTRICT,DASKA TEHSIL,11,17211,5220,22431
SIALKOT DISTRICT,DASKA TEHSIL,12,14807,4296,19103
SIALKOT DISTRICT,DASKA TEHSIL,13,15831,4772,20603
SIALKOT DISTRICT,DASKA TEHSIL,14,14930,4437,19367
SIALKOT DISTRICT,DASKA TEHSIL,15,14838,4467,19305
SIALKOT DISTRICT,DASKA TEHSIL,16,15249,4675,19924
SIALKOT DISTRICT,DASKA TEHSIL,17,14568,4604,19172
SIALKOT DISTRICT,DASKA TEHSIL,18,12820,3765,16585
SIALKOT DISTRICT,DASKA TEHSIL,19,14219,4444,18663
SIALKOT DISTRICT,DASKA TEHSIL,20,12291,3670,15961
SIALKOT DISTRICT,DASKA TEHSIL,21,13561,4448,18009
SIALKOT DISTRICT,DASKA TEHSIL,22,12078,3779,15857
SIALKOT DISTRICT,DASKA TEHSIL,23,11771,4002,15773
SIALKOT DISTRICT,DASKA TEHSIL,24,11440,3821,15261
SIALKOT DISTRICT,DASKA TEHSIL,25,9479,3063,12542
SIALKOT DISTRICT,DASKA TEHSIL,26,10792,3649,14441
SIALKOT DISTRICT,DASKA TEHSIL,27,9486,3420,12906
SIALKOT DISTRICT,DASKA TEHSIL,28,9633,3224,12857
SIALKOT DISTRICT,DASKA TEHSIL,29,8907,3133,12040
SIALKOT DISTRICT,DASKA TEHSIL,30,9217,2870,12087
SIALKOT DISTRICT,DASKA TEHSIL,31,8773,2998,11771
SIALKOT DISTRICT,DASKA TEHSIL,32,8377,3032,11409
SIALKOT DISTRICT,DASKA TEHSIL,33,8174,2912,11086
SIALKOT DISTRICT,DASKA TEHSIL,34,7755,2732,10487
SIALKOT DISTRICT,DASKA TEHSIL,35,7207,2354,9561
SIALKOT DISTRICT,DASKA TEHSIL,36,7722,2649,10371
SIALKOT DISTRICT,DASKA TEHSIL,37,6646,2325,8971
SIALKOT DISTRICT,DASKA TEHSIL,38,7413,2655,10068
SIALKOT DISTRICT,DASKA TEHSIL,39,6803,2369,9172
SIALKOT DISTRICT,DASKA TEHSIL,40,6679,2166,8845
SIALKOT DISTRICT,DASKA TEHSIL,41,6339,2334,8673
SIALKOT DISTRICT,DASKA TEHSIL,42,5861,2159,8020
SIALKOT DISTRICT,DASKA TEHSIL,43,5806,2121,7927
SIALKOT DISTRICT,DASKA TEHSIL,44,5626,2049,7675
SIALKOT DISTRICT,DASKA TEHSIL,45,5007,1691,6698
SIALKOT DISTRICT,DASKA TEHSIL,46,5166,1831,6997
SIALKOT DISTRICT,DASKA TEHSIL,47,4596,1584,6180
SIALKOT DISTRICT,DASKA TEHSIL,48,5319,1818,7137
SIALKOT DISTRICT,DASKA TEHSIL,49,5079,1731,6810
SIALKOT DISTRICT,DASKA TEHSIL,50,4855,1691,6546
SIALKOT DISTRICT,DASKA TEHSIL,51,5065,1711,6776
SIALKOT DISTRICT,DASKA TEHSIL,52,4738,1639,6377
SIALKOT DISTRICT,DASKA TEHSIL,53,4673,1631,6304
SIALKOT DISTRICT,DASKA TEHSIL,54,4304,1530,5834
SIALKOT DISTRICT,DASKA TEHSIL,55,3583,1228,4811
SIALKOT DISTRICT,DASKA TEHSIL,56,3554,1185,4739
SIALKOT DISTRICT,DASKA TEHSIL,57,2884,1035,3919
SIALKOT DISTRICT,DASKA TEHSIL,58,3340,1099,4439
SIALKOT DISTRICT,DASKA TEHSIL,59,3037,1030,4067
SIALKOT DISTRICT,DASKA TEHSIL,60,3088,960,4048
SIALKOT DISTRICT,DASKA TEHSIL,61,2981,1046,4027
SIALKOT DISTRICT,DASKA TEHSIL,62,2779,834,3613
SIALKOT DISTRICT,DASKA TEHSIL,63,2799,935,3734
SIALKOT DISTRICT,DASKA TEHSIL,64,2519,829,3348
SIALKOT DISTRICT,DASKA TEHSIL,65,2213,692,2905
SIALKOT DISTRICT,DASKA TEHSIL,66,1890,558,2448
SIALKOT DISTRICT,DASKA TEHSIL,67,1642,507,2149
SIALKOT DISTRICT,DASKA TEHSIL,68,2048,586,2634
SIALKOT DISTRICT,DASKA TEHSIL,69,1911,528,2439
SIALKOT DISTRICT,DASKA TEHSIL,70,2093,584,2677
SIALKOT DISTRICT,DASKA TEHSIL,71,1612,502,2114
SIALKOT DISTRICT,DASKA TEHSIL,72,1606,447,2053
SIALKOT DISTRICT,DASKA TEHSIL,73,1672,463,2135
SIALKOT DISTRICT,DASKA TEHSIL,74,1419,398,1817
SIALKOT DISTRICT,DASKA TEHSIL,>=75,11151,2914,14065
SIALKOT DISTRICT,PASRUR TEHSIL,<1,18179,2872,21051
SIALKOT DISTRICT,PASRUR TEHSIL,1,18203,2954,21157
SIALKOT DISTRICT,PASRUR TEHSIL,2,18463,2879,21342
SIALKOT DISTRICT,PASRUR TEHSIL,3,19714,3181,22895
SIALKOT DISTRICT,PASRUR TEHSIL,4,19181,2958,22139
SIALKOT DISTRICT,PASRUR TEHSIL,5,19288,3139,22427
SIALKOT DISTRICT,PASRUR TEHSIL,6,19187,3016,22203
SIALKOT DISTRICT,PASRUR TEHSIL,7,20302,3238,23540
SIALKOT DISTRICT,PASRUR TEHSIL,8,18674,2975,21649
SIALKOT DISTRICT,PASRUR TEHSIL,9,19864,3293,23157
SIALKOT DISTRICT,PASRUR TEHSIL,10,17779,2823,20602
SIALKOT DISTRICT,PASRUR TEHSIL,11,19437,3264,22701
SIALKOT DISTRICT,PASRUR TEHSIL,12,17014,2856,19870
SIALKOT DISTRICT,PASRUR TEHSIL,13,18134,3007,21141
SIALKOT DISTRICT,PASRUR TEHSIL,14,17360,2819,20179
SIALKOT DISTRICT,PASRUR TEHSIL,15,16893,2865,19758
SIALKOT DISTRICT,PASRUR TEHSIL,16,17137,2817,19954
SIALKOT DISTRICT,PASRUR TEHSIL,17,16096,2756,18852
SIALKOT DISTRICT,PASRUR TEHSIL,18,14970,2353,17323
SIALKOT DISTRICT,PASRUR TEHSIL,19,15929,2624,18553
SIALKOT DISTRICT,PASRUR TEHSIL,20,13858,2156,16014
SIALKOT DISTRICT,PASRUR TEHSIL,21,14901,2587,17488
SIALKOT DISTRICT,PASRUR TEHSIL,22,13816,2337,16153
SIALKOT DISTRICT,PASRUR TEHSIL,23,12684,2268,14952
SIALKOT DISTRICT,PASRUR TEHSIL,24,12316,2174,14490
SIALKOT DISTRICT,PASRUR TEHSIL,25,10432,1768,12200
SIALKOT DISTRICT,PASRUR TEHSIL,26,11217,2078,13295
SIALKOT DISTRICT,PASRUR TEHSIL,27,9877,1883,11760
SIALKOT DISTRICT,PASRUR TEHSIL,28,10312,1877,12189
SIALKOT DISTRICT,PASRUR TEHSIL,29,9099,1619,10718
SIALKOT DISTRICT,PASRUR TEHSIL,30,9810,1766,11576
SIALKOT DISTRICT,PASRUR TEHSIL,31,8725,1690,10415
SIALKOT DISTRICT,PASRUR TEHSIL,32,9005,1743,10748
SIALKOT DISTRICT,PASRUR TEHSIL,33,8491,1582,10073
SIALKOT DISTRICT,PASRUR TEHSIL,34,8179,1499,9678
SIALKOT DISTRICT,PASRUR TEHSIL,35,8233,1490,9723
SIALKOT DISTRICT,PASRUR TEHSIL,36,8452,1553,10005
SIALKOT DISTRICT,PASRUR TEHSIL,37,7311,1323,8634
SIALKOT DISTRICT,PASRUR TEHSIL,38,8019,1618,9637
SIALKOT DISTRICT,PASRUR TEHSIL,39,7339,1407,8746
SIALKOT DISTRICT,PASRUR TEHSIL,40,7476,1365,8841
SIALKOT DISTRICT,PASRUR TEHSIL,41,6983,1241,8224
SIALKOT DISTRICT,PASRUR TEHSIL,42,6217,1325,7542
SIALKOT DISTRICT,PASRUR TEHSIL,43,5951,1215,7166
SIALKOT DISTRICT,PASRUR TEHSIL,44,5770,1115,6885
SIALKOT DISTRICT,PASRUR TEHSIL,45,5629,1007,6636
SIALKOT DISTRICT,PASRUR TEHSIL,46,5534,1024,6558
SIALKOT DISTRICT,PASRUR TEHSIL,47,4816,888,5704
SIALKOT DISTRICT,PASRUR TEHSIL,48,5543,1008,6551
SIALKOT DISTRICT,PASRUR TEHSIL,49,5473,933,6406
SIALKOT DISTRICT,PASRUR TEHSIL,50,5703,1017,6720
SIALKOT DISTRICT,PASRUR TEHSIL,51,5361,979,6340
SIALKOT DISTRICT,PASRUR TEHSIL,52,5421,977,6398
SIALKOT DISTRICT,PASRUR TEHSIL,53,5167,912,6079
SIALKOT DISTRICT,PASRUR TEHSIL,54,4497,872,5369
SIALKOT DISTRICT,PASRUR TEHSIL,55,3996,690,4686
SIALKOT DISTRICT,PASRUR TEHSIL,56,3754,730,4484
SIALKOT DISTRICT,PASRUR TEHSIL,57,3128,514,3642
SIALKOT DISTRICT,PASRUR TEHSIL,58,3420,550,3970
SIALKOT DISTRICT,PASRUR TEHSIL,59,3180,538,3718
SIALKOT DISTRICT,PASRUR TEHSIL,60,3470,562,4032
SIALKOT DISTRICT,PASRUR TEHSIL,61,3196,498,3694
SIALKOT DISTRICT,PASRUR TEHSIL,62,3091,518,3609
SIALKOT DISTRICT,PASRUR TEHSIL,63,3149,507,3656
SIALKOT DISTRICT,PASRUR TEHSIL,64,2924,464,3388
SIALKOT DISTRICT,PASRUR TEHSIL,65,2939,415,3354
SIALKOT DISTRICT,PASRUR TEHSIL,66,2272,341,2613
SIALKOT DISTRICT,PASRUR TEHSIL,67,2131,319,2450
SIALKOT DISTRICT,PASRUR TEHSIL,68,2375,375,2750
SIALKOT DISTRICT,PASRUR TEHSIL,69,2196,326,2522
SIALKOT DISTRICT,PASRUR TEHSIL,70,2657,381,3038
SIALKOT DISTRICT,PASRUR TEHSIL,71,2030,283,2313
SIALKOT DISTRICT,PASRUR TEHSIL,72,2047,320,2367
SIALKOT DISTRICT,PASRUR TEHSIL,73,1911,285,2196
SIALKOT DISTRICT,PASRUR TEHSIL,74,1717,240,1957
SIALKOT DISTRICT,PASRUR TEHSIL,>=75,14129,1873,16002
SIALKOT DISTRICT,SAMBRIAL TEHSIL,<1,6651,3322,9973
SIALKOT DISTRICT,SAMBRIAL TEHSIL,1,6879,3497,10376
SIALKOT DISTRICT,SAMBRIAL TEHSIL,2,6775,3498,10273
SIALKOT DISTRICT,SAMBRIAL TEHSIL,3,7125,3636,10761
SIALKOT DISTRICT,SAMBRIAL TEHSIL,4,6744,3384,10128
SIALKOT DISTRICT,SAMBRIAL TEHSIL,5,6802,3538,10340
SIALKOT DISTRICT,SAMBRIAL TEHSIL,6,7100,3473,10573
SIALKOT DISTRICT,SAMBRIAL TEHSIL,7,7161,3628,10789
SIALKOT DISTRICT,SAMBRIAL TEHSIL,8,6492,3350,9842
SIALKOT DISTRICT,SAMBRIAL TEHSIL,9,7340,3564,10904
SIALKOT DISTRICT,SAMBRIAL TEHSIL,10,6191,3063,9254
SIALKOT DISTRICT,SAMBRIAL TEHSIL,11,7323,3646,10969
SIALKOT DISTRICT,SAMBRIAL TEHSIL,12,6089,2968,9057
SIALKOT DISTRICT,SAMBRIAL TEHSIL,13,6783,3292,10075
SIALKOT DISTRICT,SAMBRIAL TEHSIL,14,6290,3117,9407
SIALKOT DISTRICT,SAMBRIAL TEHSIL,15,6361,3107,9468
SIALKOT DISTRICT,SAMBRIAL TEHSIL,16,6486,3129,9615
SIALKOT DISTRICT,SAMBRIAL TEHSIL,17,6318,3117,9435
SIALKOT DISTRICT,SAMBRIAL TEHSIL,18,5297,2662,7959
SIALKOT DISTRICT,SAMBRIAL TEHSIL,19,5947,3137,9084
SIALKOT DISTRICT,SAMBRIAL TEHSIL,20,4750,2459,7209
SIALKOT DISTRICT,SAMBRIAL TEHSIL,21,5704,2873,8577
SIALKOT DISTRICT,SAMBRIAL TEHSIL,22,4899,2588,7487
SIALKOT DISTRICT,SAMBRIAL TEHSIL,23,5091,2661,7752
SIALKOT DISTRICT,SAMBRIAL TEHSIL,24,4714,2622,7336
SIALKOT DISTRICT,SAMBRIAL TEHSIL,25,3907,1996,5903
SIALKOT DISTRICT,SAMBRIAL TEHSIL,26,4490,2488,6978
SIALKOT DISTRICT,SAMBRIAL TEHSIL,27,4138,2392,6530
SIALKOT DISTRICT,SAMBRIAL TEHSIL,28,3999,2126,6125
SIALKOT DISTRICT,SAMBRIAL TEHSIL,29,3972,2261,6233
SIALKOT DISTRICT,SAMBRIAL TEHSIL,30,3484,1826,5310
SIALKOT DISTRICT,SAMBRIAL TEHSIL,31,3768,2111,5879
SIALKOT DISTRICT,SAMBRIAL TEHSIL,32,3424,1882,5306
SIALKOT DISTRICT,SAMBRIAL TEHSIL,33,3380,1791,5171
SIALKOT DISTRICT,SAMBRIAL TEHSIL,34,3147,1765,4912
SIALKOT DISTRICT,SAMBRIAL TEHSIL,35,2776,1474,4250
SIALKOT DISTRICT,SAMBRIAL TEHSIL,36,3206,1673,4879
SIALKOT DISTRICT,SAMBRIAL TEHSIL,37,2934,1566,4500
SIALKOT DISTRICT,SAMBRIAL TEHSIL,38,3181,1649,4830
SIALKOT DISTRICT,SAMBRIAL TEHSIL,39,2986,1592,4578
SIALKOT DISTRICT,SAMBRIAL TEHSIL,40,2567,1352,3919
SIALKOT DISTRICT,SAMBRIAL TEHSIL,41,2828,1401,4229
SIALKOT DISTRICT,SAMBRIAL TEHSIL,42,2518,1320,3838
SIALKOT DISTRICT,SAMBRIAL TEHSIL,43,2594,1318,3912
SIALKOT DISTRICT,SAMBRIAL TEHSIL,44,2430,1300,3730
SIALKOT DISTRICT,SAMBRIAL TEHSIL,45,2054,1071,3125
SIALKOT DISTRICT,SAMBRIAL TEHSIL,46,2246,1221,3467
SIALKOT DISTRICT,SAMBRIAL TEHSIL,47,2152,1093,3245
SIALKOT DISTRICT,SAMBRIAL TEHSIL,48,2340,1242,3582
SIALKOT DISTRICT,SAMBRIAL TEHSIL,49,2337,1266,3603
SIALKOT DISTRICT,SAMBRIAL TEHSIL,50,1977,997,2974
SIALKOT DISTRICT,SAMBRIAL TEHSIL,51,2276,1133,3409
SIALKOT DISTRICT,SAMBRIAL TEHSIL,52,2178,1112,3290
SIALKOT DISTRICT,SAMBRIAL TEHSIL,53,2028,1066,3094
SIALKOT DISTRICT,SAMBRIAL TEHSIL,54,2007,950,2957
SIALKOT DISTRICT,SAMBRIAL TEHSIL,55,1612,758,2370
SIALKOT DISTRICT,SAMBRIAL TEHSIL,56,1679,825,2504
SIALKOT DISTRICT,SAMBRIAL TEHSIL,57,1486,679,2165
SIALKOT DISTRICT,SAMBRIAL TEHSIL,58,1540,636,2176
SIALKOT DISTRICT,SAMBRIAL TEHSIL,59,1523,698,2221
SIALKOT DISTRICT,SAMBRIAL TEHSIL,60,1373,589,1962
SIALKOT DISTRICT,SAMBRIAL TEHSIL,61,1574,687,2261
SIALKOT DISTRICT,SAMBRIAL TEHSIL,62,1381,584,1965
SIALKOT DISTRICT,SAMBRIAL TEHSIL,63,1263,580,1843
SIALKOT DISTRICT,SAMBRIAL TEHSIL,64,1238,539,1777
SIALKOT DISTRICT,SAMBRIAL TEHSIL,65,971,427,1398
SIALKOT DISTRICT,SAMBRIAL TEHSIL,66,908,439,1347
SIALKOT DISTRICT,SAMBRIAL TEHSIL,67,874,367,1241
SIALKOT DISTRICT,SAMBRIAL TEHSIL,68,819,364,1183
SIALKOT DISTRICT,SAMBRIAL TEHSIL,69,860,335,1195
SIALKOT DISTRICT,SAMBRIAL TEHSIL,70,881,356,1237
SIALKOT DISTRICT,SAMBRIAL TEHSIL,71,772,381,1153
SIALKOT DISTRICT,SAMBRIAL TEHSIL,72,813,336,1149
SIALKOT DISTRICT,SAMBRIAL TEHSIL,73,720,298,1018
SIALKOT DISTRICT,SAMBRIAL TEHSIL,74,644,233,877
SIALKOT DISTRICT,SAMBRIAL TEHSIL,>=75,5315,2065,7380
SIALKOT DISTRICT,SIALKOT TEHSIL,<1,27227,14309,41536
SIALKOT DISTRICT,SIALKOT TEHSIL,1,27857,15330,43187
SIALKOT DISTRICT,SIALKOT TEHSIL,2,27394,14821,42215
SIALKOT DISTRICT,SIALKOT TEHSIL,3,28977,15798,44775
SIALKOT DISTRICT,SIALKOT TEHSIL,4,27411,14657,42068
SIALKOT DISTRICT,SIALKOT TEHSIL,5,27783,14947,42730
SIALKOT DISTRICT,SIALKOT TEHSIL,6,27329,14722,42051
SIALKOT DISTRICT,SIALKOT TEHSIL,7,29340,15880,45220
SIALKOT DISTRICT,SIALKOT TEHSIL,8,26522,14125,40647
SIALKOT DISTRICT,SIALKOT TEHSIL,9,29080,15672,44752
SIALKOT DISTRICT,SIALKOT TEHSIL,10,25418,13455,38873
SIALKOT DISTRICT,SIALKOT TEHSIL,11,28442,15927,44369
SIALKOT DISTRICT,SIALKOT TEHSIL,12,24946,13273,38219
SIALKOT DISTRICT,SIALKOT TEHSIL,13,26913,14656,41569
SIALKOT DISTRICT,SIALKOT TEHSIL,14,24830,13241,38071
SIALKOT DISTRICT,SIALKOT TEHSIL,15,25118,13482,38600
SIALKOT DISTRICT,SIALKOT TEHSIL,16,25982,13754,39736
SIALKOT DISTRICT,SIALKOT TEHSIL,17,25476,14278,39754
SIALKOT DISTRICT,SIALKOT TEHSIL,18,22640,12442,35082
SIALKOT DISTRICT,SIALKOT TEHSIL,19,24876,13899,38775
SIALKOT DISTRICT,SIALKOT TEHSIL,20,20946,11892,32838
SIALKOT DISTRICT,SIALKOT TEHSIL,21,23912,14839,38751
SIALKOT DISTRICT,SIALKOT TEHSIL,22,21545,12831,34376
SIALKOT DISTRICT,SIALKOT TEHSIL,23,21442,13895,35337
SIALKOT DISTRICT,SIALKOT TEHSIL,24,21124,13828,34952
SIALKOT DISTRICT,SIALKOT TEHSIL,25,17264,11185,28449
SIALKOT DISTRICT,SIALKOT TEHSIL,26,19710,13843,33553
SIALKOT DISTRICT,SIALKOT TEHSIL,27,17991,13128,31119
SIALKOT DISTRICT,SIALKOT TEHSIL,28,17582,12514,30096
SIALKOT DISTRICT,SIALKOT TEHSIL,29,16421,12065,28486
SIALKOT DISTRICT,SIALKOT TEHSIL,30,16580,11314,27894
SIALKOT DISTRICT,SIALKOT TEHSIL,31,15591,11463,27054
SIALKOT DISTRICT,SIALKOT TEHSIL,32,15221,11285,26506
SIALKOT DISTRICT,SIALKOT TEHSIL,33,14727,10879,25606
SIALKOT DISTRICT,SIALKOT TEHSIL,34,13730,10169,23899
SIALKOT DISTRICT,SIALKOT TEHSIL,35,13481,9106,22587
SIALKOT DISTRICT,SIALKOT TEHSIL,36,14363,9747,24110
SIALKOT DISTRICT,SIALKOT TEHSIL,37,11459,8248,19707
SIALKOT DISTRICT,SIALKOT TEHSIL,38,13770,10137,23907
SIALKOT DISTRICT,SIALKOT TEHSIL,39,12112,8612,20724
SIALKOT DISTRICT,SIALKOT TEHSIL,40,12684,9170,21854
SIALKOT DISTRICT,SIALKOT TEHSIL,41,11383,7818,19201
SIALKOT DISTRICT,SIALKOT TEHSIL,42,10407,7651,18058
SIALKOT DISTRICT,SIALKOT TEHSIL,43,10237,7303,17540
SIALKOT DISTRICT,SIALKOT TEHSIL,44,9469,6758,16227
SIALKOT DISTRICT,SIALKOT TEHSIL,45,9442,6488,15930
SIALKOT DISTRICT,SIALKOT TEHSIL,46,9247,5920,15167
SIALKOT DISTRICT,SIALKOT TEHSIL,47,7831,5142,12973
SIALKOT DISTRICT,SIALKOT TEHSIL,48,9204,6251,15455
SIALKOT DISTRICT,SIALKOT TEHSIL,49,8547,5492,14039
SIALKOT DISTRICT,SIALKOT TEHSIL,50,9463,6714,16177
SIALKOT DISTRICT,SIALKOT TEHSIL,51,8485,5356,13841
SIALKOT DISTRICT,SIALKOT TEHSIL,52,8212,5431,13643
SIALKOT DISTRICT,SIALKOT TEHSIL,53,7862,5465,13327
SIALKOT DISTRICT,SIALKOT TEHSIL,54,7534,5129,12663
SIALKOT DISTRICT,SIALKOT TEHSIL,55,7099,4969,12068
SIALKOT DISTRICT,SIALKOT TEHSIL,56,6423,4312,10735
SIALKOT DISTRICT,SIALKOT TEHSIL,57,5055,3261,8316
SIALKOT DISTRICT,SIALKOT TEHSIL,58,5830,3873,9703
SIALKOT DISTRICT,SIALKOT TEHSIL,59,5103,3453,8556
SIALKOT DISTRICT,SIALKOT TEHSIL,60,5969,3937,9906
SIALKOT DISTRICT,SIALKOT TEHSIL,61,5401,3314,8715
SIALKOT DISTRICT,SIALKOT TEHSIL,62,5049,3415,8464
SIALKOT DISTRICT,SIALKOT TEHSIL,63,4966,3280,8246
SIALKOT DISTRICT,SIALKOT TEHSIL,64,4254,2932,7186
SIALKOT DISTRICT,SIALKOT TEHSIL,65,4213,2872,7085
SIALKOT DISTRICT,SIALKOT TEHSIL,66,3345,2144,5489
SIALKOT DISTRICT,SIALKOT TEHSIL,67,2700,1740,4440
SIALKOT DISTRICT,SIALKOT TEHSIL,68,3135,2030,5165
SIALKOT DISTRICT,SIALKOT TEHSIL,69,2956,1886,4842
SIALKOT DISTRICT,SIALKOT TEHSIL,70,3613,2142,5755
SIALKOT DISTRICT,SIALKOT TEHSIL,71,2804,1624,4428
SIALKOT DISTRICT,SIALKOT TEHSIL,72,2670,1646,4316
SIALKOT DISTRICT,SIALKOT TEHSIL,73,2493,1540,4033
SIALKOT DISTRICT,SIALKOT TEHSIL,74,2173,1309,3482
SIALKOT DISTRICT,SIALKOT TEHSIL,>=75,17497,9449,26946
SIBI DISTRICT,KOT MANDAI SUB-TEHSIL,<1,211,0,211
SIBI DISTRICT,KOT MANDAI SUB-TEHSIL,1,351,0,351
SIBI DISTRICT,KOT MANDAI SUB-TEHSIL,2,372,0,372
SIBI DISTRICT,KOT MANDAI SUB-TEHSIL,3,477,0,477
SIBI DISTRICT,KOT MANDAI SUB-TEHSIL,4,364,0,364
SIBI DISTRICT,KOT MANDAI SUB-TEHSIL,5,320,0,320
SIBI DISTRICT,KOT MANDAI SUB-TEHSIL,6,281,0,281
SIBI DISTRICT,KOT MANDAI SUB-TEHSIL,7,384,0,384
SIBI DISTRICT,KOT MANDAI SUB-TEHSIL,8,291,0,291
SIBI DISTRICT,KOT MANDAI SUB-TEHSIL,9,252,0,252
SIBI DISTRICT,KOT MANDAI SUB-TEHSIL,10,227,0,227
SIBI DISTRICT,KOT MANDAI SUB-TEHSIL,11,134,0,134
SIBI DISTRICT,KOT MANDAI SUB-TEHSIL,12,130,0,130
SIBI DISTRICT,KOT MANDAI SUB-TEHSIL,13,97,0,97
SIBI DISTRICT,KOT MANDAI SUB-TEHSIL,14,80,0,80
SIBI DISTRICT,KOT MANDAI SUB-TEHSIL,15,64,0,64
SIBI DISTRICT,KOT MANDAI SUB-TEHSIL,16,85,0,85
SIBI DISTRICT,KOT MANDAI SUB-TEHSIL,17,72,0,72
SIBI DISTRICT,KOT MANDAI SUB-TEHSIL,18,181,0,181
SIBI DISTRICT,KOT MANDAI SUB-TEHSIL,19,139,0,139
SIBI DISTRICT,KOT MANDAI SUB-TEHSIL,20,185,0,185
SIBI DISTRICT,KOT MANDAI SUB-TEHSIL,21,145,0,145
SIBI DISTRICT,KOT MANDAI SUB-TEHSIL,22,92,0,92
SIBI DISTRICT,KOT MANDAI SUB-TEHSIL,23,93,0,93
SIBI DISTRICT,KOT MANDAI SUB-TEHSIL,24,67,0,67
SIBI DISTRICT,KOT MANDAI SUB-TEHSIL,25,143,0,143
SIBI DISTRICT,KOT MANDAI SUB-TEHSIL,26,91,0,91
SIBI DISTRICT,KOT MANDAI SUB-TEHSIL,27,128,0,128
SIBI DISTRICT,KOT MANDAI SUB-TEHSIL,28,68,0,68
SIBI DISTRICT,KOT MANDAI SUB-TEHSIL,29,96,0,96
SIBI DISTRICT,KOT MANDAI SUB-TEHSIL,30,158,0,158
SIBI DISTRICT,KOT MANDAI SUB-TEHSIL,31,123,0,123
SIBI DISTRICT,KOT MANDAI SUB-TEHSIL,32,67,0,67
SIBI DISTRICT,KOT MANDAI SUB-TEHSIL,33,84,0,84
SIBI DISTRICT,KOT MANDAI SUB-TEHSIL,34,60,0,60
SIBI DISTRICT,KOT MANDAI SUB-TEHSIL,35,103,0,103
SIBI DISTRICT,KOT MANDAI SUB-TEHSIL,36,62,0,62
SIBI DISTRICT,KOT MANDAI SUB-TEHSIL,37,66,0,66
SIBI DISTRICT,KOT MANDAI SUB-TEHSIL,38,67,0,67
SIBI DISTRICT,KOT MANDAI SUB-TEHSIL,39,51,0,51
SIBI DISTRICT,KOT MANDAI SUB-TEHSIL,40,95,0,95
SIBI DISTRICT,KOT MANDAI SUB-TEHSIL,41,69,0,69
SIBI DISTRICT,KOT MANDAI SUB-TEHSIL,42,54,0,54
SIBI DISTRICT,KOT MANDAI SUB-TEHSIL,43,46,0,46
SIBI DISTRICT,KOT MANDAI SUB-TEHSIL,44,41,0,41
SIBI DISTRICT,KOT MANDAI SUB-TEHSIL,45,59,0,59
SIBI DISTRICT,KOT MANDAI SUB-TEHSIL,46,54,0,54
SIBI DISTRICT,KOT MANDAI SUB-TEHSIL,47,34,0,34
SIBI DISTRICT,KOT MANDAI SUB-TEHSIL,48,33,0,33
SIBI DISTRICT,KOT MANDAI SUB-TEHSIL,49,28,0,28
SIBI DISTRICT,KOT MANDAI SUB-TEHSIL,50,54,0,54
SIBI DISTRICT,KOT MANDAI SUB-TEHSIL,51,40,0,40
SIBI DISTRICT,KOT MANDAI SUB-TEHSIL,52,20,0,20
SIBI DISTRICT,KOT MANDAI SUB-TEHSIL,53,30,0,30
SIBI DISTRICT,KOT MANDAI SUB-TEHSIL,54,23,0,23
SIBI DISTRICT,KOT MANDAI SUB-TEHSIL,55,23,0,23
SIBI DISTRICT,KOT MANDAI SUB-TEHSIL,56,30,0,30
SIBI DISTRICT,KOT MANDAI SUB-TEHSIL,57,29,0,29
SIBI DISTRICT,KOT MANDAI SUB-TEHSIL,58,16,0,16
SIBI DISTRICT,KOT MANDAI SUB-TEHSIL,59,14,0,14
SIBI DISTRICT,KOT MANDAI SUB-TEHSIL,60,47,0,47
SIBI DISTRICT,KOT MANDAI SUB-TEHSIL,61,32,0,32
SIBI DISTRICT,KOT MANDAI SUB-TEHSIL,62,19,0,19
SIBI DISTRICT,KOT MANDAI SUB-TEHSIL,63,20,0,20
SIBI DISTRICT,KOT MANDAI SUB-TEHSIL,64,17,0,17
SIBI DISTRICT,KOT MANDAI SUB-TEHSIL,65,15,0,15
SIBI DISTRICT,KOT MANDAI SUB-TEHSIL,66,13,0,13
SIBI DISTRICT,KOT MANDAI SUB-TEHSIL,67,10,0,10
SIBI DISTRICT,KOT MANDAI SUB-TEHSIL,68,11,0,11
SIBI DISTRICT,KOT MANDAI SUB-TEHSIL,69,8,0,8
SIBI DISTRICT,KOT MANDAI SUB-TEHSIL,70,19,0,19
SIBI DISTRICT,KOT MANDAI SUB-TEHSIL,71,9,0,9
SIBI DISTRICT,KOT MANDAI SUB-TEHSIL,72,10,0,10
SIBI DISTRICT,KOT MANDAI SUB-TEHSIL,73,15,0,15
SIBI DISTRICT,KOT MANDAI SUB-TEHSIL,74,12,0,12
SIBI DISTRICT,KOT MANDAI SUB-TEHSIL,>=75,73,0,73
SIBI DISTRICT,LEHRI TEHSIL,<1,1196,0,1196
SIBI DISTRICT,LEHRI TEHSIL,1,1425,0,1425
SIBI DISTRICT,LEHRI TEHSIL,2,1690,0,1690
SIBI DISTRICT,LEHRI TEHSIL,3,1821,0,1821
SIBI DISTRICT,LEHRI TEHSIL,4,1820,0,1820
SIBI DISTRICT,LEHRI TEHSIL,5,1792,0,1792
SIBI DISTRICT,LEHRI TEHSIL,6,1670,0,1670
SIBI DISTRICT,LEHRI TEHSIL,7,1668,0,1668
SIBI DISTRICT,LEHRI TEHSIL,8,1663,0,1663
SIBI DISTRICT,LEHRI TEHSIL,9,1356,0,1356
SIBI DISTRICT,LEHRI TEHSIL,10,1496,0,1496
SIBI DISTRICT,LEHRI TEHSIL,11,991,0,991
SIBI DISTRICT,LEHRI TEHSIL,12,1062,0,1062
SIBI DISTRICT,LEHRI TEHSIL,13,839,0,839
SIBI DISTRICT,LEHRI TEHSIL,14,777,0,777
SIBI DISTRICT,LEHRI TEHSIL,15,794,0,794
SIBI DISTRICT,LEHRI TEHSIL,16,792,0,792
SIBI DISTRICT,LEHRI TEHSIL,17,690,0,690
SIBI DISTRICT,LEHRI TEHSIL,18,884,0,884
SIBI DISTRICT,LEHRI TEHSIL,19,724,0,724
SIBI DISTRICT,LEHRI TEHSIL,20,810,0,810
SIBI DISTRICT,LEHRI TEHSIL,21,634,0,634
SIBI DISTRICT,LEHRI TEHSIL,22,602,0,602
SIBI DISTRICT,LEHRI TEHSIL,23,589,0,589
SIBI DISTRICT,LEHRI TEHSIL,24,535,0,535
SIBI DISTRICT,LEHRI TEHSIL,25,633,0,633
SIBI DISTRICT,LEHRI TEHSIL,26,536,0,536
SIBI DISTRICT,LEHRI TEHSIL,27,628,0,628
SIBI DISTRICT,LEHRI TEHSIL,28,572,0,572
SIBI DISTRICT,LEHRI TEHSIL,29,743,0,743
SIBI DISTRICT,LEHRI TEHSIL,30,586,0,586
SIBI DISTRICT,LEHRI TEHSIL,31,610,0,610
SIBI DISTRICT,LEHRI TEHSIL,32,647,0,647
SIBI DISTRICT,LEHRI TEHSIL,33,506,0,506
SIBI DISTRICT,LEHRI TEHSIL,34,433,0,433
SIBI DISTRICT,LEHRI TEHSIL,35,554,0,554
SIBI DISTRICT,LEHRI TEHSIL,36,436,0,436
SIBI DISTRICT,LEHRI TEHSIL,37,754,0,754
SIBI DISTRICT,LEHRI TEHSIL,38,406,0,406
SIBI DISTRICT,LEHRI TEHSIL,39,473,0,473
SIBI DISTRICT,LEHRI TEHSIL,40,353,0,353
SIBI DISTRICT,LEHRI TEHSIL,41,353,0,353
SIBI DISTRICT,LEHRI TEHSIL,42,385,0,385
SIBI DISTRICT,LEHRI TEHSIL,43,283,0,283
SIBI DISTRICT,LEHRI TEHSIL,44,276,0,276
SIBI DISTRICT,LEHRI TEHSIL,45,286,0,286
SIBI DISTRICT,LEHRI TEHSIL,46,318,0,318
SIBI DISTRICT,LEHRI TEHSIL,47,499,0,499
SIBI DISTRICT,LEHRI TEHSIL,48,264,0,264
SIBI DISTRICT,LEHRI TEHSIL,49,341,0,341
SIBI DISTRICT,LEHRI TEHSIL,50,241,0,241
SIBI DISTRICT,LEHRI TEHSIL,51,303,0,303
SIBI DISTRICT,LEHRI TEHSIL,52,358,0,358
SIBI DISTRICT,LEHRI TEHSIL,53,216,0,216
SIBI DISTRICT,LEHRI TEHSIL,54,198,0,198
SIBI DISTRICT,LEHRI TEHSIL,55,154,0,154
SIBI DISTRICT,LEHRI TEHSIL,56,157,0,157
SIBI DISTRICT,LEHRI TEHSIL,57,283,0,283
SIBI DISTRICT,LEHRI TEHSIL,58,132,0,132
SIBI DISTRICT,LEHRI TEHSIL,59,182,0,182
SIBI DISTRICT,LEHRI TEHSIL,60,138,0,138
SIBI DISTRICT,LEHRI TEHSIL,61,187,0,187
SIBI DISTRICT,LEHRI TEHSIL,62,163,0,163
SIBI DISTRICT,LEHRI TEHSIL,63,135,0,135
SIBI DISTRICT,LEHRI TEHSIL,64,91,0,91
SIBI DISTRICT,LEHRI TEHSIL,65,100,0,100
SIBI DISTRICT,LEHRI TEHSIL,66,162,0,162
SIBI DISTRICT,LEHRI TEHSIL,67,147,0,147
SIBI DISTRICT,LEHRI TEHSIL,68,70,0,70
SIBI DISTRICT,LEHRI TEHSIL,69,90,0,90
SIBI DISTRICT,LEHRI TEHSIL,70,57,0,57
SIBI DISTRICT,LEHRI TEHSIL,71,128,0,128
SIBI DISTRICT,LEHRI TEHSIL,72,69,0,69
SIBI DISTRICT,LEHRI TEHSIL,73,40,0,40
SIBI DISTRICT,LEHRI TEHSIL,74,52,0,52
SIBI DISTRICT,LEHRI TEHSIL,>=75,442,0,442
SIBI DISTRICT,SANGAN SUB-TEHSIL,<1,55,0,55
SIBI DISTRICT,SANGAN SUB-TEHSIL,1,98,0,98
SIBI DISTRICT,SANGAN SUB-TEHSIL,2,113,0,113
SIBI DISTRICT,SANGAN SUB-TEHSIL,3,118,0,118
SIBI DISTRICT,SANGAN SUB-TEHSIL,4,104,0,104
SIBI DISTRICT,SANGAN SUB-TEHSIL,5,88,0,88
SIBI DISTRICT,SANGAN SUB-TEHSIL,6,113,0,113
SIBI DISTRICT,SANGAN SUB-TEHSIL,7,89,0,89
SIBI DISTRICT,SANGAN SUB-TEHSIL,8,116,0,116
SIBI DISTRICT,SANGAN SUB-TEHSIL,9,75,0,75
SIBI DISTRICT,SANGAN SUB-TEHSIL,10,80,0,80
SIBI DISTRICT,SANGAN SUB-TEHSIL,11,65,0,65
SIBI DISTRICT,SANGAN SUB-TEHSIL,12,60,0,60
SIBI DISTRICT,SANGAN SUB-TEHSIL,13,47,0,47
SIBI DISTRICT,SANGAN SUB-TEHSIL,14,62,0,62
SIBI DISTRICT,SANGAN SUB-TEHSIL,15,38,0,38
SIBI DISTRICT,SANGAN SUB-TEHSIL,16,57,0,57
SIBI DISTRICT,SANGAN SUB-TEHSIL,17,35,0,35
SIBI DISTRICT,SANGAN SUB-TEHSIL,18,63,0,63
SIBI DISTRICT,SANGAN SUB-TEHSIL,19,36,0,36
SIBI DISTRICT,SANGAN SUB-TEHSIL,20,49,0,49
SIBI DISTRICT,SANGAN SUB-TEHSIL,21,40,0,40
SIBI DISTRICT,SANGAN SUB-TEHSIL,22,31,0,31
SIBI DISTRICT,SANGAN SUB-TEHSIL,23,40,0,40
SIBI DISTRICT,SANGAN SUB-TEHSIL,24,42,0,42
SIBI DISTRICT,SANGAN SUB-TEHSIL,25,66,0,66
SIBI DISTRICT,SANGAN SUB-TEHSIL,26,26,0,26
SIBI DISTRICT,SANGAN SUB-TEHSIL,27,63,0,63
SIBI DISTRICT,SANGAN SUB-TEHSIL,28,41,0,41
SIBI DISTRICT,SANGAN SUB-TEHSIL,29,26,0,26
SIBI DISTRICT,SANGAN SUB-TEHSIL,30,58,0,58
SIBI DISTRICT,SANGAN SUB-TEHSIL,31,30,0,30
SIBI DISTRICT,SANGAN SUB-TEHSIL,32,25,0,25
SIBI DISTRICT,SANGAN SUB-TEHSIL,33,26,0,26
SIBI DISTRICT,SANGAN SUB-TEHSIL,34,29,0,29
SIBI DISTRICT,SANGAN SUB-TEHSIL,35,48,0,48
SIBI DISTRICT,SANGAN SUB-TEHSIL,36,16,0,16
SIBI DISTRICT,SANGAN SUB-TEHSIL,37,19,0,19
SIBI DISTRICT,SANGAN SUB-TEHSIL,38,21,0,21
SIBI DISTRICT,SANGAN SUB-TEHSIL,39,16,0,16
SIBI DISTRICT,SANGAN SUB-TEHSIL,40,31,0,31
SIBI DISTRICT,SANGAN SUB-TEHSIL,41,12,0,12
SIBI DISTRICT,SANGAN SUB-TEHSIL,42,19,0,19
SIBI DISTRICT,SANGAN SUB-TEHSIL,43,17,0,17
SIBI DISTRICT,SANGAN SUB-TEHSIL,44,16,0,16
SIBI DISTRICT,SANGAN SUB-TEHSIL,45,29,0,29
SIBI DISTRICT,SANGAN SUB-TEHSIL,46,14,0,14
SIBI DISTRICT,SANGAN SUB-TEHSIL,47,16,0,16
SIBI DISTRICT,SANGAN SUB-TEHSIL,48,17,0,17
SIBI DISTRICT,SANGAN SUB-TEHSIL,49,13,0,13
SIBI DISTRICT,SANGAN SUB-TEHSIL,50,19,0,19
SIBI DISTRICT,SANGAN SUB-TEHSIL,51,12,0,12
SIBI DISTRICT,SANGAN SUB-TEHSIL,52,13,0,13
SIBI DISTRICT,SANGAN SUB-TEHSIL,53,13,0,13
SIBI DISTRICT,SANGAN SUB-TEHSIL,54,14,0,14
SIBI DISTRICT,SANGAN SUB-TEHSIL,55,14,0,14
SIBI DISTRICT,SANGAN SUB-TEHSIL,56,2,0,2
SIBI DISTRICT,SANGAN SUB-TEHSIL,57,6,0,6
SIBI DISTRICT,SANGAN SUB-TEHSIL,58,7,0,7
SIBI DISTRICT,SANGAN SUB-TEHSIL,59,5,0,5
SIBI DISTRICT,SANGAN SUB-TEHSIL,60,15,0,15
SIBI DISTRICT,SANGAN SUB-TEHSIL,61,12,0,12
SIBI DISTRICT,SANGAN SUB-TEHSIL,62,8,0,8
SIBI DISTRICT,SANGAN SUB-TEHSIL,63,14,0,14
SIBI DISTRICT,SANGAN SUB-TEHSIL,64,3,0,3
SIBI DISTRICT,SANGAN SUB-TEHSIL,65,9,0,9
SIBI DISTRICT,SANGAN SUB-TEHSIL,66,10,0,10
SIBI DISTRICT,SANGAN SUB-TEHSIL,67,7,0,7
SIBI DISTRICT,SANGAN SUB-TEHSIL,68,5,0,5
SIBI DISTRICT,SANGAN SUB-TEHSIL,69,7,0,7
SIBI DISTRICT,SANGAN SUB-TEHSIL,70,11,0,11
SIBI DISTRICT,SANGAN SUB-TEHSIL,71,6,0,6
SIBI DISTRICT,SANGAN SUB-TEHSIL,72,3,0,3
SIBI DISTRICT,SANGAN SUB-TEHSIL,73,5,0,5
SIBI DISTRICT,SANGAN SUB-TEHSIL,74,4,0,4
SIBI DISTRICT,SANGAN SUB-TEHSIL,>=75,33,0,33
SIBI DISTRICT,SIBI TEHSIL,<1,1460,1434,2894
SIBI DISTRICT,SIBI TEHSIL,1,1744,1605,3349
SIBI DISTRICT,SIBI TEHSIL,2,1902,1831,3733
SIBI DISTRICT,SIBI TEHSIL,3,2034,1907,3941
SIBI DISTRICT,SIBI TEHSIL,4,1978,1720,3698
SIBI DISTRICT,SIBI TEHSIL,5,1952,1883,3835
SIBI DISTRICT,SIBI TEHSIL,6,1852,1689,3541
SIBI DISTRICT,SIBI TEHSIL,7,1902,1961,3863
SIBI DISTRICT,SIBI TEHSIL,8,1890,1693,3583
SIBI DISTRICT,SIBI TEHSIL,9,1591,1810,3401
SIBI DISTRICT,SIBI TEHSIL,10,1628,1461,3089
SIBI DISTRICT,SIBI TEHSIL,11,1340,1591,2931
SIBI DISTRICT,SIBI TEHSIL,12,1357,1396,2753
SIBI DISTRICT,SIBI TEHSIL,13,1277,1471,2748
SIBI DISTRICT,SIBI TEHSIL,14,1176,1364,2540
SIBI DISTRICT,SIBI TEHSIL,15,1218,1397,2615
SIBI DISTRICT,SIBI TEHSIL,16,1113,1381,2494
SIBI DISTRICT,SIBI TEHSIL,17,1115,1442,2557
SIBI DISTRICT,SIBI TEHSIL,18,1230,1272,2502
SIBI DISTRICT,SIBI TEHSIL,19,1152,1362,2514
SIBI DISTRICT,SIBI TEHSIL,20,1125,1194,2319
SIBI DISTRICT,SIBI TEHSIL,21,1199,1382,2581
SIBI DISTRICT,SIBI TEHSIL,22,968,1100,2068
SIBI DISTRICT,SIBI TEHSIL,23,1090,1088,2178
SIBI DISTRICT,SIBI TEHSIL,24,929,1125,2054
SIBI DISTRICT,SIBI TEHSIL,25,987,958,1945
SIBI DISTRICT,SIBI TEHSIL,26,909,1004,1913
SIBI DISTRICT,SIBI TEHSIL,27,1120,1306,2426
SIBI DISTRICT,SIBI TEHSIL,28,896,1009,1905
SIBI DISTRICT,SIBI TEHSIL,29,977,1174,2151
SIBI DISTRICT,SIBI TEHSIL,30,816,792,1608
SIBI DISTRICT,SIBI TEHSIL,31,912,1144,2056
SIBI DISTRICT,SIBI TEHSIL,32,842,984,1826
SIBI DISTRICT,SIBI TEHSIL,33,836,940,1776
SIBI DISTRICT,SIBI TEHSIL,34,769,856,1625
SIBI DISTRICT,SIBI TEHSIL,35,755,663,1418
SIBI DISTRICT,SIBI TEHSIL,36,678,752,1430
SIBI DISTRICT,SIBI TEHSIL,37,835,1007,1842
SIBI DISTRICT,SIBI TEHSIL,38,622,731,1353
SIBI DISTRICT,SIBI TEHSIL,39,749,818,1567
SIBI DISTRICT,SIBI TEHSIL,40,555,558,1113
SIBI DISTRICT,SIBI TEHSIL,41,567,662,1229
SIBI DISTRICT,SIBI TEHSIL,42,557,602,1159
SIBI DISTRICT,SIBI TEHSIL,43,466,581,1047
SIBI DISTRICT,SIBI TEHSIL,44,457,531,988
SIBI DISTRICT,SIBI TEHSIL,45,429,438,867
SIBI DISTRICT,SIBI TEHSIL,46,412,484,896
SIBI DISTRICT,SIBI TEHSIL,47,560,735,1295
SIBI DISTRICT,SIBI TEHSIL,48,448,470,918
SIBI DISTRICT,SIBI TEHSIL,49,518,598,1116
SIBI DISTRICT,SIBI TEHSIL,50,415,423,838
SIBI DISTRICT,SIBI TEHSIL,51,427,584,1011
SIBI DISTRICT,SIBI TEHSIL,52,349,510,859
SIBI DISTRICT,SIBI TEHSIL,53,336,436,772
SIBI DISTRICT,SIBI TEHSIL,54,284,318,602
SIBI DISTRICT,SIBI TEHSIL,55,251,296,547
SIBI DISTRICT,SIBI TEHSIL,56,281,327,608
SIBI DISTRICT,SIBI TEHSIL,57,352,394,746
SIBI DISTRICT,SIBI TEHSIL,58,211,262,473
SIBI DISTRICT,SIBI TEHSIL,59,255,346,601
SIBI DISTRICT,SIBI TEHSIL,60,255,253,508
SIBI DISTRICT,SIBI TEHSIL,61,300,350,650
SIBI DISTRICT,SIBI TEHSIL,62,239,314,553
SIBI DISTRICT,SIBI TEHSIL,63,233,281,514
SIBI DISTRICT,SIBI TEHSIL,64,178,236,414
SIBI DISTRICT,SIBI TEHSIL,65,173,147,320
SIBI DISTRICT,SIBI TEHSIL,66,194,222,416
SIBI DISTRICT,SIBI TEHSIL,67,216,193,409
SIBI DISTRICT,SIBI TEHSIL,68,129,130,259
SIBI DISTRICT,SIBI TEHSIL,69,149,141,290
SIBI DISTRICT,SIBI TEHSIL,70,107,114,221
SIBI DISTRICT,SIBI TEHSIL,71,151,132,283
SIBI DISTRICT,SIBI TEHSIL,72,99,135,234
SIBI DISTRICT,SIBI TEHSIL,73,87,81,168
SIBI DISTRICT,SIBI TEHSIL,74,64,64,128
SIBI DISTRICT,SIBI TEHSIL,>=75,710,629,1339
SOHBATPUR DISTRICT,FARIDABAD TEHSIL,<1,1750,0,1750
SOHBATPUR DISTRICT,FARIDABAD TEHSIL,1,2293,0,2293
SOHBATPUR DISTRICT,FARIDABAD TEHSIL,2,2468,0,2468
SOHBATPUR DISTRICT,FARIDABAD TEHSIL,3,2639,0,2639
SOHBATPUR DISTRICT,FARIDABAD TEHSIL,4,2528,0,2528
SOHBATPUR DISTRICT,FARIDABAD TEHSIL,5,2365,0,2365
SOHBATPUR DISTRICT,FARIDABAD TEHSIL,6,2364,0,2364
SOHBATPUR DISTRICT,FARIDABAD TEHSIL,7,2330,0,2330
SOHBATPUR DISTRICT,FARIDABAD TEHSIL,8,2282,0,2282
SOHBATPUR DISTRICT,FARIDABAD TEHSIL,9,1938,0,1938
SOHBATPUR DISTRICT,FARIDABAD TEHSIL,10,1874,0,1874
SOHBATPUR DISTRICT,FARIDABAD TEHSIL,11,1417,0,1417
SOHBATPUR DISTRICT,FARIDABAD TEHSIL,12,1367,0,1367
SOHBATPUR DISTRICT,FARIDABAD TEHSIL,13,1200,0,1200
SOHBATPUR DISTRICT,FARIDABAD TEHSIL,14,1112,0,1112
SOHBATPUR DISTRICT,FARIDABAD TEHSIL,15,1029,0,1029
SOHBATPUR DISTRICT,FARIDABAD TEHSIL,16,934,0,934
SOHBATPUR DISTRICT,FARIDABAD TEHSIL,17,1073,0,1073
SOHBATPUR DISTRICT,FARIDABAD TEHSIL,18,1207,0,1207
SOHBATPUR DISTRICT,FARIDABAD TEHSIL,19,1025,0,1025
SOHBATPUR DISTRICT,FARIDABAD TEHSIL,20,902,0,902
SOHBATPUR DISTRICT,FARIDABAD TEHSIL,21,805,0,805
SOHBATPUR DISTRICT,FARIDABAD TEHSIL,22,680,0,680
SOHBATPUR DISTRICT,FARIDABAD TEHSIL,23,701,0,701
SOHBATPUR DISTRICT,FARIDABAD TEHSIL,24,694,0,694
SOHBATPUR DISTRICT,FARIDABAD TEHSIL,25,702,0,702
SOHBATPUR DISTRICT,FARIDABAD TEHSIL,26,655,0,655
SOHBATPUR DISTRICT,FARIDABAD TEHSIL,27,898,0,898
SOHBATPUR DISTRICT,FARIDABAD TEHSIL,28,678,0,678
SOHBATPUR DISTRICT,FARIDABAD TEHSIL,29,913,0,913
SOHBATPUR DISTRICT,FARIDABAD TEHSIL,30,651,0,651
SOHBATPUR DISTRICT,FARIDABAD TEHSIL,31,764,0,764
SOHBATPUR DISTRICT,FARIDABAD TEHSIL,32,666,0,666
SOHBATPUR DISTRICT,FARIDABAD TEHSIL,33,592,0,592
SOHBATPUR DISTRICT,FARIDABAD TEHSIL,34,646,0,646
SOHBATPUR DISTRICT,FARIDABAD TEHSIL,35,607,0,607
SOHBATPUR DISTRICT,FARIDABAD TEHSIL,36,655,0,655
SOHBATPUR DISTRICT,FARIDABAD TEHSIL,37,883,0,883
SOHBATPUR DISTRICT,FARIDABAD TEHSIL,38,601,0,601
SOHBATPUR DISTRICT,FARIDABAD TEHSIL,39,654,0,654
SOHBATPUR DISTRICT,FARIDABAD TEHSIL,40,480,0,480
SOHBATPUR DISTRICT,FARIDABAD TEHSIL,41,505,0,505
SOHBATPUR DISTRICT,FARIDABAD TEHSIL,42,528,0,528
SOHBATPUR DISTRICT,FARIDABAD TEHSIL,43,361,0,361
SOHBATPUR DISTRICT,FARIDABAD TEHSIL,44,348,0,348
SOHBATPUR DISTRICT,FARIDABAD TEHSIL,45,302,0,302
SOHBATPUR DISTRICT,FARIDABAD TEHSIL,46,346,0,346
SOHBATPUR DISTRICT,FARIDABAD TEHSIL,47,468,0,468
SOHBATPUR DISTRICT,FARIDABAD TEHSIL,48,349,0,349
SOHBATPUR DISTRICT,FARIDABAD TEHSIL,49,321,0,321
SOHBATPUR DISTRICT,FARIDABAD TEHSIL,50,261,0,261
SOHBATPUR DISTRICT,FARIDABAD TEHSIL,51,337,0,337
SOHBATPUR DISTRICT,FARIDABAD TEHSIL,52,337,0,337
SOHBATPUR DISTRICT,FARIDABAD TEHSIL,53,251,0,251
SOHBATPUR DISTRICT,FARIDABAD TEHSIL,54,213,0,213
SOHBATPUR DISTRICT,FARIDABAD TEHSIL,55,170,0,170
SOHBATPUR DISTRICT,FARIDABAD TEHSIL,56,191,0,191
SOHBATPUR DISTRICT,FARIDABAD TEHSIL,57,319,0,319
SOHBATPUR DISTRICT,FARIDABAD TEHSIL,58,177,0,177
SOHBATPUR DISTRICT,FARIDABAD TEHSIL,59,195,0,195
SOHBATPUR DISTRICT,FARIDABAD TEHSIL,60,162,0,162
SOHBATPUR DISTRICT,FARIDABAD TEHSIL,61,159,0,159
SOHBATPUR DISTRICT,FARIDABAD TEHSIL,62,173,0,173
SOHBATPUR DISTRICT,FARIDABAD TEHSIL,63,151,0,151
SOHBATPUR DISTRICT,FARIDABAD TEHSIL,64,123,0,123
SOHBATPUR DISTRICT,FARIDABAD TEHSIL,65,124,0,124
SOHBATPUR DISTRICT,FARIDABAD TEHSIL,66,102,0,102
SOHBATPUR DISTRICT,FARIDABAD TEHSIL,67,179,0,179
SOHBATPUR DISTRICT,FARIDABAD TEHSIL,68,86,0,86
SOHBATPUR DISTRICT,FARIDABAD TEHSIL,69,118,0,118
SOHBATPUR DISTRICT,FARIDABAD TEHSIL,70,65,0,65
SOHBATPUR DISTRICT,FARIDABAD TEHSIL,71,93,0,93
SOHBATPUR DISTRICT,FARIDABAD TEHSIL,72,80,0,80
SOHBATPUR DISTRICT,FARIDABAD TEHSIL,73,65,0,65
SOHBATPUR DISTRICT,FARIDABAD TEHSIL,74,62,0,62
SOHBATPUR DISTRICT,FARIDABAD TEHSIL,>=75,461,0,461
SOHBATPUR DISTRICT,SANHRI TEHSIL,<1,2442,0,2442
SOHBATPUR DISTRICT,SANHRI TEHSIL,1,3771,0,3771
SOHBATPUR DISTRICT,SANHRI TEHSIL,2,4049,0,4049
SOHBATPUR DISTRICT,SANHRI TEHSIL,3,3952,0,3952
SOHBATPUR DISTRICT,SANHRI TEHSIL,4,4088,0,4088
SOHBATPUR DISTRICT,SANHRI TEHSIL,5,3632,0,3632
SOHBATPUR DISTRICT,SANHRI TEHSIL,6,3701,0,3701
SOHBATPUR DISTRICT,SANHRI TEHSIL,7,3544,0,3544
SOHBATPUR DISTRICT,SANHRI TEHSIL,8,3465,0,3465
SOHBATPUR DISTRICT,SANHRI TEHSIL,9,2912,0,2912
SOHBATPUR DISTRICT,SANHRI TEHSIL,10,2815,0,2815
SOHBATPUR DISTRICT,SANHRI TEHSIL,11,2017,0,2017
SOHBATPUR DISTRICT,SANHRI TEHSIL,12,2081,0,2081
SOHBATPUR DISTRICT,SANHRI TEHSIL,13,1630,0,1630
SOHBATPUR DISTRICT,SANHRI TEHSIL,14,1539,0,1539
SOHBATPUR DISTRICT,SANHRI TEHSIL,15,1436,0,1436
SOHBATPUR DISTRICT,SANHRI TEHSIL,16,1409,0,1409
SOHBATPUR DISTRICT,SANHRI TEHSIL,17,1540,0,1540
SOHBATPUR DISTRICT,SANHRI TEHSIL,18,1834,0,1834
SOHBATPUR DISTRICT,SANHRI TEHSIL,19,1717,0,1717
SOHBATPUR DISTRICT,SANHRI TEHSIL,20,1439,0,1439
SOHBATPUR DISTRICT,SANHRI TEHSIL,21,1294,0,1294
SOHBATPUR DISTRICT,SANHRI TEHSIL,22,1042,0,1042
SOHBATPUR DISTRICT,SANHRI TEHSIL,23,1087,0,1087
SOHBATPUR DISTRICT,SANHRI TEHSIL,24,1048,0,1048
SOHBATPUR DISTRICT,SANHRI TEHSIL,25,1187,0,1187
SOHBATPUR DISTRICT,SANHRI TEHSIL,26,989,0,989
SOHBATPUR DISTRICT,SANHRI TEHSIL,27,1292,0,1292
SOHBATPUR DISTRICT,SANHRI TEHSIL,28,1020,0,1020
SOHBATPUR DISTRICT,SANHRI TEHSIL,29,1348,0,1348
SOHBATPUR DISTRICT,SANHRI TEHSIL,30,1059,0,1059
SOHBATPUR DISTRICT,SANHRI TEHSIL,31,1141,0,1141
SOHBATPUR DISTRICT,SANHRI TEHSIL,32,1134,0,1134
SOHBATPUR DISTRICT,SANHRI TEHSIL,33,946,0,946
SOHBATPUR DISTRICT,SANHRI TEHSIL,34,875,0,875
SOHBATPUR DISTRICT,SANHRI TEHSIL,35,883,0,883
SOHBATPUR DISTRICT,SANHRI TEHSIL,36,737,0,737
SOHBATPUR DISTRICT,SANHRI TEHSIL,37,1276,0,1276
SOHBATPUR DISTRICT,SANHRI TEHSIL,38,743,0,743
SOHBATPUR DISTRICT,SANHRI TEHSIL,39,1028,0,1028
SOHBATPUR DISTRICT,SANHRI TEHSIL,40,692,0,692
SOHBATPUR DISTRICT,SANHRI TEHSIL,41,639,0,639
SOHBATPUR DISTRICT,SANHRI TEHSIL,42,719,0,719
SOHBATPUR DISTRICT,SANHRI TEHSIL,43,565,0,565
SOHBATPUR DISTRICT,SANHRI TEHSIL,44,506,0,506
SOHBATPUR DISTRICT,SANHRI TEHSIL,45,480,0,480
SOHBATPUR DISTRICT,SANHRI TEHSIL,46,405,0,405
SOHBATPUR DISTRICT,SANHRI TEHSIL,47,841,0,841
SOHBATPUR DISTRICT,SANHRI TEHSIL,48,502,0,502
SOHBATPUR DISTRICT,SANHRI TEHSIL,49,609,0,609
SOHBATPUR DISTRICT,SANHRI TEHSIL,50,469,0,469
SOHBATPUR DISTRICT,SANHRI TEHSIL,51,447,0,447
SOHBATPUR DISTRICT,SANHRI TEHSIL,52,572,0,572
SOHBATPUR DISTRICT,SANHRI TEHSIL,53,387,0,387
SOHBATPUR DISTRICT,SANHRI TEHSIL,54,341,0,341
SOHBATPUR DISTRICT,SANHRI TEHSIL,55,325,0,325
SOHBATPUR DISTRICT,SANHRI TEHSIL,56,243,0,243
SOHBATPUR DISTRICT,SANHRI TEHSIL,57,558,0,558
SOHBATPUR DISTRICT,SANHRI TEHSIL,58,262,0,262
SOHBATPUR DISTRICT,SANHRI TEHSIL,59,297,0,297
SOHBATPUR DISTRICT,SANHRI TEHSIL,60,281,0,281
SOHBATPUR DISTRICT,SANHRI TEHSIL,61,230,0,230
SOHBATPUR DISTRICT,SANHRI TEHSIL,62,353,0,353
SOHBATPUR DISTRICT,SANHRI TEHSIL,63,206,0,206
SOHBATPUR DISTRICT,SANHRI TEHSIL,64,235,0,235
SOHBATPUR DISTRICT,SANHRI TEHSIL,65,201,0,201
SOHBATPUR DISTRICT,SANHRI TEHSIL,66,161,0,161
SOHBATPUR DISTRICT,SANHRI TEHSIL,67,337,0,337
SOHBATPUR DISTRICT,SANHRI TEHSIL,68,139,0,139
SOHBATPUR DISTRICT,SANHRI TEHSIL,69,188,0,188
SOHBATPUR DISTRICT,SANHRI TEHSIL,70,152,0,152
SOHBATPUR DISTRICT,SANHRI TEHSIL,71,135,0,135
SOHBATPUR DISTRICT,SANHRI TEHSIL,72,166,0,166
SOHBATPUR DISTRICT,SANHRI TEHSIL,73,98,0,98
SOHBATPUR DISTRICT,SANHRI TEHSIL,74,110,0,110
SOHBATPUR DISTRICT,SANHRI TEHSIL,>=75,795,0,795
SOHBATPUR DISTRICT,SOHBATPUR TEHSIL,<1,1064,277,1341
SOHBATPUR DISTRICT,SOHBATPUR TEHSIL,1,1902,381,2283
SOHBATPUR DISTRICT,SOHBATPUR TEHSIL,2,1690,437,2127
SOHBATPUR DISTRICT,SOHBATPUR TEHSIL,3,1714,455,2169
SOHBATPUR DISTRICT,SOHBATPUR TEHSIL,4,1702,448,2150
SOHBATPUR DISTRICT,SOHBATPUR TEHSIL,5,1644,469,2113
SOHBATPUR DISTRICT,SOHBATPUR TEHSIL,6,1583,446,2029
SOHBATPUR DISTRICT,SOHBATPUR TEHSIL,7,1720,521,2241
SOHBATPUR DISTRICT,SOHBATPUR TEHSIL,8,1609,472,2081
SOHBATPUR DISTRICT,SOHBATPUR TEHSIL,9,1328,420,1748
SOHBATPUR DISTRICT,SOHBATPUR TEHSIL,10,1391,412,1803
SOHBATPUR DISTRICT,SOHBATPUR TEHSIL,11,985,369,1354
SOHBATPUR DISTRICT,SOHBATPUR TEHSIL,12,967,354,1321
SOHBATPUR DISTRICT,SOHBATPUR TEHSIL,13,798,309,1107
SOHBATPUR DISTRICT,SOHBATPUR TEHSIL,14,808,273,1081
SOHBATPUR DISTRICT,SOHBATPUR TEHSIL,15,707,296,1003
SOHBATPUR DISTRICT,SOHBATPUR TEHSIL,16,754,266,1020
SOHBATPUR DISTRICT,SOHBATPUR TEHSIL,17,720,266,986
SOHBATPUR DISTRICT,SOHBATPUR TEHSIL,18,924,266,1190
SOHBATPUR DISTRICT,SOHBATPUR TEHSIL,19,716,258,974
SOHBATPUR DISTRICT,SOHBATPUR TEHSIL,20,649,191,840
SOHBATPUR DISTRICT,SOHBATPUR TEHSIL,21,533,202,735
SOHBATPUR DISTRICT,SOHBATPUR TEHSIL,22,457,189,646
SOHBATPUR DISTRICT,SOHBATPUR TEHSIL,23,494,189,683
SOHBATPUR DISTRICT,SOHBATPUR TEHSIL,24,451,168,619
SOHBATPUR DISTRICT,SOHBATPUR TEHSIL,25,491,163,654
SOHBATPUR DISTRICT,SOHBATPUR TEHSIL,26,411,178,589
SOHBATPUR DISTRICT,SOHBATPUR TEHSIL,27,595,212,807
SOHBATPUR DISTRICT,SOHBATPUR TEHSIL,28,414,174,588
SOHBATPUR DISTRICT,SOHBATPUR TEHSIL,29,652,210,862
SOHBATPUR DISTRICT,SOHBATPUR TEHSIL,30,448,147,595
SOHBATPUR DISTRICT,SOHBATPUR TEHSIL,31,511,181,692
SOHBATPUR DISTRICT,SOHBATPUR TEHSIL,32,499,207,706
SOHBATPUR DISTRICT,SOHBATPUR TEHSIL,33,402,121,523
SOHBATPUR DISTRICT,SOHBATPUR TEHSIL,34,406,119,525
SOHBATPUR DISTRICT,SOHBATPUR TEHSIL,35,436,149,585
SOHBATPUR DISTRICT,SOHBATPUR TEHSIL,36,337,113,450
SOHBATPUR DISTRICT,SOHBATPUR TEHSIL,37,667,212,879
SOHBATPUR DISTRICT,SOHBATPUR TEHSIL,38,347,114,461
SOHBATPUR DISTRICT,SOHBATPUR TEHSIL,39,562,165,727
SOHBATPUR DISTRICT,SOHBATPUR TEHSIL,40,281,87,368
SOHBATPUR DISTRICT,SOHBATPUR TEHSIL,41,319,98,417
SOHBATPUR DISTRICT,SOHBATPUR TEHSIL,42,325,120,445
SOHBATPUR DISTRICT,SOHBATPUR TEHSIL,43,267,80,347
SOHBATPUR DISTRICT,SOHBATPUR TEHSIL,44,238,69,307
SOHBATPUR DISTRICT,SOHBATPUR TEHSIL,45,221,62,283
SOHBATPUR DISTRICT,SOHBATPUR TEHSIL,46,200,63,263
SOHBATPUR DISTRICT,SOHBATPUR TEHSIL,47,375,129,504
SOHBATPUR DISTRICT,SOHBATPUR TEHSIL,48,186,59,245
SOHBATPUR DISTRICT,SOHBATPUR TEHSIL,49,249,109,358
SOHBATPUR DISTRICT,SOHBATPUR TEHSIL,50,189,79,268
SOHBATPUR DISTRICT,SOHBATPUR TEHSIL,51,233,92,325
SOHBATPUR DISTRICT,SOHBATPUR TEHSIL,52,224,93,317
SOHBATPUR DISTRICT,SOHBATPUR TEHSIL,53,175,73,248
SOHBATPUR DISTRICT,SOHBATPUR TEHSIL,54,178,65,243
SOHBATPUR DISTRICT,SOHBATPUR TEHSIL,55,146,49,195
SOHBATPUR DISTRICT,SOHBATPUR TEHSIL,56,127,47,174
SOHBATPUR DISTRICT,SOHBATPUR TEHSIL,57,270,88,358
SOHBATPUR DISTRICT,SOHBATPUR TEHSIL,58,113,41,154
SOHBATPUR DISTRICT,SOHBATPUR TEHSIL,59,127,49,176
SOHBATPUR DISTRICT,SOHBATPUR TEHSIL,60,112,48,160
SOHBATPUR DISTRICT,SOHBATPUR TEHSIL,61,119,36,155
SOHBATPUR DISTRICT,SOHBATPUR TEHSIL,62,121,53,174
SOHBATPUR DISTRICT,SOHBATPUR TEHSIL,63,110,33,143
SOHBATPUR DISTRICT,SOHBATPUR TEHSIL,64,113,29,142
SOHBATPUR DISTRICT,SOHBATPUR TEHSIL,65,101,27,128
SOHBATPUR DISTRICT,SOHBATPUR TEHSIL,66,75,31,106
SOHBATPUR DISTRICT,SOHBATPUR TEHSIL,67,152,46,198
SOHBATPUR DISTRICT,SOHBATPUR TEHSIL,68,63,22,85
SOHBATPUR DISTRICT,SOHBATPUR TEHSIL,69,66,25,91
SOHBATPUR DISTRICT,SOHBATPUR TEHSIL,70,55,16,71
SOHBATPUR DISTRICT,SOHBATPUR TEHSIL,71,49,18,67
SOHBATPUR DISTRICT,SOHBATPUR TEHSIL,72,58,10,68
SOHBATPUR DISTRICT,SOHBATPUR TEHSIL,73,43,9,52
SOHBATPUR DISTRICT,SOHBATPUR TEHSIL,74,47,10,57
SOHBATPUR DISTRICT,SOHBATPUR TEHSIL,>=75,352,103,455
SOUTH WAZIRISTAN AGENCY,BIRMIL TEHSIL,<1,3220,0,3220
SOUTH WAZIRISTAN AGENCY,BIRMIL TEHSIL,1,3727,0,3727
SOUTH WAZIRISTAN AGENCY,BIRMIL TEHSIL,2,4728,0,4728
SOUTH WAZIRISTAN AGENCY,BIRMIL TEHSIL,3,4733,0,4733
SOUTH WAZIRISTAN AGENCY,BIRMIL TEHSIL,4,4991,0,4991
SOUTH WAZIRISTAN AGENCY,BIRMIL TEHSIL,5,4239,0,4239
SOUTH WAZIRISTAN AGENCY,BIRMIL TEHSIL,6,4697,0,4697
SOUTH WAZIRISTAN AGENCY,BIRMIL TEHSIL,7,3998,0,3998
SOUTH WAZIRISTAN AGENCY,BIRMIL TEHSIL,8,4326,0,4326
SOUTH WAZIRISTAN AGENCY,BIRMIL TEHSIL,9,3564,0,3564
SOUTH WAZIRISTAN AGENCY,BIRMIL TEHSIL,10,3585,0,3585
SOUTH WAZIRISTAN AGENCY,BIRMIL TEHSIL,11,2764,0,2764
SOUTH WAZIRISTAN AGENCY,BIRMIL TEHSIL,12,2827,0,2827
SOUTH WAZIRISTAN AGENCY,BIRMIL TEHSIL,13,2482,0,2482
SOUTH WAZIRISTAN AGENCY,BIRMIL TEHSIL,14,2271,0,2271
SOUTH WAZIRISTAN AGENCY,BIRMIL TEHSIL,15,2252,0,2252
SOUTH WAZIRISTAN AGENCY,BIRMIL TEHSIL,16,1874,0,1874
SOUTH WAZIRISTAN AGENCY,BIRMIL TEHSIL,17,1560,0,1560
SOUTH WAZIRISTAN AGENCY,BIRMIL TEHSIL,18,2170,0,2170
SOUTH WAZIRISTAN AGENCY,BIRMIL TEHSIL,19,1735,0,1735
SOUTH WAZIRISTAN AGENCY,BIRMIL TEHSIL,20,2194,0,2194
SOUTH WAZIRISTAN AGENCY,BIRMIL TEHSIL,21,1634,0,1634
SOUTH WAZIRISTAN AGENCY,BIRMIL TEHSIL,22,1631,0,1631
SOUTH WAZIRISTAN AGENCY,BIRMIL TEHSIL,23,1504,0,1504
SOUTH WAZIRISTAN AGENCY,BIRMIL TEHSIL,24,1256,0,1256
SOUTH WAZIRISTAN AGENCY,BIRMIL TEHSIL,25,1821,0,1821
SOUTH WAZIRISTAN AGENCY,BIRMIL TEHSIL,26,1119,0,1119
SOUTH WAZIRISTAN AGENCY,BIRMIL TEHSIL,27,1277,0,1277
SOUTH WAZIRISTAN AGENCY,BIRMIL TEHSIL,28,1349,0,1349
SOUTH WAZIRISTAN AGENCY,BIRMIL TEHSIL,29,1261,0,1261
SOUTH WAZIRISTAN AGENCY,BIRMIL TEHSIL,30,1423,0,1423
SOUTH WAZIRISTAN AGENCY,BIRMIL TEHSIL,31,1062,0,1062
SOUTH WAZIRISTAN AGENCY,BIRMIL TEHSIL,32,859,0,859
SOUTH WAZIRISTAN AGENCY,BIRMIL TEHSIL,33,939,0,939
SOUTH WAZIRISTAN AGENCY,BIRMIL TEHSIL,34,724,0,724
SOUTH WAZIRISTAN AGENCY,BIRMIL TEHSIL,35,1129,0,1129
SOUTH WAZIRISTAN AGENCY,BIRMIL TEHSIL,36,577,0,577
SOUTH WAZIRISTAN AGENCY,BIRMIL TEHSIL,37,786,0,786
SOUTH WAZIRISTAN AGENCY,BIRMIL TEHSIL,38,849,0,849
SOUTH WAZIRISTAN AGENCY,BIRMIL TEHSIL,39,841,0,841
SOUTH WAZIRISTAN AGENCY,BIRMIL TEHSIL,40,1110,0,1110
SOUTH WAZIRISTAN AGENCY,BIRMIL TEHSIL,41,681,0,681
SOUTH WAZIRISTAN AGENCY,BIRMIL TEHSIL,42,523,0,523
SOUTH WAZIRISTAN AGENCY,BIRMIL TEHSIL,43,733,0,733
SOUTH WAZIRISTAN AGENCY,BIRMIL TEHSIL,44,548,0,548
SOUTH WAZIRISTAN AGENCY,BIRMIL TEHSIL,45,755,0,755
SOUTH WAZIRISTAN AGENCY,BIRMIL TEHSIL,46,421,0,421
SOUTH WAZIRISTAN AGENCY,BIRMIL TEHSIL,47,487,0,487
SOUTH WAZIRISTAN AGENCY,BIRMIL TEHSIL,48,510,0,510
SOUTH WAZIRISTAN AGENCY,BIRMIL TEHSIL,49,489,0,489
SOUTH WAZIRISTAN AGENCY,BIRMIL TEHSIL,50,782,0,782
SOUTH WAZIRISTAN AGENCY,BIRMIL TEHSIL,51,410,0,410
SOUTH WAZIRISTAN AGENCY,BIRMIL TEHSIL,52,364,0,364
SOUTH WAZIRISTAN AGENCY,BIRMIL TEHSIL,53,484,0,484
SOUTH WAZIRISTAN AGENCY,BIRMIL TEHSIL,54,412,0,412
SOUTH WAZIRISTAN AGENCY,BIRMIL TEHSIL,55,501,0,501
SOUTH WAZIRISTAN AGENCY,BIRMIL TEHSIL,56,326,0,326
SOUTH WAZIRISTAN AGENCY,BIRMIL TEHSIL,57,354,0,354
SOUTH WAZIRISTAN AGENCY,BIRMIL TEHSIL,58,283,0,283
SOUTH WAZIRISTAN AGENCY,BIRMIL TEHSIL,59,314,0,314
SOUTH WAZIRISTAN AGENCY,BIRMIL TEHSIL,60,461,0,461
SOUTH WAZIRISTAN AGENCY,BIRMIL TEHSIL,61,298,0,298
SOUTH WAZIRISTAN AGENCY,BIRMIL TEHSIL,62,239,0,239
SOUTH WAZIRISTAN AGENCY,BIRMIL TEHSIL,63,270,0,270
SOUTH WAZIRISTAN AGENCY,BIRMIL TEHSIL,64,247,0,247
SOUTH WAZIRISTAN AGENCY,BIRMIL TEHSIL,65,247,0,247
SOUTH WAZIRISTAN AGENCY,BIRMIL TEHSIL,66,133,0,133
SOUTH WAZIRISTAN AGENCY,BIRMIL TEHSIL,67,191,0,191
SOUTH WAZIRISTAN AGENCY,BIRMIL TEHSIL,68,183,0,183
SOUTH WAZIRISTAN AGENCY,BIRMIL TEHSIL,69,152,0,152
SOUTH WAZIRISTAN AGENCY,BIRMIL TEHSIL,70,198,0,198
SOUTH WAZIRISTAN AGENCY,BIRMIL TEHSIL,71,132,0,132
SOUTH WAZIRISTAN AGENCY,BIRMIL TEHSIL,72,91,0,91
SOUTH WAZIRISTAN AGENCY,BIRMIL TEHSIL,73,104,0,104
SOUTH WAZIRISTAN AGENCY,BIRMIL TEHSIL,74,104,0,104
SOUTH WAZIRISTAN AGENCY,BIRMIL TEHSIL,>=75,767,0,767
SOUTH WAZIRISTAN AGENCY,LADHA TEHSIL,<1,2553,0,2553
SOUTH WAZIRISTAN AGENCY,LADHA TEHSIL,1,3677,0,3677
SOUTH WAZIRISTAN AGENCY,LADHA TEHSIL,2,4108,0,4108
SOUTH WAZIRISTAN AGENCY,LADHA TEHSIL,3,4191,0,4191
SOUTH WAZIRISTAN AGENCY,LADHA TEHSIL,4,4209,0,4209
SOUTH WAZIRISTAN AGENCY,LADHA TEHSIL,5,4079,0,4079
SOUTH WAZIRISTAN AGENCY,LADHA TEHSIL,6,3983,0,3983
SOUTH WAZIRISTAN AGENCY,LADHA TEHSIL,7,3805,0,3805
SOUTH WAZIRISTAN AGENCY,LADHA TEHSIL,8,3892,0,3892
SOUTH WAZIRISTAN AGENCY,LADHA TEHSIL,9,3817,0,3817
SOUTH WAZIRISTAN AGENCY,LADHA TEHSIL,10,3432,0,3432
SOUTH WAZIRISTAN AGENCY,LADHA TEHSIL,11,3141,0,3141
SOUTH WAZIRISTAN AGENCY,LADHA TEHSIL,12,2873,0,2873
SOUTH WAZIRISTAN AGENCY,LADHA TEHSIL,13,2660,0,2660
SOUTH WAZIRISTAN AGENCY,LADHA TEHSIL,14,2301,0,2301
SOUTH WAZIRISTAN AGENCY,LADHA TEHSIL,15,2148,0,2148
SOUTH WAZIRISTAN AGENCY,LADHA TEHSIL,16,1845,0,1845
SOUTH WAZIRISTAN AGENCY,LADHA TEHSIL,17,1791,0,1791
SOUTH WAZIRISTAN AGENCY,LADHA TEHSIL,18,1879,0,1879
SOUTH WAZIRISTAN AGENCY,LADHA TEHSIL,19,2312,0,2312
SOUTH WAZIRISTAN AGENCY,LADHA TEHSIL,20,1709,0,1709
SOUTH WAZIRISTAN AGENCY,LADHA TEHSIL,21,2065,0,2065
SOUTH WAZIRISTAN AGENCY,LADHA TEHSIL,22,1730,0,1730
SOUTH WAZIRISTAN AGENCY,LADHA TEHSIL,23,1765,0,1765
SOUTH WAZIRISTAN AGENCY,LADHA TEHSIL,24,1610,0,1610
SOUTH WAZIRISTAN AGENCY,LADHA TEHSIL,25,1595,0,1595
SOUTH WAZIRISTAN AGENCY,LADHA TEHSIL,26,1704,0,1704
SOUTH WAZIRISTAN AGENCY,LADHA TEHSIL,27,2015,0,2015
SOUTH WAZIRISTAN AGENCY,LADHA TEHSIL,28,1477,0,1477
SOUTH WAZIRISTAN AGENCY,LADHA TEHSIL,29,1538,0,1538
SOUTH WAZIRISTAN AGENCY,LADHA TEHSIL,30,1311,0,1311
SOUTH WAZIRISTAN AGENCY,LADHA TEHSIL,31,1515,0,1515
SOUTH WAZIRISTAN AGENCY,LADHA TEHSIL,32,1362,0,1362
SOUTH WAZIRISTAN AGENCY,LADHA TEHSIL,33,1310,0,1310
SOUTH WAZIRISTAN AGENCY,LADHA TEHSIL,34,1228,0,1228
SOUTH WAZIRISTAN AGENCY,LADHA TEHSIL,35,1067,0,1067
SOUTH WAZIRISTAN AGENCY,LADHA TEHSIL,36,1211,0,1211
SOUTH WAZIRISTAN AGENCY,LADHA TEHSIL,37,1339,0,1339
SOUTH WAZIRISTAN AGENCY,LADHA TEHSIL,38,953,0,953
SOUTH WAZIRISTAN AGENCY,LADHA TEHSIL,39,1062,0,1062
SOUTH WAZIRISTAN AGENCY,LADHA TEHSIL,40,956,0,956
SOUTH WAZIRISTAN AGENCY,LADHA TEHSIL,41,1007,0,1007
SOUTH WAZIRISTAN AGENCY,LADHA TEHSIL,42,932,0,932
SOUTH WAZIRISTAN AGENCY,LADHA TEHSIL,43,816,0,816
SOUTH WAZIRISTAN AGENCY,LADHA TEHSIL,44,746,0,746
SOUTH WAZIRISTAN AGENCY,LADHA TEHSIL,45,633,0,633
SOUTH WAZIRISTAN AGENCY,LADHA TEHSIL,46,792,0,792
SOUTH WAZIRISTAN AGENCY,LADHA TEHSIL,47,859,0,859
SOUTH WAZIRISTAN AGENCY,LADHA TEHSIL,48,656,0,656
SOUTH WAZIRISTAN AGENCY,LADHA TEHSIL,49,635,0,635
SOUTH WAZIRISTAN AGENCY,LADHA TEHSIL,50,635,0,635
SOUTH WAZIRISTAN AGENCY,LADHA TEHSIL,51,666,0,666
SOUTH WAZIRISTAN AGENCY,LADHA TEHSIL,52,630,0,630
SOUTH WAZIRISTAN AGENCY,LADHA TEHSIL,53,548,0,548
SOUTH WAZIRISTAN AGENCY,LADHA TEHSIL,54,454,0,454
SOUTH WAZIRISTAN AGENCY,LADHA TEHSIL,55,518,0,518
SOUTH WAZIRISTAN AGENCY,LADHA TEHSIL,56,528,0,528
SOUTH WAZIRISTAN AGENCY,LADHA TEHSIL,57,593,0,593
SOUTH WAZIRISTAN AGENCY,LADHA TEHSIL,58,417,0,417
SOUTH WAZIRISTAN AGENCY,LADHA TEHSIL,59,401,0,401
SOUTH WAZIRISTAN AGENCY,LADHA TEHSIL,60,380,0,380
SOUTH WAZIRISTAN AGENCY,LADHA TEHSIL,61,466,0,466
SOUTH WAZIRISTAN AGENCY,LADHA TEHSIL,62,479,0,479
SOUTH WAZIRISTAN AGENCY,LADHA TEHSIL,63,382,0,382
SOUTH WAZIRISTAN AGENCY,LADHA TEHSIL,64,338,0,338
SOUTH WAZIRISTAN AGENCY,LADHA TEHSIL,65,263,0,263
SOUTH WAZIRISTAN AGENCY,LADHA TEHSIL,66,316,0,316
SOUTH WAZIRISTAN AGENCY,LADHA TEHSIL,67,395,0,395
SOUTH WAZIRISTAN AGENCY,LADHA TEHSIL,68,243,0,243
SOUTH WAZIRISTAN AGENCY,LADHA TEHSIL,69,210,0,210
SOUTH WAZIRISTAN AGENCY,LADHA TEHSIL,70,168,0,168
SOUTH WAZIRISTAN AGENCY,LADHA TEHSIL,71,216,0,216
SOUTH WAZIRISTAN AGENCY,LADHA TEHSIL,72,170,0,170
SOUTH WAZIRISTAN AGENCY,LADHA TEHSIL,73,139,0,139
SOUTH WAZIRISTAN AGENCY,LADHA TEHSIL,74,117,0,117
SOUTH WAZIRISTAN AGENCY,LADHA TEHSIL,>=75,876,0,876
SOUTH WAZIRISTAN AGENCY,MAKIN TEHSIL,<1,1217,0,1217
SOUTH WAZIRISTAN AGENCY,MAKIN TEHSIL,1,1881,0,1881
SOUTH WAZIRISTAN AGENCY,MAKIN TEHSIL,2,2146,0,2146
SOUTH WAZIRISTAN AGENCY,MAKIN TEHSIL,3,2264,0,2264
SOUTH WAZIRISTAN AGENCY,MAKIN TEHSIL,4,2000,0,2000
SOUTH WAZIRISTAN AGENCY,MAKIN TEHSIL,5,2035,0,2035
SOUTH WAZIRISTAN AGENCY,MAKIN TEHSIL,6,2067,0,2067
SOUTH WAZIRISTAN AGENCY,MAKIN TEHSIL,7,1919,0,1919
SOUTH WAZIRISTAN AGENCY,MAKIN TEHSIL,8,2077,0,2077
SOUTH WAZIRISTAN AGENCY,MAKIN TEHSIL,9,2007,0,2007
SOUTH WAZIRISTAN AGENCY,MAKIN TEHSIL,10,1803,0,1803
SOUTH WAZIRISTAN AGENCY,MAKIN TEHSIL,11,1641,0,1641
SOUTH WAZIRISTAN AGENCY,MAKIN TEHSIL,12,1560,0,1560
SOUTH WAZIRISTAN AGENCY,MAKIN TEHSIL,13,1383,0,1383
SOUTH WAZIRISTAN AGENCY,MAKIN TEHSIL,14,1243,0,1243
SOUTH WAZIRISTAN AGENCY,MAKIN TEHSIL,15,1156,0,1156
SOUTH WAZIRISTAN AGENCY,MAKIN TEHSIL,16,989,0,989
SOUTH WAZIRISTAN AGENCY,MAKIN TEHSIL,17,850,0,850
SOUTH WAZIRISTAN AGENCY,MAKIN TEHSIL,18,1047,0,1047
SOUTH WAZIRISTAN AGENCY,MAKIN TEHSIL,19,1298,0,1298
SOUTH WAZIRISTAN AGENCY,MAKIN TEHSIL,20,997,0,997
SOUTH WAZIRISTAN AGENCY,MAKIN TEHSIL,21,1074,0,1074
SOUTH WAZIRISTAN AGENCY,MAKIN TEHSIL,22,948,0,948
SOUTH WAZIRISTAN AGENCY,MAKIN TEHSIL,23,1063,0,1063
SOUTH WAZIRISTAN AGENCY,MAKIN TEHSIL,24,914,0,914
SOUTH WAZIRISTAN AGENCY,MAKIN TEHSIL,25,963,0,963
SOUTH WAZIRISTAN AGENCY,MAKIN TEHSIL,26,956,0,956
SOUTH WAZIRISTAN AGENCY,MAKIN TEHSIL,27,1120,0,1120
SOUTH WAZIRISTAN AGENCY,MAKIN TEHSIL,28,804,0,804
SOUTH WAZIRISTAN AGENCY,MAKIN TEHSIL,29,893,0,893
SOUTH WAZIRISTAN AGENCY,MAKIN TEHSIL,30,671,0,671
SOUTH WAZIRISTAN AGENCY,MAKIN TEHSIL,31,826,0,826
SOUTH WAZIRISTAN AGENCY,MAKIN TEHSIL,32,787,0,787
SOUTH WAZIRISTAN AGENCY,MAKIN TEHSIL,33,616,0,616
SOUTH WAZIRISTAN AGENCY,MAKIN TEHSIL,34,662,0,662
SOUTH WAZIRISTAN AGENCY,MAKIN TEHSIL,35,572,0,572
SOUTH WAZIRISTAN AGENCY,MAKIN TEHSIL,36,588,0,588
SOUTH WAZIRISTAN AGENCY,MAKIN TEHSIL,37,791,0,791
SOUTH WAZIRISTAN AGENCY,MAKIN TEHSIL,38,556,0,556
SOUTH WAZIRISTAN AGENCY,MAKIN TEHSIL,39,594,0,594
SOUTH WAZIRISTAN AGENCY,MAKIN TEHSIL,40,475,0,475
SOUTH WAZIRISTAN AGENCY,MAKIN TEHSIL,41,618,0,618
SOUTH WAZIRISTAN AGENCY,MAKIN TEHSIL,42,559,0,559
SOUTH WAZIRISTAN AGENCY,MAKIN TEHSIL,43,442,0,442
SOUTH WAZIRISTAN AGENCY,MAKIN TEHSIL,44,377,0,377
SOUTH WAZIRISTAN AGENCY,MAKIN TEHSIL,45,304,0,304
SOUTH WAZIRISTAN AGENCY,MAKIN TEHSIL,46,373,0,373
SOUTH WAZIRISTAN AGENCY,MAKIN TEHSIL,47,516,0,516
SOUTH WAZIRISTAN AGENCY,MAKIN TEHSIL,48,322,0,322
SOUTH WAZIRISTAN AGENCY,MAKIN TEHSIL,49,374,0,374
SOUTH WAZIRISTAN AGENCY,MAKIN TEHSIL,50,299,0,299
SOUTH WAZIRISTAN AGENCY,MAKIN TEHSIL,51,400,0,400
SOUTH WAZIRISTAN AGENCY,MAKIN TEHSIL,52,347,0,347
SOUTH WAZIRISTAN AGENCY,MAKIN TEHSIL,53,277,0,277
SOUTH WAZIRISTAN AGENCY,MAKIN TEHSIL,54,235,0,235
SOUTH WAZIRISTAN AGENCY,MAKIN TEHSIL,55,198,0,198
SOUTH WAZIRISTAN AGENCY,MAKIN TEHSIL,56,240,0,240
SOUTH WAZIRISTAN AGENCY,MAKIN TEHSIL,57,307,0,307
SOUTH WAZIRISTAN AGENCY,MAKIN TEHSIL,58,208,0,208
SOUTH WAZIRISTAN AGENCY,MAKIN TEHSIL,59,239,0,239
SOUTH WAZIRISTAN AGENCY,MAKIN TEHSIL,60,166,0,166
SOUTH WAZIRISTAN AGENCY,MAKIN TEHSIL,61,173,0,173
SOUTH WAZIRISTAN AGENCY,MAKIN TEHSIL,62,224,0,224
SOUTH WAZIRISTAN AGENCY,MAKIN TEHSIL,63,204,0,204
SOUTH WAZIRISTAN AGENCY,MAKIN TEHSIL,64,182,0,182
SOUTH WAZIRISTAN AGENCY,MAKIN TEHSIL,65,115,0,115
SOUTH WAZIRISTAN AGENCY,MAKIN TEHSIL,66,151,0,151
SOUTH WAZIRISTAN AGENCY,MAKIN TEHSIL,67,212,0,212
SOUTH WAZIRISTAN AGENCY,MAKIN TEHSIL,68,111,0,111
SOUTH WAZIRISTAN AGENCY,MAKIN TEHSIL,69,130,0,130
SOUTH WAZIRISTAN AGENCY,MAKIN TEHSIL,70,87,0,87
SOUTH WAZIRISTAN AGENCY,MAKIN TEHSIL,71,94,0,94
SOUTH WAZIRISTAN AGENCY,MAKIN TEHSIL,72,107,0,107
SOUTH WAZIRISTAN AGENCY,MAKIN TEHSIL,73,77,0,77
SOUTH WAZIRISTAN AGENCY,MAKIN TEHSIL,74,53,0,53
SOUTH WAZIRISTAN AGENCY,MAKIN TEHSIL,>=75,472,0,472
SOUTH WAZIRISTAN AGENCY,SARAROGHA TEHSIL,<1,2925,0,2925
SOUTH WAZIRISTAN AGENCY,SARAROGHA TEHSIL,1,3270,0,3270
SOUTH WAZIRISTAN AGENCY,SARAROGHA TEHSIL,2,3769,0,3769
SOUTH WAZIRISTAN AGENCY,SARAROGHA TEHSIL,3,3844,0,3844
SOUTH WAZIRISTAN AGENCY,SARAROGHA TEHSIL,4,3925,0,3925
SOUTH WAZIRISTAN AGENCY,SARAROGHA TEHSIL,5,3672,0,3672
SOUTH WAZIRISTAN AGENCY,SARAROGHA TEHSIL,6,3621,0,3621
SOUTH WAZIRISTAN AGENCY,SARAROGHA TEHSIL,7,3303,0,3303
SOUTH WAZIRISTAN AGENCY,SARAROGHA TEHSIL,8,3588,0,3588
SOUTH WAZIRISTAN AGENCY,SARAROGHA TEHSIL,9,3299,0,3299
SOUTH WAZIRISTAN AGENCY,SARAROGHA TEHSIL,10,3072,0,3072
SOUTH WAZIRISTAN AGENCY,SARAROGHA TEHSIL,11,2773,0,2773
SOUTH WAZIRISTAN AGENCY,SARAROGHA TEHSIL,12,2564,0,2564
SOUTH WAZIRISTAN AGENCY,SARAROGHA TEHSIL,13,2400,0,2400
SOUTH WAZIRISTAN AGENCY,SARAROGHA TEHSIL,14,2072,0,2072
SOUTH WAZIRISTAN AGENCY,SARAROGHA TEHSIL,15,1862,0,1862
SOUTH WAZIRISTAN AGENCY,SARAROGHA TEHSIL,16,1632,0,1632
SOUTH WAZIRISTAN AGENCY,SARAROGHA TEHSIL,17,1455,0,1455
SOUTH WAZIRISTAN AGENCY,SARAROGHA TEHSIL,18,1676,0,1676
SOUTH WAZIRISTAN AGENCY,SARAROGHA TEHSIL,19,1977,0,1977
SOUTH WAZIRISTAN AGENCY,SARAROGHA TEHSIL,20,1543,0,1543
SOUTH WAZIRISTAN AGENCY,SARAROGHA TEHSIL,21,1785,0,1785
SOUTH WAZIRISTAN AGENCY,SARAROGHA TEHSIL,22,1426,0,1426
SOUTH WAZIRISTAN AGENCY,SARAROGHA TEHSIL,23,1615,0,1615
SOUTH WAZIRISTAN AGENCY,SARAROGHA TEHSIL,24,1426,0,1426
SOUTH WAZIRISTAN AGENCY,SARAROGHA TEHSIL,25,1338,0,1338
SOUTH WAZIRISTAN AGENCY,SARAROGHA TEHSIL,26,1482,0,1482
SOUTH WAZIRISTAN AGENCY,SARAROGHA TEHSIL,27,1898,0,1898
SOUTH WAZIRISTAN AGENCY,SARAROGHA TEHSIL,28,1310,0,1310
SOUTH WAZIRISTAN AGENCY,SARAROGHA TEHSIL,29,1403,0,1403
SOUTH WAZIRISTAN AGENCY,SARAROGHA TEHSIL,30,1095,0,1095
SOUTH WAZIRISTAN AGENCY,SARAROGHA TEHSIL,31,1390,0,1390
SOUTH WAZIRISTAN AGENCY,SARAROGHA TEHSIL,32,1234,0,1234
SOUTH WAZIRISTAN AGENCY,SARAROGHA TEHSIL,33,1035,0,1035
SOUTH WAZIRISTAN AGENCY,SARAROGHA TEHSIL,34,1060,0,1060
SOUTH WAZIRISTAN AGENCY,SARAROGHA TEHSIL,35,819,0,819
SOUTH WAZIRISTAN AGENCY,SARAROGHA TEHSIL,36,952,0,952
SOUTH WAZIRISTAN AGENCY,SARAROGHA TEHSIL,37,1060,0,1060
SOUTH WAZIRISTAN AGENCY,SARAROGHA TEHSIL,38,840,0,840
SOUTH WAZIRISTAN AGENCY,SARAROGHA TEHSIL,39,903,0,903
SOUTH WAZIRISTAN AGENCY,SARAROGHA TEHSIL,40,706,0,706
SOUTH WAZIRISTAN AGENCY,SARAROGHA TEHSIL,41,779,0,779
SOUTH WAZIRISTAN AGENCY,SARAROGHA TEHSIL,42,785,0,785
SOUTH WAZIRISTAN AGENCY,SARAROGHA TEHSIL,43,587,0,587
SOUTH WAZIRISTAN AGENCY,SARAROGHA TEHSIL,44,573,0,573
SOUTH WAZIRISTAN AGENCY,SARAROGHA TEHSIL,45,469,0,469
SOUTH WAZIRISTAN AGENCY,SARAROGHA TEHSIL,46,645,0,645
SOUTH WAZIRISTAN AGENCY,SARAROGHA TEHSIL,47,757,0,757
SOUTH WAZIRISTAN AGENCY,SARAROGHA TEHSIL,48,500,0,500
SOUTH WAZIRISTAN AGENCY,SARAROGHA TEHSIL,49,503,0,503
SOUTH WAZIRISTAN AGENCY,SARAROGHA TEHSIL,50,459,0,459
SOUTH WAZIRISTAN AGENCY,SARAROGHA TEHSIL,51,566,0,566
SOUTH WAZIRISTAN AGENCY,SARAROGHA TEHSIL,52,612,0,612
SOUTH WAZIRISTAN AGENCY,SARAROGHA TEHSIL,53,447,0,447
SOUTH WAZIRISTAN AGENCY,SARAROGHA TEHSIL,54,410,0,410
SOUTH WAZIRISTAN AGENCY,SARAROGHA TEHSIL,55,395,0,395
SOUTH WAZIRISTAN AGENCY,SARAROGHA TEHSIL,56,443,0,443
SOUTH WAZIRISTAN AGENCY,SARAROGHA TEHSIL,57,584,0,584
SOUTH WAZIRISTAN AGENCY,SARAROGHA TEHSIL,58,341,0,341
SOUTH WAZIRISTAN AGENCY,SARAROGHA TEHSIL,59,376,0,376
SOUTH WAZIRISTAN AGENCY,SARAROGHA TEHSIL,60,314,0,314
SOUTH WAZIRISTAN AGENCY,SARAROGHA TEHSIL,61,462,0,462
SOUTH WAZIRISTAN AGENCY,SARAROGHA TEHSIL,62,422,0,422
SOUTH WAZIRISTAN AGENCY,SARAROGHA TEHSIL,63,346,0,346
SOUTH WAZIRISTAN AGENCY,SARAROGHA TEHSIL,64,302,0,302
SOUTH WAZIRISTAN AGENCY,SARAROGHA TEHSIL,65,218,0,218
SOUTH WAZIRISTAN AGENCY,SARAROGHA TEHSIL,66,319,0,319
SOUTH WAZIRISTAN AGENCY,SARAROGHA TEHSIL,67,415,0,415
SOUTH WAZIRISTAN AGENCY,SARAROGHA TEHSIL,68,220,0,220
SOUTH WAZIRISTAN AGENCY,SARAROGHA TEHSIL,69,232,0,232
SOUTH WAZIRISTAN AGENCY,SARAROGHA TEHSIL,70,130,0,130
SOUTH WAZIRISTAN AGENCY,SARAROGHA TEHSIL,71,196,0,196
SOUTH WAZIRISTAN AGENCY,SARAROGHA TEHSIL,72,199,0,199
SOUTH WAZIRISTAN AGENCY,SARAROGHA TEHSIL,73,147,0,147
SOUTH WAZIRISTAN AGENCY,SARAROGHA TEHSIL,74,127,0,127
SOUTH WAZIRISTAN AGENCY,SARAROGHA TEHSIL,>=75,881,0,881
SOUTH WAZIRISTAN AGENCY,SERWEKAI TEHSIL,<1,1416,0,1416
SOUTH WAZIRISTAN AGENCY,SERWEKAI TEHSIL,1,1926,0,1926
SOUTH WAZIRISTAN AGENCY,SERWEKAI TEHSIL,2,2319,0,2319
SOUTH WAZIRISTAN AGENCY,SERWEKAI TEHSIL,3,2221,0,2221
SOUTH WAZIRISTAN AGENCY,SERWEKAI TEHSIL,4,2253,0,2253
SOUTH WAZIRISTAN AGENCY,SERWEKAI TEHSIL,5,2136,0,2136
SOUTH WAZIRISTAN AGENCY,SERWEKAI TEHSIL,6,2139,0,2139
SOUTH WAZIRISTAN AGENCY,SERWEKAI TEHSIL,7,1988,0,1988
SOUTH WAZIRISTAN AGENCY,SERWEKAI TEHSIL,8,1963,0,1963
SOUTH WAZIRISTAN AGENCY,SERWEKAI TEHSIL,9,1937,0,1937
SOUTH WAZIRISTAN AGENCY,SERWEKAI TEHSIL,10,1682,0,1682
SOUTH WAZIRISTAN AGENCY,SERWEKAI TEHSIL,11,1540,0,1540
SOUTH WAZIRISTAN AGENCY,SERWEKAI TEHSIL,12,1504,0,1504
SOUTH WAZIRISTAN AGENCY,SERWEKAI TEHSIL,13,1282,0,1282
SOUTH WAZIRISTAN AGENCY,SERWEKAI TEHSIL,14,1135,0,1135
SOUTH WAZIRISTAN AGENCY,SERWEKAI TEHSIL,15,1058,0,1058
SOUTH WAZIRISTAN AGENCY,SERWEKAI TEHSIL,16,823,0,823
SOUTH WAZIRISTAN AGENCY,SERWEKAI TEHSIL,17,742,0,742
SOUTH WAZIRISTAN AGENCY,SERWEKAI TEHSIL,18,883,0,883
SOUTH WAZIRISTAN AGENCY,SERWEKAI TEHSIL,19,978,0,978
SOUTH WAZIRISTAN AGENCY,SERWEKAI TEHSIL,20,853,0,853
SOUTH WAZIRISTAN AGENCY,SERWEKAI TEHSIL,21,846,0,846
SOUTH WAZIRISTAN AGENCY,SERWEKAI TEHSIL,22,693,0,693
SOUTH WAZIRISTAN AGENCY,SERWEKAI TEHSIL,23,894,0,894
SOUTH WAZIRISTAN AGENCY,SERWEKAI TEHSIL,24,756,0,756
SOUTH WAZIRISTAN AGENCY,SERWEKAI TEHSIL,25,676,0,676
SOUTH WAZIRISTAN AGENCY,SERWEKAI TEHSIL,26,861,0,861
SOUTH WAZIRISTAN AGENCY,SERWEKAI TEHSIL,27,961,0,961
SOUTH WAZIRISTAN AGENCY,SERWEKAI TEHSIL,28,748,0,748
SOUTH WAZIRISTAN AGENCY,SERWEKAI TEHSIL,29,751,0,751
SOUTH WAZIRISTAN AGENCY,SERWEKAI TEHSIL,30,667,0,667
SOUTH WAZIRISTAN AGENCY,SERWEKAI TEHSIL,31,770,0,770
SOUTH WAZIRISTAN AGENCY,SERWEKAI TEHSIL,32,625,0,625
SOUTH WAZIRISTAN AGENCY,SERWEKAI TEHSIL,33,640,0,640
SOUTH WAZIRISTAN AGENCY,SERWEKAI TEHSIL,34,654,0,654
SOUTH WAZIRISTAN AGENCY,SERWEKAI TEHSIL,35,497,0,497
SOUTH WAZIRISTAN AGENCY,SERWEKAI TEHSIL,36,511,0,511
SOUTH WAZIRISTAN AGENCY,SERWEKAI TEHSIL,37,625,0,625
SOUTH WAZIRISTAN AGENCY,SERWEKAI TEHSIL,38,489,0,489
SOUTH WAZIRISTAN AGENCY,SERWEKAI TEHSIL,39,468,0,468
SOUTH WAZIRISTAN AGENCY,SERWEKAI TEHSIL,40,477,0,477
SOUTH WAZIRISTAN AGENCY,SERWEKAI TEHSIL,41,462,0,462
SOUTH WAZIRISTAN AGENCY,SERWEKAI TEHSIL,42,399,0,399
SOUTH WAZIRISTAN AGENCY,SERWEKAI TEHSIL,43,451,0,451
SOUTH WAZIRISTAN AGENCY,SERWEKAI TEHSIL,44,330,0,330
SOUTH WAZIRISTAN AGENCY,SERWEKAI TEHSIL,45,340,0,340
SOUTH WAZIRISTAN AGENCY,SERWEKAI TEHSIL,46,326,0,326
SOUTH WAZIRISTAN AGENCY,SERWEKAI TEHSIL,47,390,0,390
SOUTH WAZIRISTAN AGENCY,SERWEKAI TEHSIL,48,283,0,283
SOUTH WAZIRISTAN AGENCY,SERWEKAI TEHSIL,49,247,0,247
SOUTH WAZIRISTAN AGENCY,SERWEKAI TEHSIL,50,279,0,279
SOUTH WAZIRISTAN AGENCY,SERWEKAI TEHSIL,51,300,0,300
SOUTH WAZIRISTAN AGENCY,SERWEKAI TEHSIL,52,271,0,271
SOUTH WAZIRISTAN AGENCY,SERWEKAI TEHSIL,53,251,0,251
SOUTH WAZIRISTAN AGENCY,SERWEKAI TEHSIL,54,239,0,239
SOUTH WAZIRISTAN AGENCY,SERWEKAI TEHSIL,55,199,0,199
SOUTH WAZIRISTAN AGENCY,SERWEKAI TEHSIL,56,227,0,227
SOUTH WAZIRISTAN AGENCY,SERWEKAI TEHSIL,57,232,0,232
SOUTH WAZIRISTAN AGENCY,SERWEKAI TEHSIL,58,233,0,233
SOUTH WAZIRISTAN AGENCY,SERWEKAI TEHSIL,59,203,0,203
SOUTH WAZIRISTAN AGENCY,SERWEKAI TEHSIL,60,180,0,180
SOUTH WAZIRISTAN AGENCY,SERWEKAI TEHSIL,61,197,0,197
SOUTH WAZIRISTAN AGENCY,SERWEKAI TEHSIL,62,237,0,237
SOUTH WAZIRISTAN AGENCY,SERWEKAI TEHSIL,63,219,0,219
SOUTH WAZIRISTAN AGENCY,SERWEKAI TEHSIL,64,161,0,161
SOUTH WAZIRISTAN AGENCY,SERWEKAI TEHSIL,65,151,0,151
SOUTH WAZIRISTAN AGENCY,SERWEKAI TEHSIL,66,150,0,150
SOUTH WAZIRISTAN AGENCY,SERWEKAI TEHSIL,67,183,0,183
SOUTH WAZIRISTAN AGENCY,SERWEKAI TEHSIL,68,108,0,108
SOUTH WAZIRISTAN AGENCY,SERWEKAI TEHSIL,69,114,0,114
SOUTH WAZIRISTAN AGENCY,SERWEKAI TEHSIL,70,88,0,88
SOUTH WAZIRISTAN AGENCY,SERWEKAI TEHSIL,71,97,0,97
SOUTH WAZIRISTAN AGENCY,SERWEKAI TEHSIL,72,85,0,85
SOUTH WAZIRISTAN AGENCY,SERWEKAI TEHSIL,73,77,0,77
SOUTH WAZIRISTAN AGENCY,SERWEKAI TEHSIL,74,52,0,52
SOUTH WAZIRISTAN AGENCY,SERWEKAI TEHSIL,>=75,392,0,392
SOUTH WAZIRISTAN AGENCY,TIARZA TEHSIL,<1,1290,0,1290
SOUTH WAZIRISTAN AGENCY,TIARZA TEHSIL,1,1490,0,1490
SOUTH WAZIRISTAN AGENCY,TIARZA TEHSIL,2,1699,0,1699
SOUTH WAZIRISTAN AGENCY,TIARZA TEHSIL,3,1658,0,1658
SOUTH WAZIRISTAN AGENCY,TIARZA TEHSIL,4,1746,0,1746
SOUTH WAZIRISTAN AGENCY,TIARZA TEHSIL,5,1631,0,1631
SOUTH WAZIRISTAN AGENCY,TIARZA TEHSIL,6,1752,0,1752
SOUTH WAZIRISTAN AGENCY,TIARZA TEHSIL,7,1535,0,1535
SOUTH WAZIRISTAN AGENCY,TIARZA TEHSIL,8,1767,0,1767
SOUTH WAZIRISTAN AGENCY,TIARZA TEHSIL,9,1559,0,1559
SOUTH WAZIRISTAN AGENCY,TIARZA TEHSIL,10,1527,0,1527
SOUTH WAZIRISTAN AGENCY,TIARZA TEHSIL,11,1247,0,1247
SOUTH WAZIRISTAN AGENCY,TIARZA TEHSIL,12,1282,0,1282
SOUTH WAZIRISTAN AGENCY,TIARZA TEHSIL,13,1126,0,1126
SOUTH WAZIRISTAN AGENCY,TIARZA TEHSIL,14,992,0,992
SOUTH WAZIRISTAN AGENCY,TIARZA TEHSIL,15,806,0,806
SOUTH WAZIRISTAN AGENCY,TIARZA TEHSIL,16,635,0,635
SOUTH WAZIRISTAN AGENCY,TIARZA TEHSIL,17,587,0,587
SOUTH WAZIRISTAN AGENCY,TIARZA TEHSIL,18,757,0,757
SOUTH WAZIRISTAN AGENCY,TIARZA TEHSIL,19,834,0,834
SOUTH WAZIRISTAN AGENCY,TIARZA TEHSIL,20,739,0,739
SOUTH WAZIRISTAN AGENCY,TIARZA TEHSIL,21,846,0,846
SOUTH WAZIRISTAN AGENCY,TIARZA TEHSIL,22,700,0,700
SOUTH WAZIRISTAN AGENCY,TIARZA TEHSIL,23,742,0,742
SOUTH WAZIRISTAN AGENCY,TIARZA TEHSIL,24,704,0,704
SOUTH WAZIRISTAN AGENCY,TIARZA TEHSIL,25,711,0,711
SOUTH WAZIRISTAN AGENCY,TIARZA TEHSIL,26,680,0,680
SOUTH WAZIRISTAN AGENCY,TIARZA TEHSIL,27,724,0,724
SOUTH WAZIRISTAN AGENCY,TIARZA TEHSIL,28,633,0,633
SOUTH WAZIRISTAN AGENCY,TIARZA TEHSIL,29,573,0,573
SOUTH WAZIRISTAN AGENCY,TIARZA TEHSIL,30,550,0,550
SOUTH WAZIRISTAN AGENCY,TIARZA TEHSIL,31,602,0,602
SOUTH WAZIRISTAN AGENCY,TIARZA TEHSIL,32,519,0,519
SOUTH WAZIRISTAN AGENCY,TIARZA TEHSIL,33,547,0,547
SOUTH WAZIRISTAN AGENCY,TIARZA TEHSIL,34,489,0,489
SOUTH WAZIRISTAN AGENCY,TIARZA TEHSIL,35,416,0,416
SOUTH WAZIRISTAN AGENCY,TIARZA TEHSIL,36,458,0,458
SOUTH WAZIRISTAN AGENCY,TIARZA TEHSIL,37,497,0,497
SOUTH WAZIRISTAN AGENCY,TIARZA TEHSIL,38,366,0,366
SOUTH WAZIRISTAN AGENCY,TIARZA TEHSIL,39,404,0,404
SOUTH WAZIRISTAN AGENCY,TIARZA TEHSIL,40,385,0,385
SOUTH WAZIRISTAN AGENCY,TIARZA TEHSIL,41,433,0,433
SOUTH WAZIRISTAN AGENCY,TIARZA TEHSIL,42,313,0,313
SOUTH WAZIRISTAN AGENCY,TIARZA TEHSIL,43,303,0,303
SOUTH WAZIRISTAN AGENCY,TIARZA TEHSIL,44,268,0,268
SOUTH WAZIRISTAN AGENCY,TIARZA TEHSIL,45,211,0,211
SOUTH WAZIRISTAN AGENCY,TIARZA TEHSIL,46,271,0,271
SOUTH WAZIRISTAN AGENCY,TIARZA TEHSIL,47,283,0,283
SOUTH WAZIRISTAN AGENCY,TIARZA TEHSIL,48,215,0,215
SOUTH WAZIRISTAN AGENCY,TIARZA TEHSIL,49,214,0,214
SOUTH WAZIRISTAN AGENCY,TIARZA TEHSIL,50,228,0,228
SOUTH WAZIRISTAN AGENCY,TIARZA TEHSIL,51,229,0,229
SOUTH WAZIRISTAN AGENCY,TIARZA TEHSIL,52,215,0,215
SOUTH WAZIRISTAN AGENCY,TIARZA TEHSIL,53,203,0,203
SOUTH WAZIRISTAN AGENCY,TIARZA TEHSIL,54,184,0,184
SOUTH WAZIRISTAN AGENCY,TIARZA TEHSIL,55,200,0,200
SOUTH WAZIRISTAN AGENCY,TIARZA TEHSIL,56,212,0,212
SOUTH WAZIRISTAN AGENCY,TIARZA TEHSIL,57,298,0,298
SOUTH WAZIRISTAN AGENCY,TIARZA TEHSIL,58,164,0,164
SOUTH WAZIRISTAN AGENCY,TIARZA TEHSIL,59,144,0,144
SOUTH WAZIRISTAN AGENCY,TIARZA TEHSIL,60,217,0,217
SOUTH WAZIRISTAN AGENCY,TIARZA TEHSIL,61,204,0,204
SOUTH WAZIRISTAN AGENCY,TIARZA TEHSIL,62,212,0,212
SOUTH WAZIRISTAN AGENCY,TIARZA TEHSIL,63,183,0,183
SOUTH WAZIRISTAN AGENCY,TIARZA TEHSIL,64,155,0,155
SOUTH WAZIRISTAN AGENCY,TIARZA TEHSIL,65,133,0,133
SOUTH WAZIRISTAN AGENCY,TIARZA TEHSIL,66,155,0,155
SOUTH WAZIRISTAN AGENCY,TIARZA TEHSIL,67,169,0,169
SOUTH WAZIRISTAN AGENCY,TIARZA TEHSIL,68,118,0,118
SOUTH WAZIRISTAN AGENCY,TIARZA TEHSIL,69,96,0,96
SOUTH WAZIRISTAN AGENCY,TIARZA TEHSIL,70,69,0,69
SOUTH WAZIRISTAN AGENCY,TIARZA TEHSIL,71,81,0,81
SOUTH WAZIRISTAN AGENCY,TIARZA TEHSIL,72,80,0,80
SOUTH WAZIRISTAN AGENCY,TIARZA TEHSIL,73,58,0,58
SOUTH WAZIRISTAN AGENCY,TIARZA TEHSIL,74,55,0,55
SOUTH WAZIRISTAN AGENCY,TIARZA TEHSIL,>=75,378,0,378
SOUTH WAZIRISTAN AGENCY,TOI KHULLA TEHSIL,<1,1157,0,1157
SOUTH WAZIRISTAN AGENCY,TOI KHULLA TEHSIL,1,1795,0,1795
SOUTH WAZIRISTAN AGENCY,TOI KHULLA TEHSIL,2,1984,0,1984
SOUTH WAZIRISTAN AGENCY,TOI KHULLA TEHSIL,3,1970,0,1970
SOUTH WAZIRISTAN AGENCY,TOI KHULLA TEHSIL,4,2037,0,2037
SOUTH WAZIRISTAN AGENCY,TOI KHULLA TEHSIL,5,1892,0,1892
SOUTH WAZIRISTAN AGENCY,TOI KHULLA TEHSIL,6,2045,0,2045
SOUTH WAZIRISTAN AGENCY,TOI KHULLA TEHSIL,7,1857,0,1857
SOUTH WAZIRISTAN AGENCY,TOI KHULLA TEHSIL,8,1941,0,1941
SOUTH WAZIRISTAN AGENCY,TOI KHULLA TEHSIL,9,1699,0,1699
SOUTH WAZIRISTAN AGENCY,TOI KHULLA TEHSIL,10,1758,0,1758
SOUTH WAZIRISTAN AGENCY,TOI KHULLA TEHSIL,11,1393,0,1393
SOUTH WAZIRISTAN AGENCY,TOI KHULLA TEHSIL,12,1417,0,1417
SOUTH WAZIRISTAN AGENCY,TOI KHULLA TEHSIL,13,1209,0,1209
SOUTH WAZIRISTAN AGENCY,TOI KHULLA TEHSIL,14,1078,0,1078
SOUTH WAZIRISTAN AGENCY,TOI KHULLA TEHSIL,15,1125,0,1125
SOUTH WAZIRISTAN AGENCY,TOI KHULLA TEHSIL,16,1022,0,1022
SOUTH WAZIRISTAN AGENCY,TOI KHULLA TEHSIL,17,795,0,795
SOUTH WAZIRISTAN AGENCY,TOI KHULLA TEHSIL,18,1090,0,1090
SOUTH WAZIRISTAN AGENCY,TOI KHULLA TEHSIL,19,828,0,828
SOUTH WAZIRISTAN AGENCY,TOI KHULLA TEHSIL,20,1202,0,1202
SOUTH WAZIRISTAN AGENCY,TOI KHULLA TEHSIL,21,887,0,887
SOUTH WAZIRISTAN AGENCY,TOI KHULLA TEHSIL,22,742,0,742
SOUTH WAZIRISTAN AGENCY,TOI KHULLA TEHSIL,23,717,0,717
SOUTH WAZIRISTAN AGENCY,TOI KHULLA TEHSIL,24,604,0,604
SOUTH WAZIRISTAN AGENCY,TOI KHULLA TEHSIL,25,952,0,952
SOUTH WAZIRISTAN AGENCY,TOI KHULLA TEHSIL,26,545,0,545
SOUTH WAZIRISTAN AGENCY,TOI KHULLA TEHSIL,27,735,0,735
SOUTH WAZIRISTAN AGENCY,TOI KHULLA TEHSIL,28,596,0,596
SOUTH WAZIRISTAN AGENCY,TOI KHULLA TEHSIL,29,609,0,609
SOUTH WAZIRISTAN AGENCY,TOI KHULLA TEHSIL,30,771,0,771
SOUTH WAZIRISTAN AGENCY,TOI KHULLA TEHSIL,31,581,0,581
SOUTH WAZIRISTAN AGENCY,TOI KHULLA TEHSIL,32,436,0,436
SOUTH WAZIRISTAN AGENCY,TOI KHULLA TEHSIL,33,545,0,545
SOUTH WAZIRISTAN AGENCY,TOI KHULLA TEHSIL,34,395,0,395
SOUTH WAZIRISTAN AGENCY,TOI KHULLA TEHSIL,35,595,0,595
SOUTH WAZIRISTAN AGENCY,TOI KHULLA TEHSIL,36,345,0,345
SOUTH WAZIRISTAN AGENCY,TOI KHULLA TEHSIL,37,486,0,486
SOUTH WAZIRISTAN AGENCY,TOI KHULLA TEHSIL,38,459,0,459
SOUTH WAZIRISTAN AGENCY,TOI KHULLA TEHSIL,39,441,0,441
SOUTH WAZIRISTAN AGENCY,TOI KHULLA TEHSIL,40,612,0,612
SOUTH WAZIRISTAN AGENCY,TOI KHULLA TEHSIL,41,434,0,434
SOUTH WAZIRISTAN AGENCY,TOI KHULLA TEHSIL,42,284,0,284
SOUTH WAZIRISTAN AGENCY,TOI KHULLA TEHSIL,43,385,0,385
SOUTH WAZIRISTAN AGENCY,TOI KHULLA TEHSIL,44,329,0,329
SOUTH WAZIRISTAN AGENCY,TOI KHULLA TEHSIL,45,365,0,365
SOUTH WAZIRISTAN AGENCY,TOI KHULLA TEHSIL,46,204,0,204
SOUTH WAZIRISTAN AGENCY,TOI KHULLA TEHSIL,47,306,0,306
SOUTH WAZIRISTAN AGENCY,TOI KHULLA TEHSIL,48,250,0,250
SOUTH WAZIRISTAN AGENCY,TOI KHULLA TEHSIL,49,289,0,289
SOUTH WAZIRISTAN AGENCY,TOI KHULLA TEHSIL,50,380,0,380
SOUTH WAZIRISTAN AGENCY,TOI KHULLA TEHSIL,51,252,0,252
SOUTH WAZIRISTAN AGENCY,TOI KHULLA TEHSIL,52,217,0,217
SOUTH WAZIRISTAN AGENCY,TOI KHULLA TEHSIL,53,239,0,239
SOUTH WAZIRISTAN AGENCY,TOI KHULLA TEHSIL,54,238,0,238
SOUTH WAZIRISTAN AGENCY,TOI KHULLA TEHSIL,55,222,0,222
SOUTH WAZIRISTAN AGENCY,TOI KHULLA TEHSIL,56,158,0,158
SOUTH WAZIRISTAN AGENCY,TOI KHULLA TEHSIL,57,241,0,241
SOUTH WAZIRISTAN AGENCY,TOI KHULLA TEHSIL,58,128,0,128
SOUTH WAZIRISTAN AGENCY,TOI KHULLA TEHSIL,59,142,0,142
SOUTH WAZIRISTAN AGENCY,TOI KHULLA TEHSIL,60,219,0,219
SOUTH WAZIRISTAN AGENCY,TOI KHULLA TEHSIL,61,117,0,117
SOUTH WAZIRISTAN AGENCY,TOI KHULLA TEHSIL,62,139,0,139
SOUTH WAZIRISTAN AGENCY,TOI KHULLA TEHSIL,63,128,0,128
SOUTH WAZIRISTAN AGENCY,TOI KHULLA TEHSIL,64,116,0,116
SOUTH WAZIRISTAN AGENCY,TOI KHULLA TEHSIL,65,121,0,121
SOUTH WAZIRISTAN AGENCY,TOI KHULLA TEHSIL,66,96,0,96
SOUTH WAZIRISTAN AGENCY,TOI KHULLA TEHSIL,67,128,0,128
SOUTH WAZIRISTAN AGENCY,TOI KHULLA TEHSIL,68,75,0,75
SOUTH WAZIRISTAN AGENCY,TOI KHULLA TEHSIL,69,81,0,81
SOUTH WAZIRISTAN AGENCY,TOI KHULLA TEHSIL,70,95,0,95
SOUTH WAZIRISTAN AGENCY,TOI KHULLA TEHSIL,71,57,0,57
SOUTH WAZIRISTAN AGENCY,TOI KHULLA TEHSIL,72,59,0,59
SOUTH WAZIRISTAN AGENCY,TOI KHULLA TEHSIL,73,62,0,62
SOUTH WAZIRISTAN AGENCY,TOI KHULLA TEHSIL,74,43,0,43
SOUTH WAZIRISTAN AGENCY,TOI KHULLA TEHSIL,>=75,467,0,467
SOUTH WAZIRISTAN AGENCY,WANA TEHSIL,<1,3558,0,3558
SOUTH WAZIRISTAN AGENCY,WANA TEHSIL,1,4731,0,4731
SOUTH WAZIRISTAN AGENCY,WANA TEHSIL,2,5942,0,5942
SOUTH WAZIRISTAN AGENCY,WANA TEHSIL,3,6128,0,6128
SOUTH WAZIRISTAN AGENCY,WANA TEHSIL,4,6140,0,6140
SOUTH WAZIRISTAN AGENCY,WANA TEHSIL,5,6036,0,6036
SOUTH WAZIRISTAN AGENCY,WANA TEHSIL,6,6036,0,6036
SOUTH WAZIRISTAN AGENCY,WANA TEHSIL,7,5513,0,5513
SOUTH WAZIRISTAN AGENCY,WANA TEHSIL,8,5940,0,5940
SOUTH WAZIRISTAN AGENCY,WANA TEHSIL,9,5171,0,5171
SOUTH WAZIRISTAN AGENCY,WANA TEHSIL,10,5008,0,5008
SOUTH WAZIRISTAN AGENCY,WANA TEHSIL,11,4189,0,4189
SOUTH WAZIRISTAN AGENCY,WANA TEHSIL,12,4377,0,4377
SOUTH WAZIRISTAN AGENCY,WANA TEHSIL,13,3875,0,3875
SOUTH WAZIRISTAN AGENCY,WANA TEHSIL,14,3695,0,3695
SOUTH WAZIRISTAN AGENCY,WANA TEHSIL,15,3939,0,3939
SOUTH WAZIRISTAN AGENCY,WANA TEHSIL,16,3240,0,3240
SOUTH WAZIRISTAN AGENCY,WANA TEHSIL,17,2596,0,2596
SOUTH WAZIRISTAN AGENCY,WANA TEHSIL,18,3472,0,3472
SOUTH WAZIRISTAN AGENCY,WANA TEHSIL,19,2661,0,2661
SOUTH WAZIRISTAN AGENCY,WANA TEHSIL,20,3251,0,3251
SOUTH WAZIRISTAN AGENCY,WANA TEHSIL,21,2645,0,2645
SOUTH WAZIRISTAN AGENCY,WANA TEHSIL,22,2541,0,2541
SOUTH WAZIRISTAN AGENCY,WANA TEHSIL,23,2343,0,2343
SOUTH WAZIRISTAN AGENCY,WANA TEHSIL,24,1994,0,1994
SOUTH WAZIRISTAN AGENCY,WANA TEHSIL,25,2874,0,2874
SOUTH WAZIRISTAN AGENCY,WANA TEHSIL,26,2068,0,2068
SOUTH WAZIRISTAN AGENCY,WANA TEHSIL,27,1922,0,1922
SOUTH WAZIRISTAN AGENCY,WANA TEHSIL,28,2259,0,2259
SOUTH WAZIRISTAN AGENCY,WANA TEHSIL,29,1673,0,1673
SOUTH WAZIRISTAN AGENCY,WANA TEHSIL,30,2554,0,2554
SOUTH WAZIRISTAN AGENCY,WANA TEHSIL,31,1640,0,1640
SOUTH WAZIRISTAN AGENCY,WANA TEHSIL,32,1397,0,1397
SOUTH WAZIRISTAN AGENCY,WANA TEHSIL,33,1734,0,1734
SOUTH WAZIRISTAN AGENCY,WANA TEHSIL,34,1300,0,1300
SOUTH WAZIRISTAN AGENCY,WANA TEHSIL,35,1732,0,1732
SOUTH WAZIRISTAN AGENCY,WANA TEHSIL,36,1195,0,1195
SOUTH WAZIRISTAN AGENCY,WANA TEHSIL,37,1072,0,1072
SOUTH WAZIRISTAN AGENCY,WANA TEHSIL,38,1528,0,1528
SOUTH WAZIRISTAN AGENCY,WANA TEHSIL,39,1104,0,1104
SOUTH WAZIRISTAN AGENCY,WANA TEHSIL,40,1957,0,1957
SOUTH WAZIRISTAN AGENCY,WANA TEHSIL,41,1166,0,1166
SOUTH WAZIRISTAN AGENCY,WANA TEHSIL,42,809,0,809
SOUTH WAZIRISTAN AGENCY,WANA TEHSIL,43,1037,0,1037
SOUTH WAZIRISTAN AGENCY,WANA TEHSIL,44,796,0,796
SOUTH WAZIRISTAN AGENCY,WANA TEHSIL,45,1105,0,1105
SOUTH WAZIRISTAN AGENCY,WANA TEHSIL,46,659,0,659
SOUTH WAZIRISTAN AGENCY,WANA TEHSIL,47,621,0,621
SOUTH WAZIRISTAN AGENCY,WANA TEHSIL,48,818,0,818
SOUTH WAZIRISTAN AGENCY,WANA TEHSIL,49,674,0,674
SOUTH WAZIRISTAN AGENCY,WANA TEHSIL,50,1238,0,1238
SOUTH WAZIRISTAN AGENCY,WANA TEHSIL,51,581,0,581
SOUTH WAZIRISTAN AGENCY,WANA TEHSIL,52,455,0,455
SOUTH WAZIRISTAN AGENCY,WANA TEHSIL,53,657,0,657
SOUTH WAZIRISTAN AGENCY,WANA TEHSIL,54,580,0,580
SOUTH WAZIRISTAN AGENCY,WANA TEHSIL,55,869,0,869
SOUTH WAZIRISTAN AGENCY,WANA TEHSIL,56,507,0,507
SOUTH WAZIRISTAN AGENCY,WANA TEHSIL,57,401,0,401
SOUTH WAZIRISTAN AGENCY,WANA TEHSIL,58,482,0,482
SOUTH WAZIRISTAN AGENCY,WANA TEHSIL,59,408,0,408
SOUTH WAZIRISTAN AGENCY,WANA TEHSIL,60,745,0,745
SOUTH WAZIRISTAN AGENCY,WANA TEHSIL,61,468,0,468
SOUTH WAZIRISTAN AGENCY,WANA TEHSIL,62,381,0,381
SOUTH WAZIRISTAN AGENCY,WANA TEHSIL,63,468,0,468
SOUTH WAZIRISTAN AGENCY,WANA TEHSIL,64,410,0,410
SOUTH WAZIRISTAN AGENCY,WANA TEHSIL,65,423,0,423
SOUTH WAZIRISTAN AGENCY,WANA TEHSIL,66,301,0,301
SOUTH WAZIRISTAN AGENCY,WANA TEHSIL,67,247,0,247
SOUTH WAZIRISTAN AGENCY,WANA TEHSIL,68,263,0,263
SOUTH WAZIRISTAN AGENCY,WANA TEHSIL,69,239,0,239
SOUTH WAZIRISTAN AGENCY,WANA TEHSIL,70,277,0,277
SOUTH WAZIRISTAN AGENCY,WANA TEHSIL,71,177,0,177
SOUTH WAZIRISTAN AGENCY,WANA TEHSIL,72,161,0,161
SOUTH WAZIRISTAN AGENCY,WANA TEHSIL,73,181,0,181
SOUTH WAZIRISTAN AGENCY,WANA TEHSIL,74,138,0,138
SOUTH WAZIRISTAN AGENCY,WANA TEHSIL,>=75,1384,0,1384
SUJAWAL DISTRICT,JATI TALUKA,<1,4529,154,4683
SUJAWAL DISTRICT,JATI TALUKA,1,4459,435,4894
SUJAWAL DISTRICT,JATI TALUKA,2,6743,374,7117
SUJAWAL DISTRICT,JATI TALUKA,3,6955,435,7390
SUJAWAL DISTRICT,JATI TALUKA,4,7603,388,7991
SUJAWAL DISTRICT,JATI TALUKA,5,7219,427,7646
SUJAWAL DISTRICT,JATI TALUKA,6,7621,398,8019
SUJAWAL DISTRICT,JATI TALUKA,7,5677,345,6022
SUJAWAL DISTRICT,JATI TALUKA,8,7877,350,8227
SUJAWAL DISTRICT,JATI TALUKA,9,4659,324,4983
SUJAWAL DISTRICT,JATI TALUKA,10,6956,287,7243
SUJAWAL DISTRICT,JATI TALUKA,11,3754,262,4016
SUJAWAL DISTRICT,JATI TALUKA,12,5250,277,5527
SUJAWAL DISTRICT,JATI TALUKA,13,3142,233,3375
SUJAWAL DISTRICT,JATI TALUKA,14,3630,228,3858
SUJAWAL DISTRICT,JATI TALUKA,15,3621,261,3882
SUJAWAL DISTRICT,JATI TALUKA,16,3771,251,4022
SUJAWAL DISTRICT,JATI TALUKA,17,2470,263,2733
SUJAWAL DISTRICT,JATI TALUKA,18,4390,291,4681
SUJAWAL DISTRICT,JATI TALUKA,19,2670,230,2900
SUJAWAL DISTRICT,JATI TALUKA,20,3990,254,4244
SUJAWAL DISTRICT,JATI TALUKA,21,2132,194,2326
SUJAWAL DISTRICT,JATI TALUKA,22,2859,225,3084
SUJAWAL DISTRICT,JATI TALUKA,23,2033,185,2218
SUJAWAL DISTRICT,JATI TALUKA,24,2018,164,2182
SUJAWAL DISTRICT,JATI TALUKA,25,3535,213,3748
SUJAWAL DISTRICT,JATI TALUKA,26,2229,154,2383
SUJAWAL DISTRICT,JATI TALUKA,27,2627,208,2835
SUJAWAL DISTRICT,JATI TALUKA,28,2584,196,2780
SUJAWAL DISTRICT,JATI TALUKA,29,2693,173,2866
SUJAWAL DISTRICT,JATI TALUKA,30,3065,199,3264
SUJAWAL DISTRICT,JATI TALUKA,31,2410,200,2610
SUJAWAL DISTRICT,JATI TALUKA,32,2561,177,2738
SUJAWAL DISTRICT,JATI TALUKA,33,2385,200,2585
SUJAWAL DISTRICT,JATI TALUKA,34,2003,144,2147
SUJAWAL DISTRICT,JATI TALUKA,35,2763,172,2935
SUJAWAL DISTRICT,JATI TALUKA,36,1949,135,2084
SUJAWAL DISTRICT,JATI TALUKA,37,2637,149,2786
SUJAWAL DISTRICT,JATI TALUKA,38,2003,145,2148
SUJAWAL DISTRICT,JATI TALUKA,39,2294,140,2434
SUJAWAL DISTRICT,JATI TALUKA,40,2340,152,2492
SUJAWAL DISTRICT,JATI TALUKA,41,1914,123,2037
SUJAWAL DISTRICT,JATI TALUKA,42,1808,111,1919
SUJAWAL DISTRICT,JATI TALUKA,43,1619,95,1714
SUJAWAL DISTRICT,JATI TALUKA,44,1572,103,1675
SUJAWAL DISTRICT,JATI TALUKA,45,1577,116,1693
SUJAWAL DISTRICT,JATI TALUKA,46,1413,89,1502
SUJAWAL DISTRICT,JATI TALUKA,47,1564,86,1650
SUJAWAL DISTRICT,JATI TALUKA,48,1232,102,1334
SUJAWAL DISTRICT,JATI TALUKA,49,1397,93,1490
SUJAWAL DISTRICT,JATI TALUKA,50,1427,76,1503
SUJAWAL DISTRICT,JATI TALUKA,51,1073,70,1143
SUJAWAL DISTRICT,JATI TALUKA,52,1039,74,1113
SUJAWAL DISTRICT,JATI TALUKA,53,857,64,921
SUJAWAL DISTRICT,JATI TALUKA,54,825,69,894
SUJAWAL DISTRICT,JATI TALUKA,55,921,67,988
SUJAWAL DISTRICT,JATI TALUKA,56,707,35,742
SUJAWAL DISTRICT,JATI TALUKA,57,866,54,920
SUJAWAL DISTRICT,JATI TALUKA,58,622,72,694
SUJAWAL DISTRICT,JATI TALUKA,59,795,41,836
SUJAWAL DISTRICT,JATI TALUKA,60,866,64,930
SUJAWAL DISTRICT,JATI TALUKA,61,681,47,728
SUJAWAL DISTRICT,JATI TALUKA,62,707,49,756
SUJAWAL DISTRICT,JATI TALUKA,63,654,40,694
SUJAWAL DISTRICT,JATI TALUKA,64,657,42,699
SUJAWAL DISTRICT,JATI TALUKA,65,680,45,725
SUJAWAL DISTRICT,JATI TALUKA,66,555,51,606
SUJAWAL DISTRICT,JATI TALUKA,67,518,22,540
SUJAWAL DISTRICT,JATI TALUKA,68,436,32,468
SUJAWAL DISTRICT,JATI TALUKA,69,495,25,520
SUJAWAL DISTRICT,JATI TALUKA,70,509,26,535
SUJAWAL DISTRICT,JATI TALUKA,71,422,21,443
SUJAWAL DISTRICT,JATI TALUKA,72,331,22,353
SUJAWAL DISTRICT,JATI TALUKA,73,306,28,334
SUJAWAL DISTRICT,JATI TALUKA,74,313,14,327
SUJAWAL DISTRICT,JATI TALUKA,>=75,2243,101,2344
SUJAWAL DISTRICT,KHARO CHAN TALUKA,<1,246,0,246
SUJAWAL DISTRICT,KHARO CHAN TALUKA,1,267,0,267
SUJAWAL DISTRICT,KHARO CHAN TALUKA,2,361,0,361
SUJAWAL DISTRICT,KHARO CHAN TALUKA,3,381,0,381
SUJAWAL DISTRICT,KHARO CHAN TALUKA,4,442,0,442
SUJAWAL DISTRICT,KHARO CHAN TALUKA,5,379,0,379
SUJAWAL DISTRICT,KHARO CHAN TALUKA,6,450,0,450
SUJAWAL DISTRICT,KHARO CHAN TALUKA,7,249,0,249
SUJAWAL DISTRICT,KHARO CHAN TALUKA,8,448,0,448
SUJAWAL DISTRICT,KHARO CHAN TALUKA,9,237,0,237
SUJAWAL DISTRICT,KHARO CHAN TALUKA,10,421,0,421
SUJAWAL DISTRICT,KHARO CHAN TALUKA,11,195,0,195
SUJAWAL DISTRICT,KHARO CHAN TALUKA,12,286,0,286
SUJAWAL DISTRICT,KHARO CHAN TALUKA,13,163,0,163
SUJAWAL DISTRICT,KHARO CHAN TALUKA,14,198,0,198
SUJAWAL DISTRICT,KHARO CHAN TALUKA,15,163,0,163
SUJAWAL DISTRICT,KHARO CHAN TALUKA,16,189,0,189
SUJAWAL DISTRICT,KHARO CHAN TALUKA,17,114,0,114
SUJAWAL DISTRICT,KHARO CHAN TALUKA,18,244,0,244
SUJAWAL DISTRICT,KHARO CHAN TALUKA,19,135,0,135
SUJAWAL DISTRICT,KHARO CHAN TALUKA,20,215,0,215
SUJAWAL DISTRICT,KHARO CHAN TALUKA,21,138,0,138
SUJAWAL DISTRICT,KHARO CHAN TALUKA,22,154,0,154
SUJAWAL DISTRICT,KHARO CHAN TALUKA,23,133,0,133
SUJAWAL DISTRICT,KHARO CHAN TALUKA,24,136,0,136
SUJAWAL DISTRICT,KHARO CHAN TALUKA,25,161,0,161
SUJAWAL DISTRICT,KHARO CHAN TALUKA,26,119,0,119
SUJAWAL DISTRICT,KHARO CHAN TALUKA,27,174,0,174
SUJAWAL DISTRICT,KHARO CHAN TALUKA,28,144,0,144
SUJAWAL DISTRICT,KHARO CHAN TALUKA,29,147,0,147
SUJAWAL DISTRICT,KHARO CHAN TALUKA,30,178,0,178
SUJAWAL DISTRICT,KHARO CHAN TALUKA,31,158,0,158
SUJAWAL DISTRICT,KHARO CHAN TALUKA,32,128,0,128
SUJAWAL DISTRICT,KHARO CHAN TALUKA,33,126,0,126
SUJAWAL DISTRICT,KHARO CHAN TALUKA,34,115,0,115
SUJAWAL DISTRICT,KHARO CHAN TALUKA,35,125,0,125
SUJAWAL DISTRICT,KHARO CHAN TALUKA,36,82,0,82
SUJAWAL DISTRICT,KHARO CHAN TALUKA,37,172,0,172
SUJAWAL DISTRICT,KHARO CHAN TALUKA,38,100,0,100
SUJAWAL DISTRICT,KHARO CHAN TALUKA,39,130,0,130
SUJAWAL DISTRICT,KHARO CHAN TALUKA,40,105,0,105
SUJAWAL DISTRICT,KHARO CHAN TALUKA,41,106,0,106
SUJAWAL DISTRICT,KHARO CHAN TALUKA,42,110,0,110
SUJAWAL DISTRICT,KHARO CHAN TALUKA,43,96,0,96
SUJAWAL DISTRICT,KHARO CHAN TALUKA,44,79,0,79
SUJAWAL DISTRICT,KHARO CHAN TALUKA,45,92,0,92
SUJAWAL DISTRICT,KHARO CHAN TALUKA,46,65,0,65
SUJAWAL DISTRICT,KHARO CHAN TALUKA,47,85,0,85
SUJAWAL DISTRICT,KHARO CHAN TALUKA,48,63,0,63
SUJAWAL DISTRICT,KHARO CHAN TALUKA,49,78,0,78
SUJAWAL DISTRICT,KHARO CHAN TALUKA,50,67,0,67
SUJAWAL DISTRICT,KHARO CHAN TALUKA,51,62,0,62
SUJAWAL DISTRICT,KHARO CHAN TALUKA,52,80,0,80
SUJAWAL DISTRICT,KHARO CHAN TALUKA,53,56,0,56
SUJAWAL DISTRICT,KHARO CHAN TALUKA,54,35,0,35
SUJAWAL DISTRICT,KHARO CHAN TALUKA,55,23,0,23
SUJAWAL DISTRICT,KHARO CHAN TALUKA,56,25,0,25
SUJAWAL DISTRICT,KHARO CHAN TALUKA,57,53,0,53
SUJAWAL DISTRICT,KHARO CHAN TALUKA,58,22,0,22
SUJAWAL DISTRICT,KHARO CHAN TALUKA,59,48,0,48
SUJAWAL DISTRICT,KHARO CHAN TALUKA,60,39,0,39
SUJAWAL DISTRICT,KHARO CHAN TALUKA,61,38,0,38
SUJAWAL DISTRICT,KHARO CHAN TALUKA,62,37,0,37
SUJAWAL DISTRICT,KHARO CHAN TALUKA,63,28,0,28
SUJAWAL DISTRICT,KHARO CHAN TALUKA,64,28,0,28
SUJAWAL DISTRICT,KHARO CHAN TALUKA,65,35,0,35
SUJAWAL DISTRICT,KHARO CHAN TALUKA,66,17,0,17
SUJAWAL DISTRICT,KHARO CHAN TALUKA,67,29,0,29
SUJAWAL DISTRICT,KHARO CHAN TALUKA,68,23,0,23
SUJAWAL DISTRICT,KHARO CHAN TALUKA,69,24,0,24
SUJAWAL DISTRICT,KHARO CHAN TALUKA,70,18,0,18
SUJAWAL DISTRICT,KHARO CHAN TALUKA,71,22,0,22
SUJAWAL DISTRICT,KHARO CHAN TALUKA,72,16,0,16
SUJAWAL DISTRICT,KHARO CHAN TALUKA,73,6,0,6
SUJAWAL DISTRICT,KHARO CHAN TALUKA,74,15,0,15
SUJAWAL DISTRICT,KHARO CHAN TALUKA,>=75,107,0,107
SUJAWAL DISTRICT,MIRPUR BATHORO TALUKA,<1,3996,365,4361
SUJAWAL DISTRICT,MIRPUR BATHORO TALUKA,1,4784,528,5312
SUJAWAL DISTRICT,MIRPUR BATHORO TALUKA,2,6144,520,6664
SUJAWAL DISTRICT,MIRPUR BATHORO TALUKA,3,6680,562,7242
SUJAWAL DISTRICT,MIRPUR BATHORO TALUKA,4,6885,554,7439
SUJAWAL DISTRICT,MIRPUR BATHORO TALUKA,5,6775,606,7381
SUJAWAL DISTRICT,MIRPUR BATHORO TALUKA,6,6490,517,7007
SUJAWAL DISTRICT,MIRPUR BATHORO TALUKA,7,5681,586,6267
SUJAWAL DISTRICT,MIRPUR BATHORO TALUKA,8,6824,517,7341
SUJAWAL DISTRICT,MIRPUR BATHORO TALUKA,9,4791,498,5289
SUJAWAL DISTRICT,MIRPUR BATHORO TALUKA,10,6423,452,6875
SUJAWAL DISTRICT,MIRPUR BATHORO TALUKA,11,3961,416,4377
SUJAWAL DISTRICT,MIRPUR BATHORO TALUKA,12,5026,436,5462
SUJAWAL DISTRICT,MIRPUR BATHORO TALUKA,13,3519,410,3929
SUJAWAL DISTRICT,MIRPUR BATHORO TALUKA,14,3931,445,4376
SUJAWAL DISTRICT,MIRPUR BATHORO TALUKA,15,4099,416,4515
SUJAWAL DISTRICT,MIRPUR BATHORO TALUKA,16,3842,380,4222
SUJAWAL DISTRICT,MIRPUR BATHORO TALUKA,17,3409,428,3837
SUJAWAL DISTRICT,MIRPUR BATHORO TALUKA,18,4439,414,4853
SUJAWAL DISTRICT,MIRPUR BATHORO TALUKA,19,3195,462,3657
SUJAWAL DISTRICT,MIRPUR BATHORO TALUKA,20,4410,432,4842
SUJAWAL DISTRICT,MIRPUR BATHORO TALUKA,21,2799,424,3223
SUJAWAL DISTRICT,MIRPUR BATHORO TALUKA,22,3506,405,3911
SUJAWAL DISTRICT,MIRPUR BATHORO TALUKA,23,2627,391,3018
SUJAWAL DISTRICT,MIRPUR BATHORO TALUKA,24,2382,376,2758
SUJAWAL DISTRICT,MIRPUR BATHORO TALUKA,25,3810,395,4205
SUJAWAL DISTRICT,MIRPUR BATHORO TALUKA,26,2423,315,2738
SUJAWAL DISTRICT,MIRPUR BATHORO TALUKA,27,2626,338,2964
SUJAWAL DISTRICT,MIRPUR BATHORO TALUKA,28,2870,369,3239
SUJAWAL DISTRICT,MIRPUR BATHORO TALUKA,29,2806,345,3151
SUJAWAL DISTRICT,MIRPUR BATHORO TALUKA,30,3314,388,3702
SUJAWAL DISTRICT,MIRPUR BATHORO TALUKA,31,2436,323,2759
SUJAWAL DISTRICT,MIRPUR BATHORO TALUKA,32,2504,300,2804
SUJAWAL DISTRICT,MIRPUR BATHORO TALUKA,33,2119,305,2424
SUJAWAL DISTRICT,MIRPUR BATHORO TALUKA,34,1781,239,2020
SUJAWAL DISTRICT,MIRPUR BATHORO TALUKA,35,2645,290,2935
SUJAWAL DISTRICT,MIRPUR BATHORO TALUKA,36,1810,187,1997
SUJAWAL DISTRICT,MIRPUR BATHORO TALUKA,37,2445,257,2702
SUJAWAL DISTRICT,MIRPUR BATHORO TALUKA,38,2009,262,2271
SUJAWAL DISTRICT,MIRPUR BATHORO TALUKA,39,2093,259,2352
SUJAWAL DISTRICT,MIRPUR BATHORO TALUKA,40,2377,266,2643
SUJAWAL DISTRICT,MIRPUR BATHORO TALUKA,41,1942,203,2145
SUJAWAL DISTRICT,MIRPUR BATHORO TALUKA,42,1718,212,1930
SUJAWAL DISTRICT,MIRPUR BATHORO TALUKA,43,1642,215,1857
SUJAWAL DISTRICT,MIRPUR BATHORO TALUKA,44,1529,183,1712
SUJAWAL DISTRICT,MIRPUR BATHORO TALUKA,45,1826,180,2006
SUJAWAL DISTRICT,MIRPUR BATHORO TALUKA,46,1349,164,1513
SUJAWAL DISTRICT,MIRPUR BATHORO TALUKA,47,1624,164,1788
SUJAWAL DISTRICT,MIRPUR BATHORO TALUKA,48,1319,190,1509
SUJAWAL DISTRICT,MIRPUR BATHORO TALUKA,49,1403,182,1585
SUJAWAL DISTRICT,MIRPUR BATHORO TALUKA,50,1487,178,1665
SUJAWAL DISTRICT,MIRPUR BATHORO TALUKA,51,1155,120,1275
SUJAWAL DISTRICT,MIRPUR BATHORO TALUKA,52,990,122,1112
SUJAWAL DISTRICT,MIRPUR BATHORO TALUKA,53,949,138,1087
SUJAWAL DISTRICT,MIRPUR BATHORO TALUKA,54,834,123,957
SUJAWAL DISTRICT,MIRPUR BATHORO TALUKA,55,985,110,1095
SUJAWAL DISTRICT,MIRPUR BATHORO TALUKA,56,682,84,766
SUJAWAL DISTRICT,MIRPUR BATHORO TALUKA,57,774,95,869
SUJAWAL DISTRICT,MIRPUR BATHORO TALUKA,58,617,95,712
SUJAWAL DISTRICT,MIRPUR BATHORO TALUKA,59,763,92,855
SUJAWAL DISTRICT,MIRPUR BATHORO TALUKA,60,958,110,1068
SUJAWAL DISTRICT,MIRPUR BATHORO TALUKA,61,751,77,828
SUJAWAL DISTRICT,MIRPUR BATHORO TALUKA,62,685,71,756
SUJAWAL DISTRICT,MIRPUR BATHORO TALUKA,63,698,63,761
SUJAWAL DISTRICT,MIRPUR BATHORO TALUKA,64,786,77,863
SUJAWAL DISTRICT,MIRPUR BATHORO TALUKA,65,661,75,736
SUJAWAL DISTRICT,MIRPUR BATHORO TALUKA,66,489,44,533
SUJAWAL DISTRICT,MIRPUR BATHORO TALUKA,67,439,44,483
SUJAWAL DISTRICT,MIRPUR BATHORO TALUKA,68,426,55,481
SUJAWAL DISTRICT,MIRPUR BATHORO TALUKA,69,547,40,587
SUJAWAL DISTRICT,MIRPUR BATHORO TALUKA,70,507,51,558
SUJAWAL DISTRICT,MIRPUR BATHORO TALUKA,71,374,45,419
SUJAWAL DISTRICT,MIRPUR BATHORO TALUKA,72,306,30,336
SUJAWAL DISTRICT,MIRPUR BATHORO TALUKA,73,298,35,333
SUJAWAL DISTRICT,MIRPUR BATHORO TALUKA,74,326,24,350
SUJAWAL DISTRICT,MIRPUR BATHORO TALUKA,>=75,1995,231,2226
SUJAWAL DISTRICT,SHAH BUNDER TALUKA,<1,3449,311,3760
SUJAWAL DISTRICT,SHAH BUNDER TALUKA,1,3910,445,4355
SUJAWAL DISTRICT,SHAH BUNDER TALUKA,2,4991,491,5482
SUJAWAL DISTRICT,SHAH BUNDER TALUKA,3,5357,612,5969
SUJAWAL DISTRICT,SHAH BUNDER TALUKA,4,5526,552,6078
SUJAWAL DISTRICT,SHAH BUNDER TALUKA,5,5637,630,6267
SUJAWAL DISTRICT,SHAH BUNDER TALUKA,6,5624,514,6138
SUJAWAL DISTRICT,SHAH BUNDER TALUKA,7,4289,515,4804
SUJAWAL DISTRICT,SHAH BUNDER TALUKA,8,5746,570,6316
SUJAWAL DISTRICT,SHAH BUNDER TALUKA,9,3429,475,3904
SUJAWAL DISTRICT,SHAH BUNDER TALUKA,10,5146,485,5631
SUJAWAL DISTRICT,SHAH BUNDER TALUKA,11,2684,406,3090
SUJAWAL DISTRICT,SHAH BUNDER TALUKA,12,3711,435,4146
SUJAWAL DISTRICT,SHAH BUNDER TALUKA,13,2463,325,2788
SUJAWAL DISTRICT,SHAH BUNDER TALUKA,14,2766,350,3116
SUJAWAL DISTRICT,SHAH BUNDER TALUKA,15,2816,359,3175
SUJAWAL DISTRICT,SHAH BUNDER TALUKA,16,2626,363,2989
SUJAWAL DISTRICT,SHAH BUNDER TALUKA,17,1835,334,2169
SUJAWAL DISTRICT,SHAH BUNDER TALUKA,18,3238,401,3639
SUJAWAL DISTRICT,SHAH BUNDER TALUKA,19,2062,321,2383
SUJAWAL DISTRICT,SHAH BUNDER TALUKA,20,3219,420,3639
SUJAWAL DISTRICT,SHAH BUNDER TALUKA,21,1799,288,2087
SUJAWAL DISTRICT,SHAH BUNDER TALUKA,22,2115,304,2419
SUJAWAL DISTRICT,SHAH BUNDER TALUKA,23,1850,295,2145
SUJAWAL DISTRICT,SHAH BUNDER TALUKA,24,1690,272,1962
SUJAWAL DISTRICT,SHAH BUNDER TALUKA,25,2592,364,2956
SUJAWAL DISTRICT,SHAH BUNDER TALUKA,26,1951,256,2207
SUJAWAL DISTRICT,SHAH BUNDER TALUKA,27,1892,268,2160
SUJAWAL DISTRICT,SHAH BUNDER TALUKA,28,2296,314,2610
SUJAWAL DISTRICT,SHAH BUNDER TALUKA,29,2000,258,2258
SUJAWAL DISTRICT,SHAH BUNDER TALUKA,30,2445,346,2791
SUJAWAL DISTRICT,SHAH BUNDER TALUKA,31,1964,252,2216
SUJAWAL DISTRICT,SHAH BUNDER TALUKA,32,1833,292,2125
SUJAWAL DISTRICT,SHAH BUNDER TALUKA,33,1769,239,2008
SUJAWAL DISTRICT,SHAH BUNDER TALUKA,34,1549,190,1739
SUJAWAL DISTRICT,SHAH BUNDER TALUKA,35,1859,286,2145
SUJAWAL DISTRICT,SHAH BUNDER TALUKA,36,1505,138,1643
SUJAWAL DISTRICT,SHAH BUNDER TALUKA,37,1671,216,1887
SUJAWAL DISTRICT,SHAH BUNDER TALUKA,38,1595,219,1814
SUJAWAL DISTRICT,SHAH BUNDER TALUKA,39,1581,234,1815
SUJAWAL DISTRICT,SHAH BUNDER TALUKA,40,1702,261,1963
SUJAWAL DISTRICT,SHAH BUNDER TALUKA,41,1398,177,1575
SUJAWAL DISTRICT,SHAH BUNDER TALUKA,42,1167,153,1320
SUJAWAL DISTRICT,SHAH BUNDER TALUKA,43,1267,168,1435
SUJAWAL DISTRICT,SHAH BUNDER TALUKA,44,1110,141,1251
SUJAWAL DISTRICT,SHAH BUNDER TALUKA,45,1101,173,1274
SUJAWAL DISTRICT,SHAH BUNDER TALUKA,46,999,98,1097
SUJAWAL DISTRICT,SHAH BUNDER TALUKA,47,956,145,1101
SUJAWAL DISTRICT,SHAH BUNDER TALUKA,48,980,130,1110
SUJAWAL DISTRICT,SHAH BUNDER TALUKA,49,1006,149,1155
SUJAWAL DISTRICT,SHAH BUNDER TALUKA,50,1073,138,1211
SUJAWAL DISTRICT,SHAH BUNDER TALUKA,51,820,100,920
SUJAWAL DISTRICT,SHAH BUNDER TALUKA,52,715,105,820
SUJAWAL DISTRICT,SHAH BUNDER TALUKA,53,629,85,714
SUJAWAL DISTRICT,SHAH BUNDER TALUKA,54,585,80,665
SUJAWAL DISTRICT,SHAH BUNDER TALUKA,55,621,111,732
SUJAWAL DISTRICT,SHAH BUNDER TALUKA,56,520,56,576
SUJAWAL DISTRICT,SHAH BUNDER TALUKA,57,542,63,605
SUJAWAL DISTRICT,SHAH BUNDER TALUKA,58,441,61,502
SUJAWAL DISTRICT,SHAH BUNDER TALUKA,59,491,90,581
SUJAWAL DISTRICT,SHAH BUNDER TALUKA,60,699,91,790
SUJAWAL DISTRICT,SHAH BUNDER TALUKA,61,507,61,568
SUJAWAL DISTRICT,SHAH BUNDER TALUKA,62,472,56,528
SUJAWAL DISTRICT,SHAH BUNDER TALUKA,63,456,77,533
SUJAWAL DISTRICT,SHAH BUNDER TALUKA,64,496,54,550
SUJAWAL DISTRICT,SHAH BUNDER TALUKA,65,417,74,491
SUJAWAL DISTRICT,SHAH BUNDER TALUKA,66,411,39,450
SUJAWAL DISTRICT,SHAH BUNDER TALUKA,67,340,40,380
SUJAWAL DISTRICT,SHAH BUNDER TALUKA,68,314,44,358
SUJAWAL DISTRICT,SHAH BUNDER TALUKA,69,355,39,394
SUJAWAL DISTRICT,SHAH BUNDER TALUKA,70,371,36,407
SUJAWAL DISTRICT,SHAH BUNDER TALUKA,71,274,31,305
SUJAWAL DISTRICT,SHAH BUNDER TALUKA,72,278,30,308
SUJAWAL DISTRICT,SHAH BUNDER TALUKA,73,237,35,272
SUJAWAL DISTRICT,SHAH BUNDER TALUKA,74,214,14,228
SUJAWAL DISTRICT,SHAH BUNDER TALUKA,>=75,1577,177,1754
SUJAWAL DISTRICT,SUJAWAL TALUKA,<1,3433,662,4095
SUJAWAL DISTRICT,SUJAWAL TALUKA,1,4311,888,5199
SUJAWAL DISTRICT,SUJAWAL TALUKA,2,5583,1001,6584
SUJAWAL DISTRICT,SUJAWAL TALUKA,3,6227,1139,7366
SUJAWAL DISTRICT,SUJAWAL TALUKA,4,6380,1102,7482
SUJAWAL DISTRICT,SUJAWAL TALUKA,5,6140,1119,7259
SUJAWAL DISTRICT,SUJAWAL TALUKA,6,5986,1018,7004
SUJAWAL DISTRICT,SUJAWAL TALUKA,7,5123,1075,6198
SUJAWAL DISTRICT,SUJAWAL TALUKA,8,6136,1068,7204
SUJAWAL DISTRICT,SUJAWAL TALUKA,9,4322,958,5280
SUJAWAL DISTRICT,SUJAWAL TALUKA,10,5662,919,6581
SUJAWAL DISTRICT,SUJAWAL TALUKA,11,3438,811,4249
SUJAWAL DISTRICT,SUJAWAL TALUKA,12,4392,808,5200
SUJAWAL DISTRICT,SUJAWAL TALUKA,13,2972,713,3685
SUJAWAL DISTRICT,SUJAWAL TALUKA,14,3312,665,3977
SUJAWAL DISTRICT,SUJAWAL TALUKA,15,3324,730,4054
SUJAWAL DISTRICT,SUJAWAL TALUKA,16,3181,687,3868
SUJAWAL DISTRICT,SUJAWAL TALUKA,17,2493,710,3203
SUJAWAL DISTRICT,SUJAWAL TALUKA,18,3523,688,4211
SUJAWAL DISTRICT,SUJAWAL TALUKA,19,2447,628,3075
SUJAWAL DISTRICT,SUJAWAL TALUKA,20,3300,618,3918
SUJAWAL DISTRICT,SUJAWAL TALUKA,21,2100,633,2733
SUJAWAL DISTRICT,SUJAWAL TALUKA,22,2302,600,2902
SUJAWAL DISTRICT,SUJAWAL TALUKA,23,1981,565,2546
SUJAWAL DISTRICT,SUJAWAL TALUKA,24,1862,526,2388
SUJAWAL DISTRICT,SUJAWAL TALUKA,25,2724,502,3226
SUJAWAL DISTRICT,SUJAWAL TALUKA,26,2098,639,2737
SUJAWAL DISTRICT,SUJAWAL TALUKA,27,2159,585,2744
SUJAWAL DISTRICT,SUJAWAL TALUKA,28,2230,552,2782
SUJAWAL DISTRICT,SUJAWAL TALUKA,29,2289,579,2868
SUJAWAL DISTRICT,SUJAWAL TALUKA,30,2446,435,2881
SUJAWAL DISTRICT,SUJAWAL TALUKA,31,2186,628,2814
SUJAWAL DISTRICT,SUJAWAL TALUKA,32,2197,593,2790
SUJAWAL DISTRICT,SUJAWAL TALUKA,33,1993,511,2504
SUJAWAL DISTRICT,SUJAWAL TALUKA,34,1759,512,2271
SUJAWAL DISTRICT,SUJAWAL TALUKA,35,2031,428,2459
SUJAWAL DISTRICT,SUJAWAL TALUKA,36,1713,432,2145
SUJAWAL DISTRICT,SUJAWAL TALUKA,37,2143,483,2626
SUJAWAL DISTRICT,SUJAWAL TALUKA,38,1700,397,2097
SUJAWAL DISTRICT,SUJAWAL TALUKA,39,1865,478,2343
SUJAWAL DISTRICT,SUJAWAL TALUKA,40,1717,345,2062
SUJAWAL DISTRICT,SUJAWAL TALUKA,41,1537,417,1954
SUJAWAL DISTRICT,SUJAWAL TALUKA,42,1551,409,1960
SUJAWAL DISTRICT,SUJAWAL TALUKA,43,1476,339,1815
SUJAWAL DISTRICT,SUJAWAL TALUKA,44,1359,348,1707
SUJAWAL DISTRICT,SUJAWAL TALUKA,45,1280,273,1553
SUJAWAL DISTRICT,SUJAWAL TALUKA,46,1159,310,1469
SUJAWAL DISTRICT,SUJAWAL TALUKA,47,1286,306,1592
SUJAWAL DISTRICT,SUJAWAL TALUKA,48,1208,225,1433
SUJAWAL DISTRICT,SUJAWAL TALUKA,49,1157,273,1430
SUJAWAL DISTRICT,SUJAWAL TALUKA,50,1071,233,1304
SUJAWAL DISTRICT,SUJAWAL TALUKA,51,903,281,1184
SUJAWAL DISTRICT,SUJAWAL TALUKA,52,928,228,1156
SUJAWAL DISTRICT,SUJAWAL TALUKA,53,698,231,929
SUJAWAL DISTRICT,SUJAWAL TALUKA,54,718,214,932
SUJAWAL DISTRICT,SUJAWAL TALUKA,55,703,187,890
SUJAWAL DISTRICT,SUJAWAL TALUKA,56,577,164,741
SUJAWAL DISTRICT,SUJAWAL TALUKA,57,796,165,961
SUJAWAL DISTRICT,SUJAWAL TALUKA,58,601,170,771
SUJAWAL DISTRICT,SUJAWAL TALUKA,59,668,183,851
SUJAWAL DISTRICT,SUJAWAL TALUKA,60,630,126,756
SUJAWAL DISTRICT,SUJAWAL TALUKA,61,556,168,724
SUJAWAL DISTRICT,SUJAWAL TALUKA,62,565,170,735
SUJAWAL DISTRICT,SUJAWAL TALUKA,63,543,149,692
SUJAWAL DISTRICT,SUJAWAL TALUKA,64,637,144,781
SUJAWAL DISTRICT,SUJAWAL TALUKA,65,484,109,593
SUJAWAL DISTRICT,SUJAWAL TALUKA,66,401,126,527
SUJAWAL DISTRICT,SUJAWAL TALUKA,67,375,94,469
SUJAWAL DISTRICT,SUJAWAL TALUKA,68,380,109,489
SUJAWAL DISTRICT,SUJAWAL TALUKA,69,448,98,546
SUJAWAL DISTRICT,SUJAWAL TALUKA,70,368,75,443
SUJAWAL DISTRICT,SUJAWAL TALUKA,71,298,73,371
SUJAWAL DISTRICT,SUJAWAL TALUKA,72,256,59,315
SUJAWAL DISTRICT,SUJAWAL TALUKA,73,267,43,310
SUJAWAL DISTRICT,SUJAWAL TALUKA,74,278,71,349
SUJAWAL DISTRICT,SUJAWAL TALUKA,>=75,1741,308,2049
SUKKUR DISTRICT,NEW SUKKUR TALUKA,<1,989,6513,7502
SUKKUR DISTRICT,NEW SUKKUR TALUKA,1,1160,7837,8997
SUKKUR DISTRICT,NEW SUKKUR TALUKA,2,1561,8732,10293
SUKKUR DISTRICT,NEW SUKKUR TALUKA,3,1592,9852,11444
SUKKUR DISTRICT,NEW SUKKUR TALUKA,4,1622,9512,11134
SUKKUR DISTRICT,NEW SUKKUR TALUKA,5,1642,9710,11352
SUKKUR DISTRICT,NEW SUKKUR TALUKA,6,1560,8689,10249
SUKKUR DISTRICT,NEW SUKKUR TALUKA,7,1464,9005,10469
SUKKUR DISTRICT,NEW SUKKUR TALUKA,8,1602,8943,10545
SUKKUR DISTRICT,NEW SUKKUR TALUKA,9,1257,7739,8996
SUKKUR DISTRICT,NEW SUKKUR TALUKA,10,1457,7932,9389
SUKKUR DISTRICT,NEW SUKKUR TALUKA,11,1027,6503,7530
SUKKUR DISTRICT,NEW SUKKUR TALUKA,12,1171,6945,8116
SUKKUR DISTRICT,NEW SUKKUR TALUKA,13,880,6017,6897
SUKKUR DISTRICT,NEW SUKKUR TALUKA,14,943,5851,6794
SUKKUR DISTRICT,NEW SUKKUR TALUKA,15,980,6330,7310
SUKKUR DISTRICT,NEW SUKKUR TALUKA,16,881,6015,6896
SUKKUR DISTRICT,NEW SUKKUR TALUKA,17,803,5816,6619
SUKKUR DISTRICT,NEW SUKKUR TALUKA,18,1036,6583,7619
SUKKUR DISTRICT,NEW SUKKUR TALUKA,19,813,5878,6691
SUKKUR DISTRICT,NEW SUKKUR TALUKA,20,1024,6077,7101
SUKKUR DISTRICT,NEW SUKKUR TALUKA,21,765,5000,5765
SUKKUR DISTRICT,NEW SUKKUR TALUKA,22,699,4945,5644
SUKKUR DISTRICT,NEW SUKKUR TALUKA,23,666,4448,5114
SUKKUR DISTRICT,NEW SUKKUR TALUKA,24,629,4153,4782
SUKKUR DISTRICT,NEW SUKKUR TALUKA,25,860,4797,5657
SUKKUR DISTRICT,NEW SUKKUR TALUKA,26,562,3995,4557
SUKKUR DISTRICT,NEW SUKKUR TALUKA,27,720,4180,4900
SUKKUR DISTRICT,NEW SUKKUR TALUKA,28,642,4516,5158
SUKKUR DISTRICT,NEW SUKKUR TALUKA,29,638,4036,4674
SUKKUR DISTRICT,NEW SUKKUR TALUKA,30,706,4578,5284
SUKKUR DISTRICT,NEW SUKKUR TALUKA,31,574,3946,4520
SUKKUR DISTRICT,NEW SUKKUR TALUKA,32,491,3659,4150
SUKKUR DISTRICT,NEW SUKKUR TALUKA,33,526,3415,3941
SUKKUR DISTRICT,NEW SUKKUR TALUKA,34,458,3040,3498
SUKKUR DISTRICT,NEW SUKKUR TALUKA,35,563,3712,4275
SUKKUR DISTRICT,NEW SUKKUR TALUKA,36,415,2643,3058
SUKKUR DISTRICT,NEW SUKKUR TALUKA,37,457,2877,3334
SUKKUR DISTRICT,NEW SUKKUR TALUKA,38,471,3291,3762
SUKKUR DISTRICT,NEW SUKKUR TALUKA,39,410,2905,3315
SUKKUR DISTRICT,NEW SUKKUR TALUKA,40,465,3323,3788
SUKKUR DISTRICT,NEW SUKKUR TALUKA,41,363,2393,2756
SUKKUR DISTRICT,NEW SUKKUR TALUKA,42,300,2252,2552
SUKKUR DISTRICT,NEW SUKKUR TALUKA,43,310,2292,2602
SUKKUR DISTRICT,NEW SUKKUR TALUKA,44,263,1925,2188
SUKKUR DISTRICT,NEW SUKKUR TALUKA,45,367,2381,2748
SUKKUR DISTRICT,NEW SUKKUR TALUKA,46,230,1633,1863
SUKKUR DISTRICT,NEW SUKKUR TALUKA,47,255,1789,2044
SUKKUR DISTRICT,NEW SUKKUR TALUKA,48,285,1990,2275
SUKKUR DISTRICT,NEW SUKKUR TALUKA,49,280,1828,2108
SUKKUR DISTRICT,NEW SUKKUR TALUKA,50,329,2044,2373
SUKKUR DISTRICT,NEW SUKKUR TALUKA,51,204,1514,1718
SUKKUR DISTRICT,NEW SUKKUR TALUKA,52,224,1466,1690
SUKKUR DISTRICT,NEW SUKKUR TALUKA,53,207,1368,1575
SUKKUR DISTRICT,NEW SUKKUR TALUKA,54,190,1268,1458
SUKKUR DISTRICT,NEW SUKKUR TALUKA,55,232,1459,1691
SUKKUR DISTRICT,NEW SUKKUR TALUKA,56,165,1034,1199
SUKKUR DISTRICT,NEW SUKKUR TALUKA,57,191,1064,1255
SUKKUR DISTRICT,NEW SUKKUR TALUKA,58,173,1001,1174
SUKKUR DISTRICT,NEW SUKKUR TALUKA,59,138,1009,1147
SUKKUR DISTRICT,NEW SUKKUR TALUKA,60,169,1116,1285
SUKKUR DISTRICT,NEW SUKKUR TALUKA,61,136,794,930
SUKKUR DISTRICT,NEW SUKKUR TALUKA,62,115,885,1000
SUKKUR DISTRICT,NEW SUKKUR TALUKA,63,120,853,973
SUKKUR DISTRICT,NEW SUKKUR TALUKA,64,121,694,815
SUKKUR DISTRICT,NEW SUKKUR TALUKA,65,132,797,929
SUKKUR DISTRICT,NEW SUKKUR TALUKA,66,71,576,647
SUKKUR DISTRICT,NEW SUKKUR TALUKA,67,104,488,592
SUKKUR DISTRICT,NEW SUKKUR TALUKA,68,75,533,608
SUKKUR DISTRICT,NEW SUKKUR TALUKA,69,73,431,504
SUKKUR DISTRICT,NEW SUKKUR TALUKA,70,87,528,615
SUKKUR DISTRICT,NEW SUKKUR TALUKA,71,62,358,420
SUKKUR DISTRICT,NEW SUKKUR TALUKA,72,60,348,408
SUKKUR DISTRICT,NEW SUKKUR TALUKA,73,48,318,366
SUKKUR DISTRICT,NEW SUKKUR TALUKA,74,46,274,320
SUKKUR DISTRICT,NEW SUKKUR TALUKA,>=75,346,1930,2276
SUKKUR DISTRICT,PANO AQIL TALUKA,<1,8761,2089,10850
SUKKUR DISTRICT,PANO AQIL TALUKA,1,10135,2431,12566
SUKKUR DISTRICT,PANO AQIL TALUKA,2,11710,2579,14289
SUKKUR DISTRICT,PANO AQIL TALUKA,3,12625,2894,15519
SUKKUR DISTRICT,PANO AQIL TALUKA,4,13252,2854,16106
SUKKUR DISTRICT,PANO AQIL TALUKA,5,12863,2883,15746
SUKKUR DISTRICT,PANO AQIL TALUKA,6,12659,2781,15440
SUKKUR DISTRICT,PANO AQIL TALUKA,7,11130,2816,13946
SUKKUR DISTRICT,PANO AQIL TALUKA,8,12973,2666,15639
SUKKUR DISTRICT,PANO AQIL TALUKA,9,9991,2485,12476
SUKKUR DISTRICT,PANO AQIL TALUKA,10,11522,2325,13847
SUKKUR DISTRICT,PANO AQIL TALUKA,11,8132,2263,10395
SUKKUR DISTRICT,PANO AQIL TALUKA,12,9186,2143,11329
SUKKUR DISTRICT,PANO AQIL TALUKA,13,7449,2048,9497
SUKKUR DISTRICT,PANO AQIL TALUKA,14,7918,2021,9939
SUKKUR DISTRICT,PANO AQIL TALUKA,15,7870,2109,9979
SUKKUR DISTRICT,PANO AQIL TALUKA,16,7603,2082,9685
SUKKUR DISTRICT,PANO AQIL TALUKA,17,6718,2061,8779
SUKKUR DISTRICT,PANO AQIL TALUKA,18,8384,2057,10441
SUKKUR DISTRICT,PANO AQIL TALUKA,19,6319,1970,8289
SUKKUR DISTRICT,PANO AQIL TALUKA,20,6749,1795,8544
SUKKUR DISTRICT,PANO AQIL TALUKA,21,5051,1917,6968
SUKKUR DISTRICT,PANO AQIL TALUKA,22,5170,1901,7071
SUKKUR DISTRICT,PANO AQIL TALUKA,23,4355,2083,6438
SUKKUR DISTRICT,PANO AQIL TALUKA,24,4180,2126,6306
SUKKUR DISTRICT,PANO AQIL TALUKA,25,5329,1917,7246
SUKKUR DISTRICT,PANO AQIL TALUKA,26,4097,2115,6212
SUKKUR DISTRICT,PANO AQIL TALUKA,27,4493,2227,6720
SUKKUR DISTRICT,PANO AQIL TALUKA,28,4744,2192,6936
SUKKUR DISTRICT,PANO AQIL TALUKA,29,4388,2158,6546
SUKKUR DISTRICT,PANO AQIL TALUKA,30,4955,1866,6821
SUKKUR DISTRICT,PANO AQIL TALUKA,31,3952,2041,5993
SUKKUR DISTRICT,PANO AQIL TALUKA,32,3929,1848,5777
SUKKUR DISTRICT,PANO AQIL TALUKA,33,3715,1839,5554
SUKKUR DISTRICT,PANO AQIL TALUKA,34,3430,1732,5162
SUKKUR DISTRICT,PANO AQIL TALUKA,35,4130,1483,5613
SUKKUR DISTRICT,PANO AQIL TALUKA,36,3443,1543,4986
SUKKUR DISTRICT,PANO AQIL TALUKA,37,3675,1377,5052
SUKKUR DISTRICT,PANO AQIL TALUKA,38,3407,1621,5028
SUKKUR DISTRICT,PANO AQIL TALUKA,39,3137,1301,4438
SUKKUR DISTRICT,PANO AQIL TALUKA,40,3298,1230,4528
SUKKUR DISTRICT,PANO AQIL TALUKA,41,2543,1015,3558
SUKKUR DISTRICT,PANO AQIL TALUKA,42,2675,990,3665
SUKKUR DISTRICT,PANO AQIL TALUKA,43,2404,898,3302
SUKKUR DISTRICT,PANO AQIL TALUKA,44,2259,803,3062
SUKKUR DISTRICT,PANO AQIL TALUKA,45,2687,742,3429
SUKKUR DISTRICT,PANO AQIL TALUKA,46,1885,644,2529
SUKKUR DISTRICT,PANO AQIL TALUKA,47,2179,630,2809
SUKKUR DISTRICT,PANO AQIL TALUKA,48,2088,656,2744
SUKKUR DISTRICT,PANO AQIL TALUKA,49,1930,595,2525
SUKKUR DISTRICT,PANO AQIL TALUKA,50,2284,650,2934
SUKKUR DISTRICT,PANO AQIL TALUKA,51,1659,490,2149
SUKKUR DISTRICT,PANO AQIL TALUKA,52,1657,451,2108
SUKKUR DISTRICT,PANO AQIL TALUKA,53,1519,452,1971
SUKKUR DISTRICT,PANO AQIL TALUKA,54,1295,374,1669
SUKKUR DISTRICT,PANO AQIL TALUKA,55,1649,408,2057
SUKKUR DISTRICT,PANO AQIL TALUKA,56,1139,279,1418
SUKKUR DISTRICT,PANO AQIL TALUKA,57,1136,293,1429
SUKKUR DISTRICT,PANO AQIL TALUKA,58,1194,297,1491
SUKKUR DISTRICT,PANO AQIL TALUKA,59,1107,283,1390
SUKKUR DISTRICT,PANO AQIL TALUKA,60,1280,304,1584
SUKKUR DISTRICT,PANO AQIL TALUKA,61,938,265,1203
SUKKUR DISTRICT,PANO AQIL TALUKA,62,1011,254,1265
SUKKUR DISTRICT,PANO AQIL TALUKA,63,970,244,1214
SUKKUR DISTRICT,PANO AQIL TALUKA,64,983,225,1208
SUKKUR DISTRICT,PANO AQIL TALUKA,65,960,226,1186
SUKKUR DISTRICT,PANO AQIL TALUKA,66,707,145,852
SUKKUR DISTRICT,PANO AQIL TALUKA,67,690,146,836
SUKKUR DISTRICT,PANO AQIL TALUKA,68,605,155,760
SUKKUR DISTRICT,PANO AQIL TALUKA,69,638,140,778
SUKKUR DISTRICT,PANO AQIL TALUKA,70,701,140,841
SUKKUR DISTRICT,PANO AQIL TALUKA,71,526,130,656
SUKKUR DISTRICT,PANO AQIL TALUKA,72,497,111,608
SUKKUR DISTRICT,PANO AQIL TALUKA,73,441,106,547
SUKKUR DISTRICT,PANO AQIL TALUKA,74,374,93,467
SUKKUR DISTRICT,PANO AQIL TALUKA,>=75,2826,606,3432
SUKKUR DISTRICT,ROHRI TALUKA,<1,6827,1806,8633
SUKKUR DISTRICT,ROHRI TALUKA,1,8318,2159,10477
SUKKUR DISTRICT,ROHRI TALUKA,2,10258,2262,12520
SUKKUR DISTRICT,ROHRI TALUKA,3,10869,2613,13482
SUKKUR DISTRICT,ROHRI TALUKA,4,11179,2494,13673
SUKKUR DISTRICT,ROHRI TALUKA,5,11104,2502,13606
SUKKUR DISTRICT,ROHRI TALUKA,6,10594,2261,12855
SUKKUR DISTRICT,ROHRI TALUKA,7,9760,2528,12288
SUKKUR DISTRICT,ROHRI TALUKA,8,11203,2243,13446
SUKKUR DISTRICT,ROHRI TALUKA,9,8571,2235,10806
SUKKUR DISTRICT,ROHRI TALUKA,10,9633,2047,11680
SUKKUR DISTRICT,ROHRI TALUKA,11,6585,1924,8509
SUKKUR DISTRICT,ROHRI TALUKA,12,7466,1974,9440
SUKKUR DISTRICT,ROHRI TALUKA,13,5816,1732,7548
SUKKUR DISTRICT,ROHRI TALUKA,14,6173,1743,7916
SUKKUR DISTRICT,ROHRI TALUKA,15,6282,1866,8148
SUKKUR DISTRICT,ROHRI TALUKA,16,5789,1813,7602
SUKKUR DISTRICT,ROHRI TALUKA,17,5365,1928,7293
SUKKUR DISTRICT,ROHRI TALUKA,18,6286,1872,8158
SUKKUR DISTRICT,ROHRI TALUKA,19,5192,1956,7148
SUKKUR DISTRICT,ROHRI TALUKA,20,6129,1690,7819
SUKKUR DISTRICT,ROHRI TALUKA,21,4300,1718,6018
SUKKUR DISTRICT,ROHRI TALUKA,22,4525,1634,6159
SUKKUR DISTRICT,ROHRI TALUKA,23,3721,1508,5229
SUKKUR DISTRICT,ROHRI TALUKA,24,3753,1530,5283
SUKKUR DISTRICT,ROHRI TALUKA,25,4814,1361,6175
SUKKUR DISTRICT,ROHRI TALUKA,26,3519,1427,4946
SUKKUR DISTRICT,ROHRI TALUKA,27,3698,1407,5105
SUKKUR DISTRICT,ROHRI TALUKA,28,4163,1620,5783
SUKKUR DISTRICT,ROHRI TALUKA,29,4121,1375,5496
SUKKUR DISTRICT,ROHRI TALUKA,30,4496,1340,5836
SUKKUR DISTRICT,ROHRI TALUKA,31,3629,1423,5052
SUKKUR DISTRICT,ROHRI TALUKA,32,3404,1339,4743
SUKKUR DISTRICT,ROHRI TALUKA,33,3148,1284,4432
SUKKUR DISTRICT,ROHRI TALUKA,34,3175,1181,4356
SUKKUR DISTRICT,ROHRI TALUKA,35,3666,1075,4741
SUKKUR DISTRICT,ROHRI TALUKA,36,2812,1156,3968
SUKKUR DISTRICT,ROHRI TALUKA,37,3392,954,4346
SUKKUR DISTRICT,ROHRI TALUKA,38,2867,1011,3878
SUKKUR DISTRICT,ROHRI TALUKA,39,2921,961,3882
SUKKUR DISTRICT,ROHRI TALUKA,40,3056,907,3963
SUKKUR DISTRICT,ROHRI TALUKA,41,2367,962,3329
SUKKUR DISTRICT,ROHRI TALUKA,42,2166,851,3017
SUKKUR DISTRICT,ROHRI TALUKA,43,2025,796,2821
SUKKUR DISTRICT,ROHRI TALUKA,44,1987,750,2737
SUKKUR DISTRICT,ROHRI TALUKA,45,2209,732,2941
SUKKUR DISTRICT,ROHRI TALUKA,46,1591,705,2296
SUKKUR DISTRICT,ROHRI TALUKA,47,1850,645,2495
SUKKUR DISTRICT,ROHRI TALUKA,48,1810,801,2611
SUKKUR DISTRICT,ROHRI TALUKA,49,1769,675,2444
SUKKUR DISTRICT,ROHRI TALUKA,50,2007,570,2577
SUKKUR DISTRICT,ROHRI TALUKA,51,1470,592,2062
SUKKUR DISTRICT,ROHRI TALUKA,52,1316,608,1924
SUKKUR DISTRICT,ROHRI TALUKA,53,1265,556,1821
SUKKUR DISTRICT,ROHRI TALUKA,54,1166,492,1658
SUKKUR DISTRICT,ROHRI TALUKA,55,1403,491,1894
SUKKUR DISTRICT,ROHRI TALUKA,56,969,482,1451
SUKKUR DISTRICT,ROHRI TALUKA,57,1063,385,1448
SUKKUR DISTRICT,ROHRI TALUKA,58,872,381,1253
SUKKUR DISTRICT,ROHRI TALUKA,59,895,364,1259
SUKKUR DISTRICT,ROHRI TALUKA,60,1121,322,1443
SUKKUR DISTRICT,ROHRI TALUKA,61,900,350,1250
SUKKUR DISTRICT,ROHRI TALUKA,62,812,350,1162
SUKKUR DISTRICT,ROHRI TALUKA,63,853,313,1166
SUKKUR DISTRICT,ROHRI TALUKA,64,846,273,1119
SUKKUR DISTRICT,ROHRI TALUKA,65,804,238,1042
SUKKUR DISTRICT,ROHRI TALUKA,66,672,230,902
SUKKUR DISTRICT,ROHRI TALUKA,67,692,181,873
SUKKUR DISTRICT,ROHRI TALUKA,68,519,231,750
SUKKUR DISTRICT,ROHRI TALUKA,69,590,175,765
SUKKUR DISTRICT,ROHRI TALUKA,70,541,151,692
SUKKUR DISTRICT,ROHRI TALUKA,71,465,147,612
SUKKUR DISTRICT,ROHRI TALUKA,72,379,154,533
SUKKUR DISTRICT,ROHRI TALUKA,73,374,126,500
SUKKUR DISTRICT,ROHRI TALUKA,74,296,84,380
SUKKUR DISTRICT,ROHRI TALUKA,>=75,2197,720,2917
SUKKUR DISTRICT,SALEHPAT TALUKA,<1,2543,604,3147
SUKKUR DISTRICT,SALEHPAT TALUKA,1,3331,860,4191
SUKKUR DISTRICT,SALEHPAT TALUKA,2,4107,1026,5133
SUKKUR DISTRICT,SALEHPAT TALUKA,3,3912,1079,4991
SUKKUR DISTRICT,SALEHPAT TALUKA,4,4532,1177,5709
SUKKUR DISTRICT,SALEHPAT TALUKA,5,4084,965,5049
SUKKUR DISTRICT,SALEHPAT TALUKA,6,4638,1144,5782
SUKKUR DISTRICT,SALEHPAT TALUKA,7,3446,842,4288
SUKKUR DISTRICT,SALEHPAT TALUKA,8,4672,1136,5808
SUKKUR DISTRICT,SALEHPAT TALUKA,9,3074,804,3878
SUKKUR DISTRICT,SALEHPAT TALUKA,10,3890,963,4853
SUKKUR DISTRICT,SALEHPAT TALUKA,11,2254,623,2877
SUKKUR DISTRICT,SALEHPAT TALUKA,12,2814,804,3618
SUKKUR DISTRICT,SALEHPAT TALUKA,13,1715,488,2203
SUKKUR DISTRICT,SALEHPAT TALUKA,14,2044,625,2669
SUKKUR DISTRICT,SALEHPAT TALUKA,15,1819,516,2335
SUKKUR DISTRICT,SALEHPAT TALUKA,16,1742,499,2241
SUKKUR DISTRICT,SALEHPAT TALUKA,17,1321,404,1725
SUKKUR DISTRICT,SALEHPAT TALUKA,18,2578,729,3307
SUKKUR DISTRICT,SALEHPAT TALUKA,19,1667,490,2157
SUKKUR DISTRICT,SALEHPAT TALUKA,20,2213,622,2835
SUKKUR DISTRICT,SALEHPAT TALUKA,21,1389,395,1784
SUKKUR DISTRICT,SALEHPAT TALUKA,22,1498,465,1963
SUKKUR DISTRICT,SALEHPAT TALUKA,23,1155,343,1498
SUKKUR DISTRICT,SALEHPAT TALUKA,24,1101,342,1443
SUKKUR DISTRICT,SALEHPAT TALUKA,25,1626,426,2052
SUKKUR DISTRICT,SALEHPAT TALUKA,26,1098,301,1399
SUKKUR DISTRICT,SALEHPAT TALUKA,27,1189,331,1520
SUKKUR DISTRICT,SALEHPAT TALUKA,28,1357,396,1753
SUKKUR DISTRICT,SALEHPAT TALUKA,29,1401,356,1757
SUKKUR DISTRICT,SALEHPAT TALUKA,30,1584,402,1986
SUKKUR DISTRICT,SALEHPAT TALUKA,31,1213,320,1533
SUKKUR DISTRICT,SALEHPAT TALUKA,32,1339,320,1659
SUKKUR DISTRICT,SALEHPAT TALUKA,33,1140,300,1440
SUKKUR DISTRICT,SALEHPAT TALUKA,34,1014,288,1302
SUKKUR DISTRICT,SALEHPAT TALUKA,35,1379,370,1749
SUKKUR DISTRICT,SALEHPAT TALUKA,36,1032,243,1275
SUKKUR DISTRICT,SALEHPAT TALUKA,37,1433,307,1740
SUKKUR DISTRICT,SALEHPAT TALUKA,38,963,255,1218
SUKKUR DISTRICT,SALEHPAT TALUKA,39,1028,280,1308
SUKKUR DISTRICT,SALEHPAT TALUKA,40,986,267,1253
SUKKUR DISTRICT,SALEHPAT TALUKA,41,862,239,1101
SUKKUR DISTRICT,SALEHPAT TALUKA,42,818,218,1036
SUKKUR DISTRICT,SALEHPAT TALUKA,43,710,196,906
SUKKUR DISTRICT,SALEHPAT TALUKA,44,645,163,808
SUKKUR DISTRICT,SALEHPAT TALUKA,45,783,200,983
SUKKUR DISTRICT,SALEHPAT TALUKA,46,563,144,707
SUKKUR DISTRICT,SALEHPAT TALUKA,47,800,207,1007
SUKKUR DISTRICT,SALEHPAT TALUKA,48,560,146,706
SUKKUR DISTRICT,SALEHPAT TALUKA,49,660,172,832
SUKKUR DISTRICT,SALEHPAT TALUKA,50,623,187,810
SUKKUR DISTRICT,SALEHPAT TALUKA,51,510,146,656
SUKKUR DISTRICT,SALEHPAT TALUKA,52,507,132,639
SUKKUR DISTRICT,SALEHPAT TALUKA,53,379,107,486
SUKKUR DISTRICT,SALEHPAT TALUKA,54,349,103,452
SUKKUR DISTRICT,SALEHPAT TALUKA,55,454,119,573
SUKKUR DISTRICT,SALEHPAT TALUKA,56,290,73,363
SUKKUR DISTRICT,SALEHPAT TALUKA,57,432,104,536
SUKKUR DISTRICT,SALEHPAT TALUKA,58,287,57,344
SUKKUR DISTRICT,SALEHPAT TALUKA,59,346,68,414
SUKKUR DISTRICT,SALEHPAT TALUKA,60,419,93,512
SUKKUR DISTRICT,SALEHPAT TALUKA,61,319,69,388
SUKKUR DISTRICT,SALEHPAT TALUKA,62,315,91,406
SUKKUR DISTRICT,SALEHPAT TALUKA,63,326,77,403
SUKKUR DISTRICT,SALEHPAT TALUKA,64,286,76,362
SUKKUR DISTRICT,SALEHPAT TALUKA,65,322,74,396
SUKKUR DISTRICT,SALEHPAT TALUKA,66,272,61,333
SUKKUR DISTRICT,SALEHPAT TALUKA,67,313,49,362
SUKKUR DISTRICT,SALEHPAT TALUKA,68,197,34,231
SUKKUR DISTRICT,SALEHPAT TALUKA,69,219,41,260
SUKKUR DISTRICT,SALEHPAT TALUKA,70,217,39,256
SUKKUR DISTRICT,SALEHPAT TALUKA,71,193,48,241
SUKKUR DISTRICT,SALEHPAT TALUKA,72,157,24,181
SUKKUR DISTRICT,SALEHPAT TALUKA,73,116,35,151
SUKKUR DISTRICT,SALEHPAT TALUKA,74,148,16,164
SUKKUR DISTRICT,SALEHPAT TALUKA,>=75,1093,210,1303
SUKKUR DISTRICT,SUKKUR CITY TALUKA,<1,0,4409,4409
SUKKUR DISTRICT,SUKKUR CITY TALUKA,1,0,4775,4775
SUKKUR DISTRICT,SUKKUR CITY TALUKA,2,0,5581,5581
SUKKUR DISTRICT,SUKKUR CITY TALUKA,3,0,5889,5889
SUKKUR DISTRICT,SUKKUR CITY TALUKA,4,0,5447,5447
SUKKUR DISTRICT,SUKKUR CITY TALUKA,5,0,5902,5902
SUKKUR DISTRICT,SUKKUR CITY TALUKA,6,0,5318,5318
SUKKUR DISTRICT,SUKKUR CITY TALUKA,7,0,5849,5849
SUKKUR DISTRICT,SUKKUR CITY TALUKA,8,0,5105,5105
SUKKUR DISTRICT,SUKKUR CITY TALUKA,9,0,5518,5518
SUKKUR DISTRICT,SUKKUR CITY TALUKA,10,0,4889,4889
SUKKUR DISTRICT,SUKKUR CITY TALUKA,11,0,5435,5435
SUKKUR DISTRICT,SUKKUR CITY TALUKA,12,0,4903,4903
SUKKUR DISTRICT,SUKKUR CITY TALUKA,13,0,4833,4833
SUKKUR DISTRICT,SUKKUR CITY TALUKA,14,0,4509,4509
SUKKUR DISTRICT,SUKKUR CITY TALUKA,15,0,4895,4895
SUKKUR DISTRICT,SUKKUR CITY TALUKA,16,0,4782,4782
SUKKUR DISTRICT,SUKKUR CITY TALUKA,17,0,5342,5342
SUKKUR DISTRICT,SUKKUR CITY TALUKA,18,0,4910,4910
SUKKUR DISTRICT,SUKKUR CITY TALUKA,19,0,5004,5004
SUKKUR DISTRICT,SUKKUR CITY TALUKA,20,0,4448,4448
SUKKUR DISTRICT,SUKKUR CITY TALUKA,21,0,4676,4676
SUKKUR DISTRICT,SUKKUR CITY TALUKA,22,0,4718,4718
SUKKUR DISTRICT,SUKKUR CITY TALUKA,23,0,4320,4320
SUKKUR DISTRICT,SUKKUR CITY TALUKA,24,0,4305,4305
SUKKUR DISTRICT,SUKKUR CITY TALUKA,25,0,3973,3973
SUKKUR DISTRICT,SUKKUR CITY TALUKA,26,0,4196,4196
SUKKUR DISTRICT,SUKKUR CITY TALUKA,27,0,4104,4104
SUKKUR DISTRICT,SUKKUR CITY TALUKA,28,0,4345,4345
SUKKUR DISTRICT,SUKKUR CITY TALUKA,29,0,3816,3816
SUKKUR DISTRICT,SUKKUR CITY TALUKA,30,0,4197,4197
SUKKUR DISTRICT,SUKKUR CITY TALUKA,31,0,3949,3949
SUKKUR DISTRICT,SUKKUR CITY TALUKA,32,0,3809,3809
SUKKUR DISTRICT,SUKKUR CITY TALUKA,33,0,3525,3525
SUKKUR DISTRICT,SUKKUR CITY TALUKA,34,0,3319,3319
SUKKUR DISTRICT,SUKKUR CITY TALUKA,35,0,3384,3384
SUKKUR DISTRICT,SUKKUR CITY TALUKA,36,0,2933,2933
SUKKUR DISTRICT,SUKKUR CITY TALUKA,37,0,2802,2802
SUKKUR DISTRICT,SUKKUR CITY TALUKA,38,0,3431,3431
SUKKUR DISTRICT,SUKKUR CITY TALUKA,39,0,2949,2949
SUKKUR DISTRICT,SUKKUR CITY TALUKA,40,0,3379,3379
SUKKUR DISTRICT,SUKKUR CITY TALUKA,41,0,2516,2516
SUKKUR DISTRICT,SUKKUR CITY TALUKA,42,0,2856,2856
SUKKUR DISTRICT,SUKKUR CITY TALUKA,43,0,2425,2425
SUKKUR DISTRICT,SUKKUR CITY TALUKA,44,0,2208,2208
SUKKUR DISTRICT,SUKKUR CITY TALUKA,45,0,2439,2439
SUKKUR DISTRICT,SUKKUR CITY TALUKA,46,0,1810,1810
SUKKUR DISTRICT,SUKKUR CITY TALUKA,47,0,1841,1841
SUKKUR DISTRICT,SUKKUR CITY TALUKA,48,0,2117,2117
SUKKUR DISTRICT,SUKKUR CITY TALUKA,49,0,1960,1960
SUKKUR DISTRICT,SUKKUR CITY TALUKA,50,0,2236,2236
SUKKUR DISTRICT,SUKKUR CITY TALUKA,51,0,1799,1799
SUKKUR DISTRICT,SUKKUR CITY TALUKA,52,0,1743,1743
SUKKUR DISTRICT,SUKKUR CITY TALUKA,53,0,1631,1631
SUKKUR DISTRICT,SUKKUR CITY TALUKA,54,0,1457,1457
SUKKUR DISTRICT,SUKKUR CITY TALUKA,55,0,1675,1675
SUKKUR DISTRICT,SUKKUR CITY TALUKA,56,0,1216,1216
SUKKUR DISTRICT,SUKKUR CITY TALUKA,57,0,1158,1158
SUKKUR DISTRICT,SUKKUR CITY TALUKA,58,0,1257,1257
SUKKUR DISTRICT,SUKKUR CITY TALUKA,59,0,1057,1057
SUKKUR DISTRICT,SUKKUR CITY TALUKA,60,0,1124,1124
SUKKUR DISTRICT,SUKKUR CITY TALUKA,61,0,1047,1047
SUKKUR DISTRICT,SUKKUR CITY TALUKA,62,0,1045,1045
SUKKUR DISTRICT,SUKKUR CITY TALUKA,63,0,966,966
SUKKUR DISTRICT,SUKKUR CITY TALUKA,64,0,771,771
SUKKUR DISTRICT,SUKKUR CITY TALUKA,65,0,868,868
SUKKUR DISTRICT,SUKKUR CITY TALUKA,66,0,535,535
SUKKUR DISTRICT,SUKKUR CITY TALUKA,67,0,490,490
SUKKUR DISTRICT,SUKKUR CITY TALUKA,68,0,604,604
SUKKUR DISTRICT,SUKKUR CITY TALUKA,69,0,492,492
SUKKUR DISTRICT,SUKKUR CITY TALUKA,70,0,489,489
SUKKUR DISTRICT,SUKKUR CITY TALUKA,71,0,429,429
SUKKUR DISTRICT,SUKKUR CITY TALUKA,72,0,382,382
SUKKUR DISTRICT,SUKKUR CITY TALUKA,73,0,408,408
SUKKUR DISTRICT,SUKKUR CITY TALUKA,74,0,328,328
SUKKUR DISTRICT,SUKKUR CITY TALUKA,>=75,0,2207,2207
SWABI DISTRICT,LAHOR TEHSIL,<1,6689,950,7639
SWABI DISTRICT,LAHOR TEHSIL,1,6675,1106,7781
SWABI DISTRICT,LAHOR TEHSIL,2,7334,1070,8404
SWABI DISTRICT,LAHOR TEHSIL,3,7794,1165,8959
SWABI DISTRICT,LAHOR TEHSIL,4,7915,1090,9005
SWABI DISTRICT,LAHOR TEHSIL,5,7608,1174,8782
SWABI DISTRICT,LAHOR TEHSIL,6,7525,1151,8676
SWABI DISTRICT,LAHOR TEHSIL,7,7629,1137,8766
SWABI DISTRICT,LAHOR TEHSIL,8,7521,1121,8642
SWABI DISTRICT,LAHOR TEHSIL,9,7527,1132,8659
SWABI DISTRICT,LAHOR TEHSIL,10,6901,1022,7923
SWABI DISTRICT,LAHOR TEHSIL,11,6935,1041,7976
SWABI DISTRICT,LAHOR TEHSIL,12,6316,960,7276
SWABI DISTRICT,LAHOR TEHSIL,13,6802,1116,7918
SWABI DISTRICT,LAHOR TEHSIL,14,6400,987,7387
SWABI DISTRICT,LAHOR TEHSIL,15,6571,1052,7623
SWABI DISTRICT,LAHOR TEHSIL,16,5959,951,6910
SWABI DISTRICT,LAHOR TEHSIL,17,6083,998,7081
SWABI DISTRICT,LAHOR TEHSIL,18,5677,809,6486
SWABI DISTRICT,LAHOR TEHSIL,19,5592,903,6495
SWABI DISTRICT,LAHOR TEHSIL,20,5407,840,6247
SWABI DISTRICT,LAHOR TEHSIL,21,4966,852,5818
SWABI DISTRICT,LAHOR TEHSIL,22,4764,744,5508
SWABI DISTRICT,LAHOR TEHSIL,23,4665,730,5395
SWABI DISTRICT,LAHOR TEHSIL,24,4317,652,4969
SWABI DISTRICT,LAHOR TEHSIL,25,4622,583,5205
SWABI DISTRICT,LAHOR TEHSIL,26,4187,662,4849
SWABI DISTRICT,LAHOR TEHSIL,27,4123,661,4784
SWABI DISTRICT,LAHOR TEHSIL,28,3930,610,4540
SWABI DISTRICT,LAHOR TEHSIL,29,4313,666,4979
SWABI DISTRICT,LAHOR TEHSIL,30,4011,610,4621
SWABI DISTRICT,LAHOR TEHSIL,31,3785,622,4407
SWABI DISTRICT,LAHOR TEHSIL,32,2975,493,3468
SWABI DISTRICT,LAHOR TEHSIL,33,3149,511,3660
SWABI DISTRICT,LAHOR TEHSIL,34,2854,459,3313
SWABI DISTRICT,LAHOR TEHSIL,35,3026,416,3442
SWABI DISTRICT,LAHOR TEHSIL,36,2748,440,3188
SWABI DISTRICT,LAHOR TEHSIL,37,2802,478,3280
SWABI DISTRICT,LAHOR TEHSIL,38,2483,398,2881
SWABI DISTRICT,LAHOR TEHSIL,39,2609,453,3062
SWABI DISTRICT,LAHOR TEHSIL,40,2760,372,3132
SWABI DISTRICT,LAHOR TEHSIL,41,2433,413,2846
SWABI DISTRICT,LAHOR TEHSIL,42,2166,386,2552
SWABI DISTRICT,LAHOR TEHSIL,43,2253,377,2630
SWABI DISTRICT,LAHOR TEHSIL,44,2084,339,2423
SWABI DISTRICT,LAHOR TEHSIL,45,1942,282,2224
SWABI DISTRICT,LAHOR TEHSIL,46,1988,333,2321
SWABI DISTRICT,LAHOR TEHSIL,47,1979,348,2327
SWABI DISTRICT,LAHOR TEHSIL,48,1873,281,2154
SWABI DISTRICT,LAHOR TEHSIL,49,1853,313,2166
SWABI DISTRICT,LAHOR TEHSIL,50,1921,260,2181
SWABI DISTRICT,LAHOR TEHSIL,51,1682,281,1963
SWABI DISTRICT,LAHOR TEHSIL,52,1539,273,1812
SWABI DISTRICT,LAHOR TEHSIL,53,1449,232,1681
SWABI DISTRICT,LAHOR TEHSIL,54,1373,218,1591
SWABI DISTRICT,LAHOR TEHSIL,55,1233,184,1417
SWABI DISTRICT,LAHOR TEHSIL,56,1092,244,1336
SWABI DISTRICT,LAHOR TEHSIL,57,1105,188,1293
SWABI DISTRICT,LAHOR TEHSIL,58,1166,175,1341
SWABI DISTRICT,LAHOR TEHSIL,59,1241,177,1418
SWABI DISTRICT,LAHOR TEHSIL,60,1300,181,1481
SWABI DISTRICT,LAHOR TEHSIL,61,1321,280,1601
SWABI DISTRICT,LAHOR TEHSIL,62,1123,208,1331
SWABI DISTRICT,LAHOR TEHSIL,63,1109,182,1291
SWABI DISTRICT,LAHOR TEHSIL,64,1051,156,1207
SWABI DISTRICT,LAHOR TEHSIL,65,863,109,972
SWABI DISTRICT,LAHOR TEHSIL,66,919,166,1085
SWABI DISTRICT,LAHOR TEHSIL,67,895,190,1085
SWABI DISTRICT,LAHOR TEHSIL,68,707,120,827
SWABI DISTRICT,LAHOR TEHSIL,69,733,105,838
SWABI DISTRICT,LAHOR TEHSIL,70,709,93,802
SWABI DISTRICT,LAHOR TEHSIL,71,641,153,794
SWABI DISTRICT,LAHOR TEHSIL,72,576,139,715
SWABI DISTRICT,LAHOR TEHSIL,73,471,96,567
SWABI DISTRICT,LAHOR TEHSIL,74,442,64,506
SWABI DISTRICT,LAHOR TEHSIL,>=75,3282,586,3868
SWABI DISTRICT,RAZAR TEHSIL,<1,14410,659,15069
SWABI DISTRICT,RAZAR TEHSIL,1,15166,627,15793
SWABI DISTRICT,RAZAR TEHSIL,2,16094,627,16721
SWABI DISTRICT,RAZAR TEHSIL,3,17310,755,18065
SWABI DISTRICT,RAZAR TEHSIL,4,17897,791,18688
SWABI DISTRICT,RAZAR TEHSIL,5,17186,760,17946
SWABI DISTRICT,RAZAR TEHSIL,6,16245,681,16926
SWABI DISTRICT,RAZAR TEHSIL,7,16937,715,17652
SWABI DISTRICT,RAZAR TEHSIL,8,16509,658,17167
SWABI DISTRICT,RAZAR TEHSIL,9,16856,725,17581
SWABI DISTRICT,RAZAR TEHSIL,10,15082,639,15721
SWABI DISTRICT,RAZAR TEHSIL,11,15275,672,15947
SWABI DISTRICT,RAZAR TEHSIL,12,14035,550,14585
SWABI DISTRICT,RAZAR TEHSIL,13,14752,671,15423
SWABI DISTRICT,RAZAR TEHSIL,14,13948,604,14552
SWABI DISTRICT,RAZAR TEHSIL,15,14044,657,14701
SWABI DISTRICT,RAZAR TEHSIL,16,12498,571,13069
SWABI DISTRICT,RAZAR TEHSIL,17,13024,589,13613
SWABI DISTRICT,RAZAR TEHSIL,18,11275,524,11799
SWABI DISTRICT,RAZAR TEHSIL,19,11416,586,12002
SWABI DISTRICT,RAZAR TEHSIL,20,10774,494,11268
SWABI DISTRICT,RAZAR TEHSIL,21,9844,476,10320
SWABI DISTRICT,RAZAR TEHSIL,22,9119,434,9553
SWABI DISTRICT,RAZAR TEHSIL,23,8788,415,9203
SWABI DISTRICT,RAZAR TEHSIL,24,8289,441,8730
SWABI DISTRICT,RAZAR TEHSIL,25,8960,436,9396
SWABI DISTRICT,RAZAR TEHSIL,26,8614,424,9038
SWABI DISTRICT,RAZAR TEHSIL,27,8574,420,8994
SWABI DISTRICT,RAZAR TEHSIL,28,7515,435,7950
SWABI DISTRICT,RAZAR TEHSIL,29,8049,399,8448
SWABI DISTRICT,RAZAR TEHSIL,30,7849,359,8208
SWABI DISTRICT,RAZAR TEHSIL,31,7160,376,7536
SWABI DISTRICT,RAZAR TEHSIL,32,6299,319,6618
SWABI DISTRICT,RAZAR TEHSIL,33,6458,336,6794
SWABI DISTRICT,RAZAR TEHSIL,34,5797,278,6075
SWABI DISTRICT,RAZAR TEHSIL,35,5789,259,6048
SWABI DISTRICT,RAZAR TEHSIL,36,5538,254,5792
SWABI DISTRICT,RAZAR TEHSIL,37,5762,319,6081
SWABI DISTRICT,RAZAR TEHSIL,38,5166,273,5439
SWABI DISTRICT,RAZAR TEHSIL,39,5268,288,5556
SWABI DISTRICT,RAZAR TEHSIL,40,5538,232,5770
SWABI DISTRICT,RAZAR TEHSIL,41,5041,263,5304
SWABI DISTRICT,RAZAR TEHSIL,42,4566,295,4861
SWABI DISTRICT,RAZAR TEHSIL,43,4704,246,4950
SWABI DISTRICT,RAZAR TEHSIL,44,4538,226,4764
SWABI DISTRICT,RAZAR TEHSIL,45,3955,198,4153
SWABI DISTRICT,RAZAR TEHSIL,46,4144,216,4360
SWABI DISTRICT,RAZAR TEHSIL,47,4254,226,4480
SWABI DISTRICT,RAZAR TEHSIL,48,3783,199,3982
SWABI DISTRICT,RAZAR TEHSIL,49,3820,206,4026
SWABI DISTRICT,RAZAR TEHSIL,50,3942,209,4151
SWABI DISTRICT,RAZAR TEHSIL,51,3720,219,3939
SWABI DISTRICT,RAZAR TEHSIL,52,3415,159,3574
SWABI DISTRICT,RAZAR TEHSIL,53,3279,164,3443
SWABI DISTRICT,RAZAR TEHSIL,54,3064,145,3209
SWABI DISTRICT,RAZAR TEHSIL,55,2971,144,3115
SWABI DISTRICT,RAZAR TEHSIL,56,2561,119,2680
SWABI DISTRICT,RAZAR TEHSIL,57,2616,130,2746
SWABI DISTRICT,RAZAR TEHSIL,58,2439,137,2576
SWABI DISTRICT,RAZAR TEHSIL,59,2780,156,2936
SWABI DISTRICT,RAZAR TEHSIL,60,2708,120,2828
SWABI DISTRICT,RAZAR TEHSIL,61,2757,170,2927
SWABI DISTRICT,RAZAR TEHSIL,62,2581,145,2726
SWABI DISTRICT,RAZAR TEHSIL,63,2364,152,2516
SWABI DISTRICT,RAZAR TEHSIL,64,2152,137,2289
SWABI DISTRICT,RAZAR TEHSIL,65,1797,102,1899
SWABI DISTRICT,RAZAR TEHSIL,66,2009,124,2133
SWABI DISTRICT,RAZAR TEHSIL,67,1830,97,1927
SWABI DISTRICT,RAZAR TEHSIL,68,1490,68,1558
SWABI DISTRICT,RAZAR TEHSIL,69,1443,85,1528
SWABI DISTRICT,RAZAR TEHSIL,70,1451,53,1504
SWABI DISTRICT,RAZAR TEHSIL,71,1429,78,1507
SWABI DISTRICT,RAZAR TEHSIL,72,1294,83,1377
SWABI DISTRICT,RAZAR TEHSIL,73,1036,46,1082
SWABI DISTRICT,RAZAR TEHSIL,74,898,28,926
SWABI DISTRICT,RAZAR TEHSIL,>=75,6722,341,7063
SWABI DISTRICT,SWABI TEHSIL,<1,6662,3977,10639
SWABI DISTRICT,SWABI TEHSIL,1,6168,4005,10173
SWABI DISTRICT,SWABI TEHSIL,2,6808,4048,10856
SWABI DISTRICT,SWABI TEHSIL,3,7121,4483,11604
SWABI DISTRICT,SWABI TEHSIL,4,7499,4448,11947
SWABI DISTRICT,SWABI TEHSIL,5,6831,4368,11199
SWABI DISTRICT,SWABI TEHSIL,6,7003,4272,11275
SWABI DISTRICT,SWABI TEHSIL,7,7152,4292,11444
SWABI DISTRICT,SWABI TEHSIL,8,6898,4007,10905
SWABI DISTRICT,SWABI TEHSIL,9,7065,4312,11377
SWABI DISTRICT,SWABI TEHSIL,10,6358,3842,10200
SWABI DISTRICT,SWABI TEHSIL,11,6561,4015,10576
SWABI DISTRICT,SWABI TEHSIL,12,6083,3681,9764
SWABI DISTRICT,SWABI TEHSIL,13,6656,4057,10713
SWABI DISTRICT,SWABI TEHSIL,14,6206,3870,10076
SWABI DISTRICT,SWABI TEHSIL,15,6274,3758,10032
SWABI DISTRICT,SWABI TEHSIL,16,5872,3587,9459
SWABI DISTRICT,SWABI TEHSIL,17,6016,3655,9671
SWABI DISTRICT,SWABI TEHSIL,18,5238,3318,8556
SWABI DISTRICT,SWABI TEHSIL,19,5630,3513,9143
SWABI DISTRICT,SWABI TEHSIL,20,5187,3015,8202
SWABI DISTRICT,SWABI TEHSIL,21,4897,2994,7891
SWABI DISTRICT,SWABI TEHSIL,22,4349,2712,7061
SWABI DISTRICT,SWABI TEHSIL,23,4399,2729,7128
SWABI DISTRICT,SWABI TEHSIL,24,3983,2503,6486
SWABI DISTRICT,SWABI TEHSIL,25,3989,2471,6460
SWABI DISTRICT,SWABI TEHSIL,26,3794,2501,6295
SWABI DISTRICT,SWABI TEHSIL,27,3824,2393,6217
SWABI DISTRICT,SWABI TEHSIL,28,3531,2251,5782
SWABI DISTRICT,SWABI TEHSIL,29,3564,2276,5840
SWABI DISTRICT,SWABI TEHSIL,30,3665,2191,5856
SWABI DISTRICT,SWABI TEHSIL,31,3302,2154,5456
SWABI DISTRICT,SWABI TEHSIL,32,2843,1934,4777
SWABI DISTRICT,SWABI TEHSIL,33,2993,1964,4957
SWABI DISTRICT,SWABI TEHSIL,34,2681,1681,4362
SWABI DISTRICT,SWABI TEHSIL,35,2708,1586,4294
SWABI DISTRICT,SWABI TEHSIL,36,2422,1480,3902
SWABI DISTRICT,SWABI TEHSIL,37,2412,1512,3924
SWABI DISTRICT,SWABI TEHSIL,38,2441,1566,4007
SWABI DISTRICT,SWABI TEHSIL,39,2436,1478,3914
SWABI DISTRICT,SWABI TEHSIL,40,2713,1703,4416
SWABI DISTRICT,SWABI TEHSIL,41,2238,1555,3793
SWABI DISTRICT,SWABI TEHSIL,42,2074,1418,3492
SWABI DISTRICT,SWABI TEHSIL,43,2209,1420,3629
SWABI DISTRICT,SWABI TEHSIL,44,2037,1417,3454
SWABI DISTRICT,SWABI TEHSIL,45,1893,1189,3082
SWABI DISTRICT,SWABI TEHSIL,46,1921,1212,3133
SWABI DISTRICT,SWABI TEHSIL,47,1719,1196,2915
SWABI DISTRICT,SWABI TEHSIL,48,1780,1136,2916
SWABI DISTRICT,SWABI TEHSIL,49,1671,1153,2824
SWABI DISTRICT,SWABI TEHSIL,50,1971,1236,3207
SWABI DISTRICT,SWABI TEHSIL,51,1631,1071,2702
SWABI DISTRICT,SWABI TEHSIL,52,1413,917,2330
SWABI DISTRICT,SWABI TEHSIL,53,1530,1012,2542
SWABI DISTRICT,SWABI TEHSIL,54,1451,905,2356
SWABI DISTRICT,SWABI TEHSIL,55,1352,852,2204
SWABI DISTRICT,SWABI TEHSIL,56,1204,708,1912
SWABI DISTRICT,SWABI TEHSIL,57,1104,719,1823
SWABI DISTRICT,SWABI TEHSIL,58,1174,796,1970
SWABI DISTRICT,SWABI TEHSIL,59,1395,893,2288
SWABI DISTRICT,SWABI TEHSIL,60,1490,824,2314
SWABI DISTRICT,SWABI TEHSIL,61,1387,891,2278
SWABI DISTRICT,SWABI TEHSIL,62,1161,710,1871
SWABI DISTRICT,SWABI TEHSIL,63,1154,726,1880
SWABI DISTRICT,SWABI TEHSIL,64,1033,649,1682
SWABI DISTRICT,SWABI TEHSIL,65,928,558,1486
SWABI DISTRICT,SWABI TEHSIL,66,876,608,1484
SWABI DISTRICT,SWABI TEHSIL,67,830,534,1364
SWABI DISTRICT,SWABI TEHSIL,68,705,425,1130
SWABI DISTRICT,SWABI TEHSIL,69,657,372,1029
SWABI DISTRICT,SWABI TEHSIL,70,759,401,1160
SWABI DISTRICT,SWABI TEHSIL,71,676,464,1140
SWABI DISTRICT,SWABI TEHSIL,72,586,337,923
SWABI DISTRICT,SWABI TEHSIL,73,558,297,855
SWABI DISTRICT,SWABI TEHSIL,74,442,248,690
SWABI DISTRICT,SWABI TEHSIL,>=75,3673,1954,5627
SWABI DISTRICT,TOPI TEHSIL,<1,6601,1354,7955
SWABI DISTRICT,TOPI TEHSIL,1,7020,1315,8335
SWABI DISTRICT,TOPI TEHSIL,2,7163,1416,8579
SWABI DISTRICT,TOPI TEHSIL,3,7318,1539,8857
SWABI DISTRICT,TOPI TEHSIL,4,7695,1586,9281
SWABI DISTRICT,TOPI TEHSIL,5,7345,1554,8899
SWABI DISTRICT,TOPI TEHSIL,6,7431,1449,8880
SWABI DISTRICT,TOPI TEHSIL,7,7457,1576,9033
SWABI DISTRICT,TOPI TEHSIL,8,7234,1438,8672
SWABI DISTRICT,TOPI TEHSIL,9,7606,1518,9124
SWABI DISTRICT,TOPI TEHSIL,10,6637,1287,7924
SWABI DISTRICT,TOPI TEHSIL,11,6952,1436,8388
SWABI DISTRICT,TOPI TEHSIL,12,6216,1269,7485
SWABI DISTRICT,TOPI TEHSIL,13,6911,1367,8278
SWABI DISTRICT,TOPI TEHSIL,14,6400,1180,7580
SWABI DISTRICT,TOPI TEHSIL,15,6656,1279,7935
SWABI DISTRICT,TOPI TEHSIL,16,6549,1217,7766
SWABI DISTRICT,TOPI TEHSIL,17,6749,1215,7964
SWABI DISTRICT,TOPI TEHSIL,18,5995,1138,7133
SWABI DISTRICT,TOPI TEHSIL,19,6572,1144,7716
SWABI DISTRICT,TOPI TEHSIL,20,5784,1066,6850
SWABI DISTRICT,TOPI TEHSIL,21,6039,1108,7147
SWABI DISTRICT,TOPI TEHSIL,22,5207,906,6113
SWABI DISTRICT,TOPI TEHSIL,23,5266,923,6189
SWABI DISTRICT,TOPI TEHSIL,24,5076,861,5937
SWABI DISTRICT,TOPI TEHSIL,25,4647,884,5531
SWABI DISTRICT,TOPI TEHSIL,26,4701,772,5473
SWABI DISTRICT,TOPI TEHSIL,27,4483,887,5370
SWABI DISTRICT,TOPI TEHSIL,28,4118,706,4824
SWABI DISTRICT,TOPI TEHSIL,29,4324,869,5193
SWABI DISTRICT,TOPI TEHSIL,30,3876,852,4728
SWABI DISTRICT,TOPI TEHSIL,31,3971,727,4698
SWABI DISTRICT,TOPI TEHSIL,32,3470,616,4086
SWABI DISTRICT,TOPI TEHSIL,33,3317,678,3995
SWABI DISTRICT,TOPI TEHSIL,34,3236,612,3848
SWABI DISTRICT,TOPI TEHSIL,35,3001,567,3568
SWABI DISTRICT,TOPI TEHSIL,36,3092,538,3630
SWABI DISTRICT,TOPI TEHSIL,37,2997,578,3575
SWABI DISTRICT,TOPI TEHSIL,38,2621,553,3174
SWABI DISTRICT,TOPI TEHSIL,39,2871,581,3452
SWABI DISTRICT,TOPI TEHSIL,40,2670,647,3317
SWABI DISTRICT,TOPI TEHSIL,41,2649,508,3157
SWABI DISTRICT,TOPI TEHSIL,42,2461,480,2941
SWABI DISTRICT,TOPI TEHSIL,43,2412,506,2918
SWABI DISTRICT,TOPI TEHSIL,44,2277,424,2701
SWABI DISTRICT,TOPI TEHSIL,45,2012,416,2428
SWABI DISTRICT,TOPI TEHSIL,46,2186,341,2527
SWABI DISTRICT,TOPI TEHSIL,47,2143,417,2560
SWABI DISTRICT,TOPI TEHSIL,48,2031,339,2370
SWABI DISTRICT,TOPI TEHSIL,49,2017,339,2356
SWABI DISTRICT,TOPI TEHSIL,50,1831,381,2212
SWABI DISTRICT,TOPI TEHSIL,51,1876,327,2203
SWABI DISTRICT,TOPI TEHSIL,52,1615,303,1918
SWABI DISTRICT,TOPI TEHSIL,53,1673,301,1974
SWABI DISTRICT,TOPI TEHSIL,54,1483,289,1772
SWABI DISTRICT,TOPI TEHSIL,55,1275,282,1557
SWABI DISTRICT,TOPI TEHSIL,56,1288,232,1520
SWABI DISTRICT,TOPI TEHSIL,57,1177,199,1376
SWABI DISTRICT,TOPI TEHSIL,58,1309,240,1549
SWABI DISTRICT,TOPI TEHSIL,59,1414,255,1669
SWABI DISTRICT,TOPI TEHSIL,60,1278,276,1554
SWABI DISTRICT,TOPI TEHSIL,61,1428,254,1682
SWABI DISTRICT,TOPI TEHSIL,62,1141,255,1396
SWABI DISTRICT,TOPI TEHSIL,63,1181,223,1404
SWABI DISTRICT,TOPI TEHSIL,64,1058,216,1274
SWABI DISTRICT,TOPI TEHSIL,65,769,165,934
SWABI DISTRICT,TOPI TEHSIL,66,981,160,1141
SWABI DISTRICT,TOPI TEHSIL,67,768,181,949
SWABI DISTRICT,TOPI TEHSIL,68,885,138,1023
SWABI DISTRICT,TOPI TEHSIL,69,784,133,917
SWABI DISTRICT,TOPI TEHSIL,70,669,153,822
SWABI DISTRICT,TOPI TEHSIL,71,735,122,857
SWABI DISTRICT,TOPI TEHSIL,72,494,135,629
SWABI DISTRICT,TOPI TEHSIL,73,554,107,661
SWABI DISTRICT,TOPI TEHSIL,74,474,68,542
SWABI DISTRICT,TOPI TEHSIL,>=75,3870,653,4523
SWAT DISTRICT,BABUZAI TEHSIL,<1,7570,9183,16753
SWAT DISTRICT,BABUZAI TEHSIL,1,7367,8690,16057
SWAT DISTRICT,BABUZAI TEHSIL,2,8436,9605,18041
SWAT DISTRICT,BABUZAI TEHSIL,3,8663,10321,18984
SWAT DISTRICT,BABUZAI TEHSIL,4,8991,9896,18887
SWAT DISTRICT,BABUZAI TEHSIL,5,8800,10284,19084
SWAT DISTRICT,BABUZAI TEHSIL,6,8684,9809,18493
SWAT DISTRICT,BABUZAI TEHSIL,7,8836,10431,19267
SWAT DISTRICT,BABUZAI TEHSIL,8,8801,9565,18366
SWAT DISTRICT,BABUZAI TEHSIL,9,8385,9950,18335
SWAT DISTRICT,BABUZAI TEHSIL,10,7883,8819,16702
SWAT DISTRICT,BABUZAI TEHSIL,11,7360,9256,16616
SWAT DISTRICT,BABUZAI TEHSIL,12,7077,8273,15350
SWAT DISTRICT,BABUZAI TEHSIL,13,7054,8847,15901
SWAT DISTRICT,BABUZAI TEHSIL,14,6151,7771,13922
SWAT DISTRICT,BABUZAI TEHSIL,15,6486,8070,14556
SWAT DISTRICT,BABUZAI TEHSIL,16,5867,7356,13223
SWAT DISTRICT,BABUZAI TEHSIL,17,6074,7875,13949
SWAT DISTRICT,BABUZAI TEHSIL,18,5666,7373,13039
SWAT DISTRICT,BABUZAI TEHSIL,19,5272,6871,12143
SWAT DISTRICT,BABUZAI TEHSIL,20,5749,6701,12450
SWAT DISTRICT,BABUZAI TEHSIL,21,4603,5996,10599
SWAT DISTRICT,BABUZAI TEHSIL,22,4295,5665,9960
SWAT DISTRICT,BABUZAI TEHSIL,23,3969,5430,9399
SWAT DISTRICT,BABUZAI TEHSIL,24,3647,4946,8593
SWAT DISTRICT,BABUZAI TEHSIL,25,5003,5937,10940
SWAT DISTRICT,BABUZAI TEHSIL,26,4265,5534,9799
SWAT DISTRICT,BABUZAI TEHSIL,27,4355,5802,10157
SWAT DISTRICT,BABUZAI TEHSIL,28,4047,5381,9428
SWAT DISTRICT,BABUZAI TEHSIL,29,3942,5168,9110
SWAT DISTRICT,BABUZAI TEHSIL,30,4482,5443,9925
SWAT DISTRICT,BABUZAI TEHSIL,31,3533,4801,8334
SWAT DISTRICT,BABUZAI TEHSIL,32,2990,4332,7322
SWAT DISTRICT,BABUZAI TEHSIL,33,3318,4418,7736
SWAT DISTRICT,BABUZAI TEHSIL,34,2766,3580,6346
SWAT DISTRICT,BABUZAI TEHSIL,35,3181,4003,7184
SWAT DISTRICT,BABUZAI TEHSIL,36,2480,3272,5752
SWAT DISTRICT,BABUZAI TEHSIL,37,2551,3319,5870
SWAT DISTRICT,BABUZAI TEHSIL,38,2460,3390,5850
SWAT DISTRICT,BABUZAI TEHSIL,39,2361,3330,5691
SWAT DISTRICT,BABUZAI TEHSIL,40,3035,3903,6938
SWAT DISTRICT,BABUZAI TEHSIL,41,2100,2826,4926
SWAT DISTRICT,BABUZAI TEHSIL,42,1730,2485,4215
SWAT DISTRICT,BABUZAI TEHSIL,43,2075,2766,4841
SWAT DISTRICT,BABUZAI TEHSIL,44,1718,2466,4184
SWAT DISTRICT,BABUZAI TEHSIL,45,1960,2631,4591
SWAT DISTRICT,BABUZAI TEHSIL,46,1624,2052,3676
SWAT DISTRICT,BABUZAI TEHSIL,47,1647,2105,3752
SWAT DISTRICT,BABUZAI TEHSIL,48,1468,2150,3618
SWAT DISTRICT,BABUZAI TEHSIL,49,1553,2064,3617
SWAT DISTRICT,BABUZAI TEHSIL,50,1995,2572,4567
SWAT DISTRICT,BABUZAI TEHSIL,51,1407,1896,3303
SWAT DISTRICT,BABUZAI TEHSIL,52,1177,1741,2918
SWAT DISTRICT,BABUZAI TEHSIL,53,1342,1779,3121
SWAT DISTRICT,BABUZAI TEHSIL,54,1285,1481,2766
SWAT DISTRICT,BABUZAI TEHSIL,55,1348,1762,3110
SWAT DISTRICT,BABUZAI TEHSIL,56,952,1307,2259
SWAT DISTRICT,BABUZAI TEHSIL,57,921,1152,2073
SWAT DISTRICT,BABUZAI TEHSIL,58,855,1194,2049
SWAT DISTRICT,BABUZAI TEHSIL,59,887,1125,2012
SWAT DISTRICT,BABUZAI TEHSIL,60,1336,1555,2891
SWAT DISTRICT,BABUZAI TEHSIL,61,1080,1223,2303
SWAT DISTRICT,BABUZAI TEHSIL,62,945,1188,2133
SWAT DISTRICT,BABUZAI TEHSIL,63,973,1211,2184
SWAT DISTRICT,BABUZAI TEHSIL,64,772,923,1695
SWAT DISTRICT,BABUZAI TEHSIL,65,755,909,1664
SWAT DISTRICT,BABUZAI TEHSIL,66,653,722,1375
SWAT DISTRICT,BABUZAI TEHSIL,67,607,736,1343
SWAT DISTRICT,BABUZAI TEHSIL,68,556,656,1212
SWAT DISTRICT,BABUZAI TEHSIL,69,474,541,1015
SWAT DISTRICT,BABUZAI TEHSIL,70,605,618,1223
SWAT DISTRICT,BABUZAI TEHSIL,71,584,535,1119
SWAT DISTRICT,BABUZAI TEHSIL,72,520,504,1024
SWAT DISTRICT,BABUZAI TEHSIL,73,447,530,977
SWAT DISTRICT,BABUZAI TEHSIL,74,312,353,665
SWAT DISTRICT,BABUZAI TEHSIL,>=75,2829,3023,5852
SWAT DISTRICT,BARIKOT TEHSIL,<1,2454,2401,4855
SWAT DISTRICT,BARIKOT TEHSIL,1,2441,2732,5173
SWAT DISTRICT,BARIKOT TEHSIL,2,2736,2843,5579
SWAT DISTRICT,BARIKOT TEHSIL,3,2700,2832,5532
SWAT DISTRICT,BARIKOT TEHSIL,4,2675,3057,5732
SWAT DISTRICT,BARIKOT TEHSIL,5,2901,2933,5834
SWAT DISTRICT,BARIKOT TEHSIL,6,2734,2776,5510
SWAT DISTRICT,BARIKOT TEHSIL,7,2749,3078,5827
SWAT DISTRICT,BARIKOT TEHSIL,8,2924,2972,5896
SWAT DISTRICT,BARIKOT TEHSIL,9,2767,2818,5585
SWAT DISTRICT,BARIKOT TEHSIL,10,2698,2625,5323
SWAT DISTRICT,BARIKOT TEHSIL,11,2495,2651,5146
SWAT DISTRICT,BARIKOT TEHSIL,12,2383,2402,4785
SWAT DISTRICT,BARIKOT TEHSIL,13,2419,2590,5009
SWAT DISTRICT,BARIKOT TEHSIL,14,2187,2317,4504
SWAT DISTRICT,BARIKOT TEHSIL,15,2345,2426,4771
SWAT DISTRICT,BARIKOT TEHSIL,16,2026,2068,4094
SWAT DISTRICT,BARIKOT TEHSIL,17,1997,2233,4230
SWAT DISTRICT,BARIKOT TEHSIL,18,2032,2079,4111
SWAT DISTRICT,BARIKOT TEHSIL,19,1775,1899,3674
SWAT DISTRICT,BARIKOT TEHSIL,20,1945,1884,3829
SWAT DISTRICT,BARIKOT TEHSIL,21,1613,1707,3320
SWAT DISTRICT,BARIKOT TEHSIL,22,1472,1560,3032
SWAT DISTRICT,BARIKOT TEHSIL,23,1407,1425,2832
SWAT DISTRICT,BARIKOT TEHSIL,24,1278,1321,2599
SWAT DISTRICT,BARIKOT TEHSIL,25,1560,1542,3102
SWAT DISTRICT,BARIKOT TEHSIL,26,1478,1398,2876
SWAT DISTRICT,BARIKOT TEHSIL,27,1548,1479,3027
SWAT DISTRICT,BARIKOT TEHSIL,28,1375,1347,2722
SWAT DISTRICT,BARIKOT TEHSIL,29,1442,1411,2853
SWAT DISTRICT,BARIKOT TEHSIL,30,1348,1461,2809
SWAT DISTRICT,BARIKOT TEHSIL,31,1257,1383,2640
SWAT DISTRICT,BARIKOT TEHSIL,32,1065,1141,2206
SWAT DISTRICT,BARIKOT TEHSIL,33,1115,1235,2350
SWAT DISTRICT,BARIKOT TEHSIL,34,959,905,1864
SWAT DISTRICT,BARIKOT TEHSIL,35,974,1111,2085
SWAT DISTRICT,BARIKOT TEHSIL,36,886,838,1724
SWAT DISTRICT,BARIKOT TEHSIL,37,875,1094,1969
SWAT DISTRICT,BARIKOT TEHSIL,38,814,881,1695
SWAT DISTRICT,BARIKOT TEHSIL,39,777,855,1632
SWAT DISTRICT,BARIKOT TEHSIL,40,876,1010,1886
SWAT DISTRICT,BARIKOT TEHSIL,41,653,759,1412
SWAT DISTRICT,BARIKOT TEHSIL,42,622,724,1346
SWAT DISTRICT,BARIKOT TEHSIL,43,649,713,1362
SWAT DISTRICT,BARIKOT TEHSIL,44,587,615,1202
SWAT DISTRICT,BARIKOT TEHSIL,45,554,687,1241
SWAT DISTRICT,BARIKOT TEHSIL,46,571,548,1119
SWAT DISTRICT,BARIKOT TEHSIL,47,541,631,1172
SWAT DISTRICT,BARIKOT TEHSIL,48,546,575,1121
SWAT DISTRICT,BARIKOT TEHSIL,49,551,553,1104
SWAT DISTRICT,BARIKOT TEHSIL,50,593,637,1230
SWAT DISTRICT,BARIKOT TEHSIL,51,515,491,1006
SWAT DISTRICT,BARIKOT TEHSIL,52,463,461,924
SWAT DISTRICT,BARIKOT TEHSIL,53,502,469,971
SWAT DISTRICT,BARIKOT TEHSIL,54,428,432,860
SWAT DISTRICT,BARIKOT TEHSIL,55,374,512,886
SWAT DISTRICT,BARIKOT TEHSIL,56,337,343,680
SWAT DISTRICT,BARIKOT TEHSIL,57,300,371,671
SWAT DISTRICT,BARIKOT TEHSIL,58,309,350,659
SWAT DISTRICT,BARIKOT TEHSIL,59,359,348,707
SWAT DISTRICT,BARIKOT TEHSIL,60,416,464,880
SWAT DISTRICT,BARIKOT TEHSIL,61,371,419,790
SWAT DISTRICT,BARIKOT TEHSIL,62,346,358,704
SWAT DISTRICT,BARIKOT TEHSIL,63,352,345,697
SWAT DISTRICT,BARIKOT TEHSIL,64,301,285,586
SWAT DISTRICT,BARIKOT TEHSIL,65,240,287,527
SWAT DISTRICT,BARIKOT TEHSIL,66,267,237,504
SWAT DISTRICT,BARIKOT TEHSIL,67,221,292,513
SWAT DISTRICT,BARIKOT TEHSIL,68,220,191,411
SWAT DISTRICT,BARIKOT TEHSIL,69,171,170,341
SWAT DISTRICT,BARIKOT TEHSIL,70,226,217,443
SWAT DISTRICT,BARIKOT TEHSIL,71,243,198,441
SWAT DISTRICT,BARIKOT TEHSIL,72,158,192,350
SWAT DISTRICT,BARIKOT TEHSIL,73,151,158,309
SWAT DISTRICT,BARIKOT TEHSIL,74,125,136,261
SWAT DISTRICT,BARIKOT TEHSIL,>=75,994,1131,2125
SWAT DISTRICT,BEHRAIN TEHSIL,<1,4729,1498,6227
SWAT DISTRICT,BEHRAIN TEHSIL,1,5697,1536,7233
SWAT DISTRICT,BEHRAIN TEHSIL,2,6500,1848,8348
SWAT DISTRICT,BEHRAIN TEHSIL,3,6247,1894,8141
SWAT DISTRICT,BEHRAIN TEHSIL,4,6901,2033,8934
SWAT DISTRICT,BEHRAIN TEHSIL,5,6396,1954,8350
SWAT DISTRICT,BEHRAIN TEHSIL,6,7021,1905,8926
SWAT DISTRICT,BEHRAIN TEHSIL,7,6013,1926,7939
SWAT DISTRICT,BEHRAIN TEHSIL,8,6939,1989,8928
SWAT DISTRICT,BEHRAIN TEHSIL,9,5902,1783,7685
SWAT DISTRICT,BEHRAIN TEHSIL,10,6402,1897,8299
SWAT DISTRICT,BEHRAIN TEHSIL,11,5135,1509,6644
SWAT DISTRICT,BEHRAIN TEHSIL,12,5405,1667,7072
SWAT DISTRICT,BEHRAIN TEHSIL,13,4712,1658,6370
SWAT DISTRICT,BEHRAIN TEHSIL,14,4810,1477,6287
SWAT DISTRICT,BEHRAIN TEHSIL,15,4637,1519,6156
SWAT DISTRICT,BEHRAIN TEHSIL,16,4156,1360,5516
SWAT DISTRICT,BEHRAIN TEHSIL,17,3828,1320,5148
SWAT DISTRICT,BEHRAIN TEHSIL,18,4091,1420,5511
SWAT DISTRICT,BEHRAIN TEHSIL,19,3341,1239,4580
SWAT DISTRICT,BEHRAIN TEHSIL,20,4078,1349,5427
SWAT DISTRICT,BEHRAIN TEHSIL,21,3182,1037,4219
SWAT DISTRICT,BEHRAIN TEHSIL,22,3097,1098,4195
SWAT DISTRICT,BEHRAIN TEHSIL,23,2721,1018,3739
SWAT DISTRICT,BEHRAIN TEHSIL,24,2534,887,3421
SWAT DISTRICT,BEHRAIN TEHSIL,25,3505,1209,4714
SWAT DISTRICT,BEHRAIN TEHSIL,26,2973,1001,3974
SWAT DISTRICT,BEHRAIN TEHSIL,27,2789,1043,3832
SWAT DISTRICT,BEHRAIN TEHSIL,28,2761,1055,3816
SWAT DISTRICT,BEHRAIN TEHSIL,29,2600,1015,3615
SWAT DISTRICT,BEHRAIN TEHSIL,30,2891,1082,3973
SWAT DISTRICT,BEHRAIN TEHSIL,31,2251,844,3095
SWAT DISTRICT,BEHRAIN TEHSIL,32,2048,767,2815
SWAT DISTRICT,BEHRAIN TEHSIL,33,1875,734,2609
SWAT DISTRICT,BEHRAIN TEHSIL,34,1708,529,2237
SWAT DISTRICT,BEHRAIN TEHSIL,35,2108,771,2879
SWAT DISTRICT,BEHRAIN TEHSIL,36,1845,588,2433
SWAT DISTRICT,BEHRAIN TEHSIL,37,1781,678,2459
SWAT DISTRICT,BEHRAIN TEHSIL,38,1673,623,2296
SWAT DISTRICT,BEHRAIN TEHSIL,39,1478,580,2058
SWAT DISTRICT,BEHRAIN TEHSIL,40,1766,687,2453
SWAT DISTRICT,BEHRAIN TEHSIL,41,1271,493,1764
SWAT DISTRICT,BEHRAIN TEHSIL,42,1148,469,1617
SWAT DISTRICT,BEHRAIN TEHSIL,43,1197,482,1679
SWAT DISTRICT,BEHRAIN TEHSIL,44,1136,418,1554
SWAT DISTRICT,BEHRAIN TEHSIL,45,1345,494,1839
SWAT DISTRICT,BEHRAIN TEHSIL,46,1007,343,1350
SWAT DISTRICT,BEHRAIN TEHSIL,47,1071,440,1511
SWAT DISTRICT,BEHRAIN TEHSIL,48,1032,349,1381
SWAT DISTRICT,BEHRAIN TEHSIL,49,888,361,1249
SWAT DISTRICT,BEHRAIN TEHSIL,50,1158,435,1593
SWAT DISTRICT,BEHRAIN TEHSIL,51,822,338,1160
SWAT DISTRICT,BEHRAIN TEHSIL,52,777,335,1112
SWAT DISTRICT,BEHRAIN TEHSIL,53,745,300,1045
SWAT DISTRICT,BEHRAIN TEHSIL,54,665,275,940
SWAT DISTRICT,BEHRAIN TEHSIL,55,806,307,1113
SWAT DISTRICT,BEHRAIN TEHSIL,56,545,204,749
SWAT DISTRICT,BEHRAIN TEHSIL,57,507,218,725
SWAT DISTRICT,BEHRAIN TEHSIL,58,455,202,657
SWAT DISTRICT,BEHRAIN TEHSIL,59,486,229,715
SWAT DISTRICT,BEHRAIN TEHSIL,60,839,269,1108
SWAT DISTRICT,BEHRAIN TEHSIL,61,607,219,826
SWAT DISTRICT,BEHRAIN TEHSIL,62,526,212,738
SWAT DISTRICT,BEHRAIN TEHSIL,63,493,209,702
SWAT DISTRICT,BEHRAIN TEHSIL,64,481,168,649
SWAT DISTRICT,BEHRAIN TEHSIL,65,527,172,699
SWAT DISTRICT,BEHRAIN TEHSIL,66,475,153,628
SWAT DISTRICT,BEHRAIN TEHSIL,67,454,199,653
SWAT DISTRICT,BEHRAIN TEHSIL,68,366,131,497
SWAT DISTRICT,BEHRAIN TEHSIL,69,335,131,466
SWAT DISTRICT,BEHRAIN TEHSIL,70,498,150,648
SWAT DISTRICT,BEHRAIN TEHSIL,71,349,138,487
SWAT DISTRICT,BEHRAIN TEHSIL,72,350,128,478
SWAT DISTRICT,BEHRAIN TEHSIL,73,294,101,395
SWAT DISTRICT,BEHRAIN TEHSIL,74,252,87,339
SWAT DISTRICT,BEHRAIN TEHSIL,>=75,2100,703,2803
SWAT DISTRICT,CHARBAGH TEHSIL,<1,3317,0,3317
SWAT DISTRICT,CHARBAGH TEHSIL,1,3580,0,3580
SWAT DISTRICT,CHARBAGH TEHSIL,2,4089,0,4089
SWAT DISTRICT,CHARBAGH TEHSIL,3,4156,0,4156
SWAT DISTRICT,CHARBAGH TEHSIL,4,4531,0,4531
SWAT DISTRICT,CHARBAGH TEHSIL,5,4245,0,4245
SWAT DISTRICT,CHARBAGH TEHSIL,6,4177,0,4177
SWAT DISTRICT,CHARBAGH TEHSIL,7,4010,0,4010
SWAT DISTRICT,CHARBAGH TEHSIL,8,4395,0,4395
SWAT DISTRICT,CHARBAGH TEHSIL,9,4050,0,4050
SWAT DISTRICT,CHARBAGH TEHSIL,10,3904,0,3904
SWAT DISTRICT,CHARBAGH TEHSIL,11,3599,0,3599
SWAT DISTRICT,CHARBAGH TEHSIL,12,3454,0,3454
SWAT DISTRICT,CHARBAGH TEHSIL,13,3251,0,3251
SWAT DISTRICT,CHARBAGH TEHSIL,14,3055,0,3055
SWAT DISTRICT,CHARBAGH TEHSIL,15,3038,0,3038
SWAT DISTRICT,CHARBAGH TEHSIL,16,2658,0,2658
SWAT DISTRICT,CHARBAGH TEHSIL,17,2621,0,2621
SWAT DISTRICT,CHARBAGH TEHSIL,18,2795,0,2795
SWAT DISTRICT,CHARBAGH TEHSIL,19,2304,0,2304
SWAT DISTRICT,CHARBAGH TEHSIL,20,2541,0,2541
SWAT DISTRICT,CHARBAGH TEHSIL,21,2068,0,2068
SWAT DISTRICT,CHARBAGH TEHSIL,22,2002,0,2002
SWAT DISTRICT,CHARBAGH TEHSIL,23,1983,0,1983
SWAT DISTRICT,CHARBAGH TEHSIL,24,1744,0,1744
SWAT DISTRICT,CHARBAGH TEHSIL,25,2337,0,2337
SWAT DISTRICT,CHARBAGH TEHSIL,26,2041,0,2041
SWAT DISTRICT,CHARBAGH TEHSIL,27,2053,0,2053
SWAT DISTRICT,CHARBAGH TEHSIL,28,1972,0,1972
SWAT DISTRICT,CHARBAGH TEHSIL,29,1765,0,1765
SWAT DISTRICT,CHARBAGH TEHSIL,30,2006,0,2006
SWAT DISTRICT,CHARBAGH TEHSIL,31,1737,0,1737
SWAT DISTRICT,CHARBAGH TEHSIL,32,1425,0,1425
SWAT DISTRICT,CHARBAGH TEHSIL,33,1508,0,1508
SWAT DISTRICT,CHARBAGH TEHSIL,34,1261,0,1261
SWAT DISTRICT,CHARBAGH TEHSIL,35,1445,0,1445
SWAT DISTRICT,CHARBAGH TEHSIL,36,1248,0,1248
SWAT DISTRICT,CHARBAGH TEHSIL,37,1268,0,1268
SWAT DISTRICT,CHARBAGH TEHSIL,38,1190,0,1190
SWAT DISTRICT,CHARBAGH TEHSIL,39,1068,0,1068
SWAT DISTRICT,CHARBAGH TEHSIL,40,1291,0,1291
SWAT DISTRICT,CHARBAGH TEHSIL,41,944,0,944
SWAT DISTRICT,CHARBAGH TEHSIL,42,855,0,855
SWAT DISTRICT,CHARBAGH TEHSIL,43,875,0,875
SWAT DISTRICT,CHARBAGH TEHSIL,44,805,0,805
SWAT DISTRICT,CHARBAGH TEHSIL,45,864,0,864
SWAT DISTRICT,CHARBAGH TEHSIL,46,715,0,715
SWAT DISTRICT,CHARBAGH TEHSIL,47,766,0,766
SWAT DISTRICT,CHARBAGH TEHSIL,48,745,0,745
SWAT DISTRICT,CHARBAGH TEHSIL,49,679,0,679
SWAT DISTRICT,CHARBAGH TEHSIL,50,825,0,825
SWAT DISTRICT,CHARBAGH TEHSIL,51,642,0,642
SWAT DISTRICT,CHARBAGH TEHSIL,52,598,0,598
SWAT DISTRICT,CHARBAGH TEHSIL,53,665,0,665
SWAT DISTRICT,CHARBAGH TEHSIL,54,551,0,551
SWAT DISTRICT,CHARBAGH TEHSIL,55,639,0,639
SWAT DISTRICT,CHARBAGH TEHSIL,56,369,0,369
SWAT DISTRICT,CHARBAGH TEHSIL,57,389,0,389
SWAT DISTRICT,CHARBAGH TEHSIL,58,394,0,394
SWAT DISTRICT,CHARBAGH TEHSIL,59,416,0,416
SWAT DISTRICT,CHARBAGH TEHSIL,60,542,0,542
SWAT DISTRICT,CHARBAGH TEHSIL,61,431,0,431
SWAT DISTRICT,CHARBAGH TEHSIL,62,411,0,411
SWAT DISTRICT,CHARBAGH TEHSIL,63,428,0,428
SWAT DISTRICT,CHARBAGH TEHSIL,64,338,0,338
SWAT DISTRICT,CHARBAGH TEHSIL,65,325,0,325
SWAT DISTRICT,CHARBAGH TEHSIL,66,271,0,271
SWAT DISTRICT,CHARBAGH TEHSIL,67,314,0,314
SWAT DISTRICT,CHARBAGH TEHSIL,68,255,0,255
SWAT DISTRICT,CHARBAGH TEHSIL,69,234,0,234
SWAT DISTRICT,CHARBAGH TEHSIL,70,273,0,273
SWAT DISTRICT,CHARBAGH TEHSIL,71,234,0,234
SWAT DISTRICT,CHARBAGH TEHSIL,72,243,0,243
SWAT DISTRICT,CHARBAGH TEHSIL,73,194,0,194
SWAT DISTRICT,CHARBAGH TEHSIL,74,165,0,165
SWAT DISTRICT,CHARBAGH TEHSIL,>=75,1425,0,1425
SWAT DISTRICT,KABAL TEHSIL,<1,8053,2727,10780
SWAT DISTRICT,KABAL TEHSIL,1,8621,3177,11798
SWAT DISTRICT,KABAL TEHSIL,2,9785,3386,13171
SWAT DISTRICT,KABAL TEHSIL,3,10009,3485,13494
SWAT DISTRICT,KABAL TEHSIL,4,10187,3520,13707
SWAT DISTRICT,KABAL TEHSIL,5,10251,3507,13758
SWAT DISTRICT,KABAL TEHSIL,6,10049,3520,13569
SWAT DISTRICT,KABAL TEHSIL,7,9940,3658,13598
SWAT DISTRICT,KABAL TEHSIL,8,10662,3348,14010
SWAT DISTRICT,KABAL TEHSIL,9,9977,3661,13638
SWAT DISTRICT,KABAL TEHSIL,10,9885,3300,13185
SWAT DISTRICT,KABAL TEHSIL,11,9111,3379,12490
SWAT DISTRICT,KABAL TEHSIL,12,8792,3039,11831
SWAT DISTRICT,KABAL TEHSIL,13,8543,3300,11843
SWAT DISTRICT,KABAL TEHSIL,14,7571,2866,10437
SWAT DISTRICT,KABAL TEHSIL,15,7648,3011,10659
SWAT DISTRICT,KABAL TEHSIL,16,6934,2772,9706
SWAT DISTRICT,KABAL TEHSIL,17,6945,2816,9761
SWAT DISTRICT,KABAL TEHSIL,18,6803,2688,9491
SWAT DISTRICT,KABAL TEHSIL,19,6052,2557,8609
SWAT DISTRICT,KABAL TEHSIL,20,6221,2561,8782
SWAT DISTRICT,KABAL TEHSIL,21,5005,2220,7225
SWAT DISTRICT,KABAL TEHSIL,22,4812,2016,6828
SWAT DISTRICT,KABAL TEHSIL,23,4560,2069,6629
SWAT DISTRICT,KABAL TEHSIL,24,4003,1776,5779
SWAT DISTRICT,KABAL TEHSIL,25,5149,1988,7137
SWAT DISTRICT,KABAL TEHSIL,26,4320,1972,6292
SWAT DISTRICT,KABAL TEHSIL,27,4608,2100,6708
SWAT DISTRICT,KABAL TEHSIL,28,4203,1782,5985
SWAT DISTRICT,KABAL TEHSIL,29,4250,1798,6048
SWAT DISTRICT,KABAL TEHSIL,30,4494,1892,6386
SWAT DISTRICT,KABAL TEHSIL,31,3636,1760,5396
SWAT DISTRICT,KABAL TEHSIL,32,3268,1388,4656
SWAT DISTRICT,KABAL TEHSIL,33,3349,1547,4896
SWAT DISTRICT,KABAL TEHSIL,34,2738,1233,3971
SWAT DISTRICT,KABAL TEHSIL,35,3234,1267,4501
SWAT DISTRICT,KABAL TEHSIL,36,2619,1190,3809
SWAT DISTRICT,KABAL TEHSIL,37,2804,1189,3993
SWAT DISTRICT,KABAL TEHSIL,38,2628,1198,3826
SWAT DISTRICT,KABAL TEHSIL,39,2468,1111,3579
SWAT DISTRICT,KABAL TEHSIL,40,3006,1241,4247
SWAT DISTRICT,KABAL TEHSIL,41,2215,944,3159
SWAT DISTRICT,KABAL TEHSIL,42,1807,854,2661
SWAT DISTRICT,KABAL TEHSIL,43,2120,908,3028
SWAT DISTRICT,KABAL TEHSIL,44,1709,818,2527
SWAT DISTRICT,KABAL TEHSIL,45,2019,889,2908
SWAT DISTRICT,KABAL TEHSIL,46,1733,816,2549
SWAT DISTRICT,KABAL TEHSIL,47,1722,732,2454
SWAT DISTRICT,KABAL TEHSIL,48,1672,806,2478
SWAT DISTRICT,KABAL TEHSIL,49,1591,682,2273
SWAT DISTRICT,KABAL TEHSIL,50,2017,787,2804
SWAT DISTRICT,KABAL TEHSIL,51,1383,618,2001
SWAT DISTRICT,KABAL TEHSIL,52,1200,548,1748
SWAT DISTRICT,KABAL TEHSIL,53,1393,580,1973
SWAT DISTRICT,KABAL TEHSIL,54,1271,557,1828
SWAT DISTRICT,KABAL TEHSIL,55,1400,579,1979
SWAT DISTRICT,KABAL TEHSIL,56,1023,466,1489
SWAT DISTRICT,KABAL TEHSIL,57,1054,424,1478
SWAT DISTRICT,KABAL TEHSIL,58,994,430,1424
SWAT DISTRICT,KABAL TEHSIL,59,1065,439,1504
SWAT DISTRICT,KABAL TEHSIL,60,1509,545,2054
SWAT DISTRICT,KABAL TEHSIL,61,1157,535,1692
SWAT DISTRICT,KABAL TEHSIL,62,985,407,1392
SWAT DISTRICT,KABAL TEHSIL,63,1066,470,1536
SWAT DISTRICT,KABAL TEHSIL,64,865,352,1217
SWAT DISTRICT,KABAL TEHSIL,65,908,312,1220
SWAT DISTRICT,KABAL TEHSIL,66,760,281,1041
SWAT DISTRICT,KABAL TEHSIL,67,740,307,1047
SWAT DISTRICT,KABAL TEHSIL,68,629,255,884
SWAT DISTRICT,KABAL TEHSIL,69,639,238,877
SWAT DISTRICT,KABAL TEHSIL,70,740,263,1003
SWAT DISTRICT,KABAL TEHSIL,71,687,231,918
SWAT DISTRICT,KABAL TEHSIL,72,517,208,725
SWAT DISTRICT,KABAL TEHSIL,73,506,236,742
SWAT DISTRICT,KABAL TEHSIL,74,373,141,514
SWAT DISTRICT,KABAL TEHSIL,>=75,3366,1300,4666
SWAT DISTRICT,KHAWAZAKHELA TEHSIL,<1,5836,1333,7169
SWAT DISTRICT,KHAWAZAKHELA TEHSIL,1,6291,1334,7625
SWAT DISTRICT,KHAWAZAKHELA TEHSIL,2,6817,1454,8271
SWAT DISTRICT,KHAWAZAKHELA TEHSIL,3,7023,1442,8465
SWAT DISTRICT,KHAWAZAKHELA TEHSIL,4,7381,1552,8933
SWAT DISTRICT,KHAWAZAKHELA TEHSIL,5,7508,1411,8919
SWAT DISTRICT,KHAWAZAKHELA TEHSIL,6,7412,1512,8924
SWAT DISTRICT,KHAWAZAKHELA TEHSIL,7,6898,1534,8432
SWAT DISTRICT,KHAWAZAKHELA TEHSIL,8,7344,1445,8789
SWAT DISTRICT,KHAWAZAKHELA TEHSIL,9,6981,1568,8549
SWAT DISTRICT,KHAWAZAKHELA TEHSIL,10,6707,1315,8022
SWAT DISTRICT,KHAWAZAKHELA TEHSIL,11,6066,1352,7418
SWAT DISTRICT,KHAWAZAKHELA TEHSIL,12,5969,1182,7151
SWAT DISTRICT,KHAWAZAKHELA TEHSIL,13,5771,1277,7048
SWAT DISTRICT,KHAWAZAKHELA TEHSIL,14,5148,1073,6221
SWAT DISTRICT,KHAWAZAKHELA TEHSIL,15,5324,1146,6470
SWAT DISTRICT,KHAWAZAKHELA TEHSIL,16,4674,1048,5722
SWAT DISTRICT,KHAWAZAKHELA TEHSIL,17,4491,1080,5571
SWAT DISTRICT,KHAWAZAKHELA TEHSIL,18,4829,1000,5829
SWAT DISTRICT,KHAWAZAKHELA TEHSIL,19,4044,953,4997
SWAT DISTRICT,KHAWAZAKHELA TEHSIL,20,4595,1056,5651
SWAT DISTRICT,KHAWAZAKHELA TEHSIL,21,3536,919,4455
SWAT DISTRICT,KHAWAZAKHELA TEHSIL,22,3422,801,4223
SWAT DISTRICT,KHAWAZAKHELA TEHSIL,23,3214,777,3991
SWAT DISTRICT,KHAWAZAKHELA TEHSIL,24,2959,775,3734
SWAT DISTRICT,KHAWAZAKHELA TEHSIL,25,3786,871,4657
SWAT DISTRICT,KHAWAZAKHELA TEHSIL,26,3479,860,4339
SWAT DISTRICT,KHAWAZAKHELA TEHSIL,27,3613,833,4446
SWAT DISTRICT,KHAWAZAKHELA TEHSIL,28,3330,792,4122
SWAT DISTRICT,KHAWAZAKHELA TEHSIL,29,3059,800,3859
SWAT DISTRICT,KHAWAZAKHELA TEHSIL,30,3286,803,4089
SWAT DISTRICT,KHAWAZAKHELA TEHSIL,31,2971,778,3749
SWAT DISTRICT,KHAWAZAKHELA TEHSIL,32,2419,571,2990
SWAT DISTRICT,KHAWAZAKHELA TEHSIL,33,2384,629,3013
SWAT DISTRICT,KHAWAZAKHELA TEHSIL,34,2284,489,2773
SWAT DISTRICT,KHAWAZAKHELA TEHSIL,35,2385,563,2948
SWAT DISTRICT,KHAWAZAKHELA TEHSIL,36,2293,607,2900
SWAT DISTRICT,KHAWAZAKHELA TEHSIL,37,2173,477,2650
SWAT DISTRICT,KHAWAZAKHELA TEHSIL,38,2013,484,2497
SWAT DISTRICT,KHAWAZAKHELA TEHSIL,39,1860,419,2279
SWAT DISTRICT,KHAWAZAKHELA TEHSIL,40,2142,535,2677
SWAT DISTRICT,KHAWAZAKHELA TEHSIL,41,1856,435,2291
SWAT DISTRICT,KHAWAZAKHELA TEHSIL,42,1610,358,1968
SWAT DISTRICT,KHAWAZAKHELA TEHSIL,43,1648,379,2027
SWAT DISTRICT,KHAWAZAKHELA TEHSIL,44,1418,315,1733
SWAT DISTRICT,KHAWAZAKHELA TEHSIL,45,1432,320,1752
SWAT DISTRICT,KHAWAZAKHELA TEHSIL,46,1475,319,1794
SWAT DISTRICT,KHAWAZAKHELA TEHSIL,47,1296,288,1584
SWAT DISTRICT,KHAWAZAKHELA TEHSIL,48,1263,287,1550
SWAT DISTRICT,KHAWAZAKHELA TEHSIL,49,1222,260,1482
SWAT DISTRICT,KHAWAZAKHELA TEHSIL,50,1425,319,1744
SWAT DISTRICT,KHAWAZAKHELA TEHSIL,51,1195,219,1414
SWAT DISTRICT,KHAWAZAKHELA TEHSIL,52,970,223,1193
SWAT DISTRICT,KHAWAZAKHELA TEHSIL,53,1001,234,1235
SWAT DISTRICT,KHAWAZAKHELA TEHSIL,54,939,191,1130
SWAT DISTRICT,KHAWAZAKHELA TEHSIL,55,901,222,1123
SWAT DISTRICT,KHAWAZAKHELA TEHSIL,56,826,172,998
SWAT DISTRICT,KHAWAZAKHELA TEHSIL,57,648,135,783
SWAT DISTRICT,KHAWAZAKHELA TEHSIL,58,705,166,871
SWAT DISTRICT,KHAWAZAKHELA TEHSIL,59,692,140,832
SWAT DISTRICT,KHAWAZAKHELA TEHSIL,60,914,206,1120
SWAT DISTRICT,KHAWAZAKHELA TEHSIL,61,843,176,1019
SWAT DISTRICT,KHAWAZAKHELA TEHSIL,62,670,148,818
SWAT DISTRICT,KHAWAZAKHELA TEHSIL,63,716,140,856
SWAT DISTRICT,KHAWAZAKHELA TEHSIL,64,682,139,821
SWAT DISTRICT,KHAWAZAKHELA TEHSIL,65,647,123,770
SWAT DISTRICT,KHAWAZAKHELA TEHSIL,66,609,131,740
SWAT DISTRICT,KHAWAZAKHELA TEHSIL,67,539,92,631
SWAT DISTRICT,KHAWAZAKHELA TEHSIL,68,559,92,651
SWAT DISTRICT,KHAWAZAKHELA TEHSIL,69,468,76,544
SWAT DISTRICT,KHAWAZAKHELA TEHSIL,70,550,116,666
SWAT DISTRICT,KHAWAZAKHELA TEHSIL,71,521,92,613
SWAT DISTRICT,KHAWAZAKHELA TEHSIL,72,356,75,431
SWAT DISTRICT,KHAWAZAKHELA TEHSIL,73,373,75,448
SWAT DISTRICT,KHAWAZAKHELA TEHSIL,74,335,53,388
SWAT DISTRICT,KHAWAZAKHELA TEHSIL,>=75,2463,450,2913
SWAT DISTRICT,MATTA TEHSIL,<1,10922,1187,12109
SWAT DISTRICT,MATTA TEHSIL,1,12700,1265,13965
SWAT DISTRICT,MATTA TEHSIL,2,14068,1232,15300
SWAT DISTRICT,MATTA TEHSIL,3,14359,1357,15716
SWAT DISTRICT,MATTA TEHSIL,4,14833,1360,16193
SWAT DISTRICT,MATTA TEHSIL,5,14551,1371,15922
SWAT DISTRICT,MATTA TEHSIL,6,14327,1361,15688
SWAT DISTRICT,MATTA TEHSIL,7,13780,1323,15103
SWAT DISTRICT,MATTA TEHSIL,8,15129,1379,16508
SWAT DISTRICT,MATTA TEHSIL,9,13507,1397,14904
SWAT DISTRICT,MATTA TEHSIL,10,13944,1247,15191
SWAT DISTRICT,MATTA TEHSIL,11,11772,1208,12980
SWAT DISTRICT,MATTA TEHSIL,12,12197,1130,13327
SWAT DISTRICT,MATTA TEHSIL,13,11262,1195,12457
SWAT DISTRICT,MATTA TEHSIL,14,10414,1011,11425
SWAT DISTRICT,MATTA TEHSIL,15,10509,1075,11584
SWAT DISTRICT,MATTA TEHSIL,16,9144,979,10123
SWAT DISTRICT,MATTA TEHSIL,17,8855,1113,9968
SWAT DISTRICT,MATTA TEHSIL,18,9023,817,9840
SWAT DISTRICT,MATTA TEHSIL,19,7265,856,8121
SWAT DISTRICT,MATTA TEHSIL,20,9124,924,10048
SWAT DISTRICT,MATTA TEHSIL,21,7006,754,7760
SWAT DISTRICT,MATTA TEHSIL,22,7132,751,7883
SWAT DISTRICT,MATTA TEHSIL,23,6409,733,7142
SWAT DISTRICT,MATTA TEHSIL,24,5445,652,6097
SWAT DISTRICT,MATTA TEHSIL,25,7787,768,8555
SWAT DISTRICT,MATTA TEHSIL,26,5830,644,6474
SWAT DISTRICT,MATTA TEHSIL,27,6309,690,6999
SWAT DISTRICT,MATTA TEHSIL,28,5980,598,6578
SWAT DISTRICT,MATTA TEHSIL,29,5979,581,6560
SWAT DISTRICT,MATTA TEHSIL,30,6804,697,7501
SWAT DISTRICT,MATTA TEHSIL,31,5027,585,5612
SWAT DISTRICT,MATTA TEHSIL,32,4944,551,5495
SWAT DISTRICT,MATTA TEHSIL,33,4782,513,5295
SWAT DISTRICT,MATTA TEHSIL,34,3655,420,4075
SWAT DISTRICT,MATTA TEHSIL,35,4795,447,5242
SWAT DISTRICT,MATTA TEHSIL,36,3361,400,3761
SWAT DISTRICT,MATTA TEHSIL,37,4124,438,4562
SWAT DISTRICT,MATTA TEHSIL,38,3860,391,4251
SWAT DISTRICT,MATTA TEHSIL,39,3589,388,3977
SWAT DISTRICT,MATTA TEHSIL,40,4548,441,4989
SWAT DISTRICT,MATTA TEHSIL,41,3153,325,3478
SWAT DISTRICT,MATTA TEHSIL,42,3051,289,3340
SWAT DISTRICT,MATTA TEHSIL,43,3024,360,3384
SWAT DISTRICT,MATTA TEHSIL,44,2492,280,2772
SWAT DISTRICT,MATTA TEHSIL,45,3081,280,3361
SWAT DISTRICT,MATTA TEHSIL,46,2159,238,2397
SWAT DISTRICT,MATTA TEHSIL,47,2448,280,2728
SWAT DISTRICT,MATTA TEHSIL,48,2411,264,2675
SWAT DISTRICT,MATTA TEHSIL,49,2402,250,2652
SWAT DISTRICT,MATTA TEHSIL,50,3036,291,3327
SWAT DISTRICT,MATTA TEHSIL,51,2096,237,2333
SWAT DISTRICT,MATTA TEHSIL,52,1746,159,1905
SWAT DISTRICT,MATTA TEHSIL,53,2006,215,2221
SWAT DISTRICT,MATTA TEHSIL,54,1730,172,1902
SWAT DISTRICT,MATTA TEHSIL,55,2111,199,2310
SWAT DISTRICT,MATTA TEHSIL,56,1397,161,1558
SWAT DISTRICT,MATTA TEHSIL,57,1313,120,1433
SWAT DISTRICT,MATTA TEHSIL,58,1288,126,1414
SWAT DISTRICT,MATTA TEHSIL,59,1352,133,1485
SWAT DISTRICT,MATTA TEHSIL,60,2000,177,2177
SWAT DISTRICT,MATTA TEHSIL,61,1667,170,1837
SWAT DISTRICT,MATTA TEHSIL,62,1238,117,1355
SWAT DISTRICT,MATTA TEHSIL,63,1421,132,1553
SWAT DISTRICT,MATTA TEHSIL,64,1161,124,1285
SWAT DISTRICT,MATTA TEHSIL,65,1297,104,1401
SWAT DISTRICT,MATTA TEHSIL,66,1188,96,1284
SWAT DISTRICT,MATTA TEHSIL,67,937,81,1018
SWAT DISTRICT,MATTA TEHSIL,68,835,95,930
SWAT DISTRICT,MATTA TEHSIL,69,854,80,934
SWAT DISTRICT,MATTA TEHSIL,70,1088,76,1164
SWAT DISTRICT,MATTA TEHSIL,71,1046,84,1130
SWAT DISTRICT,MATTA TEHSIL,72,661,71,732
SWAT DISTRICT,MATTA TEHSIL,73,690,52,742
SWAT DISTRICT,MATTA TEHSIL,74,576,47,623
SWAT DISTRICT,MATTA TEHSIL,>=75,5046,433,5479
TANDO ALLAHYAR DISTRICT,CHAMBER TALUKA,<1,4072,783,4855
TANDO ALLAHYAR DISTRICT,CHAMBER TALUKA,1,5336,871,6207
TANDO ALLAHYAR DISTRICT,CHAMBER TALUKA,2,5864,1058,6922
TANDO ALLAHYAR DISTRICT,CHAMBER TALUKA,3,6449,1214,7663
TANDO ALLAHYAR DISTRICT,CHAMBER TALUKA,4,6328,1165,7493
TANDO ALLAHYAR DISTRICT,CHAMBER TALUKA,5,6530,1267,7797
TANDO ALLAHYAR DISTRICT,CHAMBER TALUKA,6,6289,1185,7474
TANDO ALLAHYAR DISTRICT,CHAMBER TALUKA,7,5918,1200,7118
TANDO ALLAHYAR DISTRICT,CHAMBER TALUKA,8,6525,1229,7754
TANDO ALLAHYAR DISTRICT,CHAMBER TALUKA,9,4775,998,5773
TANDO ALLAHYAR DISTRICT,CHAMBER TALUKA,10,5910,1219,7129
TANDO ALLAHYAR DISTRICT,CHAMBER TALUKA,11,3870,825,4695
TANDO ALLAHYAR DISTRICT,CHAMBER TALUKA,12,4508,979,5487
TANDO ALLAHYAR DISTRICT,CHAMBER TALUKA,13,3437,749,4186
TANDO ALLAHYAR DISTRICT,CHAMBER TALUKA,14,3457,716,4173
TANDO ALLAHYAR DISTRICT,CHAMBER TALUKA,15,3682,830,4512
TANDO ALLAHYAR DISTRICT,CHAMBER TALUKA,16,3458,759,4217
TANDO ALLAHYAR DISTRICT,CHAMBER TALUKA,17,3057,687,3744
TANDO ALLAHYAR DISTRICT,CHAMBER TALUKA,18,3952,887,4839
TANDO ALLAHYAR DISTRICT,CHAMBER TALUKA,19,3080,682,3762
TANDO ALLAHYAR DISTRICT,CHAMBER TALUKA,20,3685,736,4421
TANDO ALLAHYAR DISTRICT,CHAMBER TALUKA,21,2653,571,3224
TANDO ALLAHYAR DISTRICT,CHAMBER TALUKA,22,2603,590,3193
TANDO ALLAHYAR DISTRICT,CHAMBER TALUKA,23,2434,542,2976
TANDO ALLAHYAR DISTRICT,CHAMBER TALUKA,24,2194,463,2657
TANDO ALLAHYAR DISTRICT,CHAMBER TALUKA,25,2460,644,3104
TANDO ALLAHYAR DISTRICT,CHAMBER TALUKA,26,2371,471,2842
TANDO ALLAHYAR DISTRICT,CHAMBER TALUKA,27,2559,555,3114
TANDO ALLAHYAR DISTRICT,CHAMBER TALUKA,28,2721,519,3240
TANDO ALLAHYAR DISTRICT,CHAMBER TALUKA,29,2756,589,3345
TANDO ALLAHYAR DISTRICT,CHAMBER TALUKA,30,2478,523,3001
TANDO ALLAHYAR DISTRICT,CHAMBER TALUKA,31,2740,600,3340
TANDO ALLAHYAR DISTRICT,CHAMBER TALUKA,32,2261,459,2720
TANDO ALLAHYAR DISTRICT,CHAMBER TALUKA,33,2433,527,2960
TANDO ALLAHYAR DISTRICT,CHAMBER TALUKA,34,2184,484,2668
TANDO ALLAHYAR DISTRICT,CHAMBER TALUKA,35,1848,469,2317
TANDO ALLAHYAR DISTRICT,CHAMBER TALUKA,36,2294,394,2688
TANDO ALLAHYAR DISTRICT,CHAMBER TALUKA,37,2417,559,2976
TANDO ALLAHYAR DISTRICT,CHAMBER TALUKA,38,1819,429,2248
TANDO ALLAHYAR DISTRICT,CHAMBER TALUKA,39,2050,458,2508
TANDO ALLAHYAR DISTRICT,CHAMBER TALUKA,40,1545,332,1877
TANDO ALLAHYAR DISTRICT,CHAMBER TALUKA,41,1597,344,1941
TANDO ALLAHYAR DISTRICT,CHAMBER TALUKA,42,1488,307,1795
TANDO ALLAHYAR DISTRICT,CHAMBER TALUKA,43,1358,295,1653
TANDO ALLAHYAR DISTRICT,CHAMBER TALUKA,44,1278,291,1569
TANDO ALLAHYAR DISTRICT,CHAMBER TALUKA,45,1067,265,1332
TANDO ALLAHYAR DISTRICT,CHAMBER TALUKA,46,1421,236,1657
TANDO ALLAHYAR DISTRICT,CHAMBER TALUKA,47,1411,310,1721
TANDO ALLAHYAR DISTRICT,CHAMBER TALUKA,48,1282,252,1534
TANDO ALLAHYAR DISTRICT,CHAMBER TALUKA,49,1249,288,1537
TANDO ALLAHYAR DISTRICT,CHAMBER TALUKA,50,902,211,1113
TANDO ALLAHYAR DISTRICT,CHAMBER TALUKA,51,964,230,1194
TANDO ALLAHYAR DISTRICT,CHAMBER TALUKA,52,797,166,963
TANDO ALLAHYAR DISTRICT,CHAMBER TALUKA,53,757,191,948
TANDO ALLAHYAR DISTRICT,CHAMBER TALUKA,54,632,140,772
TANDO ALLAHYAR DISTRICT,CHAMBER TALUKA,55,555,127,682
TANDO ALLAHYAR DISTRICT,CHAMBER TALUKA,56,598,112,710
TANDO ALLAHYAR DISTRICT,CHAMBER TALUKA,57,704,150,854
TANDO ALLAHYAR DISTRICT,CHAMBER TALUKA,58,561,130,691
TANDO ALLAHYAR DISTRICT,CHAMBER TALUKA,59,639,156,795
TANDO ALLAHYAR DISTRICT,CHAMBER TALUKA,60,545,130,675
TANDO ALLAHYAR DISTRICT,CHAMBER TALUKA,61,633,165,798
TANDO ALLAHYAR DISTRICT,CHAMBER TALUKA,62,566,138,704
TANDO ALLAHYAR DISTRICT,CHAMBER TALUKA,63,508,125,633
TANDO ALLAHYAR DISTRICT,CHAMBER TALUKA,64,574,123,697
TANDO ALLAHYAR DISTRICT,CHAMBER TALUKA,65,445,87,532
TANDO ALLAHYAR DISTRICT,CHAMBER TALUKA,66,505,113,618
TANDO ALLAHYAR DISTRICT,CHAMBER TALUKA,67,395,93,488
TANDO ALLAHYAR DISTRICT,CHAMBER TALUKA,68,356,81,437
TANDO ALLAHYAR DISTRICT,CHAMBER TALUKA,69,379,81,460
TANDO ALLAHYAR DISTRICT,CHAMBER TALUKA,70,308,68,376
TANDO ALLAHYAR DISTRICT,CHAMBER TALUKA,71,342,76,418
TANDO ALLAHYAR DISTRICT,CHAMBER TALUKA,72,254,52,306
TANDO ALLAHYAR DISTRICT,CHAMBER TALUKA,73,225,50,275
TANDO ALLAHYAR DISTRICT,CHAMBER TALUKA,74,245,38,283
TANDO ALLAHYAR DISTRICT,CHAMBER TALUKA,>=75,1475,347,1822
TANDO ALLAHYAR DISTRICT,JHANDO MARI TALUKA,<1,5490,403,5893
TANDO ALLAHYAR DISTRICT,JHANDO MARI TALUKA,1,6332,430,6762
TANDO ALLAHYAR DISTRICT,JHANDO MARI TALUKA,2,7343,527,7870
TANDO ALLAHYAR DISTRICT,JHANDO MARI TALUKA,3,7986,602,8588
TANDO ALLAHYAR DISTRICT,JHANDO MARI TALUKA,4,7939,553,8492
TANDO ALLAHYAR DISTRICT,JHANDO MARI TALUKA,5,8076,665,8741
TANDO ALLAHYAR DISTRICT,JHANDO MARI TALUKA,6,8015,579,8594
TANDO ALLAHYAR DISTRICT,JHANDO MARI TALUKA,7,6937,533,7470
TANDO ALLAHYAR DISTRICT,JHANDO MARI TALUKA,8,8274,677,8951
TANDO ALLAHYAR DISTRICT,JHANDO MARI TALUKA,9,6063,464,6527
TANDO ALLAHYAR DISTRICT,JHANDO MARI TALUKA,10,7314,630,7944
TANDO ALLAHYAR DISTRICT,JHANDO MARI TALUKA,11,4982,401,5383
TANDO ALLAHYAR DISTRICT,JHANDO MARI TALUKA,12,5816,500,6316
TANDO ALLAHYAR DISTRICT,JHANDO MARI TALUKA,13,4417,365,4782
TANDO ALLAHYAR DISTRICT,JHANDO MARI TALUKA,14,4606,402,5008
TANDO ALLAHYAR DISTRICT,JHANDO MARI TALUKA,15,4704,391,5095
TANDO ALLAHYAR DISTRICT,JHANDO MARI TALUKA,16,4499,396,4895
TANDO ALLAHYAR DISTRICT,JHANDO MARI TALUKA,17,3754,308,4062
TANDO ALLAHYAR DISTRICT,JHANDO MARI TALUKA,18,5189,376,5565
TANDO ALLAHYAR DISTRICT,JHANDO MARI TALUKA,19,3988,326,4314
TANDO ALLAHYAR DISTRICT,JHANDO MARI TALUKA,20,4604,418,5022
TANDO ALLAHYAR DISTRICT,JHANDO MARI TALUKA,21,3411,286,3697
TANDO ALLAHYAR DISTRICT,JHANDO MARI TALUKA,22,3308,304,3612
TANDO ALLAHYAR DISTRICT,JHANDO MARI TALUKA,23,2959,257,3216
TANDO ALLAHYAR DISTRICT,JHANDO MARI TALUKA,24,2744,253,2997
TANDO ALLAHYAR DISTRICT,JHANDO MARI TALUKA,25,3457,291,3748
TANDO ALLAHYAR DISTRICT,JHANDO MARI TALUKA,26,2967,232,3199
TANDO ALLAHYAR DISTRICT,JHANDO MARI TALUKA,27,3387,281,3668
TANDO ALLAHYAR DISTRICT,JHANDO MARI TALUKA,28,3242,235,3477
TANDO ALLAHYAR DISTRICT,JHANDO MARI TALUKA,29,3530,373,3903
TANDO ALLAHYAR DISTRICT,JHANDO MARI TALUKA,30,3104,253,3357
TANDO ALLAHYAR DISTRICT,JHANDO MARI TALUKA,31,3448,261,3709
TANDO ALLAHYAR DISTRICT,JHANDO MARI TALUKA,32,3251,238,3489
TANDO ALLAHYAR DISTRICT,JHANDO MARI TALUKA,33,3135,254,3389
TANDO ALLAHYAR DISTRICT,JHANDO MARI TALUKA,34,2821,207,3028
TANDO ALLAHYAR DISTRICT,JHANDO MARI TALUKA,35,2642,223,2865
TANDO ALLAHYAR DISTRICT,JHANDO MARI TALUKA,36,2624,193,2817
TANDO ALLAHYAR DISTRICT,JHANDO MARI TALUKA,37,3736,393,4129
TANDO ALLAHYAR DISTRICT,JHANDO MARI TALUKA,38,2241,171,2412
TANDO ALLAHYAR DISTRICT,JHANDO MARI TALUKA,39,2830,211,3041
TANDO ALLAHYAR DISTRICT,JHANDO MARI TALUKA,40,1824,142,1966
TANDO ALLAHYAR DISTRICT,JHANDO MARI TALUKA,41,2203,166,2369
TANDO ALLAHYAR DISTRICT,JHANDO MARI TALUKA,42,2118,192,2310
TANDO ALLAHYAR DISTRICT,JHANDO MARI TALUKA,43,1787,118,1905
TANDO ALLAHYAR DISTRICT,JHANDO MARI TALUKA,44,1747,130,1877
TANDO ALLAHYAR DISTRICT,JHANDO MARI TALUKA,45,1471,128,1599
TANDO ALLAHYAR DISTRICT,JHANDO MARI TALUKA,46,1594,123,1717
TANDO ALLAHYAR DISTRICT,JHANDO MARI TALUKA,47,2131,200,2331
TANDO ALLAHYAR DISTRICT,JHANDO MARI TALUKA,48,1487,136,1623
TANDO ALLAHYAR DISTRICT,JHANDO MARI TALUKA,49,1683,157,1840
TANDO ALLAHYAR DISTRICT,JHANDO MARI TALUKA,50,1157,94,1251
TANDO ALLAHYAR DISTRICT,JHANDO MARI TALUKA,51,1430,104,1534
TANDO ALLAHYAR DISTRICT,JHANDO MARI TALUKA,52,1277,108,1385
TANDO ALLAHYAR DISTRICT,JHANDO MARI TALUKA,53,1000,80,1080
TANDO ALLAHYAR DISTRICT,JHANDO MARI TALUKA,54,836,77,913
TANDO ALLAHYAR DISTRICT,JHANDO MARI TALUKA,55,728,60,788
TANDO ALLAHYAR DISTRICT,JHANDO MARI TALUKA,56,733,57,790
TANDO ALLAHYAR DISTRICT,JHANDO MARI TALUKA,57,981,98,1079
TANDO ALLAHYAR DISTRICT,JHANDO MARI TALUKA,58,707,61,768
TANDO ALLAHYAR DISTRICT,JHANDO MARI TALUKA,59,882,89,971
TANDO ALLAHYAR DISTRICT,JHANDO MARI TALUKA,60,690,57,747
TANDO ALLAHYAR DISTRICT,JHANDO MARI TALUKA,61,837,45,882
TANDO ALLAHYAR DISTRICT,JHANDO MARI TALUKA,62,784,64,848
TANDO ALLAHYAR DISTRICT,JHANDO MARI TALUKA,63,689,51,740
TANDO ALLAHYAR DISTRICT,JHANDO MARI TALUKA,64,690,67,757
TANDO ALLAHYAR DISTRICT,JHANDO MARI TALUKA,65,569,55,624
TANDO ALLAHYAR DISTRICT,JHANDO MARI TALUKA,66,579,54,633
TANDO ALLAHYAR DISTRICT,JHANDO MARI TALUKA,67,576,50,626
TANDO ALLAHYAR DISTRICT,JHANDO MARI TALUKA,68,464,41,505
TANDO ALLAHYAR DISTRICT,JHANDO MARI TALUKA,69,527,43,570
TANDO ALLAHYAR DISTRICT,JHANDO MARI TALUKA,70,407,32,439
TANDO ALLAHYAR DISTRICT,JHANDO MARI TALUKA,71,443,34,477
TANDO ALLAHYAR DISTRICT,JHANDO MARI TALUKA,72,304,17,321
TANDO ALLAHYAR DISTRICT,JHANDO MARI TALUKA,73,288,28,316
TANDO ALLAHYAR DISTRICT,JHANDO MARI TALUKA,74,285,20,305
TANDO ALLAHYAR DISTRICT,JHANDO MARI TALUKA,>=75,2098,159,2257
TANDO ALLAHYAR DISTRICT,TANDO ALLAHYAR TALUKA,<1,4262,4785,9047
TANDO ALLAHYAR DISTRICT,TANDO ALLAHYAR TALUKA,1,4840,5385,10225
TANDO ALLAHYAR DISTRICT,TANDO ALLAHYAR TALUKA,2,5571,5931,11502
TANDO ALLAHYAR DISTRICT,TANDO ALLAHYAR TALUKA,3,6051,6517,12568
TANDO ALLAHYAR DISTRICT,TANDO ALLAHYAR TALUKA,4,6462,6214,12676
TANDO ALLAHYAR DISTRICT,TANDO ALLAHYAR TALUKA,5,6147,6634,12781
TANDO ALLAHYAR DISTRICT,TANDO ALLAHYAR TALUKA,6,6263,6072,12335
TANDO ALLAHYAR DISTRICT,TANDO ALLAHYAR TALUKA,7,5504,6272,11776
TANDO ALLAHYAR DISTRICT,TANDO ALLAHYAR TALUKA,8,6537,6184,12721
TANDO ALLAHYAR DISTRICT,TANDO ALLAHYAR TALUKA,9,4836,5614,10450
TANDO ALLAHYAR DISTRICT,TANDO ALLAHYAR TALUKA,10,5886,5727,11613
TANDO ALLAHYAR DISTRICT,TANDO ALLAHYAR TALUKA,11,4103,5054,9157
TANDO ALLAHYAR DISTRICT,TANDO ALLAHYAR TALUKA,12,4682,5135,9817
TANDO ALLAHYAR DISTRICT,TANDO ALLAHYAR TALUKA,13,3635,4754,8389
TANDO ALLAHYAR DISTRICT,TANDO ALLAHYAR TALUKA,14,3646,4521,8167
TANDO ALLAHYAR DISTRICT,TANDO ALLAHYAR TALUKA,15,3900,4903,8803
TANDO ALLAHYAR DISTRICT,TANDO ALLAHYAR TALUKA,16,3522,4782,8304
TANDO ALLAHYAR DISTRICT,TANDO ALLAHYAR TALUKA,17,3166,4643,7809
TANDO ALLAHYAR DISTRICT,TANDO ALLAHYAR TALUKA,18,3931,4775,8706
TANDO ALLAHYAR DISTRICT,TANDO ALLAHYAR TALUKA,19,3143,4524,7667
TANDO ALLAHYAR DISTRICT,TANDO ALLAHYAR TALUKA,20,3580,4475,8055
TANDO ALLAHYAR DISTRICT,TANDO ALLAHYAR TALUKA,21,2673,4159,6832
TANDO ALLAHYAR DISTRICT,TANDO ALLAHYAR TALUKA,22,2546,3823,6369
TANDO ALLAHYAR DISTRICT,TANDO ALLAHYAR TALUKA,23,2407,3576,5983
TANDO ALLAHYAR DISTRICT,TANDO ALLAHYAR TALUKA,24,2181,3509,5690
TANDO ALLAHYAR DISTRICT,TANDO ALLAHYAR TALUKA,25,2685,3581,6266
TANDO ALLAHYAR DISTRICT,TANDO ALLAHYAR TALUKA,26,2166,3532,5698
TANDO ALLAHYAR DISTRICT,TANDO ALLAHYAR TALUKA,27,2790,3643,6433
TANDO ALLAHYAR DISTRICT,TANDO ALLAHYAR TALUKA,28,2426,3427,5853
TANDO ALLAHYAR DISTRICT,TANDO ALLAHYAR TALUKA,29,2694,3472,6166
TANDO ALLAHYAR DISTRICT,TANDO ALLAHYAR TALUKA,30,2370,3301,5671
TANDO ALLAHYAR DISTRICT,TANDO ALLAHYAR TALUKA,31,2572,3395,5967
TANDO ALLAHYAR DISTRICT,TANDO ALLAHYAR TALUKA,32,2339,3133,5472
TANDO ALLAHYAR DISTRICT,TANDO ALLAHYAR TALUKA,33,2473,3140,5613
TANDO ALLAHYAR DISTRICT,TANDO ALLAHYAR TALUKA,34,2176,2859,5035
TANDO ALLAHYAR DISTRICT,TANDO ALLAHYAR TALUKA,35,2057,2616,4673
TANDO ALLAHYAR DISTRICT,TANDO ALLAHYAR TALUKA,36,1954,2730,4684
TANDO ALLAHYAR DISTRICT,TANDO ALLAHYAR TALUKA,37,2933,2945,5878
TANDO ALLAHYAR DISTRICT,TANDO ALLAHYAR TALUKA,38,1797,2471,4268
TANDO ALLAHYAR DISTRICT,TANDO ALLAHYAR TALUKA,39,2124,2681,4805
TANDO ALLAHYAR DISTRICT,TANDO ALLAHYAR TALUKA,40,1494,2087,3581
TANDO ALLAHYAR DISTRICT,TANDO ALLAHYAR TALUKA,41,1550,2229,3779
TANDO ALLAHYAR DISTRICT,TANDO ALLAHYAR TALUKA,42,1479,2070,3549
TANDO ALLAHYAR DISTRICT,TANDO ALLAHYAR TALUKA,43,1410,1890,3300
TANDO ALLAHYAR DISTRICT,TANDO ALLAHYAR TALUKA,44,1331,1945,3276
TANDO ALLAHYAR DISTRICT,TANDO ALLAHYAR TALUKA,45,1191,1586,2777
TANDO ALLAHYAR DISTRICT,TANDO ALLAHYAR TALUKA,46,1175,1813,2988
TANDO ALLAHYAR DISTRICT,TANDO ALLAHYAR TALUKA,47,1600,1840,3440
TANDO ALLAHYAR DISTRICT,TANDO ALLAHYAR TALUKA,48,1125,1695,2820
TANDO ALLAHYAR DISTRICT,TANDO ALLAHYAR TALUKA,49,1238,1797,3035
TANDO ALLAHYAR DISTRICT,TANDO ALLAHYAR TALUKA,50,885,1348,2233
TANDO ALLAHYAR DISTRICT,TANDO ALLAHYAR TALUKA,51,1000,1548,2548
TANDO ALLAHYAR DISTRICT,TANDO ALLAHYAR TALUKA,52,952,1269,2221
TANDO ALLAHYAR DISTRICT,TANDO ALLAHYAR TALUKA,53,730,1198,1928
TANDO ALLAHYAR DISTRICT,TANDO ALLAHYAR TALUKA,54,644,1061,1705
TANDO ALLAHYAR DISTRICT,TANDO ALLAHYAR TALUKA,55,589,878,1467
TANDO ALLAHYAR DISTRICT,TANDO ALLAHYAR TALUKA,56,486,910,1396
TANDO ALLAHYAR DISTRICT,TANDO ALLAHYAR TALUKA,57,811,890,1701
TANDO ALLAHYAR DISTRICT,TANDO ALLAHYAR TALUKA,58,554,789,1343
TANDO ALLAHYAR DISTRICT,TANDO ALLAHYAR TALUKA,59,737,847,1584
TANDO ALLAHYAR DISTRICT,TANDO ALLAHYAR TALUKA,60,571,631,1202
TANDO ALLAHYAR DISTRICT,TANDO ALLAHYAR TALUKA,61,596,847,1443
TANDO ALLAHYAR DISTRICT,TANDO ALLAHYAR TALUKA,62,571,719,1290
TANDO ALLAHYAR DISTRICT,TANDO ALLAHYAR TALUKA,63,521,709,1230
TANDO ALLAHYAR DISTRICT,TANDO ALLAHYAR TALUKA,64,549,683,1232
TANDO ALLAHYAR DISTRICT,TANDO ALLAHYAR TALUKA,65,418,561,979
TANDO ALLAHYAR DISTRICT,TANDO ALLAHYAR TALUKA,66,394,474,868
TANDO ALLAHYAR DISTRICT,TANDO ALLAHYAR TALUKA,67,426,492,918
TANDO ALLAHYAR DISTRICT,TANDO ALLAHYAR TALUKA,68,323,461,784
TANDO ALLAHYAR DISTRICT,TANDO ALLAHYAR TALUKA,69,363,422,785
TANDO ALLAHYAR DISTRICT,TANDO ALLAHYAR TALUKA,70,262,361,623
TANDO ALLAHYAR DISTRICT,TANDO ALLAHYAR TALUKA,71,260,353,613
TANDO ALLAHYAR DISTRICT,TANDO ALLAHYAR TALUKA,72,240,314,554
TANDO ALLAHYAR DISTRICT,TANDO ALLAHYAR TALUKA,73,214,316,530
TANDO ALLAHYAR DISTRICT,TANDO ALLAHYAR TALUKA,74,192,243,435
TANDO ALLAHYAR DISTRICT,TANDO ALLAHYAR TALUKA,>=75,1329,1745,3074
TANDO MUHAMMAD KHAN DISTRICT,BULRI SHAH KARIM TALUKA,<1,5112,124,5236
TANDO MUHAMMAD KHAN DISTRICT,BULRI SHAH KARIM TALUKA,1,6045,162,6207
TANDO MUHAMMAD KHAN DISTRICT,BULRI SHAH KARIM TALUKA,2,7266,197,7463
TANDO MUHAMMAD KHAN DISTRICT,BULRI SHAH KARIM TALUKA,3,8249,212,8461
TANDO MUHAMMAD KHAN DISTRICT,BULRI SHAH KARIM TALUKA,4,8693,208,8901
TANDO MUHAMMAD KHAN DISTRICT,BULRI SHAH KARIM TALUKA,5,8414,215,8629
TANDO MUHAMMAD KHAN DISTRICT,BULRI SHAH KARIM TALUKA,6,8102,186,8288
TANDO MUHAMMAD KHAN DISTRICT,BULRI SHAH KARIM TALUKA,7,7153,197,7350
TANDO MUHAMMAD KHAN DISTRICT,BULRI SHAH KARIM TALUKA,8,8533,204,8737
TANDO MUHAMMAD KHAN DISTRICT,BULRI SHAH KARIM TALUKA,9,5861,179,6040
TANDO MUHAMMAD KHAN DISTRICT,BULRI SHAH KARIM TALUKA,10,7639,188,7827
TANDO MUHAMMAD KHAN DISTRICT,BULRI SHAH KARIM TALUKA,11,4702,144,4846
TANDO MUHAMMAD KHAN DISTRICT,BULRI SHAH KARIM TALUKA,12,5795,151,5946
TANDO MUHAMMAD KHAN DISTRICT,BULRI SHAH KARIM TALUKA,13,4273,147,4420
TANDO MUHAMMAD KHAN DISTRICT,BULRI SHAH KARIM TALUKA,14,4659,132,4791
TANDO MUHAMMAD KHAN DISTRICT,BULRI SHAH KARIM TALUKA,15,4941,154,5095
TANDO MUHAMMAD KHAN DISTRICT,BULRI SHAH KARIM TALUKA,16,4549,125,4674
TANDO MUHAMMAD KHAN DISTRICT,BULRI SHAH KARIM TALUKA,17,4012,153,4165
TANDO MUHAMMAD KHAN DISTRICT,BULRI SHAH KARIM TALUKA,18,5376,119,5495
TANDO MUHAMMAD KHAN DISTRICT,BULRI SHAH KARIM TALUKA,19,3840,97,3937
TANDO MUHAMMAD KHAN DISTRICT,BULRI SHAH KARIM TALUKA,20,5132,117,5249
TANDO MUHAMMAD KHAN DISTRICT,BULRI SHAH KARIM TALUKA,21,3273,104,3377
TANDO MUHAMMAD KHAN DISTRICT,BULRI SHAH KARIM TALUKA,22,3580,110,3690
TANDO MUHAMMAD KHAN DISTRICT,BULRI SHAH KARIM TALUKA,23,2921,77,2998
TANDO MUHAMMAD KHAN DISTRICT,BULRI SHAH KARIM TALUKA,24,2713,90,2803
TANDO MUHAMMAD KHAN DISTRICT,BULRI SHAH KARIM TALUKA,25,4109,91,4200
TANDO MUHAMMAD KHAN DISTRICT,BULRI SHAH KARIM TALUKA,26,3233,106,3339
TANDO MUHAMMAD KHAN DISTRICT,BULRI SHAH KARIM TALUKA,27,3431,93,3524
TANDO MUHAMMAD KHAN DISTRICT,BULRI SHAH KARIM TALUKA,28,3672,109,3781
TANDO MUHAMMAD KHAN DISTRICT,BULRI SHAH KARIM TALUKA,29,3400,84,3484
TANDO MUHAMMAD KHAN DISTRICT,BULRI SHAH KARIM TALUKA,30,3703,99,3802
TANDO MUHAMMAD KHAN DISTRICT,BULRI SHAH KARIM TALUKA,31,3200,85,3285
TANDO MUHAMMAD KHAN DISTRICT,BULRI SHAH KARIM TALUKA,32,3059,103,3162
TANDO MUHAMMAD KHAN DISTRICT,BULRI SHAH KARIM TALUKA,33,2812,92,2904
TANDO MUHAMMAD KHAN DISTRICT,BULRI SHAH KARIM TALUKA,34,2589,68,2657
TANDO MUHAMMAD KHAN DISTRICT,BULRI SHAH KARIM TALUKA,35,3195,98,3293
TANDO MUHAMMAD KHAN DISTRICT,BULRI SHAH KARIM TALUKA,36,2816,65,2881
TANDO MUHAMMAD KHAN DISTRICT,BULRI SHAH KARIM TALUKA,37,3456,106,3562
TANDO MUHAMMAD KHAN DISTRICT,BULRI SHAH KARIM TALUKA,38,2641,90,2731
TANDO MUHAMMAD KHAN DISTRICT,BULRI SHAH KARIM TALUKA,39,2830,99,2929
TANDO MUHAMMAD KHAN DISTRICT,BULRI SHAH KARIM TALUKA,40,2420,81,2501
TANDO MUHAMMAD KHAN DISTRICT,BULRI SHAH KARIM TALUKA,41,2311,66,2377
TANDO MUHAMMAD KHAN DISTRICT,BULRI SHAH KARIM TALUKA,42,2150,67,2217
TANDO MUHAMMAD KHAN DISTRICT,BULRI SHAH KARIM TALUKA,43,1916,59,1975
TANDO MUHAMMAD KHAN DISTRICT,BULRI SHAH KARIM TALUKA,44,1700,50,1750
TANDO MUHAMMAD KHAN DISTRICT,BULRI SHAH KARIM TALUKA,45,1688,58,1746
TANDO MUHAMMAD KHAN DISTRICT,BULRI SHAH KARIM TALUKA,46,1872,42,1914
TANDO MUHAMMAD KHAN DISTRICT,BULRI SHAH KARIM TALUKA,47,1996,65,2061
TANDO MUHAMMAD KHAN DISTRICT,BULRI SHAH KARIM TALUKA,48,1578,44,1622
TANDO MUHAMMAD KHAN DISTRICT,BULRI SHAH KARIM TALUKA,49,1603,53,1656
TANDO MUHAMMAD KHAN DISTRICT,BULRI SHAH KARIM TALUKA,50,1412,41,1453
TANDO MUHAMMAD KHAN DISTRICT,BULRI SHAH KARIM TALUKA,51,1340,38,1378
TANDO MUHAMMAD KHAN DISTRICT,BULRI SHAH KARIM TALUKA,52,1191,39,1230
TANDO MUHAMMAD KHAN DISTRICT,BULRI SHAH KARIM TALUKA,53,967,29,996
TANDO MUHAMMAD KHAN DISTRICT,BULRI SHAH KARIM TALUKA,54,914,28,942
TANDO MUHAMMAD KHAN DISTRICT,BULRI SHAH KARIM TALUKA,55,959,28,987
TANDO MUHAMMAD KHAN DISTRICT,BULRI SHAH KARIM TALUKA,56,814,24,838
TANDO MUHAMMAD KHAN DISTRICT,BULRI SHAH KARIM TALUKA,57,1058,29,1087
TANDO MUHAMMAD KHAN DISTRICT,BULRI SHAH KARIM TALUKA,58,863,14,877
TANDO MUHAMMAD KHAN DISTRICT,BULRI SHAH KARIM TALUKA,59,943,23,966
TANDO MUHAMMAD KHAN DISTRICT,BULRI SHAH KARIM TALUKA,60,931,20,951
TANDO MUHAMMAD KHAN DISTRICT,BULRI SHAH KARIM TALUKA,61,923,33,956
TANDO MUHAMMAD KHAN DISTRICT,BULRI SHAH KARIM TALUKA,62,855,28,883
TANDO MUHAMMAD KHAN DISTRICT,BULRI SHAH KARIM TALUKA,63,770,18,788
TANDO MUHAMMAD KHAN DISTRICT,BULRI SHAH KARIM TALUKA,64,896,17,913
TANDO MUHAMMAD KHAN DISTRICT,BULRI SHAH KARIM TALUKA,65,861,26,887
TANDO MUHAMMAD KHAN DISTRICT,BULRI SHAH KARIM TALUKA,66,624,19,643
TANDO MUHAMMAD KHAN DISTRICT,BULRI SHAH KARIM TALUKA,67,615,15,630
TANDO MUHAMMAD KHAN DISTRICT,BULRI SHAH KARIM TALUKA,68,540,16,556
TANDO MUHAMMAD KHAN DISTRICT,BULRI SHAH KARIM TALUKA,69,616,16,632
TANDO MUHAMMAD KHAN DISTRICT,BULRI SHAH KARIM TALUKA,70,522,13,535
TANDO MUHAMMAD KHAN DISTRICT,BULRI SHAH KARIM TALUKA,71,416,14,430
TANDO MUHAMMAD KHAN DISTRICT,BULRI SHAH KARIM TALUKA,72,379,10,389
TANDO MUHAMMAD KHAN DISTRICT,BULRI SHAH KARIM TALUKA,73,340,14,354
TANDO MUHAMMAD KHAN DISTRICT,BULRI SHAH KARIM TALUKA,74,365,8,373
TANDO MUHAMMAD KHAN DISTRICT,BULRI SHAH KARIM TALUKA,>=75,2303,56,2359
TANDO MUHAMMAD KHAN DISTRICT,TANDO GHULAM HYDER TALUKA,<1,3379,802,4181
TANDO MUHAMMAD KHAN DISTRICT,TANDO GHULAM HYDER TALUKA,1,4257,803,5060
TANDO MUHAMMAD KHAN DISTRICT,TANDO GHULAM HYDER TALUKA,2,5257,1110,6367
TANDO MUHAMMAD KHAN DISTRICT,TANDO GHULAM HYDER TALUKA,3,5653,1153,6806
TANDO MUHAMMAD KHAN DISTRICT,TANDO GHULAM HYDER TALUKA,4,5893,1224,7117
TANDO MUHAMMAD KHAN DISTRICT,TANDO GHULAM HYDER TALUKA,5,5738,1246,6984
TANDO MUHAMMAD KHAN DISTRICT,TANDO GHULAM HYDER TALUKA,6,5664,1230,6894
TANDO MUHAMMAD KHAN DISTRICT,TANDO GHULAM HYDER TALUKA,7,4933,1164,6097
TANDO MUHAMMAD KHAN DISTRICT,TANDO GHULAM HYDER TALUKA,8,5872,1179,7051
TANDO MUHAMMAD KHAN DISTRICT,TANDO GHULAM HYDER TALUKA,9,4063,935,4998
TANDO MUHAMMAD KHAN DISTRICT,TANDO GHULAM HYDER TALUKA,10,5119,1034,6153
TANDO MUHAMMAD KHAN DISTRICT,TANDO GHULAM HYDER TALUKA,11,3295,796,4091
TANDO MUHAMMAD KHAN DISTRICT,TANDO GHULAM HYDER TALUKA,12,3838,849,4687
TANDO MUHAMMAD KHAN DISTRICT,TANDO GHULAM HYDER TALUKA,13,2822,747,3569
TANDO MUHAMMAD KHAN DISTRICT,TANDO GHULAM HYDER TALUKA,14,3046,669,3715
TANDO MUHAMMAD KHAN DISTRICT,TANDO GHULAM HYDER TALUKA,15,2955,790,3745
TANDO MUHAMMAD KHAN DISTRICT,TANDO GHULAM HYDER TALUKA,16,2895,689,3584
TANDO MUHAMMAD KHAN DISTRICT,TANDO GHULAM HYDER TALUKA,17,2430,675,3105
TANDO MUHAMMAD KHAN DISTRICT,TANDO GHULAM HYDER TALUKA,18,3517,789,4306
TANDO MUHAMMAD KHAN DISTRICT,TANDO GHULAM HYDER TALUKA,19,2707,660,3367
TANDO MUHAMMAD KHAN DISTRICT,TANDO GHULAM HYDER TALUKA,20,3410,712,4122
TANDO MUHAMMAD KHAN DISTRICT,TANDO GHULAM HYDER TALUKA,21,2109,552,2661
TANDO MUHAMMAD KHAN DISTRICT,TANDO GHULAM HYDER TALUKA,22,2350,513,2863
TANDO MUHAMMAD KHAN DISTRICT,TANDO GHULAM HYDER TALUKA,23,1894,443,2337
TANDO MUHAMMAD KHAN DISTRICT,TANDO GHULAM HYDER TALUKA,24,1841,386,2227
TANDO MUHAMMAD KHAN DISTRICT,TANDO GHULAM HYDER TALUKA,25,2482,527,3009
TANDO MUHAMMAD KHAN DISTRICT,TANDO GHULAM HYDER TALUKA,26,1993,401,2394
TANDO MUHAMMAD KHAN DISTRICT,TANDO GHULAM HYDER TALUKA,27,2161,550,2711
TANDO MUHAMMAD KHAN DISTRICT,TANDO GHULAM HYDER TALUKA,28,2266,475,2741
TANDO MUHAMMAD KHAN DISTRICT,TANDO GHULAM HYDER TALUKA,29,2273,563,2836
TANDO MUHAMMAD KHAN DISTRICT,TANDO GHULAM HYDER TALUKA,30,2159,496,2655
TANDO MUHAMMAD KHAN DISTRICT,TANDO GHULAM HYDER TALUKA,31,2050,462,2512
TANDO MUHAMMAD KHAN DISTRICT,TANDO GHULAM HYDER TALUKA,32,1983,437,2420
TANDO MUHAMMAD KHAN DISTRICT,TANDO GHULAM HYDER TALUKA,33,1817,400,2217
TANDO MUHAMMAD KHAN DISTRICT,TANDO GHULAM HYDER TALUKA,34,1666,370,2036
TANDO MUHAMMAD KHAN DISTRICT,TANDO GHULAM HYDER TALUKA,35,1822,435,2257
TANDO MUHAMMAD KHAN DISTRICT,TANDO GHULAM HYDER TALUKA,36,1939,376,2315
TANDO MUHAMMAD KHAN DISTRICT,TANDO GHULAM HYDER TALUKA,37,2429,522,2951
TANDO MUHAMMAD KHAN DISTRICT,TANDO GHULAM HYDER TALUKA,38,1534,388,1922
TANDO MUHAMMAD KHAN DISTRICT,TANDO GHULAM HYDER TALUKA,39,1740,399,2139
TANDO MUHAMMAD KHAN DISTRICT,TANDO GHULAM HYDER TALUKA,40,1352,331,1683
TANDO MUHAMMAD KHAN DISTRICT,TANDO GHULAM HYDER TALUKA,41,1425,292,1717
TANDO MUHAMMAD KHAN DISTRICT,TANDO GHULAM HYDER TALUKA,42,1444,341,1785
TANDO MUHAMMAD KHAN DISTRICT,TANDO GHULAM HYDER TALUKA,43,1087,259,1346
TANDO MUHAMMAD KHAN DISTRICT,TANDO GHULAM HYDER TALUKA,44,1074,263,1337
TANDO MUHAMMAD KHAN DISTRICT,TANDO GHULAM HYDER TALUKA,45,1005,266,1271
TANDO MUHAMMAD KHAN DISTRICT,TANDO GHULAM HYDER TALUKA,46,1061,190,1251
TANDO MUHAMMAD KHAN DISTRICT,TANDO GHULAM HYDER TALUKA,47,1306,323,1629
TANDO MUHAMMAD KHAN DISTRICT,TANDO GHULAM HYDER TALUKA,48,977,218,1195
TANDO MUHAMMAD KHAN DISTRICT,TANDO GHULAM HYDER TALUKA,49,984,228,1212
TANDO MUHAMMAD KHAN DISTRICT,TANDO GHULAM HYDER TALUKA,50,851,214,1065
TANDO MUHAMMAD KHAN DISTRICT,TANDO GHULAM HYDER TALUKA,51,827,177,1004
TANDO MUHAMMAD KHAN DISTRICT,TANDO GHULAM HYDER TALUKA,52,785,201,986
TANDO MUHAMMAD KHAN DISTRICT,TANDO GHULAM HYDER TALUKA,53,607,141,748
TANDO MUHAMMAD KHAN DISTRICT,TANDO GHULAM HYDER TALUKA,54,534,127,661
TANDO MUHAMMAD KHAN DISTRICT,TANDO GHULAM HYDER TALUKA,55,598,159,757
TANDO MUHAMMAD KHAN DISTRICT,TANDO GHULAM HYDER TALUKA,56,530,101,631
TANDO MUHAMMAD KHAN DISTRICT,TANDO GHULAM HYDER TALUKA,57,680,166,846
TANDO MUHAMMAD KHAN DISTRICT,TANDO GHULAM HYDER TALUKA,58,515,121,636
TANDO MUHAMMAD KHAN DISTRICT,TANDO GHULAM HYDER TALUKA,59,564,141,705
TANDO MUHAMMAD KHAN DISTRICT,TANDO GHULAM HYDER TALUKA,60,514,121,635
TANDO MUHAMMAD KHAN DISTRICT,TANDO GHULAM HYDER TALUKA,61,533,126,659
TANDO MUHAMMAD KHAN DISTRICT,TANDO GHULAM HYDER TALUKA,62,549,117,666
TANDO MUHAMMAD KHAN DISTRICT,TANDO GHULAM HYDER TALUKA,63,540,96,636
TANDO MUHAMMAD KHAN DISTRICT,TANDO GHULAM HYDER TALUKA,64,474,106,580
TANDO MUHAMMAD KHAN DISTRICT,TANDO GHULAM HYDER TALUKA,65,482,85,567
TANDO MUHAMMAD KHAN DISTRICT,TANDO GHULAM HYDER TALUKA,66,436,75,511
TANDO MUHAMMAD KHAN DISTRICT,TANDO GHULAM HYDER TALUKA,67,399,89,488
TANDO MUHAMMAD KHAN DISTRICT,TANDO GHULAM HYDER TALUKA,68,356,70,426
TANDO MUHAMMAD KHAN DISTRICT,TANDO GHULAM HYDER TALUKA,69,380,75,455
TANDO MUHAMMAD KHAN DISTRICT,TANDO GHULAM HYDER TALUKA,70,313,70,383
TANDO MUHAMMAD KHAN DISTRICT,TANDO GHULAM HYDER TALUKA,71,270,79,349
TANDO MUHAMMAD KHAN DISTRICT,TANDO GHULAM HYDER TALUKA,72,226,63,289
TANDO MUHAMMAD KHAN DISTRICT,TANDO GHULAM HYDER TALUKA,73,224,54,278
TANDO MUHAMMAD KHAN DISTRICT,TANDO GHULAM HYDER TALUKA,74,210,47,257
TANDO MUHAMMAD KHAN DISTRICT,TANDO GHULAM HYDER TALUKA,>=75,1532,305,1837
TANDO MUHAMMAD KHAN DISTRICT,TANDO MUHAMMAD KHAN TALUKA,<1,3600,2081,5681
TANDO MUHAMMAD KHAN DISTRICT,TANDO MUHAMMAD KHAN TALUKA,1,4302,2490,6792
TANDO MUHAMMAD KHAN DISTRICT,TANDO MUHAMMAD KHAN TALUKA,2,5122,2614,7736
TANDO MUHAMMAD KHAN DISTRICT,TANDO MUHAMMAD KHAN TALUKA,3,5544,3129,8673
TANDO MUHAMMAD KHAN DISTRICT,TANDO MUHAMMAD KHAN TALUKA,4,5704,2830,8534
TANDO MUHAMMAD KHAN DISTRICT,TANDO MUHAMMAD KHAN TALUKA,5,5703,3027,8730
TANDO MUHAMMAD KHAN DISTRICT,TANDO MUHAMMAD KHAN TALUKA,6,5569,2710,8279
TANDO MUHAMMAD KHAN DISTRICT,TANDO MUHAMMAD KHAN TALUKA,7,4831,2912,7743
TANDO MUHAMMAD KHAN DISTRICT,TANDO MUHAMMAD KHAN TALUKA,8,5760,2794,8554
TANDO MUHAMMAD KHAN DISTRICT,TANDO MUHAMMAD KHAN TALUKA,9,4051,2644,6695
TANDO MUHAMMAD KHAN DISTRICT,TANDO MUHAMMAD KHAN TALUKA,10,5085,2448,7533
TANDO MUHAMMAD KHAN DISTRICT,TANDO MUHAMMAD KHAN TALUKA,11,3162,2291,5453
TANDO MUHAMMAD KHAN DISTRICT,TANDO MUHAMMAD KHAN TALUKA,12,3806,2200,6006
TANDO MUHAMMAD KHAN DISTRICT,TANDO MUHAMMAD KHAN TALUKA,13,2995,2135,5130
TANDO MUHAMMAD KHAN DISTRICT,TANDO MUHAMMAD KHAN TALUKA,14,2981,2046,5027
TANDO MUHAMMAD KHAN DISTRICT,TANDO MUHAMMAD KHAN TALUKA,15,3205,2231,5436
TANDO MUHAMMAD KHAN DISTRICT,TANDO MUHAMMAD KHAN TALUKA,16,3018,2203,5221
TANDO MUHAMMAD KHAN DISTRICT,TANDO MUHAMMAD KHAN TALUKA,17,2430,2120,4550
TANDO MUHAMMAD KHAN DISTRICT,TANDO MUHAMMAD KHAN TALUKA,18,3402,2233,5635
TANDO MUHAMMAD KHAN DISTRICT,TANDO MUHAMMAD KHAN TALUKA,19,2842,2081,4923
TANDO MUHAMMAD KHAN DISTRICT,TANDO MUHAMMAD KHAN TALUKA,20,3580,2146,5726
TANDO MUHAMMAD KHAN DISTRICT,TANDO MUHAMMAD KHAN TALUKA,21,2445,1913,4358
TANDO MUHAMMAD KHAN DISTRICT,TANDO MUHAMMAD KHAN TALUKA,22,2451,1892,4343
TANDO MUHAMMAD KHAN DISTRICT,TANDO MUHAMMAD KHAN TALUKA,23,2055,1763,3818
TANDO MUHAMMAD KHAN DISTRICT,TANDO MUHAMMAD KHAN TALUKA,24,1882,1640,3522
TANDO MUHAMMAD KHAN DISTRICT,TANDO MUHAMMAD KHAN TALUKA,25,2558,1772,4330
TANDO MUHAMMAD KHAN DISTRICT,TANDO MUHAMMAD KHAN TALUKA,26,2147,1727,3874
TANDO MUHAMMAD KHAN DISTRICT,TANDO MUHAMMAD KHAN TALUKA,27,2399,1796,4195
TANDO MUHAMMAD KHAN DISTRICT,TANDO MUHAMMAD KHAN TALUKA,28,2324,1697,4021
TANDO MUHAMMAD KHAN DISTRICT,TANDO MUHAMMAD KHAN TALUKA,29,2618,1812,4430
TANDO MUHAMMAD KHAN DISTRICT,TANDO MUHAMMAD KHAN TALUKA,30,2359,1530,3889
TANDO MUHAMMAD KHAN DISTRICT,TANDO MUHAMMAD KHAN TALUKA,31,2246,1725,3971
TANDO MUHAMMAD KHAN DISTRICT,TANDO MUHAMMAD KHAN TALUKA,32,2042,1535,3577
TANDO MUHAMMAD KHAN DISTRICT,TANDO MUHAMMAD KHAN TALUKA,33,1976,1455,3431
TANDO MUHAMMAD KHAN DISTRICT,TANDO MUHAMMAD KHAN TALUKA,34,1693,1347,3040
TANDO MUHAMMAD KHAN DISTRICT,TANDO MUHAMMAD KHAN TALUKA,35,1845,1211,3056
TANDO MUHAMMAD KHAN DISTRICT,TANDO MUHAMMAD KHAN TALUKA,36,1843,1411,3254
TANDO MUHAMMAD KHAN DISTRICT,TANDO MUHAMMAD KHAN TALUKA,37,2448,1492,3940
TANDO MUHAMMAD KHAN DISTRICT,TANDO MUHAMMAD KHAN TALUKA,38,1564,1263,2827
TANDO MUHAMMAD KHAN DISTRICT,TANDO MUHAMMAD KHAN TALUKA,39,1868,1294,3162
TANDO MUHAMMAD KHAN DISTRICT,TANDO MUHAMMAD KHAN TALUKA,40,1332,975,2307
TANDO MUHAMMAD KHAN DISTRICT,TANDO MUHAMMAD KHAN TALUKA,41,1438,1102,2540
TANDO MUHAMMAD KHAN DISTRICT,TANDO MUHAMMAD KHAN TALUKA,42,1411,990,2401
TANDO MUHAMMAD KHAN DISTRICT,TANDO MUHAMMAD KHAN TALUKA,43,1132,907,2039
TANDO MUHAMMAD KHAN DISTRICT,TANDO MUHAMMAD KHAN TALUKA,44,1078,1022,2100
TANDO MUHAMMAD KHAN DISTRICT,TANDO MUHAMMAD KHAN TALUKA,45,1178,766,1944
TANDO MUHAMMAD KHAN DISTRICT,TANDO MUHAMMAD KHAN TALUKA,46,1161,979,2140
TANDO MUHAMMAD KHAN DISTRICT,TANDO MUHAMMAD KHAN TALUKA,47,1385,865,2250
TANDO MUHAMMAD KHAN DISTRICT,TANDO MUHAMMAD KHAN TALUKA,48,1004,855,1859
TANDO MUHAMMAD KHAN DISTRICT,TANDO MUHAMMAD KHAN TALUKA,49,1098,860,1958
TANDO MUHAMMAD KHAN DISTRICT,TANDO MUHAMMAD KHAN TALUKA,50,915,674,1589
TANDO MUHAMMAD KHAN DISTRICT,TANDO MUHAMMAD KHAN TALUKA,51,901,802,1703
TANDO MUHAMMAD KHAN DISTRICT,TANDO MUHAMMAD KHAN TALUKA,52,747,702,1449
TANDO MUHAMMAD KHAN DISTRICT,TANDO MUHAMMAD KHAN TALUKA,53,621,627,1248
TANDO MUHAMMAD KHAN DISTRICT,TANDO MUHAMMAD KHAN TALUKA,54,532,525,1057
TANDO MUHAMMAD KHAN DISTRICT,TANDO MUHAMMAD KHAN TALUKA,55,559,468,1027
TANDO MUHAMMAD KHAN DISTRICT,TANDO MUHAMMAD KHAN TALUKA,56,543,502,1045
TANDO MUHAMMAD KHAN DISTRICT,TANDO MUHAMMAD KHAN TALUKA,57,748,524,1272
TANDO MUHAMMAD KHAN DISTRICT,TANDO MUHAMMAD KHAN TALUKA,58,478,447,925
TANDO MUHAMMAD KHAN DISTRICT,TANDO MUHAMMAD KHAN TALUKA,59,577,477,1054
TANDO MUHAMMAD KHAN DISTRICT,TANDO MUHAMMAD KHAN TALUKA,60,543,350,893
TANDO MUHAMMAD KHAN DISTRICT,TANDO MUHAMMAD KHAN TALUKA,61,568,478,1046
TANDO MUHAMMAD KHAN DISTRICT,TANDO MUHAMMAD KHAN TALUKA,62,529,436,965
TANDO MUHAMMAD KHAN DISTRICT,TANDO MUHAMMAD KHAN TALUKA,63,484,387,871
TANDO MUHAMMAD KHAN DISTRICT,TANDO MUHAMMAD KHAN TALUKA,64,576,358,934
TANDO MUHAMMAD KHAN DISTRICT,TANDO MUHAMMAD KHAN TALUKA,65,493,293,786
TANDO MUHAMMAD KHAN DISTRICT,TANDO MUHAMMAD KHAN TALUKA,66,383,293,676
TANDO MUHAMMAD KHAN DISTRICT,TANDO MUHAMMAD KHAN TALUKA,67,405,276,681
TANDO MUHAMMAD KHAN DISTRICT,TANDO MUHAMMAD KHAN TALUKA,68,336,236,572
TANDO MUHAMMAD KHAN DISTRICT,TANDO MUHAMMAD KHAN TALUKA,69,382,218,600
TANDO MUHAMMAD KHAN DISTRICT,TANDO MUHAMMAD KHAN TALUKA,70,280,199,479
TANDO MUHAMMAD KHAN DISTRICT,TANDO MUHAMMAD KHAN TALUKA,71,262,215,477
TANDO MUHAMMAD KHAN DISTRICT,TANDO MUHAMMAD KHAN TALUKA,72,229,188,417
TANDO MUHAMMAD KHAN DISTRICT,TANDO MUHAMMAD KHAN TALUKA,73,210,174,384
TANDO MUHAMMAD KHAN DISTRICT,TANDO MUHAMMAD KHAN TALUKA,74,209,122,331
TANDO MUHAMMAD KHAN DISTRICT,TANDO MUHAMMAD KHAN TALUKA,>=75,1354,936,2290
TANK DISTRICT,TANK TEHSIL,<1,10125,1091,11216
TANK DISTRICT,TANK TEHSIL,1,10996,1210,12206
TANK DISTRICT,TANK TEHSIL,2,13100,1437,14537
TANK DISTRICT,TANK TEHSIL,3,13405,1527,14932
TANK DISTRICT,TANK TEHSIL,4,13670,1417,15087
TANK DISTRICT,TANK TEHSIL,5,12966,1562,14528
TANK DISTRICT,TANK TEHSIL,6,12591,1363,13954
TANK DISTRICT,TANK TEHSIL,7,12272,1466,13738
TANK DISTRICT,TANK TEHSIL,8,12238,1333,13571
TANK DISTRICT,TANK TEHSIL,9,11196,1352,12548
TANK DISTRICT,TANK TEHSIL,10,10728,1258,11986
TANK DISTRICT,TANK TEHSIL,11,9055,1248,10303
TANK DISTRICT,TANK TEHSIL,12,8853,1154,10007
TANK DISTRICT,TANK TEHSIL,13,8273,1174,9447
TANK DISTRICT,TANK TEHSIL,14,7983,1026,9009
TANK DISTRICT,TANK TEHSIL,15,7318,1123,8441
TANK DISTRICT,TANK TEHSIL,16,6826,1073,7899
TANK DISTRICT,TANK TEHSIL,17,6735,1020,7755
TANK DISTRICT,TANK TEHSIL,18,6089,877,6966
TANK DISTRICT,TANK TEHSIL,19,5828,880,6708
TANK DISTRICT,TANK TEHSIL,20,6187,828,7015
TANK DISTRICT,TANK TEHSIL,21,5266,898,6164
TANK DISTRICT,TANK TEHSIL,22,4881,810,5691
TANK DISTRICT,TANK TEHSIL,23,5056,848,5904
TANK DISTRICT,TANK TEHSIL,24,5404,778,6182
TANK DISTRICT,TANK TEHSIL,25,5908,846,6754
TANK DISTRICT,TANK TEHSIL,26,5216,935,6151
TANK DISTRICT,TANK TEHSIL,27,5623,832,6455
TANK DISTRICT,TANK TEHSIL,28,4678,742,5420
TANK DISTRICT,TANK TEHSIL,29,4644,751,5395
TANK DISTRICT,TANK TEHSIL,30,4568,716,5284
TANK DISTRICT,TANK TEHSIL,31,4124,671,4795
TANK DISTRICT,TANK TEHSIL,32,3573,643,4216
TANK DISTRICT,TANK TEHSIL,33,3339,593,3932
TANK DISTRICT,TANK TEHSIL,34,3059,573,3632
TANK DISTRICT,TANK TEHSIL,35,3502,540,4042
TANK DISTRICT,TANK TEHSIL,36,3004,524,3528
TANK DISTRICT,TANK TEHSIL,37,3059,467,3526
TANK DISTRICT,TANK TEHSIL,38,2821,490,3311
TANK DISTRICT,TANK TEHSIL,39,2760,492,3252
TANK DISTRICT,TANK TEHSIL,40,3012,449,3461
TANK DISTRICT,TANK TEHSIL,41,2576,405,2981
TANK DISTRICT,TANK TEHSIL,42,2394,404,2798
TANK DISTRICT,TANK TEHSIL,43,2289,381,2670
TANK DISTRICT,TANK TEHSIL,44,2119,353,2472
TANK DISTRICT,TANK TEHSIL,45,2132,332,2464
TANK DISTRICT,TANK TEHSIL,46,1989,324,2313
TANK DISTRICT,TANK TEHSIL,47,2208,360,2568
TANK DISTRICT,TANK TEHSIL,48,2072,320,2392
TANK DISTRICT,TANK TEHSIL,49,2019,330,2349
TANK DISTRICT,TANK TEHSIL,50,2253,357,2610
TANK DISTRICT,TANK TEHSIL,51,2043,296,2339
TANK DISTRICT,TANK TEHSIL,52,1777,283,2060
TANK DISTRICT,TANK TEHSIL,53,1807,266,2073
TANK DISTRICT,TANK TEHSIL,54,1710,218,1928
TANK DISTRICT,TANK TEHSIL,55,1623,222,1845
TANK DISTRICT,TANK TEHSIL,56,1427,208,1635
TANK DISTRICT,TANK TEHSIL,57,1528,194,1722
TANK DISTRICT,TANK TEHSIL,58,1303,187,1490
TANK DISTRICT,TANK TEHSIL,59,1367,185,1552
TANK DISTRICT,TANK TEHSIL,60,1553,203,1756
TANK DISTRICT,TANK TEHSIL,61,1343,167,1510
TANK DISTRICT,TANK TEHSIL,62,1351,175,1526
TANK DISTRICT,TANK TEHSIL,63,1124,204,1328
TANK DISTRICT,TANK TEHSIL,64,1100,155,1255
TANK DISTRICT,TANK TEHSIL,65,961,125,1086
TANK DISTRICT,TANK TEHSIL,66,933,145,1078
TANK DISTRICT,TANK TEHSIL,67,1012,126,1138
TANK DISTRICT,TANK TEHSIL,68,758,110,868
TANK DISTRICT,TANK TEHSIL,69,757,96,853
TANK DISTRICT,TANK TEHSIL,70,696,86,782
TANK DISTRICT,TANK TEHSIL,71,715,114,829
TANK DISTRICT,TANK TEHSIL,72,625,110,735
TANK DISTRICT,TANK TEHSIL,73,506,75,581
TANK DISTRICT,TANK TEHSIL,74,413,50,463
TANK DISTRICT,TANK TEHSIL,>=75,3148,481,3629
THARPARKAR DISTRICT,CHACHRO TALUKA,<1,15866,952,16818
THARPARKAR DISTRICT,CHACHRO TALUKA,1,11835,900,12735
THARPARKAR DISTRICT,CHACHRO TALUKA,2,16156,1034,17190
THARPARKAR DISTRICT,CHACHRO TALUKA,3,13834,920,14754
THARPARKAR DISTRICT,CHACHRO TALUKA,4,15223,939,16162
THARPARKAR DISTRICT,CHACHRO TALUKA,5,12983,838,13821
THARPARKAR DISTRICT,CHACHRO TALUKA,6,14834,883,15717
THARPARKAR DISTRICT,CHACHRO TALUKA,7,10915,709,11624
THARPARKAR DISTRICT,CHACHRO TALUKA,8,14618,863,15481
THARPARKAR DISTRICT,CHACHRO TALUKA,9,11678,749,12427
THARPARKAR DISTRICT,CHACHRO TALUKA,10,12973,777,13750
THARPARKAR DISTRICT,CHACHRO TALUKA,11,10175,595,10770
THARPARKAR DISTRICT,CHACHRO TALUKA,12,10243,622,10865
THARPARKAR DISTRICT,CHACHRO TALUKA,13,8624,551,9175
THARPARKAR DISTRICT,CHACHRO TALUKA,14,9189,494,9683
THARPARKAR DISTRICT,CHACHRO TALUKA,15,8084,475,8559
THARPARKAR DISTRICT,CHACHRO TALUKA,16,7384,403,7787
THARPARKAR DISTRICT,CHACHRO TALUKA,17,6383,450,6833
THARPARKAR DISTRICT,CHACHRO TALUKA,18,5354,440,5794
THARPARKAR DISTRICT,CHACHRO TALUKA,19,4505,388,4893
THARPARKAR DISTRICT,CHACHRO TALUKA,20,4739,403,5142
THARPARKAR DISTRICT,CHACHRO TALUKA,21,4550,376,4926
THARPARKAR DISTRICT,CHACHRO TALUKA,22,3723,289,4012
THARPARKAR DISTRICT,CHACHRO TALUKA,23,3700,378,4078
THARPARKAR DISTRICT,CHACHRO TALUKA,24,3292,307,3599
THARPARKAR DISTRICT,CHACHRO TALUKA,25,2917,260,3177
THARPARKAR DISTRICT,CHACHRO TALUKA,26,3110,277,3387
THARPARKAR DISTRICT,CHACHRO TALUKA,27,3636,372,4008
THARPARKAR DISTRICT,CHACHRO TALUKA,28,3031,315,3346
THARPARKAR DISTRICT,CHACHRO TALUKA,29,3610,342,3952
THARPARKAR DISTRICT,CHACHRO TALUKA,30,2514,199,2713
THARPARKAR DISTRICT,CHACHRO TALUKA,31,3283,313,3596
THARPARKAR DISTRICT,CHACHRO TALUKA,32,3286,318,3604
THARPARKAR DISTRICT,CHACHRO TALUKA,33,2706,260,2966
THARPARKAR DISTRICT,CHACHRO TALUKA,34,2682,259,2941
THARPARKAR DISTRICT,CHACHRO TALUKA,35,2455,193,2648
THARPARKAR DISTRICT,CHACHRO TALUKA,36,2648,198,2846
THARPARKAR DISTRICT,CHACHRO TALUKA,37,3925,369,4294
THARPARKAR DISTRICT,CHACHRO TALUKA,38,2295,191,2486
THARPARKAR DISTRICT,CHACHRO TALUKA,39,2849,275,3124
THARPARKAR DISTRICT,CHACHRO TALUKA,40,1657,109,1766
THARPARKAR DISTRICT,CHACHRO TALUKA,41,2156,192,2348
THARPARKAR DISTRICT,CHACHRO TALUKA,42,2372,194,2566
THARPARKAR DISTRICT,CHACHRO TALUKA,43,1731,158,1889
THARPARKAR DISTRICT,CHACHRO TALUKA,44,1603,143,1746
THARPARKAR DISTRICT,CHACHRO TALUKA,45,1202,108,1310
THARPARKAR DISTRICT,CHACHRO TALUKA,46,1439,144,1583
THARPARKAR DISTRICT,CHACHRO TALUKA,47,2153,169,2322
THARPARKAR DISTRICT,CHACHRO TALUKA,48,1494,104,1598
THARPARKAR DISTRICT,CHACHRO TALUKA,49,1635,176,1811
THARPARKAR DISTRICT,CHACHRO TALUKA,50,1095,85,1180
THARPARKAR DISTRICT,CHACHRO TALUKA,51,1427,139,1566
THARPARKAR DISTRICT,CHACHRO TALUKA,52,1345,91,1436
THARPARKAR DISTRICT,CHACHRO TALUKA,53,1042,124,1166
THARPARKAR DISTRICT,CHACHRO TALUKA,54,995,87,1082
THARPARKAR DISTRICT,CHACHRO TALUKA,55,760,55,815
THARPARKAR DISTRICT,CHACHRO TALUKA,56,764,61,825
THARPARKAR DISTRICT,CHACHRO TALUKA,57,994,77,1071
THARPARKAR DISTRICT,CHACHRO TALUKA,58,889,75,964
THARPARKAR DISTRICT,CHACHRO TALUKA,59,1139,92,1231
THARPARKAR DISTRICT,CHACHRO TALUKA,60,695,52,747
THARPARKAR DISTRICT,CHACHRO TALUKA,61,799,86,885
THARPARKAR DISTRICT,CHACHRO TALUKA,62,767,52,819
THARPARKAR DISTRICT,CHACHRO TALUKA,63,863,72,935
THARPARKAR DISTRICT,CHACHRO TALUKA,64,1272,76,1348
THARPARKAR DISTRICT,CHACHRO TALUKA,65,618,42,660
THARPARKAR DISTRICT,CHACHRO TALUKA,66,588,68,656
THARPARKAR DISTRICT,CHACHRO TALUKA,67,649,43,692
THARPARKAR DISTRICT,CHACHRO TALUKA,68,602,54,656
THARPARKAR DISTRICT,CHACHRO TALUKA,69,979,74,1053
THARPARKAR DISTRICT,CHACHRO TALUKA,70,476,27,503
THARPARKAR DISTRICT,CHACHRO TALUKA,71,466,71,537
THARPARKAR DISTRICT,CHACHRO TALUKA,72,435,29,464
THARPARKAR DISTRICT,CHACHRO TALUKA,73,490,45,535
THARPARKAR DISTRICT,CHACHRO TALUKA,74,709,39,748
THARPARKAR DISTRICT,CHACHRO TALUKA,>=75,3385,226,3611
THARPARKAR DISTRICT,DAHLI TALUKA,<1,16108,482,16590
THARPARKAR DISTRICT,DAHLI TALUKA,1,12156,250,12406
THARPARKAR DISTRICT,DAHLI TALUKA,2,16300,326,16626
THARPARKAR DISTRICT,DAHLI TALUKA,3,13071,361,13432
THARPARKAR DISTRICT,DAHLI TALUKA,4,14197,320,14517
THARPARKAR DISTRICT,DAHLI TALUKA,5,12332,319,12651
THARPARKAR DISTRICT,DAHLI TALUKA,6,13782,300,14082
THARPARKAR DISTRICT,DAHLI TALUKA,7,11605,327,11932
THARPARKAR DISTRICT,DAHLI TALUKA,8,12576,297,12873
THARPARKAR DISTRICT,DAHLI TALUKA,9,12477,302,12779
THARPARKAR DISTRICT,DAHLI TALUKA,10,11216,285,11501
THARPARKAR DISTRICT,DAHLI TALUKA,11,10906,290,11196
THARPARKAR DISTRICT,DAHLI TALUKA,12,9336,254,9590
THARPARKAR DISTRICT,DAHLI TALUKA,13,9410,241,9651
THARPARKAR DISTRICT,DAHLI TALUKA,14,8385,239,8624
THARPARKAR DISTRICT,DAHLI TALUKA,15,8394,224,8618
THARPARKAR DISTRICT,DAHLI TALUKA,16,6165,195,6360
THARPARKAR DISTRICT,DAHLI TALUKA,17,6922,212,7134
THARPARKAR DISTRICT,DAHLI TALUKA,18,3805,112,3917
THARPARKAR DISTRICT,DAHLI TALUKA,19,4027,106,4133
THARPARKAR DISTRICT,DAHLI TALUKA,20,3627,83,3710
THARPARKAR DISTRICT,DAHLI TALUKA,21,4135,81,4216
THARPARKAR DISTRICT,DAHLI TALUKA,22,3249,85,3334
THARPARKAR DISTRICT,DAHLI TALUKA,23,3494,86,3580
THARPARKAR DISTRICT,DAHLI TALUKA,24,3247,64,3311
THARPARKAR DISTRICT,DAHLI TALUKA,25,2614,49,2663
THARPARKAR DISTRICT,DAHLI TALUKA,26,2824,68,2892
THARPARKAR DISTRICT,DAHLI TALUKA,27,3020,73,3093
THARPARKAR DISTRICT,DAHLI TALUKA,28,2507,50,2557
THARPARKAR DISTRICT,DAHLI TALUKA,29,2792,79,2871
THARPARKAR DISTRICT,DAHLI TALUKA,30,2098,49,2147
THARPARKAR DISTRICT,DAHLI TALUKA,31,2548,46,2594
THARPARKAR DISTRICT,DAHLI TALUKA,32,2506,49,2555
THARPARKAR DISTRICT,DAHLI TALUKA,33,2284,48,2332
THARPARKAR DISTRICT,DAHLI TALUKA,34,2236,38,2274
THARPARKAR DISTRICT,DAHLI TALUKA,35,1958,57,2015
THARPARKAR DISTRICT,DAHLI TALUKA,36,2161,46,2207
THARPARKAR DISTRICT,DAHLI TALUKA,37,3136,70,3206
THARPARKAR DISTRICT,DAHLI TALUKA,38,2090,51,2141
THARPARKAR DISTRICT,DAHLI TALUKA,39,2231,54,2285
THARPARKAR DISTRICT,DAHLI TALUKA,40,1417,32,1449
THARPARKAR DISTRICT,DAHLI TALUKA,41,1413,26,1439
THARPARKAR DISTRICT,DAHLI TALUKA,42,1737,36,1773
THARPARKAR DISTRICT,DAHLI TALUKA,43,1210,34,1244
THARPARKAR DISTRICT,DAHLI TALUKA,44,1278,35,1313
THARPARKAR DISTRICT,DAHLI TALUKA,45,1029,40,1069
THARPARKAR DISTRICT,DAHLI TALUKA,46,1078,26,1104
THARPARKAR DISTRICT,DAHLI TALUKA,47,1534,50,1584
THARPARKAR DISTRICT,DAHLI TALUKA,48,1191,41,1232
THARPARKAR DISTRICT,DAHLI TALUKA,49,1281,43,1324
THARPARKAR DISTRICT,DAHLI TALUKA,50,893,32,925
THARPARKAR DISTRICT,DAHLI TALUKA,51,996,33,1029
THARPARKAR DISTRICT,DAHLI TALUKA,52,1041,26,1067
THARPARKAR DISTRICT,DAHLI TALUKA,53,801,26,827
THARPARKAR DISTRICT,DAHLI TALUKA,54,708,19,727
THARPARKAR DISTRICT,DAHLI TALUKA,55,614,15,629
THARPARKAR DISTRICT,DAHLI TALUKA,56,584,16,600
THARPARKAR DISTRICT,DAHLI TALUKA,57,766,16,782
THARPARKAR DISTRICT,DAHLI TALUKA,58,668,21,689
THARPARKAR DISTRICT,DAHLI TALUKA,59,762,15,777
THARPARKAR DISTRICT,DAHLI TALUKA,60,530,19,549
THARPARKAR DISTRICT,DAHLI TALUKA,61,592,13,605
THARPARKAR DISTRICT,DAHLI TALUKA,62,545,15,560
THARPARKAR DISTRICT,DAHLI TALUKA,63,574,19,593
THARPARKAR DISTRICT,DAHLI TALUKA,64,659,10,669
THARPARKAR DISTRICT,DAHLI TALUKA,65,429,12,441
THARPARKAR DISTRICT,DAHLI TALUKA,66,447,9,456
THARPARKAR DISTRICT,DAHLI TALUKA,67,496,10,506
THARPARKAR DISTRICT,DAHLI TALUKA,68,386,15,401
THARPARKAR DISTRICT,DAHLI TALUKA,69,551,12,563
THARPARKAR DISTRICT,DAHLI TALUKA,70,364,9,373
THARPARKAR DISTRICT,DAHLI TALUKA,71,379,9,388
THARPARKAR DISTRICT,DAHLI TALUKA,72,322,7,329
THARPARKAR DISTRICT,DAHLI TALUKA,73,287,11,298
THARPARKAR DISTRICT,DAHLI TALUKA,74,341,9,350
THARPARKAR DISTRICT,DAHLI TALUKA,>=75,2215,55,2270
THARPARKAR DISTRICT,DIPLO TALUKA,<1,4020,358,4378
THARPARKAR DISTRICT,DIPLO TALUKA,1,4073,382,4455
THARPARKAR DISTRICT,DIPLO TALUKA,2,5084,406,5490
THARPARKAR DISTRICT,DIPLO TALUKA,3,4924,405,5329
THARPARKAR DISTRICT,DIPLO TALUKA,4,5013,401,5414
THARPARKAR DISTRICT,DIPLO TALUKA,5,4836,388,5224
THARPARKAR DISTRICT,DIPLO TALUKA,6,4462,377,4839
THARPARKAR DISTRICT,DIPLO TALUKA,7,3635,367,4002
THARPARKAR DISTRICT,DIPLO TALUKA,8,4800,376,5176
THARPARKAR DISTRICT,DIPLO TALUKA,9,3481,311,3792
THARPARKAR DISTRICT,DIPLO TALUKA,10,4093,285,4378
THARPARKAR DISTRICT,DIPLO TALUKA,11,3052,313,3365
THARPARKAR DISTRICT,DIPLO TALUKA,12,3331,286,3617
THARPARKAR DISTRICT,DIPLO TALUKA,13,2742,286,3028
THARPARKAR DISTRICT,DIPLO TALUKA,14,2668,275,2943
THARPARKAR DISTRICT,DIPLO TALUKA,15,2742,285,3027
THARPARKAR DISTRICT,DIPLO TALUKA,16,2443,254,2697
THARPARKAR DISTRICT,DIPLO TALUKA,17,2126,271,2397
THARPARKAR DISTRICT,DIPLO TALUKA,18,2697,191,2888
THARPARKAR DISTRICT,DIPLO TALUKA,19,2147,223,2370
THARPARKAR DISTRICT,DIPLO TALUKA,20,2462,221,2683
THARPARKAR DISTRICT,DIPLO TALUKA,21,2220,277,2497
THARPARKAR DISTRICT,DIPLO TALUKA,22,2027,208,2235
THARPARKAR DISTRICT,DIPLO TALUKA,23,1872,234,2106
THARPARKAR DISTRICT,DIPLO TALUKA,24,1689,192,1881
THARPARKAR DISTRICT,DIPLO TALUKA,25,1829,178,2007
THARPARKAR DISTRICT,DIPLO TALUKA,26,1667,190,1857
THARPARKAR DISTRICT,DIPLO TALUKA,27,1962,235,2197
THARPARKAR DISTRICT,DIPLO TALUKA,28,1797,185,1982
THARPARKAR DISTRICT,DIPLO TALUKA,29,1995,257,2252
THARPARKAR DISTRICT,DIPLO TALUKA,30,1682,161,1843
THARPARKAR DISTRICT,DIPLO TALUKA,31,1976,241,2217
THARPARKAR DISTRICT,DIPLO TALUKA,32,1969,213,2182
THARPARKAR DISTRICT,DIPLO TALUKA,33,1604,195,1799
THARPARKAR DISTRICT,DIPLO TALUKA,34,1549,169,1718
THARPARKAR DISTRICT,DIPLO TALUKA,35,1499,151,1650
THARPARKAR DISTRICT,DIPLO TALUKA,36,1504,143,1647
THARPARKAR DISTRICT,DIPLO TALUKA,37,2480,262,2742
THARPARKAR DISTRICT,DIPLO TALUKA,38,1354,118,1472
THARPARKAR DISTRICT,DIPLO TALUKA,39,1750,217,1967
THARPARKAR DISTRICT,DIPLO TALUKA,40,1011,106,1117
THARPARKAR DISTRICT,DIPLO TALUKA,41,1282,136,1418
THARPARKAR DISTRICT,DIPLO TALUKA,42,1346,136,1482
THARPARKAR DISTRICT,DIPLO TALUKA,43,993,130,1123
THARPARKAR DISTRICT,DIPLO TALUKA,44,970,110,1080
THARPARKAR DISTRICT,DIPLO TALUKA,45,791,65,856
THARPARKAR DISTRICT,DIPLO TALUKA,46,907,98,1005
THARPARKAR DISTRICT,DIPLO TALUKA,47,1443,143,1586
THARPARKAR DISTRICT,DIPLO TALUKA,48,810,89,899
THARPARKAR DISTRICT,DIPLO TALUKA,49,1042,122,1164
THARPARKAR DISTRICT,DIPLO TALUKA,50,643,50,693
THARPARKAR DISTRICT,DIPLO TALUKA,51,921,130,1051
THARPARKAR DISTRICT,DIPLO TALUKA,52,925,80,1005
THARPARKAR DISTRICT,DIPLO TALUKA,53,586,67,653
THARPARKAR DISTRICT,DIPLO TALUKA,54,529,70,599
THARPARKAR DISTRICT,DIPLO TALUKA,55,470,44,514
THARPARKAR DISTRICT,DIPLO TALUKA,56,485,40,525
THARPARKAR DISTRICT,DIPLO TALUKA,57,819,65,884
THARPARKAR DISTRICT,DIPLO TALUKA,58,617,45,662
THARPARKAR DISTRICT,DIPLO TALUKA,59,743,86,829
THARPARKAR DISTRICT,DIPLO TALUKA,60,446,32,478
THARPARKAR DISTRICT,DIPLO TALUKA,61,580,107,687
THARPARKAR DISTRICT,DIPLO TALUKA,62,551,55,606
THARPARKAR DISTRICT,DIPLO TALUKA,63,575,63,638
THARPARKAR DISTRICT,DIPLO TALUKA,64,925,64,989
THARPARKAR DISTRICT,DIPLO TALUKA,65,330,42,372
THARPARKAR DISTRICT,DIPLO TALUKA,66,348,62,410
THARPARKAR DISTRICT,DIPLO TALUKA,67,467,39,506
THARPARKAR DISTRICT,DIPLO TALUKA,68,384,28,412
THARPARKAR DISTRICT,DIPLO TALUKA,69,763,50,813
THARPARKAR DISTRICT,DIPLO TALUKA,70,284,20,304
THARPARKAR DISTRICT,DIPLO TALUKA,71,302,50,352
THARPARKAR DISTRICT,DIPLO TALUKA,72,226,14,240
THARPARKAR DISTRICT,DIPLO TALUKA,73,249,21,270
THARPARKAR DISTRICT,DIPLO TALUKA,74,485,34,519
THARPARKAR DISTRICT,DIPLO TALUKA,>=75,2225,162,2387
THARPARKAR DISTRICT,ISLAMKOT TALUKA,<1,7446,436,7882
THARPARKAR DISTRICT,ISLAMKOT TALUKA,1,6958,533,7491
THARPARKAR DISTRICT,ISLAMKOT TALUKA,2,9129,552,9681
THARPARKAR DISTRICT,ISLAMKOT TALUKA,3,8066,563,8629
THARPARKAR DISTRICT,ISLAMKOT TALUKA,4,9197,621,9818
THARPARKAR DISTRICT,ISLAMKOT TALUKA,5,8235,581,8816
THARPARKAR DISTRICT,ISLAMKOT TALUKA,6,8912,533,9445
THARPARKAR DISTRICT,ISLAMKOT TALUKA,7,6104,560,6664
THARPARKAR DISTRICT,ISLAMKOT TALUKA,8,9620,603,10223
THARPARKAR DISTRICT,ISLAMKOT TALUKA,9,6221,528,6749
THARPARKAR DISTRICT,ISLAMKOT TALUKA,10,8114,508,8622
THARPARKAR DISTRICT,ISLAMKOT TALUKA,11,4926,445,5371
THARPARKAR DISTRICT,ISLAMKOT TALUKA,12,6382,430,6812
THARPARKAR DISTRICT,ISLAMKOT TALUKA,13,4380,429,4809
THARPARKAR DISTRICT,ISLAMKOT TALUKA,14,4855,384,5239
THARPARKAR DISTRICT,ISLAMKOT TALUKA,15,4696,419,5115
THARPARKAR DISTRICT,ISLAMKOT TALUKA,16,4209,329,4538
THARPARKAR DISTRICT,ISLAMKOT TALUKA,17,3270,365,3635
THARPARKAR DISTRICT,ISLAMKOT TALUKA,18,4680,390,5070
THARPARKAR DISTRICT,ISLAMKOT TALUKA,19,3342,384,3726
THARPARKAR DISTRICT,ISLAMKOT TALUKA,20,4648,346,4994
THARPARKAR DISTRICT,ISLAMKOT TALUKA,21,3306,370,3676
THARPARKAR DISTRICT,ISLAMKOT TALUKA,22,3076,265,3341
THARPARKAR DISTRICT,ISLAMKOT TALUKA,23,2909,335,3244
THARPARKAR DISTRICT,ISLAMKOT TALUKA,24,2207,242,2449
THARPARKAR DISTRICT,ISLAMKOT TALUKA,25,3170,284,3454
THARPARKAR DISTRICT,ISLAMKOT TALUKA,26,2288,260,2548
THARPARKAR DISTRICT,ISLAMKOT TALUKA,27,2754,276,3030
THARPARKAR DISTRICT,ISLAMKOT TALUKA,28,3037,226,3263
THARPARKAR DISTRICT,ISLAMKOT TALUKA,29,3244,325,3569
THARPARKAR DISTRICT,ISLAMKOT TALUKA,30,3012,235,3247
THARPARKAR DISTRICT,ISLAMKOT TALUKA,31,3225,296,3521
THARPARKAR DISTRICT,ISLAMKOT TALUKA,32,2982,320,3302
THARPARKAR DISTRICT,ISLAMKOT TALUKA,33,2536,253,2789
THARPARKAR DISTRICT,ISLAMKOT TALUKA,34,2394,223,2617
THARPARKAR DISTRICT,ISLAMKOT TALUKA,35,2443,201,2644
THARPARKAR DISTRICT,ISLAMKOT TALUKA,36,2450,226,2676
THARPARKAR DISTRICT,ISLAMKOT TALUKA,37,3082,341,3423
THARPARKAR DISTRICT,ISLAMKOT TALUKA,38,2169,192,2361
THARPARKAR DISTRICT,ISLAMKOT TALUKA,39,2554,271,2825
THARPARKAR DISTRICT,ISLAMKOT TALUKA,40,1814,130,1944
THARPARKAR DISTRICT,ISLAMKOT TALUKA,41,2110,180,2290
THARPARKAR DISTRICT,ISLAMKOT TALUKA,42,1886,207,2093
THARPARKAR DISTRICT,ISLAMKOT TALUKA,43,1538,156,1694
THARPARKAR DISTRICT,ISLAMKOT TALUKA,44,1496,156,1652
THARPARKAR DISTRICT,ISLAMKOT TALUKA,45,1370,99,1469
THARPARKAR DISTRICT,ISLAMKOT TALUKA,46,1559,147,1706
THARPARKAR DISTRICT,ISLAMKOT TALUKA,47,2023,195,2218
THARPARKAR DISTRICT,ISLAMKOT TALUKA,48,1286,108,1394
THARPARKAR DISTRICT,ISLAMKOT TALUKA,49,1476,141,1617
THARPARKAR DISTRICT,ISLAMKOT TALUKA,50,1163,89,1252
THARPARKAR DISTRICT,ISLAMKOT TALUKA,51,1432,145,1577
THARPARKAR DISTRICT,ISLAMKOT TALUKA,52,1000,108,1108
THARPARKAR DISTRICT,ISLAMKOT TALUKA,53,939,104,1043
THARPARKAR DISTRICT,ISLAMKOT TALUKA,54,787,76,863
THARPARKAR DISTRICT,ISLAMKOT TALUKA,55,724,49,773
THARPARKAR DISTRICT,ISLAMKOT TALUKA,56,775,67,842
THARPARKAR DISTRICT,ISLAMKOT TALUKA,57,954,91,1045
THARPARKAR DISTRICT,ISLAMKOT TALUKA,58,907,76,983
THARPARKAR DISTRICT,ISLAMKOT TALUKA,59,985,112,1097
THARPARKAR DISTRICT,ISLAMKOT TALUKA,60,817,39,856
THARPARKAR DISTRICT,ISLAMKOT TALUKA,61,830,83,913
THARPARKAR DISTRICT,ISLAMKOT TALUKA,62,708,55,763
THARPARKAR DISTRICT,ISLAMKOT TALUKA,63,1016,80,1096
THARPARKAR DISTRICT,ISLAMKOT TALUKA,64,1225,70,1295
THARPARKAR DISTRICT,ISLAMKOT TALUKA,65,591,47,638
THARPARKAR DISTRICT,ISLAMKOT TALUKA,66,561,60,621
THARPARKAR DISTRICT,ISLAMKOT TALUKA,67,648,54,702
THARPARKAR DISTRICT,ISLAMKOT TALUKA,68,749,42,791
THARPARKAR DISTRICT,ISLAMKOT TALUKA,69,944,67,1011
THARPARKAR DISTRICT,ISLAMKOT TALUKA,70,474,24,498
THARPARKAR DISTRICT,ISLAMKOT TALUKA,71,399,50,449
THARPARKAR DISTRICT,ISLAMKOT TALUKA,72,321,32,353
THARPARKAR DISTRICT,ISLAMKOT TALUKA,73,494,34,528
THARPARKAR DISTRICT,ISLAMKOT TALUKA,74,638,38,676
THARPARKAR DISTRICT,ISLAMKOT TALUKA,>=75,3060,221,3281
THARPARKAR DISTRICT,KALOI TALUKA,<1,3465,0,3465
THARPARKAR DISTRICT,KALOI TALUKA,1,3823,0,3823
THARPARKAR DISTRICT,KALOI TALUKA,2,4629,0,4629
THARPARKAR DISTRICT,KALOI TALUKA,3,4850,0,4850
THARPARKAR DISTRICT,KALOI TALUKA,4,4578,0,4578
THARPARKAR DISTRICT,KALOI TALUKA,5,4622,0,4622
THARPARKAR DISTRICT,KALOI TALUKA,6,4274,0,4274
THARPARKAR DISTRICT,KALOI TALUKA,7,3650,0,3650
THARPARKAR DISTRICT,KALOI TALUKA,8,4343,0,4343
THARPARKAR DISTRICT,KALOI TALUKA,9,3078,0,3078
THARPARKAR DISTRICT,KALOI TALUKA,10,3789,0,3789
THARPARKAR DISTRICT,KALOI TALUKA,11,2635,0,2635
THARPARKAR DISTRICT,KALOI TALUKA,12,2862,0,2862
THARPARKAR DISTRICT,KALOI TALUKA,13,2322,0,2322
THARPARKAR DISTRICT,KALOI TALUKA,14,2190,0,2190
THARPARKAR DISTRICT,KALOI TALUKA,15,2268,0,2268
THARPARKAR DISTRICT,KALOI TALUKA,16,1995,0,1995
THARPARKAR DISTRICT,KALOI TALUKA,17,1875,0,1875
THARPARKAR DISTRICT,KALOI TALUKA,18,2318,0,2318
THARPARKAR DISTRICT,KALOI TALUKA,19,1876,0,1876
THARPARKAR DISTRICT,KALOI TALUKA,20,2122,0,2122
THARPARKAR DISTRICT,KALOI TALUKA,21,1781,0,1781
THARPARKAR DISTRICT,KALOI TALUKA,22,1693,0,1693
THARPARKAR DISTRICT,KALOI TALUKA,23,1703,0,1703
THARPARKAR DISTRICT,KALOI TALUKA,24,1455,0,1455
THARPARKAR DISTRICT,KALOI TALUKA,25,1748,0,1748
THARPARKAR DISTRICT,KALOI TALUKA,26,1648,0,1648
THARPARKAR DISTRICT,KALOI TALUKA,27,1881,0,1881
THARPARKAR DISTRICT,KALOI TALUKA,28,1654,0,1654
THARPARKAR DISTRICT,KALOI TALUKA,29,1894,0,1894
THARPARKAR DISTRICT,KALOI TALUKA,30,1500,0,1500
THARPARKAR DISTRICT,KALOI TALUKA,31,1714,0,1714
THARPARKAR DISTRICT,KALOI TALUKA,32,1638,0,1638
THARPARKAR DISTRICT,KALOI TALUKA,33,1444,0,1444
THARPARKAR DISTRICT,KALOI TALUKA,34,1316,0,1316
THARPARKAR DISTRICT,KALOI TALUKA,35,1251,0,1251
THARPARKAR DISTRICT,KALOI TALUKA,36,1236,0,1236
THARPARKAR DISTRICT,KALOI TALUKA,37,2038,0,2038
THARPARKAR DISTRICT,KALOI TALUKA,38,1090,0,1090
THARPARKAR DISTRICT,KALOI TALUKA,39,1436,0,1436
THARPARKAR DISTRICT,KALOI TALUKA,40,829,0,829
THARPARKAR DISTRICT,KALOI TALUKA,41,992,0,992
THARPARKAR DISTRICT,KALOI TALUKA,42,1157,0,1157
THARPARKAR DISTRICT,KALOI TALUKA,43,793,0,793
THARPARKAR DISTRICT,KALOI TALUKA,44,840,0,840
THARPARKAR DISTRICT,KALOI TALUKA,45,691,0,691
THARPARKAR DISTRICT,KALOI TALUKA,46,727,0,727
THARPARKAR DISTRICT,KALOI TALUKA,47,1122,0,1122
THARPARKAR DISTRICT,KALOI TALUKA,48,666,0,666
THARPARKAR DISTRICT,KALOI TALUKA,49,781,0,781
THARPARKAR DISTRICT,KALOI TALUKA,50,515,0,515
THARPARKAR DISTRICT,KALOI TALUKA,51,754,0,754
THARPARKAR DISTRICT,KALOI TALUKA,52,611,0,611
THARPARKAR DISTRICT,KALOI TALUKA,53,478,0,478
THARPARKAR DISTRICT,KALOI TALUKA,54,409,0,409
THARPARKAR DISTRICT,KALOI TALUKA,55,370,0,370
THARPARKAR DISTRICT,KALOI TALUKA,56,413,0,413
THARPARKAR DISTRICT,KALOI TALUKA,57,626,0,626
THARPARKAR DISTRICT,KALOI TALUKA,58,397,0,397
THARPARKAR DISTRICT,KALOI TALUKA,59,458,0,458
THARPARKAR DISTRICT,KALOI TALUKA,60,386,0,386
THARPARKAR DISTRICT,KALOI TALUKA,61,502,0,502
THARPARKAR DISTRICT,KALOI TALUKA,62,446,0,446
THARPARKAR DISTRICT,KALOI TALUKA,63,419,0,419
THARPARKAR DISTRICT,KALOI TALUKA,64,460,0,460
THARPARKAR DISTRICT,KALOI TALUKA,65,275,0,275
THARPARKAR DISTRICT,KALOI TALUKA,66,362,0,362
THARPARKAR DISTRICT,KALOI TALUKA,67,369,0,369
THARPARKAR DISTRICT,KALOI TALUKA,68,302,0,302
THARPARKAR DISTRICT,KALOI TALUKA,69,367,0,367
THARPARKAR DISTRICT,KALOI TALUKA,70,205,0,205
THARPARKAR DISTRICT,KALOI TALUKA,71,276,0,276
THARPARKAR DISTRICT,KALOI TALUKA,72,164,0,164
THARPARKAR DISTRICT,KALOI TALUKA,73,202,0,202
THARPARKAR DISTRICT,KALOI TALUKA,74,211,0,211
THARPARKAR DISTRICT,KALOI TALUKA,>=75,1350,0,1350
THARPARKAR DISTRICT,MITHI TALUKA,<1,4473,1155,5628
THARPARKAR DISTRICT,MITHI TALUKA,1,5175,1547,6722
THARPARKAR DISTRICT,MITHI TALUKA,2,5711,1536,7247
THARPARKAR DISTRICT,MITHI TALUKA,3,6081,1610,7691
THARPARKAR DISTRICT,MITHI TALUKA,4,5928,1606,7534
THARPARKAR DISTRICT,MITHI TALUKA,5,5985,1748,7733
THARPARKAR DISTRICT,MITHI TALUKA,6,5961,1555,7516
THARPARKAR DISTRICT,MITHI TALUKA,7,4356,1503,5859
THARPARKAR DISTRICT,MITHI TALUKA,8,6418,1619,8037
THARPARKAR DISTRICT,MITHI TALUKA,9,4590,1483,6073
THARPARKAR DISTRICT,MITHI TALUKA,10,5415,1395,6810
THARPARKAR DISTRICT,MITHI TALUKA,11,3700,1312,5012
THARPARKAR DISTRICT,MITHI TALUKA,12,4181,1400,5581
THARPARKAR DISTRICT,MITHI TALUKA,13,3545,1330,4875
THARPARKAR DISTRICT,MITHI TALUKA,14,3221,1221,4442
THARPARKAR DISTRICT,MITHI TALUKA,15,3620,1354,4974
THARPARKAR DISTRICT,MITHI TALUKA,16,3009,1196,4205
THARPARKAR DISTRICT,MITHI TALUKA,17,2731,1324,4055
THARPARKAR DISTRICT,MITHI TALUKA,18,3286,1159,4445
THARPARKAR DISTRICT,MITHI TALUKA,19,2496,1252,3748
THARPARKAR DISTRICT,MITHI TALUKA,20,3092,1116,4208
THARPARKAR DISTRICT,MITHI TALUKA,21,2668,1262,3930
THARPARKAR DISTRICT,MITHI TALUKA,22,2294,1072,3366
THARPARKAR DISTRICT,MITHI TALUKA,23,2373,1134,3507
THARPARKAR DISTRICT,MITHI TALUKA,24,1860,975,2835
THARPARKAR DISTRICT,MITHI TALUKA,25,2067,893,2960
THARPARKAR DISTRICT,MITHI TALUKA,26,1892,915,2807
THARPARKAR DISTRICT,MITHI TALUKA,27,2363,976,3339
THARPARKAR DISTRICT,MITHI TALUKA,28,2005,842,2847
THARPARKAR DISTRICT,MITHI TALUKA,29,2345,894,3239
THARPARKAR DISTRICT,MITHI TALUKA,30,1832,721,2553
THARPARKAR DISTRICT,MITHI TALUKA,31,2308,994,3302
THARPARKAR DISTRICT,MITHI TALUKA,32,2232,923,3155
THARPARKAR DISTRICT,MITHI TALUKA,33,1841,743,2584
THARPARKAR DISTRICT,MITHI TALUKA,34,1715,748,2463
THARPARKAR DISTRICT,MITHI TALUKA,35,1679,612,2291
THARPARKAR DISTRICT,MITHI TALUKA,36,1601,706,2307
THARPARKAR DISTRICT,MITHI TALUKA,37,2752,975,3727
THARPARKAR DISTRICT,MITHI TALUKA,38,1435,697,2132
THARPARKAR DISTRICT,MITHI TALUKA,39,1958,807,2765
THARPARKAR DISTRICT,MITHI TALUKA,40,1013,543,1556
THARPARKAR DISTRICT,MITHI TALUKA,41,1357,660,2017
THARPARKAR DISTRICT,MITHI TALUKA,42,1520,564,2084
THARPARKAR DISTRICT,MITHI TALUKA,43,1086,565,1651
THARPARKAR DISTRICT,MITHI TALUKA,44,1104,588,1692
THARPARKAR DISTRICT,MITHI TALUKA,45,851,447,1298
THARPARKAR DISTRICT,MITHI TALUKA,46,1063,425,1488
THARPARKAR DISTRICT,MITHI TALUKA,47,1607,531,2138
THARPARKAR DISTRICT,MITHI TALUKA,48,990,478,1468
THARPARKAR DISTRICT,MITHI TALUKA,49,1229,523,1752
THARPARKAR DISTRICT,MITHI TALUKA,50,798,383,1181
THARPARKAR DISTRICT,MITHI TALUKA,51,1025,515,1540
THARPARKAR DISTRICT,MITHI TALUKA,52,1031,391,1422
THARPARKAR DISTRICT,MITHI TALUKA,53,664,386,1050
THARPARKAR DISTRICT,MITHI TALUKA,54,666,322,988
THARPARKAR DISTRICT,MITHI TALUKA,55,528,220,748
THARPARKAR DISTRICT,MITHI TALUKA,56,550,195,745
THARPARKAR DISTRICT,MITHI TALUKA,57,830,284,1114
THARPARKAR DISTRICT,MITHI TALUKA,58,639,276,915
THARPARKAR DISTRICT,MITHI TALUKA,59,846,277,1123
THARPARKAR DISTRICT,MITHI TALUKA,60,537,233,770
THARPARKAR DISTRICT,MITHI TALUKA,61,606,241,847
THARPARKAR DISTRICT,MITHI TALUKA,62,650,245,895
THARPARKAR DISTRICT,MITHI TALUKA,63,634,244,878
THARPARKAR DISTRICT,MITHI TALUKA,64,887,284,1171
THARPARKAR DISTRICT,MITHI TALUKA,65,517,176,693
THARPARKAR DISTRICT,MITHI TALUKA,66,356,156,512
THARPARKAR DISTRICT,MITHI TALUKA,67,512,164,676
THARPARKAR DISTRICT,MITHI TALUKA,68,454,138,592
THARPARKAR DISTRICT,MITHI TALUKA,69,733,184,917
THARPARKAR DISTRICT,MITHI TALUKA,70,386,123,509
THARPARKAR DISTRICT,MITHI TALUKA,71,274,125,399
THARPARKAR DISTRICT,MITHI TALUKA,72,310,106,416
THARPARKAR DISTRICT,MITHI TALUKA,73,325,119,444
THARPARKAR DISTRICT,MITHI TALUKA,74,486,141,627
THARPARKAR DISTRICT,MITHI TALUKA,>=75,2363,718,3081
THARPARKAR DISTRICT,NAGAR PARKAR TALUKA,<1,7722,338,8060
THARPARKAR DISTRICT,NAGAR PARKAR TALUKA,1,8628,425,9053
THARPARKAR DISTRICT,NAGAR PARKAR TALUKA,2,10629,446,11075
THARPARKAR DISTRICT,NAGAR PARKAR TALUKA,3,9324,478,9802
THARPARKAR DISTRICT,NAGAR PARKAR TALUKA,4,10205,458,10663
THARPARKAR DISTRICT,NAGAR PARKAR TALUKA,5,8787,425,9212
THARPARKAR DISTRICT,NAGAR PARKAR TALUKA,6,10350,432,10782
THARPARKAR DISTRICT,NAGAR PARKAR TALUKA,7,7271,384,7655
THARPARKAR DISTRICT,NAGAR PARKAR TALUKA,8,10773,424,11197
THARPARKAR DISTRICT,NAGAR PARKAR TALUKA,9,7013,340,7353
THARPARKAR DISTRICT,NAGAR PARKAR TALUKA,10,9242,319,9561
THARPARKAR DISTRICT,NAGAR PARKAR TALUKA,11,5556,288,5844
THARPARKAR DISTRICT,NAGAR PARKAR TALUKA,12,7128,297,7425
THARPARKAR DISTRICT,NAGAR PARKAR TALUKA,13,5015,232,5247
THARPARKAR DISTRICT,NAGAR PARKAR TALUKA,14,5505,201,5706
THARPARKAR DISTRICT,NAGAR PARKAR TALUKA,15,5144,252,5396
THARPARKAR DISTRICT,NAGAR PARKAR TALUKA,16,4718,193,4911
THARPARKAR DISTRICT,NAGAR PARKAR TALUKA,17,3590,186,3776
THARPARKAR DISTRICT,NAGAR PARKAR TALUKA,18,4959,206,5165
THARPARKAR DISTRICT,NAGAR PARKAR TALUKA,19,3666,192,3858
THARPARKAR DISTRICT,NAGAR PARKAR TALUKA,20,4541,234,4775
THARPARKAR DISTRICT,NAGAR PARKAR TALUKA,21,3843,229,4072
THARPARKAR DISTRICT,NAGAR PARKAR TALUKA,22,3246,177,3423
THARPARKAR DISTRICT,NAGAR PARKAR TALUKA,23,2814,175,2989
THARPARKAR DISTRICT,NAGAR PARKAR TALUKA,24,2257,107,2364
THARPARKAR DISTRICT,NAGAR PARKAR TALUKA,25,3003,134,3137
THARPARKAR DISTRICT,NAGAR PARKAR TALUKA,26,2391,135,2526
THARPARKAR DISTRICT,NAGAR PARKAR TALUKA,27,3637,219,3856
THARPARKAR DISTRICT,NAGAR PARKAR TALUKA,28,2779,146,2925
THARPARKAR DISTRICT,NAGAR PARKAR TALUKA,29,4182,259,4441
THARPARKAR DISTRICT,NAGAR PARKAR TALUKA,30,2678,130,2808
THARPARKAR DISTRICT,NAGAR PARKAR TALUKA,31,3285,209,3494
THARPARKAR DISTRICT,NAGAR PARKAR TALUKA,32,3264,195,3459
THARPARKAR DISTRICT,NAGAR PARKAR TALUKA,33,2562,142,2704
THARPARKAR DISTRICT,NAGAR PARKAR TALUKA,34,2450,136,2586
THARPARKAR DISTRICT,NAGAR PARKAR TALUKA,35,2595,108,2703
THARPARKAR DISTRICT,NAGAR PARKAR TALUKA,36,2014,102,2116
THARPARKAR DISTRICT,NAGAR PARKAR TALUKA,37,4608,272,4880
THARPARKAR DISTRICT,NAGAR PARKAR TALUKA,38,1921,94,2015
THARPARKAR DISTRICT,NAGAR PARKAR TALUKA,39,3137,130,3267
THARPARKAR DISTRICT,NAGAR PARKAR TALUKA,40,1507,67,1574
THARPARKAR DISTRICT,NAGAR PARKAR TALUKA,41,1925,100,2025
THARPARKAR DISTRICT,NAGAR PARKAR TALUKA,42,2170,125,2295
THARPARKAR DISTRICT,NAGAR PARKAR TALUKA,43,1501,72,1573
THARPARKAR DISTRICT,NAGAR PARKAR TALUKA,44,1512,75,1587
THARPARKAR DISTRICT,NAGAR PARKAR TALUKA,45,1316,58,1374
THARPARKAR DISTRICT,NAGAR PARKAR TALUKA,46,1348,64,1412
THARPARKAR DISTRICT,NAGAR PARKAR TALUKA,47,2344,111,2455
THARPARKAR DISTRICT,NAGAR PARKAR TALUKA,48,1323,56,1379
THARPARKAR DISTRICT,NAGAR PARKAR TALUKA,49,1676,63,1739
THARPARKAR DISTRICT,NAGAR PARKAR TALUKA,50,1036,54,1090
THARPARKAR DISTRICT,NAGAR PARKAR TALUKA,51,1329,53,1382
THARPARKAR DISTRICT,NAGAR PARKAR TALUKA,52,1429,83,1512
THARPARKAR DISTRICT,NAGAR PARKAR TALUKA,53,857,48,905
THARPARKAR DISTRICT,NAGAR PARKAR TALUKA,54,858,42,900
THARPARKAR DISTRICT,NAGAR PARKAR TALUKA,55,702,23,725
THARPARKAR DISTRICT,NAGAR PARKAR TALUKA,56,732,53,785
THARPARKAR DISTRICT,NAGAR PARKAR TALUKA,57,1357,74,1431
THARPARKAR DISTRICT,NAGAR PARKAR TALUKA,58,856,50,906
THARPARKAR DISTRICT,NAGAR PARKAR TALUKA,59,1249,50,1299
THARPARKAR DISTRICT,NAGAR PARKAR TALUKA,60,814,32,846
THARPARKAR DISTRICT,NAGAR PARKAR TALUKA,61,860,41,901
THARPARKAR DISTRICT,NAGAR PARKAR TALUKA,62,969,51,1020
THARPARKAR DISTRICT,NAGAR PARKAR TALUKA,63,804,32,836
THARPARKAR DISTRICT,NAGAR PARKAR TALUKA,64,1256,48,1304
THARPARKAR DISTRICT,NAGAR PARKAR TALUKA,65,860,50,910
THARPARKAR DISTRICT,NAGAR PARKAR TALUKA,66,513,27,540
THARPARKAR DISTRICT,NAGAR PARKAR TALUKA,67,788,25,813
THARPARKAR DISTRICT,NAGAR PARKAR TALUKA,68,609,33,642
THARPARKAR DISTRICT,NAGAR PARKAR TALUKA,69,1086,38,1124
THARPARKAR DISTRICT,NAGAR PARKAR TALUKA,70,614,33,647
THARPARKAR DISTRICT,NAGAR PARKAR TALUKA,71,435,17,452
THARPARKAR DISTRICT,NAGAR PARKAR TALUKA,72,445,13,458
THARPARKAR DISTRICT,NAGAR PARKAR TALUKA,73,432,23,455
THARPARKAR DISTRICT,NAGAR PARKAR TALUKA,74,713,29,742
THARPARKAR DISTRICT,NAGAR PARKAR TALUKA,>=75,3422,139,3561
THATTA DISTRICT,GHORABARI TALUKA,<1,3715,570,4285
THATTA DISTRICT,GHORABARI TALUKA,1,4056,622,4678
THATTA DISTRICT,GHORABARI TALUKA,2,5132,768,5900
THATTA DISTRICT,GHORABARI TALUKA,3,5467,946,6413
THATTA DISTRICT,GHORABARI TALUKA,4,5886,854,6740
THATTA DISTRICT,GHORABARI TALUKA,5,5411,855,6266
THATTA DISTRICT,GHORABARI TALUKA,6,5851,790,6641
THATTA DISTRICT,GHORABARI TALUKA,7,4435,767,5202
THATTA DISTRICT,GHORABARI TALUKA,8,5924,796,6720
THATTA DISTRICT,GHORABARI TALUKA,9,3936,642,4578
THATTA DISTRICT,GHORABARI TALUKA,10,5491,695,6186
THATTA DISTRICT,GHORABARI TALUKA,11,3066,500,3566
THATTA DISTRICT,GHORABARI TALUKA,12,4014,526,4540
THATTA DISTRICT,GHORABARI TALUKA,13,2684,416,3100
THATTA DISTRICT,GHORABARI TALUKA,14,3177,496,3673
THATTA DISTRICT,GHORABARI TALUKA,15,2994,459,3453
THATTA DISTRICT,GHORABARI TALUKA,16,3042,463,3505
THATTA DISTRICT,GHORABARI TALUKA,17,2179,366,2545
THATTA DISTRICT,GHORABARI TALUKA,18,3441,491,3932
THATTA DISTRICT,GHORABARI TALUKA,19,2214,414,2628
THATTA DISTRICT,GHORABARI TALUKA,20,3243,452,3695
THATTA DISTRICT,GHORABARI TALUKA,21,2010,334,2344
THATTA DISTRICT,GHORABARI TALUKA,22,2385,369,2754
THATTA DISTRICT,GHORABARI TALUKA,23,1845,323,2168
THATTA DISTRICT,GHORABARI TALUKA,24,1907,283,2190
THATTA DISTRICT,GHORABARI TALUKA,25,2781,387,3168
THATTA DISTRICT,GHORABARI TALUKA,26,2089,328,2417
THATTA DISTRICT,GHORABARI TALUKA,27,1959,352,2311
THATTA DISTRICT,GHORABARI TALUKA,28,2240,329,2569
THATTA DISTRICT,GHORABARI TALUKA,29,2015,382,2397
THATTA DISTRICT,GHORABARI TALUKA,30,2420,379,2799
THATTA DISTRICT,GHORABARI TALUKA,31,1930,341,2271
THATTA DISTRICT,GHORABARI TALUKA,32,1789,305,2094
THATTA DISTRICT,GHORABARI TALUKA,33,1976,292,2268
THATTA DISTRICT,GHORABARI TALUKA,34,1598,276,1874
THATTA DISTRICT,GHORABARI TALUKA,35,2227,294,2521
THATTA DISTRICT,GHORABARI TALUKA,36,1423,247,1670
THATTA DISTRICT,GHORABARI TALUKA,37,1987,344,2331
THATTA DISTRICT,GHORABARI TALUKA,38,1847,300,2147
THATTA DISTRICT,GHORABARI TALUKA,39,1887,382,2269
THATTA DISTRICT,GHORABARI TALUKA,40,1751,310,2061
THATTA DISTRICT,GHORABARI TALUKA,41,1462,238,1700
THATTA DISTRICT,GHORABARI TALUKA,42,1392,199,1591
THATTA DISTRICT,GHORABARI TALUKA,43,1307,201,1508
THATTA DISTRICT,GHORABARI TALUKA,44,1192,163,1355
THATTA DISTRICT,GHORABARI TALUKA,45,1220,175,1395
THATTA DISTRICT,GHORABARI TALUKA,46,892,150,1042
THATTA DISTRICT,GHORABARI TALUKA,47,1091,133,1224
THATTA DISTRICT,GHORABARI TALUKA,48,938,136,1074
THATTA DISTRICT,GHORABARI TALUKA,49,1131,165,1296
THATTA DISTRICT,GHORABARI TALUKA,50,1087,156,1243
THATTA DISTRICT,GHORABARI TALUKA,51,866,124,990
THATTA DISTRICT,GHORABARI TALUKA,52,749,103,852
THATTA DISTRICT,GHORABARI TALUKA,53,696,104,800
THATTA DISTRICT,GHORABARI TALUKA,54,606,91,697
THATTA DISTRICT,GHORABARI TALUKA,55,751,90,841
THATTA DISTRICT,GHORABARI TALUKA,56,453,81,534
THATTA DISTRICT,GHORABARI TALUKA,57,615,106,721
THATTA DISTRICT,GHORABARI TALUKA,58,486,85,571
THATTA DISTRICT,GHORABARI TALUKA,59,634,94,728
THATTA DISTRICT,GHORABARI TALUKA,60,632,107,739
THATTA DISTRICT,GHORABARI TALUKA,61,558,91,649
THATTA DISTRICT,GHORABARI TALUKA,62,521,60,581
THATTA DISTRICT,GHORABARI TALUKA,63,526,91,617
THATTA DISTRICT,GHORABARI TALUKA,64,496,72,568
THATTA DISTRICT,GHORABARI TALUKA,65,493,88,581
THATTA DISTRICT,GHORABARI TALUKA,66,403,52,455
THATTA DISTRICT,GHORABARI TALUKA,67,343,53,396
THATTA DISTRICT,GHORABARI TALUKA,68,331,55,386
THATTA DISTRICT,GHORABARI TALUKA,69,404,57,461
THATTA DISTRICT,GHORABARI TALUKA,70,370,55,425
THATTA DISTRICT,GHORABARI TALUKA,71,345,59,404
THATTA DISTRICT,GHORABARI TALUKA,72,221,28,249
THATTA DISTRICT,GHORABARI TALUKA,73,239,35,274
THATTA DISTRICT,GHORABARI TALUKA,74,203,32,235
THATTA DISTRICT,GHORABARI TALUKA,>=75,1767,228,1995
THATTA DISTRICT,KETI BUNDER TALUKA,<1,1305,99,1404
THATTA DISTRICT,KETI BUNDER TALUKA,1,1473,75,1548
THATTA DISTRICT,KETI BUNDER TALUKA,2,1763,119,1882
THATTA DISTRICT,KETI BUNDER TALUKA,3,2058,158,2216
THATTA DISTRICT,KETI BUNDER TALUKA,4,2046,142,2188
THATTA DISTRICT,KETI BUNDER TALUKA,5,2019,145,2164
THATTA DISTRICT,KETI BUNDER TALUKA,6,1898,139,2037
THATTA DISTRICT,KETI BUNDER TALUKA,7,1660,122,1782
THATTA DISTRICT,KETI BUNDER TALUKA,8,2066,150,2216
THATTA DISTRICT,KETI BUNDER TALUKA,9,1320,85,1405
THATTA DISTRICT,KETI BUNDER TALUKA,10,1841,133,1974
THATTA DISTRICT,KETI BUNDER TALUKA,11,1080,70,1150
THATTA DISTRICT,KETI BUNDER TALUKA,12,1423,97,1520
THATTA DISTRICT,KETI BUNDER TALUKA,13,936,64,1000
THATTA DISTRICT,KETI BUNDER TALUKA,14,1120,78,1198
THATTA DISTRICT,KETI BUNDER TALUKA,15,1187,80,1267
THATTA DISTRICT,KETI BUNDER TALUKA,16,1013,88,1101
THATTA DISTRICT,KETI BUNDER TALUKA,17,881,67,948
THATTA DISTRICT,KETI BUNDER TALUKA,18,1135,88,1223
THATTA DISTRICT,KETI BUNDER TALUKA,19,919,68,987
THATTA DISTRICT,KETI BUNDER TALUKA,20,1229,85,1314
THATTA DISTRICT,KETI BUNDER TALUKA,21,821,43,864
THATTA DISTRICT,KETI BUNDER TALUKA,22,970,65,1035
THATTA DISTRICT,KETI BUNDER TALUKA,23,684,46,730
THATTA DISTRICT,KETI BUNDER TALUKA,24,772,58,830
THATTA DISTRICT,KETI BUNDER TALUKA,25,1170,73,1243
THATTA DISTRICT,KETI BUNDER TALUKA,26,776,89,865
THATTA DISTRICT,KETI BUNDER TALUKA,27,771,74,845
THATTA DISTRICT,KETI BUNDER TALUKA,28,854,75,929
THATTA DISTRICT,KETI BUNDER TALUKA,29,751,73,824
THATTA DISTRICT,KETI BUNDER TALUKA,30,982,71,1053
THATTA DISTRICT,KETI BUNDER TALUKA,31,722,75,797
THATTA DISTRICT,KETI BUNDER TALUKA,32,671,68,739
THATTA DISTRICT,KETI BUNDER TALUKA,33,660,63,723
THATTA DISTRICT,KETI BUNDER TALUKA,34,630,39,669
THATTA DISTRICT,KETI BUNDER TALUKA,35,805,62,867
THATTA DISTRICT,KETI BUNDER TALUKA,36,517,58,575
THATTA DISTRICT,KETI BUNDER TALUKA,37,687,73,760
THATTA DISTRICT,KETI BUNDER TALUKA,38,673,41,714
THATTA DISTRICT,KETI BUNDER TALUKA,39,739,86,825
THATTA DISTRICT,KETI BUNDER TALUKA,40,714,51,765
THATTA DISTRICT,KETI BUNDER TALUKA,41,565,41,606
THATTA DISTRICT,KETI BUNDER TALUKA,42,470,47,517
THATTA DISTRICT,KETI BUNDER TALUKA,43,483,45,528
THATTA DISTRICT,KETI BUNDER TALUKA,44,437,40,477
THATTA DISTRICT,KETI BUNDER TALUKA,45,484,41,525
THATTA DISTRICT,KETI BUNDER TALUKA,46,396,32,428
THATTA DISTRICT,KETI BUNDER TALUKA,47,380,47,427
THATTA DISTRICT,KETI BUNDER TALUKA,48,341,39,380
THATTA DISTRICT,KETI BUNDER TALUKA,49,380,45,425
THATTA DISTRICT,KETI BUNDER TALUKA,50,400,37,437
THATTA DISTRICT,KETI BUNDER TALUKA,51,300,33,333
THATTA DISTRICT,KETI BUNDER TALUKA,52,257,34,291
THATTA DISTRICT,KETI BUNDER TALUKA,53,245,17,262
THATTA DISTRICT,KETI BUNDER TALUKA,54,248,15,263
THATTA DISTRICT,KETI BUNDER TALUKA,55,280,17,297
THATTA DISTRICT,KETI BUNDER TALUKA,56,215,17,232
THATTA DISTRICT,KETI BUNDER TALUKA,57,268,37,305
THATTA DISTRICT,KETI BUNDER TALUKA,58,202,18,220
THATTA DISTRICT,KETI BUNDER TALUKA,59,234,18,252
THATTA DISTRICT,KETI BUNDER TALUKA,60,264,14,278
THATTA DISTRICT,KETI BUNDER TALUKA,61,244,19,263
THATTA DISTRICT,KETI BUNDER TALUKA,62,182,15,197
THATTA DISTRICT,KETI BUNDER TALUKA,63,199,22,221
THATTA DISTRICT,KETI BUNDER TALUKA,64,160,13,173
THATTA DISTRICT,KETI BUNDER TALUKA,65,206,18,224
THATTA DISTRICT,KETI BUNDER TALUKA,66,133,12,145
THATTA DISTRICT,KETI BUNDER TALUKA,67,139,21,160
THATTA DISTRICT,KETI BUNDER TALUKA,68,130,7,137
THATTA DISTRICT,KETI BUNDER TALUKA,69,167,11,178
THATTA DISTRICT,KETI BUNDER TALUKA,70,137,6,143
THATTA DISTRICT,KETI BUNDER TALUKA,71,130,8,138
THATTA DISTRICT,KETI BUNDER TALUKA,72,79,5,84
THATTA DISTRICT,KETI BUNDER TALUKA,73,109,5,114
THATTA DISTRICT,KETI BUNDER TALUKA,74,95,5,100
THATTA DISTRICT,KETI BUNDER TALUKA,>=75,729,34,763
THATTA DISTRICT,MIRPUR SAKRO TALUKA,<1,6827,1091,7918
THATTA DISTRICT,MIRPUR SAKRO TALUKA,1,7717,1158,8875
THATTA DISTRICT,MIRPUR SAKRO TALUKA,2,9584,1377,10961
THATTA DISTRICT,MIRPUR SAKRO TALUKA,3,10147,1573,11720
THATTA DISTRICT,MIRPUR SAKRO TALUKA,4,10415,1457,11872
THATTA DISTRICT,MIRPUR SAKRO TALUKA,5,10258,1493,11751
THATTA DISTRICT,MIRPUR SAKRO TALUKA,6,10102,1436,11538
THATTA DISTRICT,MIRPUR SAKRO TALUKA,7,9232,1503,10735
THATTA DISTRICT,MIRPUR SAKRO TALUKA,8,10606,1435,12041
THATTA DISTRICT,MIRPUR SAKRO TALUKA,9,7807,1329,9136
THATTA DISTRICT,MIRPUR SAKRO TALUKA,10,9573,1275,10848
THATTA DISTRICT,MIRPUR SAKRO TALUKA,11,6397,1159,7556
THATTA DISTRICT,MIRPUR SAKRO TALUKA,12,7830,1113,8943
THATTA DISTRICT,MIRPUR SAKRO TALUKA,13,5671,1052,6723
THATTA DISTRICT,MIRPUR SAKRO TALUKA,14,6337,952,7289
THATTA DISTRICT,MIRPUR SAKRO TALUKA,15,5990,1037,7027
THATTA DISTRICT,MIRPUR SAKRO TALUKA,16,6218,969,7187
THATTA DISTRICT,MIRPUR SAKRO TALUKA,17,4869,1050,5919
THATTA DISTRICT,MIRPUR SAKRO TALUKA,18,6607,987,7594
THATTA DISTRICT,MIRPUR SAKRO TALUKA,19,4991,1024,6015
THATTA DISTRICT,MIRPUR SAKRO TALUKA,20,6179,870,7049
THATTA DISTRICT,MIRPUR SAKRO TALUKA,21,4570,859,5429
THATTA DISTRICT,MIRPUR SAKRO TALUKA,22,5035,877,5912
THATTA DISTRICT,MIRPUR SAKRO TALUKA,23,4227,759,4986
THATTA DISTRICT,MIRPUR SAKRO TALUKA,24,3962,707,4669
THATTA DISTRICT,MIRPUR SAKRO TALUKA,25,5220,815,6035
THATTA DISTRICT,MIRPUR SAKRO TALUKA,26,4249,717,4966
THATTA DISTRICT,MIRPUR SAKRO TALUKA,27,4190,783,4973
THATTA DISTRICT,MIRPUR SAKRO TALUKA,28,4842,756,5598
THATTA DISTRICT,MIRPUR SAKRO TALUKA,29,4298,788,5086
THATTA DISTRICT,MIRPUR SAKRO TALUKA,30,4808,775,5583
THATTA DISTRICT,MIRPUR SAKRO TALUKA,31,4165,752,4917
THATTA DISTRICT,MIRPUR SAKRO TALUKA,32,3807,698,4505
THATTA DISTRICT,MIRPUR SAKRO TALUKA,33,3742,619,4361
THATTA DISTRICT,MIRPUR SAKRO TALUKA,34,3161,594,3755
THATTA DISTRICT,MIRPUR SAKRO TALUKA,35,4162,609,4771
THATTA DISTRICT,MIRPUR SAKRO TALUKA,36,3023,524,3547
THATTA DISTRICT,MIRPUR SAKRO TALUKA,37,3574,587,4161
THATTA DISTRICT,MIRPUR SAKRO TALUKA,38,3427,511,3938
THATTA DISTRICT,MIRPUR SAKRO TALUKA,39,3629,567,4196
THATTA DISTRICT,MIRPUR SAKRO TALUKA,40,3413,471,3884
THATTA DISTRICT,MIRPUR SAKRO TALUKA,41,2821,414,3235
THATTA DISTRICT,MIRPUR SAKRO TALUKA,42,2559,435,2994
THATTA DISTRICT,MIRPUR SAKRO TALUKA,43,2430,420,2850
THATTA DISTRICT,MIRPUR SAKRO TALUKA,44,2137,401,2538
THATTA DISTRICT,MIRPUR SAKRO TALUKA,45,2500,417,2917
THATTA DISTRICT,MIRPUR SAKRO TALUKA,46,1837,351,2188
THATTA DISTRICT,MIRPUR SAKRO TALUKA,47,2026,401,2427
THATTA DISTRICT,MIRPUR SAKRO TALUKA,48,2066,307,2373
THATTA DISTRICT,MIRPUR SAKRO TALUKA,49,2126,328,2454
THATTA DISTRICT,MIRPUR SAKRO TALUKA,50,2206,322,2528
THATTA DISTRICT,MIRPUR SAKRO TALUKA,51,1795,298,2093
THATTA DISTRICT,MIRPUR SAKRO TALUKA,52,1496,280,1776
THATTA DISTRICT,MIRPUR SAKRO TALUKA,53,1524,220,1744
THATTA DISTRICT,MIRPUR SAKRO TALUKA,54,1321,229,1550
THATTA DISTRICT,MIRPUR SAKRO TALUKA,55,1487,275,1762
THATTA DISTRICT,MIRPUR SAKRO TALUKA,56,1077,185,1262
THATTA DISTRICT,MIRPUR SAKRO TALUKA,57,1216,187,1403
THATTA DISTRICT,MIRPUR SAKRO TALUKA,58,1031,184,1215
THATTA DISTRICT,MIRPUR SAKRO TALUKA,59,1249,205,1454
THATTA DISTRICT,MIRPUR SAKRO TALUKA,60,1281,197,1478
THATTA DISTRICT,MIRPUR SAKRO TALUKA,61,1146,206,1352
THATTA DISTRICT,MIRPUR SAKRO TALUKA,62,1033,188,1221
THATTA DISTRICT,MIRPUR SAKRO TALUKA,63,960,181,1141
THATTA DISTRICT,MIRPUR SAKRO TALUKA,64,895,142,1037
THATTA DISTRICT,MIRPUR SAKRO TALUKA,65,936,130,1066
THATTA DISTRICT,MIRPUR SAKRO TALUKA,66,796,123,919
THATTA DISTRICT,MIRPUR SAKRO TALUKA,67,669,87,756
THATTA DISTRICT,MIRPUR SAKRO TALUKA,68,591,100,691
THATTA DISTRICT,MIRPUR SAKRO TALUKA,69,706,101,807
THATTA DISTRICT,MIRPUR SAKRO TALUKA,70,653,67,720
THATTA DISTRICT,MIRPUR SAKRO TALUKA,71,617,74,691
THATTA DISTRICT,MIRPUR SAKRO TALUKA,72,462,62,524
THATTA DISTRICT,MIRPUR SAKRO TALUKA,73,478,74,552
THATTA DISTRICT,MIRPUR SAKRO TALUKA,74,385,50,435
THATTA DISTRICT,MIRPUR SAKRO TALUKA,>=75,3188,379,3567
THATTA DISTRICT,THATTA TALUKA,<1,6689,2247,8936
THATTA DISTRICT,THATTA TALUKA,1,8058,2457,10515
THATTA DISTRICT,THATTA TALUKA,2,9428,2766,12194
THATTA DISTRICT,THATTA TALUKA,3,10887,3240,14127
THATTA DISTRICT,THATTA TALUKA,4,10725,3007,13732
THATTA DISTRICT,THATTA TALUKA,5,10889,3055,13944
THATTA DISTRICT,THATTA TALUKA,6,10034,2827,12861
THATTA DISTRICT,THATTA TALUKA,7,9385,2970,12355
THATTA DISTRICT,THATTA TALUKA,8,10392,2845,13237
THATTA DISTRICT,THATTA TALUKA,9,7775,2651,10426
THATTA DISTRICT,THATTA TALUKA,10,9419,2608,12027
THATTA DISTRICT,THATTA TALUKA,11,6135,2327,8462
THATTA DISTRICT,THATTA TALUKA,12,7390,2391,9781
THATTA DISTRICT,THATTA TALUKA,13,5530,2130,7660
THATTA DISTRICT,THATTA TALUKA,14,5959,1967,7926
THATTA DISTRICT,THATTA TALUKA,15,6296,2158,8454
THATTA DISTRICT,THATTA TALUKA,16,5854,2044,7898
THATTA DISTRICT,THATTA TALUKA,17,5112,2209,7321
THATTA DISTRICT,THATTA TALUKA,18,6486,2117,8603
THATTA DISTRICT,THATTA TALUKA,19,4894,2066,6960
THATTA DISTRICT,THATTA TALUKA,20,6007,1981,7988
THATTA DISTRICT,THATTA TALUKA,21,4340,1845,6185
THATTA DISTRICT,THATTA TALUKA,22,5206,1865,7071
THATTA DISTRICT,THATTA TALUKA,23,4135,1741,5876
THATTA DISTRICT,THATTA TALUKA,24,4024,1660,5684
THATTA DISTRICT,THATTA TALUKA,25,5492,1748,7240
THATTA DISTRICT,THATTA TALUKA,26,4351,1661,6012
THATTA DISTRICT,THATTA TALUKA,27,4634,1664,6298
THATTA DISTRICT,THATTA TALUKA,28,4730,1757,6487
THATTA DISTRICT,THATTA TALUKA,29,4575,1600,6175
THATTA DISTRICT,THATTA TALUKA,30,5170,1733,6903
THATTA DISTRICT,THATTA TALUKA,31,4428,1611,6039
THATTA DISTRICT,THATTA TALUKA,32,4220,1554,5774
THATTA DISTRICT,THATTA TALUKA,33,4127,1467,5594
THATTA DISTRICT,THATTA TALUKA,34,3465,1304,4769
THATTA DISTRICT,THATTA TALUKA,35,4368,1375,5743
THATTA DISTRICT,THATTA TALUKA,36,3310,1180,4490
THATTA DISTRICT,THATTA TALUKA,37,4066,1218,5284
THATTA DISTRICT,THATTA TALUKA,38,3638,1290,4928
THATTA DISTRICT,THATTA TALUKA,39,4003,1228,5231
THATTA DISTRICT,THATTA TALUKA,40,3604,1199,4803
THATTA DISTRICT,THATTA TALUKA,41,3175,1127,4302
THATTA DISTRICT,THATTA TALUKA,42,2794,999,3793
THATTA DISTRICT,THATTA TALUKA,43,2705,947,3652
THATTA DISTRICT,THATTA TALUKA,44,2430,904,3334
THATTA DISTRICT,THATTA TALUKA,45,2720,854,3574
THATTA DISTRICT,THATTA TALUKA,46,1990,767,2757
THATTA DISTRICT,THATTA TALUKA,47,2331,749,3080
THATTA DISTRICT,THATTA TALUKA,48,2157,772,2929
THATTA DISTRICT,THATTA TALUKA,49,2324,812,3136
THATTA DISTRICT,THATTA TALUKA,50,2347,754,3101
THATTA DISTRICT,THATTA TALUKA,51,1849,675,2524
THATTA DISTRICT,THATTA TALUKA,52,1717,660,2377
THATTA DISTRICT,THATTA TALUKA,53,1536,628,2164
THATTA DISTRICT,THATTA TALUKA,54,1445,585,2030
THATTA DISTRICT,THATTA TALUKA,55,1661,520,2181
THATTA DISTRICT,THATTA TALUKA,56,1172,418,1590
THATTA DISTRICT,THATTA TALUKA,57,1472,455,1927
THATTA DISTRICT,THATTA TALUKA,58,1250,504,1754
THATTA DISTRICT,THATTA TALUKA,59,1395,506,1901
THATTA DISTRICT,THATTA TALUKA,60,1393,494,1887
THATTA DISTRICT,THATTA TALUKA,61,1218,474,1692
THATTA DISTRICT,THATTA TALUKA,62,1165,387,1552
THATTA DISTRICT,THATTA TALUKA,63,1149,440,1589
THATTA DISTRICT,THATTA TALUKA,64,1214,388,1602
THATTA DISTRICT,THATTA TALUKA,65,1082,318,1400
THATTA DISTRICT,THATTA TALUKA,66,858,283,1141
THATTA DISTRICT,THATTA TALUKA,67,847,217,1064
THATTA DISTRICT,THATTA TALUKA,68,726,243,969
THATTA DISTRICT,THATTA TALUKA,69,866,239,1105
THATTA DISTRICT,THATTA TALUKA,70,790,242,1032
THATTA DISTRICT,THATTA TALUKA,71,602,178,780
THATTA DISTRICT,THATTA TALUKA,72,582,147,729
THATTA DISTRICT,THATTA TALUKA,73,541,186,727
THATTA DISTRICT,THATTA TALUKA,74,550,165,715
THATTA DISTRICT,THATTA TALUKA,>=75,3545,1076,4621
TOBA TEK SINGH DISTRICT,GOJRA TEHSIL,<1,11349,4045,15394
TOBA TEK SINGH DISTRICT,GOJRA TEHSIL,1,11972,4044,16016
TOBA TEK SINGH DISTRICT,GOJRA TEHSIL,2,11331,4073,15404
TOBA TEK SINGH DISTRICT,GOJRA TEHSIL,3,12354,4292,16646
TOBA TEK SINGH DISTRICT,GOJRA TEHSIL,4,12009,4110,16119
TOBA TEK SINGH DISTRICT,GOJRA TEHSIL,5,11964,4020,15984
TOBA TEK SINGH DISTRICT,GOJRA TEHSIL,6,11682,3987,15669
TOBA TEK SINGH DISTRICT,GOJRA TEHSIL,7,12809,4132,16941
TOBA TEK SINGH DISTRICT,GOJRA TEHSIL,8,11427,3784,15211
TOBA TEK SINGH DISTRICT,GOJRA TEHSIL,9,12501,4344,16845
TOBA TEK SINGH DISTRICT,GOJRA TEHSIL,10,10785,3662,14447
TOBA TEK SINGH DISTRICT,GOJRA TEHSIL,11,11775,4428,16203
TOBA TEK SINGH DISTRICT,GOJRA TEHSIL,12,10116,3566,13682
TOBA TEK SINGH DISTRICT,GOJRA TEHSIL,13,10776,3984,14760
TOBA TEK SINGH DISTRICT,GOJRA TEHSIL,14,9883,3647,13530
TOBA TEK SINGH DISTRICT,GOJRA TEHSIL,15,10381,3904,14285
TOBA TEK SINGH DISTRICT,GOJRA TEHSIL,16,10213,3839,14052
TOBA TEK SINGH DISTRICT,GOJRA TEHSIL,17,11014,4471,15485
TOBA TEK SINGH DISTRICT,GOJRA TEHSIL,18,8254,2662,10916
TOBA TEK SINGH DISTRICT,GOJRA TEHSIL,19,10078,3718,13796
TOBA TEK SINGH DISTRICT,GOJRA TEHSIL,20,8756,3142,11898
TOBA TEK SINGH DISTRICT,GOJRA TEHSIL,21,10029,3847,13876
TOBA TEK SINGH DISTRICT,GOJRA TEHSIL,22,8717,3251,11968
TOBA TEK SINGH DISTRICT,GOJRA TEHSIL,23,8717,3383,12100
TOBA TEK SINGH DISTRICT,GOJRA TEHSIL,24,7934,3285,11219
TOBA TEK SINGH DISTRICT,GOJRA TEHSIL,25,7118,2578,9696
TOBA TEK SINGH DISTRICT,GOJRA TEHSIL,26,7761,3136,10897
TOBA TEK SINGH DISTRICT,GOJRA TEHSIL,27,7641,3219,10860
TOBA TEK SINGH DISTRICT,GOJRA TEHSIL,28,7214,2944,10158
TOBA TEK SINGH DISTRICT,GOJRA TEHSIL,29,7197,3055,10252
TOBA TEK SINGH DISTRICT,GOJRA TEHSIL,30,6583,2386,8969
TOBA TEK SINGH DISTRICT,GOJRA TEHSIL,31,7071,2804,9875
TOBA TEK SINGH DISTRICT,GOJRA TEHSIL,32,6078,2534,8612
TOBA TEK SINGH DISTRICT,GOJRA TEHSIL,33,6181,2628,8809
TOBA TEK SINGH DISTRICT,GOJRA TEHSIL,34,6225,2480,8705
TOBA TEK SINGH DISTRICT,GOJRA TEHSIL,35,5345,1950,7295
TOBA TEK SINGH DISTRICT,GOJRA TEHSIL,36,6251,2303,8554
TOBA TEK SINGH DISTRICT,GOJRA TEHSIL,37,5894,2182,8076
TOBA TEK SINGH DISTRICT,GOJRA TEHSIL,38,5969,2118,8087
TOBA TEK SINGH DISTRICT,GOJRA TEHSIL,39,5694,2171,7865
TOBA TEK SINGH DISTRICT,GOJRA TEHSIL,40,4672,1624,6296
TOBA TEK SINGH DISTRICT,GOJRA TEHSIL,41,5542,1902,7444
TOBA TEK SINGH DISTRICT,GOJRA TEHSIL,42,4686,1785,6471
TOBA TEK SINGH DISTRICT,GOJRA TEHSIL,43,4568,1742,6310
TOBA TEK SINGH DISTRICT,GOJRA TEHSIL,44,4422,1691,6113
TOBA TEK SINGH DISTRICT,GOJRA TEHSIL,45,3462,1295,4757
TOBA TEK SINGH DISTRICT,GOJRA TEHSIL,46,4341,1492,5833
TOBA TEK SINGH DISTRICT,GOJRA TEHSIL,47,4257,1545,5802
TOBA TEK SINGH DISTRICT,GOJRA TEHSIL,48,4190,1652,5842
TOBA TEK SINGH DISTRICT,GOJRA TEHSIL,49,4387,1621,6008
TOBA TEK SINGH DISTRICT,GOJRA TEHSIL,50,3573,1310,4883
TOBA TEK SINGH DISTRICT,GOJRA TEHSIL,51,4513,1605,6118
TOBA TEK SINGH DISTRICT,GOJRA TEHSIL,52,4164,1533,5697
TOBA TEK SINGH DISTRICT,GOJRA TEHSIL,53,3994,1591,5585
TOBA TEK SINGH DISTRICT,GOJRA TEHSIL,54,3733,1496,5229
TOBA TEK SINGH DISTRICT,GOJRA TEHSIL,55,2736,1016,3752
TOBA TEK SINGH DISTRICT,GOJRA TEHSIL,56,3270,1234,4504
TOBA TEK SINGH DISTRICT,GOJRA TEHSIL,57,2890,1032,3922
TOBA TEK SINGH DISTRICT,GOJRA TEHSIL,58,2715,928,3643
TOBA TEK SINGH DISTRICT,GOJRA TEHSIL,59,3060,1058,4118
TOBA TEK SINGH DISTRICT,GOJRA TEHSIL,60,2236,713,2949
TOBA TEK SINGH DISTRICT,GOJRA TEHSIL,61,2921,956,3877
TOBA TEK SINGH DISTRICT,GOJRA TEHSIL,62,2609,932,3541
TOBA TEK SINGH DISTRICT,GOJRA TEHSIL,63,2411,868,3279
TOBA TEK SINGH DISTRICT,GOJRA TEHSIL,64,2240,742,2982
TOBA TEK SINGH DISTRICT,GOJRA TEHSIL,65,1798,548,2346
TOBA TEK SINGH DISTRICT,GOJRA TEHSIL,66,2170,627,2797
TOBA TEK SINGH DISTRICT,GOJRA TEHSIL,67,1731,540,2271
TOBA TEK SINGH DISTRICT,GOJRA TEHSIL,68,1587,536,2123
TOBA TEK SINGH DISTRICT,GOJRA TEHSIL,69,1655,486,2141
TOBA TEK SINGH DISTRICT,GOJRA TEHSIL,70,1405,376,1781
TOBA TEK SINGH DISTRICT,GOJRA TEHSIL,71,1841,460,2301
TOBA TEK SINGH DISTRICT,GOJRA TEHSIL,72,1467,523,1990
TOBA TEK SINGH DISTRICT,GOJRA TEHSIL,73,1337,403,1740
TOBA TEK SINGH DISTRICT,GOJRA TEHSIL,74,1205,312,1517
TOBA TEK SINGH DISTRICT,GOJRA TEHSIL,>=75,9555,2549,12104
TOBA TEK SINGH DISTRICT,KAMALIA TEHSIL,<1,5662,3008,8670
TOBA TEK SINGH DISTRICT,KAMALIA TEHSIL,1,5734,3521,9255
TOBA TEK SINGH DISTRICT,KAMALIA TEHSIL,2,5803,3164,8967
TOBA TEK SINGH DISTRICT,KAMALIA TEHSIL,3,6523,3429,9952
TOBA TEK SINGH DISTRICT,KAMALIA TEHSIL,4,6752,3290,10042
TOBA TEK SINGH DISTRICT,KAMALIA TEHSIL,5,6666,3282,9948
TOBA TEK SINGH DISTRICT,KAMALIA TEHSIL,6,6401,3270,9671
TOBA TEK SINGH DISTRICT,KAMALIA TEHSIL,7,6841,3507,10348
TOBA TEK SINGH DISTRICT,KAMALIA TEHSIL,8,6491,3009,9500
TOBA TEK SINGH DISTRICT,KAMALIA TEHSIL,9,6417,3308,9725
TOBA TEK SINGH DISTRICT,KAMALIA TEHSIL,10,5842,2812,8654
TOBA TEK SINGH DISTRICT,KAMALIA TEHSIL,11,5567,3325,8892
TOBA TEK SINGH DISTRICT,KAMALIA TEHSIL,12,5370,2817,8187
TOBA TEK SINGH DISTRICT,KAMALIA TEHSIL,13,5158,2997,8155
TOBA TEK SINGH DISTRICT,KAMALIA TEHSIL,14,5035,2888,7923
TOBA TEK SINGH DISTRICT,KAMALIA TEHSIL,15,5213,2927,8140
TOBA TEK SINGH DISTRICT,KAMALIA TEHSIL,16,5013,2808,7821
TOBA TEK SINGH DISTRICT,KAMALIA TEHSIL,17,5979,3134,9113
TOBA TEK SINGH DISTRICT,KAMALIA TEHSIL,18,3628,2344,5972
TOBA TEK SINGH DISTRICT,KAMALIA TEHSIL,19,4185,2806,6991
TOBA TEK SINGH DISTRICT,KAMALIA TEHSIL,20,4120,2353,6473
TOBA TEK SINGH DISTRICT,KAMALIA TEHSIL,21,4007,2837,6844
TOBA TEK SINGH DISTRICT,KAMALIA TEHSIL,22,4076,2523,6599
TOBA TEK SINGH DISTRICT,KAMALIA TEHSIL,23,3697,2566,6263
TOBA TEK SINGH DISTRICT,KAMALIA TEHSIL,24,3522,2469,5991
TOBA TEK SINGH DISTRICT,KAMALIA TEHSIL,25,3534,2094,5628
TOBA TEK SINGH DISTRICT,KAMALIA TEHSIL,26,3583,2450,6033
TOBA TEK SINGH DISTRICT,KAMALIA TEHSIL,27,3383,2294,5677
TOBA TEK SINGH DISTRICT,KAMALIA TEHSIL,28,3396,2332,5728
TOBA TEK SINGH DISTRICT,KAMALIA TEHSIL,29,3538,2259,5797
TOBA TEK SINGH DISTRICT,KAMALIA TEHSIL,30,3350,1997,5347
TOBA TEK SINGH DISTRICT,KAMALIA TEHSIL,31,3381,2108,5489
TOBA TEK SINGH DISTRICT,KAMALIA TEHSIL,32,3165,2052,5217
TOBA TEK SINGH DISTRICT,KAMALIA TEHSIL,33,2912,2040,4952
TOBA TEK SINGH DISTRICT,KAMALIA TEHSIL,34,2986,1891,4877
TOBA TEK SINGH DISTRICT,KAMALIA TEHSIL,35,2806,1595,4401
TOBA TEK SINGH DISTRICT,KAMALIA TEHSIL,36,2999,1855,4854
TOBA TEK SINGH DISTRICT,KAMALIA TEHSIL,37,2755,1625,4380
TOBA TEK SINGH DISTRICT,KAMALIA TEHSIL,38,2652,1639,4291
TOBA TEK SINGH DISTRICT,KAMALIA TEHSIL,39,2766,1630,4396
TOBA TEK SINGH DISTRICT,KAMALIA TEHSIL,40,2363,1434,3797
TOBA TEK SINGH DISTRICT,KAMALIA TEHSIL,41,2610,1592,4202
TOBA TEK SINGH DISTRICT,KAMALIA TEHSIL,42,2251,1256,3507
TOBA TEK SINGH DISTRICT,KAMALIA TEHSIL,43,2113,1351,3464
TOBA TEK SINGH DISTRICT,KAMALIA TEHSIL,44,2201,1316,3517
TOBA TEK SINGH DISTRICT,KAMALIA TEHSIL,45,1863,1148,3011
TOBA TEK SINGH DISTRICT,KAMALIA TEHSIL,46,2208,1308,3516
TOBA TEK SINGH DISTRICT,KAMALIA TEHSIL,47,1985,1076,3061
TOBA TEK SINGH DISTRICT,KAMALIA TEHSIL,48,1992,1284,3276
TOBA TEK SINGH DISTRICT,KAMALIA TEHSIL,49,2163,1281,3444
TOBA TEK SINGH DISTRICT,KAMALIA TEHSIL,50,1791,1147,2938
TOBA TEK SINGH DISTRICT,KAMALIA TEHSIL,51,2175,1284,3459
TOBA TEK SINGH DISTRICT,KAMALIA TEHSIL,52,1921,1104,3025
TOBA TEK SINGH DISTRICT,KAMALIA TEHSIL,53,1786,1134,2920
TOBA TEK SINGH DISTRICT,KAMALIA TEHSIL,54,1582,1095,2677
TOBA TEK SINGH DISTRICT,KAMALIA TEHSIL,55,1333,817,2150
TOBA TEK SINGH DISTRICT,KAMALIA TEHSIL,56,1471,898,2369
TOBA TEK SINGH DISTRICT,KAMALIA TEHSIL,57,1185,662,1847
TOBA TEK SINGH DISTRICT,KAMALIA TEHSIL,58,1195,715,1910
TOBA TEK SINGH DISTRICT,KAMALIA TEHSIL,59,1302,758,2060
TOBA TEK SINGH DISTRICT,KAMALIA TEHSIL,60,1110,627,1737
TOBA TEK SINGH DISTRICT,KAMALIA TEHSIL,61,1346,714,2060
TOBA TEK SINGH DISTRICT,KAMALIA TEHSIL,62,1198,653,1851
TOBA TEK SINGH DISTRICT,KAMALIA TEHSIL,63,1096,690,1786
TOBA TEK SINGH DISTRICT,KAMALIA TEHSIL,64,1037,530,1567
TOBA TEK SINGH DISTRICT,KAMALIA TEHSIL,65,963,450,1413
TOBA TEK SINGH DISTRICT,KAMALIA TEHSIL,66,1177,495,1672
TOBA TEK SINGH DISTRICT,KAMALIA TEHSIL,67,782,285,1067
TOBA TEK SINGH DISTRICT,KAMALIA TEHSIL,68,773,369,1142
TOBA TEK SINGH DISTRICT,KAMALIA TEHSIL,69,805,384,1189
TOBA TEK SINGH DISTRICT,KAMALIA TEHSIL,70,719,355,1074
TOBA TEK SINGH DISTRICT,KAMALIA TEHSIL,71,887,336,1223
TOBA TEK SINGH DISTRICT,KAMALIA TEHSIL,72,639,344,983
TOBA TEK SINGH DISTRICT,KAMALIA TEHSIL,73,582,298,880
TOBA TEK SINGH DISTRICT,KAMALIA TEHSIL,74,523,258,781
TOBA TEK SINGH DISTRICT,KAMALIA TEHSIL,>=75,4301,1971,6272
TOBA TEK SINGH DISTRICT,PIRMAHAL TEHSIL,<1,9918,1038,10956
TOBA TEK SINGH DISTRICT,PIRMAHAL TEHSIL,1,10268,1137,11405
TOBA TEK SINGH DISTRICT,PIRMAHAL TEHSIL,2,10120,937,11057
TOBA TEK SINGH DISTRICT,PIRMAHAL TEHSIL,3,10587,1010,11597
TOBA TEK SINGH DISTRICT,PIRMAHAL TEHSIL,4,10979,1014,11993
TOBA TEK SINGH DISTRICT,PIRMAHAL TEHSIL,5,10566,1051,11617
TOBA TEK SINGH DISTRICT,PIRMAHAL TEHSIL,6,10230,996,11226
TOBA TEK SINGH DISTRICT,PIRMAHAL TEHSIL,7,11018,1068,12086
TOBA TEK SINGH DISTRICT,PIRMAHAL TEHSIL,8,10064,978,11042
TOBA TEK SINGH DISTRICT,PIRMAHAL TEHSIL,9,10303,1114,11417
TOBA TEK SINGH DISTRICT,PIRMAHAL TEHSIL,10,9276,900,10176
TOBA TEK SINGH DISTRICT,PIRMAHAL TEHSIL,11,9437,1162,10599
TOBA TEK SINGH DISTRICT,PIRMAHAL TEHSIL,12,8229,840,9069
TOBA TEK SINGH DISTRICT,PIRMAHAL TEHSIL,13,8459,1068,9527
TOBA TEK SINGH DISTRICT,PIRMAHAL TEHSIL,14,7949,906,8855
TOBA TEK SINGH DISTRICT,PIRMAHAL TEHSIL,15,7761,940,8701
TOBA TEK SINGH DISTRICT,PIRMAHAL TEHSIL,16,7723,952,8675
TOBA TEK SINGH DISTRICT,PIRMAHAL TEHSIL,17,7556,993,8549
TOBA TEK SINGH DISTRICT,PIRMAHAL TEHSIL,18,7001,820,7821
TOBA TEK SINGH DISTRICT,PIRMAHAL TEHSIL,19,7429,929,8358
TOBA TEK SINGH DISTRICT,PIRMAHAL TEHSIL,20,6588,770,7358
TOBA TEK SINGH DISTRICT,PIRMAHAL TEHSIL,21,6909,977,7886
TOBA TEK SINGH DISTRICT,PIRMAHAL TEHSIL,22,6622,788,7410
TOBA TEK SINGH DISTRICT,PIRMAHAL TEHSIL,23,6270,816,7086
TOBA TEK SINGH DISTRICT,PIRMAHAL TEHSIL,24,6041,850,6891
TOBA TEK SINGH DISTRICT,PIRMAHAL TEHSIL,25,5687,567,6254
TOBA TEK SINGH DISTRICT,PIRMAHAL TEHSIL,26,5763,783,6546
TOBA TEK SINGH DISTRICT,PIRMAHAL TEHSIL,27,5695,773,6468
TOBA TEK SINGH DISTRICT,PIRMAHAL TEHSIL,28,5433,704,6137
TOBA TEK SINGH DISTRICT,PIRMAHAL TEHSIL,29,5897,752,6649
TOBA TEK SINGH DISTRICT,PIRMAHAL TEHSIL,30,5198,601,5799
TOBA TEK SINGH DISTRICT,PIRMAHAL TEHSIL,31,5899,797,6696
TOBA TEK SINGH DISTRICT,PIRMAHAL TEHSIL,32,5180,674,5854
TOBA TEK SINGH DISTRICT,PIRMAHAL TEHSIL,33,4952,653,5605
TOBA TEK SINGH DISTRICT,PIRMAHAL TEHSIL,34,5114,666,5780
TOBA TEK SINGH DISTRICT,PIRMAHAL TEHSIL,35,4280,467,4747
TOBA TEK SINGH DISTRICT,PIRMAHAL TEHSIL,36,4999,656,5655
TOBA TEK SINGH DISTRICT,PIRMAHAL TEHSIL,37,4780,548,5328
TOBA TEK SINGH DISTRICT,PIRMAHAL TEHSIL,38,4404,626,5030
TOBA TEK SINGH DISTRICT,PIRMAHAL TEHSIL,39,4393,583,4976
TOBA TEK SINGH DISTRICT,PIRMAHAL TEHSIL,40,3340,445,3785
TOBA TEK SINGH DISTRICT,PIRMAHAL TEHSIL,41,4185,549,4734
TOBA TEK SINGH DISTRICT,PIRMAHAL TEHSIL,42,3557,416,3973
TOBA TEK SINGH DISTRICT,PIRMAHAL TEHSIL,43,3378,456,3834
TOBA TEK SINGH DISTRICT,PIRMAHAL TEHSIL,44,3336,455,3791
TOBA TEK SINGH DISTRICT,PIRMAHAL TEHSIL,45,2734,309,3043
TOBA TEK SINGH DISTRICT,PIRMAHAL TEHSIL,46,3324,430,3754
TOBA TEK SINGH DISTRICT,PIRMAHAL TEHSIL,47,2910,347,3257
TOBA TEK SINGH DISTRICT,PIRMAHAL TEHSIL,48,3128,427,3555
TOBA TEK SINGH DISTRICT,PIRMAHAL TEHSIL,49,3200,389,3589
TOBA TEK SINGH DISTRICT,PIRMAHAL TEHSIL,50,2575,344,2919
TOBA TEK SINGH DISTRICT,PIRMAHAL TEHSIL,51,3347,419,3766
TOBA TEK SINGH DISTRICT,PIRMAHAL TEHSIL,52,2831,382,3213
TOBA TEK SINGH DISTRICT,PIRMAHAL TEHSIL,53,2754,388,3142
TOBA TEK SINGH DISTRICT,PIRMAHAL TEHSIL,54,2576,367,2943
TOBA TEK SINGH DISTRICT,PIRMAHAL TEHSIL,55,1957,259,2216
TOBA TEK SINGH DISTRICT,PIRMAHAL TEHSIL,56,2340,284,2624
TOBA TEK SINGH DISTRICT,PIRMAHAL TEHSIL,57,1838,225,2063
TOBA TEK SINGH DISTRICT,PIRMAHAL TEHSIL,58,1915,266,2181
TOBA TEK SINGH DISTRICT,PIRMAHAL TEHSIL,59,2057,253,2310
TOBA TEK SINGH DISTRICT,PIRMAHAL TEHSIL,60,1544,181,1725
TOBA TEK SINGH DISTRICT,PIRMAHAL TEHSIL,61,2002,269,2271
TOBA TEK SINGH DISTRICT,PIRMAHAL TEHSIL,62,1871,236,2107
TOBA TEK SINGH DISTRICT,PIRMAHAL TEHSIL,63,1678,246,1924
TOBA TEK SINGH DISTRICT,PIRMAHAL TEHSIL,64,1648,192,1840
TOBA TEK SINGH DISTRICT,PIRMAHAL TEHSIL,65,1265,121,1386
TOBA TEK SINGH DISTRICT,PIRMAHAL TEHSIL,66,1566,184,1750
TOBA TEK SINGH DISTRICT,PIRMAHAL TEHSIL,67,1077,128,1205
TOBA TEK SINGH DISTRICT,PIRMAHAL TEHSIL,68,1240,113,1353
TOBA TEK SINGH DISTRICT,PIRMAHAL TEHSIL,69,1144,107,1251
TOBA TEK SINGH DISTRICT,PIRMAHAL TEHSIL,70,934,84,1018
TOBA TEK SINGH DISTRICT,PIRMAHAL TEHSIL,71,1137,127,1264
TOBA TEK SINGH DISTRICT,PIRMAHAL TEHSIL,72,937,101,1038
TOBA TEK SINGH DISTRICT,PIRMAHAL TEHSIL,73,859,96,955
TOBA TEK SINGH DISTRICT,PIRMAHAL TEHSIL,74,723,80,803
TOBA TEK SINGH DISTRICT,PIRMAHAL TEHSIL,>=75,6142,641,6783
TOBA TEK SINGH DISTRICT,TOBA TEK SINGH TEHSIL,<1,16602,1977,18579
TOBA TEK SINGH DISTRICT,TOBA TEK SINGH TEHSIL,1,17328,2117,19445
TOBA TEK SINGH DISTRICT,TOBA TEK SINGH TEHSIL,2,15944,1986,17930
TOBA TEK SINGH DISTRICT,TOBA TEK SINGH TEHSIL,3,17225,2095,19320
TOBA TEK SINGH DISTRICT,TOBA TEK SINGH TEHSIL,4,17349,1984,19333
TOBA TEK SINGH DISTRICT,TOBA TEK SINGH TEHSIL,5,16631,1952,18583
TOBA TEK SINGH DISTRICT,TOBA TEK SINGH TEHSIL,6,16095,1807,17902
TOBA TEK SINGH DISTRICT,TOBA TEK SINGH TEHSIL,7,17285,1995,19280
TOBA TEK SINGH DISTRICT,TOBA TEK SINGH TEHSIL,8,15639,1733,17372
TOBA TEK SINGH DISTRICT,TOBA TEK SINGH TEHSIL,9,16923,2091,19014
TOBA TEK SINGH DISTRICT,TOBA TEK SINGH TEHSIL,10,14445,1672,16117
TOBA TEK SINGH DISTRICT,TOBA TEK SINGH TEHSIL,11,16105,2110,18215
TOBA TEK SINGH DISTRICT,TOBA TEK SINGH TEHSIL,12,13314,1692,15006
TOBA TEK SINGH DISTRICT,TOBA TEK SINGH TEHSIL,13,14349,2021,16370
TOBA TEK SINGH DISTRICT,TOBA TEK SINGH TEHSIL,14,13324,1857,15181
TOBA TEK SINGH DISTRICT,TOBA TEK SINGH TEHSIL,15,14075,1798,15873
TOBA TEK SINGH DISTRICT,TOBA TEK SINGH TEHSIL,16,13785,1970,15755
TOBA TEK SINGH DISTRICT,TOBA TEK SINGH TEHSIL,17,15341,2012,17353
TOBA TEK SINGH DISTRICT,TOBA TEK SINGH TEHSIL,18,10945,1502,12447
TOBA TEK SINGH DISTRICT,TOBA TEK SINGH TEHSIL,19,13031,1937,14968
TOBA TEK SINGH DISTRICT,TOBA TEK SINGH TEHSIL,20,11459,1487,12946
TOBA TEK SINGH DISTRICT,TOBA TEK SINGH TEHSIL,21,12900,1983,14883
TOBA TEK SINGH DISTRICT,TOBA TEK SINGH TEHSIL,22,11745,1565,13310
TOBA TEK SINGH DISTRICT,TOBA TEK SINGH TEHSIL,23,11746,1779,13525
TOBA TEK SINGH DISTRICT,TOBA TEK SINGH TEHSIL,24,10950,1670,12620
TOBA TEK SINGH DISTRICT,TOBA TEK SINGH TEHSIL,25,9267,1241,10508
TOBA TEK SINGH DISTRICT,TOBA TEK SINGH TEHSIL,26,10427,1530,11957
TOBA TEK SINGH DISTRICT,TOBA TEK SINGH TEHSIL,27,10130,1568,11698
TOBA TEK SINGH DISTRICT,TOBA TEK SINGH TEHSIL,28,9558,1474,11032
TOBA TEK SINGH DISTRICT,TOBA TEK SINGH TEHSIL,29,9701,1489,11190
TOBA TEK SINGH DISTRICT,TOBA TEK SINGH TEHSIL,30,8704,1232,9936
TOBA TEK SINGH DISTRICT,TOBA TEK SINGH TEHSIL,31,9691,1456,11147
TOBA TEK SINGH DISTRICT,TOBA TEK SINGH TEHSIL,32,8332,1271,9603
TOBA TEK SINGH DISTRICT,TOBA TEK SINGH TEHSIL,33,8567,1277,9844
TOBA TEK SINGH DISTRICT,TOBA TEK SINGH TEHSIL,34,9020,1285,10305
TOBA TEK SINGH DISTRICT,TOBA TEK SINGH TEHSIL,35,7503,966,8469
TOBA TEK SINGH DISTRICT,TOBA TEK SINGH TEHSIL,36,8915,1183,10098
TOBA TEK SINGH DISTRICT,TOBA TEK SINGH TEHSIL,37,7767,1154,8921
TOBA TEK SINGH DISTRICT,TOBA TEK SINGH TEHSIL,38,7642,1138,8780
TOBA TEK SINGH DISTRICT,TOBA TEK SINGH TEHSIL,39,7615,1101,8716
TOBA TEK SINGH DISTRICT,TOBA TEK SINGH TEHSIL,40,6069,865,6934
TOBA TEK SINGH DISTRICT,TOBA TEK SINGH TEHSIL,41,7517,978,8495
TOBA TEK SINGH DISTRICT,TOBA TEK SINGH TEHSIL,42,5957,859,6816
TOBA TEK SINGH DISTRICT,TOBA TEK SINGH TEHSIL,43,6121,945,7066
TOBA TEK SINGH DISTRICT,TOBA TEK SINGH TEHSIL,44,6140,871,7011
TOBA TEK SINGH DISTRICT,TOBA TEK SINGH TEHSIL,45,4812,672,5484
TOBA TEK SINGH DISTRICT,TOBA TEK SINGH TEHSIL,46,5954,851,6805
TOBA TEK SINGH DISTRICT,TOBA TEK SINGH TEHSIL,47,5218,724,5942
TOBA TEK SINGH DISTRICT,TOBA TEK SINGH TEHSIL,48,5765,845,6610
TOBA TEK SINGH DISTRICT,TOBA TEK SINGH TEHSIL,49,5900,872,6772
TOBA TEK SINGH DISTRICT,TOBA TEK SINGH TEHSIL,50,4833,688,5521
TOBA TEK SINGH DISTRICT,TOBA TEK SINGH TEHSIL,51,6214,804,7018
TOBA TEK SINGH DISTRICT,TOBA TEK SINGH TEHSIL,52,5411,777,6188
TOBA TEK SINGH DISTRICT,TOBA TEK SINGH TEHSIL,53,5393,874,6267
TOBA TEK SINGH DISTRICT,TOBA TEK SINGH TEHSIL,54,5010,806,5816
TOBA TEK SINGH DISTRICT,TOBA TEK SINGH TEHSIL,55,3694,595,4289
TOBA TEK SINGH DISTRICT,TOBA TEK SINGH TEHSIL,56,4597,684,5281
TOBA TEK SINGH DISTRICT,TOBA TEK SINGH TEHSIL,57,3608,541,4149
TOBA TEK SINGH DISTRICT,TOBA TEK SINGH TEHSIL,58,3834,553,4387
TOBA TEK SINGH DISTRICT,TOBA TEK SINGH TEHSIL,59,3884,538,4422
TOBA TEK SINGH DISTRICT,TOBA TEK SINGH TEHSIL,60,3005,417,3422
TOBA TEK SINGH DISTRICT,TOBA TEK SINGH TEHSIL,61,3904,523,4427
TOBA TEK SINGH DISTRICT,TOBA TEK SINGH TEHSIL,62,3424,435,3859
TOBA TEK SINGH DISTRICT,TOBA TEK SINGH TEHSIL,63,3266,446,3712
TOBA TEK SINGH DISTRICT,TOBA TEK SINGH TEHSIL,64,3079,339,3418
TOBA TEK SINGH DISTRICT,TOBA TEK SINGH TEHSIL,65,2462,291,2753
TOBA TEK SINGH DISTRICT,TOBA TEK SINGH TEHSIL,66,2664,309,2973
TOBA TEK SINGH DISTRICT,TOBA TEK SINGH TEHSIL,67,2140,239,2379
TOBA TEK SINGH DISTRICT,TOBA TEK SINGH TEHSIL,68,2216,266,2482
TOBA TEK SINGH DISTRICT,TOBA TEK SINGH TEHSIL,69,2192,243,2435
TOBA TEK SINGH DISTRICT,TOBA TEK SINGH TEHSIL,70,1794,193,1987
TOBA TEK SINGH DISTRICT,TOBA TEK SINGH TEHSIL,71,2299,240,2539
TOBA TEK SINGH DISTRICT,TOBA TEK SINGH TEHSIL,72,1957,215,2172
TOBA TEK SINGH DISTRICT,TOBA TEK SINGH TEHSIL,73,1768,183,1951
TOBA TEK SINGH DISTRICT,TOBA TEK SINGH TEHSIL,74,1528,169,1697
TOBA TEK SINGH DISTRICT,TOBA TEK SINGH TEHSIL,>=75,11768,1239,13007
TORGHAR DISTRICT,JUDBA TEHSIL,<1,3202,0,3202
TORGHAR DISTRICT,JUDBA TEHSIL,1,2943,0,2943
TORGHAR DISTRICT,JUDBA TEHSIL,2,3479,0,3479
TORGHAR DISTRICT,JUDBA TEHSIL,3,3549,0,3549
TORGHAR DISTRICT,JUDBA TEHSIL,4,3737,0,3737
TORGHAR DISTRICT,JUDBA TEHSIL,5,3635,0,3635
TORGHAR DISTRICT,JUDBA TEHSIL,6,3436,0,3436
TORGHAR DISTRICT,JUDBA TEHSIL,7,3379,0,3379
TORGHAR DISTRICT,JUDBA TEHSIL,8,3569,0,3569
TORGHAR DISTRICT,JUDBA TEHSIL,9,3345,0,3345
TORGHAR DISTRICT,JUDBA TEHSIL,10,3273,0,3273
TORGHAR DISTRICT,JUDBA TEHSIL,11,2747,0,2747
TORGHAR DISTRICT,JUDBA TEHSIL,12,2765,0,2765
TORGHAR DISTRICT,JUDBA TEHSIL,13,2494,0,2494
TORGHAR DISTRICT,JUDBA TEHSIL,14,2038,0,2038
TORGHAR DISTRICT,JUDBA TEHSIL,15,2178,0,2178
TORGHAR DISTRICT,JUDBA TEHSIL,16,1700,0,1700
TORGHAR DISTRICT,JUDBA TEHSIL,17,1595,0,1595
TORGHAR DISTRICT,JUDBA TEHSIL,18,1858,0,1858
TORGHAR DISTRICT,JUDBA TEHSIL,19,1539,0,1539
TORGHAR DISTRICT,JUDBA TEHSIL,20,1873,0,1873
TORGHAR DISTRICT,JUDBA TEHSIL,21,1575,0,1575
TORGHAR DISTRICT,JUDBA TEHSIL,22,1518,0,1518
TORGHAR DISTRICT,JUDBA TEHSIL,23,1360,0,1360
TORGHAR DISTRICT,JUDBA TEHSIL,24,1273,0,1273
TORGHAR DISTRICT,JUDBA TEHSIL,25,1481,0,1481
TORGHAR DISTRICT,JUDBA TEHSIL,26,1339,0,1339
TORGHAR DISTRICT,JUDBA TEHSIL,27,1494,0,1494
TORGHAR DISTRICT,JUDBA TEHSIL,28,1082,0,1082
TORGHAR DISTRICT,JUDBA TEHSIL,29,1363,0,1363
TORGHAR DISTRICT,JUDBA TEHSIL,30,1185,0,1185
TORGHAR DISTRICT,JUDBA TEHSIL,31,1248,0,1248
TORGHAR DISTRICT,JUDBA TEHSIL,32,1082,0,1082
TORGHAR DISTRICT,JUDBA TEHSIL,33,949,0,949
TORGHAR DISTRICT,JUDBA TEHSIL,34,940,0,940
TORGHAR DISTRICT,JUDBA TEHSIL,35,923,0,923
TORGHAR DISTRICT,JUDBA TEHSIL,36,980,0,980
TORGHAR DISTRICT,JUDBA TEHSIL,37,1091,0,1091
TORGHAR DISTRICT,JUDBA TEHSIL,38,719,0,719
TORGHAR DISTRICT,JUDBA TEHSIL,39,813,0,813
TORGHAR DISTRICT,JUDBA TEHSIL,40,790,0,790
TORGHAR DISTRICT,JUDBA TEHSIL,41,925,0,925
TORGHAR DISTRICT,JUDBA TEHSIL,42,770,0,770
TORGHAR DISTRICT,JUDBA TEHSIL,43,611,0,611
TORGHAR DISTRICT,JUDBA TEHSIL,44,607,0,607
TORGHAR DISTRICT,JUDBA TEHSIL,45,567,0,567
TORGHAR DISTRICT,JUDBA TEHSIL,46,659,0,659
TORGHAR DISTRICT,JUDBA TEHSIL,47,722,0,722
TORGHAR DISTRICT,JUDBA TEHSIL,48,448,0,448
TORGHAR DISTRICT,JUDBA TEHSIL,49,539,0,539
TORGHAR DISTRICT,JUDBA TEHSIL,50,515,0,515
TORGHAR DISTRICT,JUDBA TEHSIL,51,546,0,546
TORGHAR DISTRICT,JUDBA TEHSIL,52,482,0,482
TORGHAR DISTRICT,JUDBA TEHSIL,53,389,0,389
TORGHAR DISTRICT,JUDBA TEHSIL,54,362,0,362
TORGHAR DISTRICT,JUDBA TEHSIL,55,358,0,358
TORGHAR DISTRICT,JUDBA TEHSIL,56,373,0,373
TORGHAR DISTRICT,JUDBA TEHSIL,57,443,0,443
TORGHAR DISTRICT,JUDBA TEHSIL,58,301,0,301
TORGHAR DISTRICT,JUDBA TEHSIL,59,310,0,310
TORGHAR DISTRICT,JUDBA TEHSIL,60,353,0,353
TORGHAR DISTRICT,JUDBA TEHSIL,61,354,0,354
TORGHAR DISTRICT,JUDBA TEHSIL,62,338,0,338
TORGHAR DISTRICT,JUDBA TEHSIL,63,298,0,298
TORGHAR DISTRICT,JUDBA TEHSIL,64,332,0,332
TORGHAR DISTRICT,JUDBA TEHSIL,65,270,0,270
TORGHAR DISTRICT,JUDBA TEHSIL,66,282,0,282
TORGHAR DISTRICT,JUDBA TEHSIL,67,335,0,335
TORGHAR DISTRICT,JUDBA TEHSIL,68,242,0,242
TORGHAR DISTRICT,JUDBA TEHSIL,69,258,0,258
TORGHAR DISTRICT,JUDBA TEHSIL,70,251,0,251
TORGHAR DISTRICT,JUDBA TEHSIL,71,221,0,221
TORGHAR DISTRICT,JUDBA TEHSIL,72,195,0,195
TORGHAR DISTRICT,JUDBA TEHSIL,73,172,0,172
TORGHAR DISTRICT,JUDBA TEHSIL,74,176,0,176
TORGHAR DISTRICT,JUDBA TEHSIL,>=75,1345,0,1345
TORGHAR DISTRICT,KHANDER TEHSIL,<1,2500,0,2500
TORGHAR DISTRICT,KHANDER TEHSIL,1,2180,0,2180
TORGHAR DISTRICT,KHANDER TEHSIL,2,2531,0,2531
TORGHAR DISTRICT,KHANDER TEHSIL,3,2619,0,2619
TORGHAR DISTRICT,KHANDER TEHSIL,4,2649,0,2649
TORGHAR DISTRICT,KHANDER TEHSIL,5,2599,0,2599
TORGHAR DISTRICT,KHANDER TEHSIL,6,2662,0,2662
TORGHAR DISTRICT,KHANDER TEHSIL,7,2606,0,2606
TORGHAR DISTRICT,KHANDER TEHSIL,8,2688,0,2688
TORGHAR DISTRICT,KHANDER TEHSIL,9,2484,0,2484
TORGHAR DISTRICT,KHANDER TEHSIL,10,2356,0,2356
TORGHAR DISTRICT,KHANDER TEHSIL,11,2063,0,2063
TORGHAR DISTRICT,KHANDER TEHSIL,12,2022,0,2022
TORGHAR DISTRICT,KHANDER TEHSIL,13,1821,0,1821
TORGHAR DISTRICT,KHANDER TEHSIL,14,1716,0,1716
TORGHAR DISTRICT,KHANDER TEHSIL,15,1572,0,1572
TORGHAR DISTRICT,KHANDER TEHSIL,16,1412,0,1412
TORGHAR DISTRICT,KHANDER TEHSIL,17,1334,0,1334
TORGHAR DISTRICT,KHANDER TEHSIL,18,1252,0,1252
TORGHAR DISTRICT,KHANDER TEHSIL,19,1243,0,1243
TORGHAR DISTRICT,KHANDER TEHSIL,20,1198,0,1198
TORGHAR DISTRICT,KHANDER TEHSIL,21,1151,0,1151
TORGHAR DISTRICT,KHANDER TEHSIL,22,1090,0,1090
TORGHAR DISTRICT,KHANDER TEHSIL,23,1057,0,1057
TORGHAR DISTRICT,KHANDER TEHSIL,24,1176,0,1176
TORGHAR DISTRICT,KHANDER TEHSIL,25,963,0,963
TORGHAR DISTRICT,KHANDER TEHSIL,26,1166,0,1166
TORGHAR DISTRICT,KHANDER TEHSIL,27,1122,0,1122
TORGHAR DISTRICT,KHANDER TEHSIL,28,887,0,887
TORGHAR DISTRICT,KHANDER TEHSIL,29,1080,0,1080
TORGHAR DISTRICT,KHANDER TEHSIL,30,769,0,769
TORGHAR DISTRICT,KHANDER TEHSIL,31,1059,0,1059
TORGHAR DISTRICT,KHANDER TEHSIL,32,823,0,823
TORGHAR DISTRICT,KHANDER TEHSIL,33,716,0,716
TORGHAR DISTRICT,KHANDER TEHSIL,34,784,0,784
TORGHAR DISTRICT,KHANDER TEHSIL,35,615,0,615
TORGHAR DISTRICT,KHANDER TEHSIL,36,864,0,864
TORGHAR DISTRICT,KHANDER TEHSIL,37,750,0,750
TORGHAR DISTRICT,KHANDER TEHSIL,38,644,0,644
TORGHAR DISTRICT,KHANDER TEHSIL,39,683,0,683
TORGHAR DISTRICT,KHANDER TEHSIL,40,485,0,485
TORGHAR DISTRICT,KHANDER TEHSIL,41,789,0,789
TORGHAR DISTRICT,KHANDER TEHSIL,42,624,0,624
TORGHAR DISTRICT,KHANDER TEHSIL,43,535,0,535
TORGHAR DISTRICT,KHANDER TEHSIL,44,507,0,507
TORGHAR DISTRICT,KHANDER TEHSIL,45,398,0,398
TORGHAR DISTRICT,KHANDER TEHSIL,46,640,0,640
TORGHAR DISTRICT,KHANDER TEHSIL,47,508,0,508
TORGHAR DISTRICT,KHANDER TEHSIL,48,419,0,419
TORGHAR DISTRICT,KHANDER TEHSIL,49,457,0,457
TORGHAR DISTRICT,KHANDER TEHSIL,50,340,0,340
TORGHAR DISTRICT,KHANDER TEHSIL,51,486,0,486
TORGHAR DISTRICT,KHANDER TEHSIL,52,405,0,405
TORGHAR DISTRICT,KHANDER TEHSIL,53,306,0,306
TORGHAR DISTRICT,KHANDER TEHSIL,54,278,0,278
TORGHAR DISTRICT,KHANDER TEHSIL,55,235,0,235
TORGHAR DISTRICT,KHANDER TEHSIL,56,354,0,354
TORGHAR DISTRICT,KHANDER TEHSIL,57,353,0,353
TORGHAR DISTRICT,KHANDER TEHSIL,58,293,0,293
TORGHAR DISTRICT,KHANDER TEHSIL,59,279,0,279
TORGHAR DISTRICT,KHANDER TEHSIL,60,264,0,264
TORGHAR DISTRICT,KHANDER TEHSIL,61,313,0,313
TORGHAR DISTRICT,KHANDER TEHSIL,62,301,0,301
TORGHAR DISTRICT,KHANDER TEHSIL,63,256,0,256
TORGHAR DISTRICT,KHANDER TEHSIL,64,270,0,270
TORGHAR DISTRICT,KHANDER TEHSIL,65,221,0,221
TORGHAR DISTRICT,KHANDER TEHSIL,66,272,0,272
TORGHAR DISTRICT,KHANDER TEHSIL,67,253,0,253
TORGHAR DISTRICT,KHANDER TEHSIL,68,255,0,255
TORGHAR DISTRICT,KHANDER TEHSIL,69,309,0,309
TORGHAR DISTRICT,KHANDER TEHSIL,70,205,0,205
TORGHAR DISTRICT,KHANDER TEHSIL,71,191,0,191
TORGHAR DISTRICT,KHANDER TEHSIL,72,172,0,172
TORGHAR DISTRICT,KHANDER TEHSIL,73,190,0,190
TORGHAR DISTRICT,KHANDER TEHSIL,74,205,0,205
TORGHAR DISTRICT,KHANDER TEHSIL,>=75,1187,0,1187
UMER KOT DISTRICT,KUNRI TALUKA,<1,4580,899,5479
UMER KOT DISTRICT,KUNRI TALUKA,1,5408,1009,6417
UMER KOT DISTRICT,KUNRI TALUKA,2,6518,1022,7540
UMER KOT DISTRICT,KUNRI TALUKA,3,6647,1038,7685
UMER KOT DISTRICT,KUNRI TALUKA,4,6803,1219,8022
UMER KOT DISTRICT,KUNRI TALUKA,5,6662,1035,7697
UMER KOT DISTRICT,KUNRI TALUKA,6,6802,1069,7871
UMER KOT DISTRICT,KUNRI TALUKA,7,5594,1001,6595
UMER KOT DISTRICT,KUNRI TALUKA,8,7182,1092,8274
UMER KOT DISTRICT,KUNRI TALUKA,9,4981,1002,5983
UMER KOT DISTRICT,KUNRI TALUKA,10,6235,914,7149
UMER KOT DISTRICT,KUNRI TALUKA,11,3906,947,4853
UMER KOT DISTRICT,KUNRI TALUKA,12,4744,925,5669
UMER KOT DISTRICT,KUNRI TALUKA,13,3302,832,4134
UMER KOT DISTRICT,KUNRI TALUKA,14,3342,848,4190
UMER KOT DISTRICT,KUNRI TALUKA,15,3445,819,4264
UMER KOT DISTRICT,KUNRI TALUKA,16,3242,855,4097
UMER KOT DISTRICT,KUNRI TALUKA,17,2684,828,3512
UMER KOT DISTRICT,KUNRI TALUKA,18,3825,791,4616
UMER KOT DISTRICT,KUNRI TALUKA,19,2919,779,3698
UMER KOT DISTRICT,KUNRI TALUKA,20,3854,773,4627
UMER KOT DISTRICT,KUNRI TALUKA,21,2641,748,3389
UMER KOT DISTRICT,KUNRI TALUKA,22,2757,656,3413
UMER KOT DISTRICT,KUNRI TALUKA,23,2602,671,3273
UMER KOT DISTRICT,KUNRI TALUKA,24,2397,615,3012
UMER KOT DISTRICT,KUNRI TALUKA,25,2819,597,3416
UMER KOT DISTRICT,KUNRI TALUKA,26,2437,680,3117
UMER KOT DISTRICT,KUNRI TALUKA,27,2892,690,3582
UMER KOT DISTRICT,KUNRI TALUKA,28,2532,597,3129
UMER KOT DISTRICT,KUNRI TALUKA,29,2746,634,3380
UMER KOT DISTRICT,KUNRI TALUKA,30,2522,490,3012
UMER KOT DISTRICT,KUNRI TALUKA,31,2787,696,3483
UMER KOT DISTRICT,KUNRI TALUKA,32,2558,559,3117
UMER KOT DISTRICT,KUNRI TALUKA,33,2324,576,2900
UMER KOT DISTRICT,KUNRI TALUKA,34,1968,539,2507
UMER KOT DISTRICT,KUNRI TALUKA,35,2113,442,2555
UMER KOT DISTRICT,KUNRI TALUKA,36,1971,555,2526
UMER KOT DISTRICT,KUNRI TALUKA,37,2863,619,3482
UMER KOT DISTRICT,KUNRI TALUKA,38,1704,512,2216
UMER KOT DISTRICT,KUNRI TALUKA,39,2174,506,2680
UMER KOT DISTRICT,KUNRI TALUKA,40,1447,331,1778
UMER KOT DISTRICT,KUNRI TALUKA,41,1660,423,2083
UMER KOT DISTRICT,KUNRI TALUKA,42,1630,389,2019
UMER KOT DISTRICT,KUNRI TALUKA,43,1339,367,1706
UMER KOT DISTRICT,KUNRI TALUKA,44,1212,341,1553
UMER KOT DISTRICT,KUNRI TALUKA,45,1165,290,1455
UMER KOT DISTRICT,KUNRI TALUKA,46,1264,336,1600
UMER KOT DISTRICT,KUNRI TALUKA,47,1591,353,1944
UMER KOT DISTRICT,KUNRI TALUKA,48,1059,322,1381
UMER KOT DISTRICT,KUNRI TALUKA,49,1168,354,1522
UMER KOT DISTRICT,KUNRI TALUKA,50,1012,239,1251
UMER KOT DISTRICT,KUNRI TALUKA,51,1044,299,1343
UMER KOT DISTRICT,KUNRI TALUKA,52,959,266,1225
UMER KOT DISTRICT,KUNRI TALUKA,53,736,273,1009
UMER KOT DISTRICT,KUNRI TALUKA,54,614,241,855
UMER KOT DISTRICT,KUNRI TALUKA,55,573,166,739
UMER KOT DISTRICT,KUNRI TALUKA,56,581,186,767
UMER KOT DISTRICT,KUNRI TALUKA,57,702,197,899
UMER KOT DISTRICT,KUNRI TALUKA,58,552,179,731
UMER KOT DISTRICT,KUNRI TALUKA,59,726,199,925
UMER KOT DISTRICT,KUNRI TALUKA,60,625,158,783
UMER KOT DISTRICT,KUNRI TALUKA,61,650,200,850
UMER KOT DISTRICT,KUNRI TALUKA,62,616,169,785
UMER KOT DISTRICT,KUNRI TALUKA,63,587,184,771
UMER KOT DISTRICT,KUNRI TALUKA,64,638,169,807
UMER KOT DISTRICT,KUNRI TALUKA,65,527,107,634
UMER KOT DISTRICT,KUNRI TALUKA,66,443,125,568
UMER KOT DISTRICT,KUNRI TALUKA,67,391,129,520
UMER KOT DISTRICT,KUNRI TALUKA,68,395,89,484
UMER KOT DISTRICT,KUNRI TALUKA,69,473,97,570
UMER KOT DISTRICT,KUNRI TALUKA,70,410,88,498
UMER KOT DISTRICT,KUNRI TALUKA,71,367,100,467
UMER KOT DISTRICT,KUNRI TALUKA,72,234,95,329
UMER KOT DISTRICT,KUNRI TALUKA,73,275,66,341
UMER KOT DISTRICT,KUNRI TALUKA,74,296,70,366
UMER KOT DISTRICT,KUNRI TALUKA,>=75,1823,518,2341
UMER KOT DISTRICT,PITHORO TALUKA,<1,3017,321,3338
UMER KOT DISTRICT,PITHORO TALUKA,1,3504,356,3860
UMER KOT DISTRICT,PITHORO TALUKA,2,3994,376,4370
UMER KOT DISTRICT,PITHORO TALUKA,3,4328,420,4748
UMER KOT DISTRICT,PITHORO TALUKA,4,4190,387,4577
UMER KOT DISTRICT,PITHORO TALUKA,5,4153,448,4601
UMER KOT DISTRICT,PITHORO TALUKA,6,3963,370,4333
UMER KOT DISTRICT,PITHORO TALUKA,7,3491,403,3894
UMER KOT DISTRICT,PITHORO TALUKA,8,4038,359,4397
UMER KOT DISTRICT,PITHORO TALUKA,9,3150,337,3487
UMER KOT DISTRICT,PITHORO TALUKA,10,3371,351,3722
UMER KOT DISTRICT,PITHORO TALUKA,11,2379,285,2664
UMER KOT DISTRICT,PITHORO TALUKA,12,2580,307,2887
UMER KOT DISTRICT,PITHORO TALUKA,13,1998,247,2245
UMER KOT DISTRICT,PITHORO TALUKA,14,1994,246,2240
UMER KOT DISTRICT,PITHORO TALUKA,15,2074,266,2340
UMER KOT DISTRICT,PITHORO TALUKA,16,1837,259,2096
UMER KOT DISTRICT,PITHORO TALUKA,17,1625,240,1865
UMER KOT DISTRICT,PITHORO TALUKA,18,2257,241,2498
UMER KOT DISTRICT,PITHORO TALUKA,19,1969,269,2238
UMER KOT DISTRICT,PITHORO TALUKA,20,1986,252,2238
UMER KOT DISTRICT,PITHORO TALUKA,21,1600,211,1811
UMER KOT DISTRICT,PITHORO TALUKA,22,1436,193,1629
UMER KOT DISTRICT,PITHORO TALUKA,23,1573,222,1795
UMER KOT DISTRICT,PITHORO TALUKA,24,1468,202,1670
UMER KOT DISTRICT,PITHORO TALUKA,25,1446,191,1637
UMER KOT DISTRICT,PITHORO TALUKA,26,1688,217,1905
UMER KOT DISTRICT,PITHORO TALUKA,27,1840,242,2082
UMER KOT DISTRICT,PITHORO TALUKA,28,1447,191,1638
UMER KOT DISTRICT,PITHORO TALUKA,29,1663,262,1925
UMER KOT DISTRICT,PITHORO TALUKA,30,1246,192,1438
UMER KOT DISTRICT,PITHORO TALUKA,31,1692,256,1948
UMER KOT DISTRICT,PITHORO TALUKA,32,1493,198,1691
UMER KOT DISTRICT,PITHORO TALUKA,33,1329,192,1521
UMER KOT DISTRICT,PITHORO TALUKA,34,1259,162,1421
UMER KOT DISTRICT,PITHORO TALUKA,35,1088,145,1233
UMER KOT DISTRICT,PITHORO TALUKA,36,1469,144,1613
UMER KOT DISTRICT,PITHORO TALUKA,37,1683,229,1912
UMER KOT DISTRICT,PITHORO TALUKA,38,1143,122,1265
UMER KOT DISTRICT,PITHORO TALUKA,39,1185,176,1361
UMER KOT DISTRICT,PITHORO TALUKA,40,720,109,829
UMER KOT DISTRICT,PITHORO TALUKA,41,1033,137,1170
UMER KOT DISTRICT,PITHORO TALUKA,42,959,136,1095
UMER KOT DISTRICT,PITHORO TALUKA,43,781,112,893
UMER KOT DISTRICT,PITHORO TALUKA,44,785,79,864
UMER KOT DISTRICT,PITHORO TALUKA,45,548,91,639
UMER KOT DISTRICT,PITHORO TALUKA,46,837,99,936
UMER KOT DISTRICT,PITHORO TALUKA,47,889,120,1009
UMER KOT DISTRICT,PITHORO TALUKA,48,653,88,741
UMER KOT DISTRICT,PITHORO TALUKA,49,723,102,825
UMER KOT DISTRICT,PITHORO TALUKA,50,450,57,507
UMER KOT DISTRICT,PITHORO TALUKA,51,730,103,833
UMER KOT DISTRICT,PITHORO TALUKA,52,575,75,650
UMER KOT DISTRICT,PITHORO TALUKA,53,436,92,528
UMER KOT DISTRICT,PITHORO TALUKA,54,407,74,481
UMER KOT DISTRICT,PITHORO TALUKA,55,333,62,395
UMER KOT DISTRICT,PITHORO TALUKA,56,405,55,460
UMER KOT DISTRICT,PITHORO TALUKA,57,470,79,549
UMER KOT DISTRICT,PITHORO TALUKA,58,330,55,385
UMER KOT DISTRICT,PITHORO TALUKA,59,351,57,408
UMER KOT DISTRICT,PITHORO TALUKA,60,276,48,324
UMER KOT DISTRICT,PITHORO TALUKA,61,371,60,431
UMER KOT DISTRICT,PITHORO TALUKA,62,352,53,405
UMER KOT DISTRICT,PITHORO TALUKA,63,281,65,346
UMER KOT DISTRICT,PITHORO TALUKA,64,342,45,387
UMER KOT DISTRICT,PITHORO TALUKA,65,258,41,299
UMER KOT DISTRICT,PITHORO TALUKA,66,302,36,338
UMER KOT DISTRICT,PITHORO TALUKA,67,270,31,301
UMER KOT DISTRICT,PITHORO TALUKA,68,227,43,270
UMER KOT DISTRICT,PITHORO TALUKA,69,275,26,301
UMER KOT DISTRICT,PITHORO TALUKA,70,171,18,189
UMER KOT DISTRICT,PITHORO TALUKA,71,214,23,237
UMER KOT DISTRICT,PITHORO TALUKA,72,193,22,215
UMER KOT DISTRICT,PITHORO TALUKA,73,194,22,216
UMER KOT DISTRICT,PITHORO TALUKA,74,152,26,178
UMER KOT DISTRICT,PITHORO TALUKA,>=75,1094,144,1238
UMER KOT DISTRICT,SAMARO TALUKA,<1,4769,183,4952
UMER KOT DISTRICT,SAMARO TALUKA,1,4821,194,5015
UMER KOT DISTRICT,SAMARO TALUKA,2,6005,220,6225
UMER KOT DISTRICT,SAMARO TALUKA,3,6130,257,6387
UMER KOT DISTRICT,SAMARO TALUKA,4,6358,232,6590
UMER KOT DISTRICT,SAMARO TALUKA,5,6156,244,6400
UMER KOT DISTRICT,SAMARO TALUKA,6,6269,207,6476
UMER KOT DISTRICT,SAMARO TALUKA,7,5122,228,5350
UMER KOT DISTRICT,SAMARO TALUKA,8,6458,193,6651
UMER KOT DISTRICT,SAMARO TALUKA,9,4362,215,4577
UMER KOT DISTRICT,SAMARO TALUKA,10,5389,205,5594
UMER KOT DISTRICT,SAMARO TALUKA,11,3438,227,3665
UMER KOT DISTRICT,SAMARO TALUKA,12,4167,194,4361
UMER KOT DISTRICT,SAMARO TALUKA,13,2828,188,3016
UMER KOT DISTRICT,SAMARO TALUKA,14,3108,192,3300
UMER KOT DISTRICT,SAMARO TALUKA,15,3154,186,3340
UMER KOT DISTRICT,SAMARO TALUKA,16,2907,193,3100
UMER KOT DISTRICT,SAMARO TALUKA,17,2289,210,2499
UMER KOT DISTRICT,SAMARO TALUKA,18,3557,167,3724
UMER KOT DISTRICT,SAMARO TALUKA,19,2635,250,2885
UMER KOT DISTRICT,SAMARO TALUKA,20,3096,164,3260
UMER KOT DISTRICT,SAMARO TALUKA,21,2274,205,2479
UMER KOT DISTRICT,SAMARO TALUKA,22,2280,141,2421
UMER KOT DISTRICT,SAMARO TALUKA,23,2094,211,2305
UMER KOT DISTRICT,SAMARO TALUKA,24,2294,181,2475
UMER KOT DISTRICT,SAMARO TALUKA,25,2388,147,2535
UMER KOT DISTRICT,SAMARO TALUKA,26,2422,147,2569
UMER KOT DISTRICT,SAMARO TALUKA,27,2794,213,3007
UMER KOT DISTRICT,SAMARO TALUKA,28,2280,147,2427
UMER KOT DISTRICT,SAMARO TALUKA,29,2557,173,2730
UMER KOT DISTRICT,SAMARO TALUKA,30,1913,139,2052
UMER KOT DISTRICT,SAMARO TALUKA,31,2603,143,2746
UMER KOT DISTRICT,SAMARO TALUKA,32,2483,172,2655
UMER KOT DISTRICT,SAMARO TALUKA,33,2054,151,2205
UMER KOT DISTRICT,SAMARO TALUKA,34,1925,145,2070
UMER KOT DISTRICT,SAMARO TALUKA,35,1664,114,1778
UMER KOT DISTRICT,SAMARO TALUKA,36,2037,132,2169
UMER KOT DISTRICT,SAMARO TALUKA,37,2719,162,2881
UMER KOT DISTRICT,SAMARO TALUKA,38,1412,115,1527
UMER KOT DISTRICT,SAMARO TALUKA,39,1909,116,2025
UMER KOT DISTRICT,SAMARO TALUKA,40,995,82,1077
UMER KOT DISTRICT,SAMARO TALUKA,41,1537,97,1634
UMER KOT DISTRICT,SAMARO TALUKA,42,1513,113,1626
UMER KOT DISTRICT,SAMARO TALUKA,43,1083,99,1182
UMER KOT DISTRICT,SAMARO TALUKA,44,1148,81,1229
UMER KOT DISTRICT,SAMARO TALUKA,45,940,51,991
UMER KOT DISTRICT,SAMARO TALUKA,46,1227,67,1294
UMER KOT DISTRICT,SAMARO TALUKA,47,1522,88,1610
UMER KOT DISTRICT,SAMARO TALUKA,48,1014,86,1100
UMER KOT DISTRICT,SAMARO TALUKA,49,1088,94,1182
UMER KOT DISTRICT,SAMARO TALUKA,50,661,75,736
UMER KOT DISTRICT,SAMARO TALUKA,51,974,96,1070
UMER KOT DISTRICT,SAMARO TALUKA,52,789,68,857
UMER KOT DISTRICT,SAMARO TALUKA,53,633,54,687
UMER KOT DISTRICT,SAMARO TALUKA,54,568,59,627
UMER KOT DISTRICT,SAMARO TALUKA,55,418,37,455
UMER KOT DISTRICT,SAMARO TALUKA,56,516,48,564
UMER KOT DISTRICT,SAMARO TALUKA,57,712,59,771
UMER KOT DISTRICT,SAMARO TALUKA,58,501,52,553
UMER KOT DISTRICT,SAMARO TALUKA,59,580,39,619
UMER KOT DISTRICT,SAMARO TALUKA,60,420,22,442
UMER KOT DISTRICT,SAMARO TALUKA,61,521,48,569
UMER KOT DISTRICT,SAMARO TALUKA,62,528,28,556
UMER KOT DISTRICT,SAMARO TALUKA,63,501,45,546
UMER KOT DISTRICT,SAMARO TALUKA,64,614,40,654
UMER KOT DISTRICT,SAMARO TALUKA,65,385,24,409
UMER KOT DISTRICT,SAMARO TALUKA,66,368,27,395
UMER KOT DISTRICT,SAMARO TALUKA,67,436,27,463
UMER KOT DISTRICT,SAMARO TALUKA,68,381,19,400
UMER KOT DISTRICT,SAMARO TALUKA,69,474,24,498
UMER KOT DISTRICT,SAMARO TALUKA,70,265,15,280
UMER KOT DISTRICT,SAMARO TALUKA,71,277,21,298
UMER KOT DISTRICT,SAMARO TALUKA,72,221,21,242
UMER KOT DISTRICT,SAMARO TALUKA,73,213,20,233
UMER KOT DISTRICT,SAMARO TALUKA,74,275,19,294
UMER KOT DISTRICT,SAMARO TALUKA,>=75,1549,101,1650
UMER KOT DISTRICT,UMER KOT TALUKA,<1,11467,4452,15919
UMER KOT DISTRICT,UMER KOT TALUKA,1,13364,5453,18817
UMER KOT DISTRICT,UMER KOT TALUKA,2,14990,5953,20943
UMER KOT DISTRICT,UMER KOT TALUKA,3,14766,6159,20925
UMER KOT DISTRICT,UMER KOT TALUKA,4,15339,6290,21629
UMER KOT DISTRICT,UMER KOT TALUKA,5,14102,6017,20119
UMER KOT DISTRICT,UMER KOT TALUKA,6,14664,5892,20556
UMER KOT DISTRICT,UMER KOT TALUKA,7,11128,5060,16188
UMER KOT DISTRICT,UMER KOT TALUKA,8,15272,6153,21425
UMER KOT DISTRICT,UMER KOT TALUKA,9,10750,5043,15793
UMER KOT DISTRICT,UMER KOT TALUKA,10,12555,5166,17721
UMER KOT DISTRICT,UMER KOT TALUKA,11,8379,4233,12612
UMER KOT DISTRICT,UMER KOT TALUKA,12,9964,4407,14371
UMER KOT DISTRICT,UMER KOT TALUKA,13,7318,3865,11183
UMER KOT DISTRICT,UMER KOT TALUKA,14,7397,3511,10908
UMER KOT DISTRICT,UMER KOT TALUKA,15,7517,3941,11458
UMER KOT DISTRICT,UMER KOT TALUKA,16,6893,3474,10367
UMER KOT DISTRICT,UMER KOT TALUKA,17,5906,3683,9589
UMER KOT DISTRICT,UMER KOT TALUKA,18,8213,3732,11945
UMER KOT DISTRICT,UMER KOT TALUKA,19,6865,3711,10576
UMER KOT DISTRICT,UMER KOT TALUKA,20,7758,3582,11340
UMER KOT DISTRICT,UMER KOT TALUKA,21,5956,3223,9179
UMER KOT DISTRICT,UMER KOT TALUKA,22,5378,2888,8266
UMER KOT DISTRICT,UMER KOT TALUKA,23,5353,3041,8394
UMER KOT DISTRICT,UMER KOT TALUKA,24,4991,2851,7842
UMER KOT DISTRICT,UMER KOT TALUKA,25,5177,2777,7954
UMER KOT DISTRICT,UMER KOT TALUKA,26,4931,2722,7653
UMER KOT DISTRICT,UMER KOT TALUKA,27,6109,3124,9233
UMER KOT DISTRICT,UMER KOT TALUKA,28,4827,2699,7526
UMER KOT DISTRICT,UMER KOT TALUKA,29,5884,3252,9136
UMER KOT DISTRICT,UMER KOT TALUKA,30,4392,2381,6773
UMER KOT DISTRICT,UMER KOT TALUKA,31,5943,3120,9063
UMER KOT DISTRICT,UMER KOT TALUKA,32,5452,2827,8279
UMER KOT DISTRICT,UMER KOT TALUKA,33,4796,2720,7516
UMER KOT DISTRICT,UMER KOT TALUKA,34,4604,2606,7210
UMER KOT DISTRICT,UMER KOT TALUKA,35,4023,1949,5972
UMER KOT DISTRICT,UMER KOT TALUKA,36,4714,2420,7134
UMER KOT DISTRICT,UMER KOT TALUKA,37,6429,2941,9370
UMER KOT DISTRICT,UMER KOT TALUKA,38,3383,1950,5333
UMER KOT DISTRICT,UMER KOT TALUKA,39,4421,2357,6778
UMER KOT DISTRICT,UMER KOT TALUKA,40,2464,1370,3834
UMER KOT DISTRICT,UMER KOT TALUKA,41,3268,1763,5031
UMER KOT DISTRICT,UMER KOT TALUKA,42,3339,1738,5077
UMER KOT DISTRICT,UMER KOT TALUKA,43,2556,1436,3992
UMER KOT DISTRICT,UMER KOT TALUKA,44,2592,1305,3897
UMER KOT DISTRICT,UMER KOT TALUKA,45,2112,1010,3122
UMER KOT DISTRICT,UMER KOT TALUKA,46,2659,1375,4034
UMER KOT DISTRICT,UMER KOT TALUKA,47,3277,1558,4835
UMER KOT DISTRICT,UMER KOT TALUKA,48,2282,1186,3468
UMER KOT DISTRICT,UMER KOT TALUKA,49,2639,1311,3950
UMER KOT DISTRICT,UMER KOT TALUKA,50,1706,881,2587
UMER KOT DISTRICT,UMER KOT TALUKA,51,2406,1175,3581
UMER KOT DISTRICT,UMER KOT TALUKA,52,2047,1063,3110
UMER KOT DISTRICT,UMER KOT TALUKA,53,1640,907,2547
UMER KOT DISTRICT,UMER KOT TALUKA,54,1381,811,2192
UMER KOT DISTRICT,UMER KOT TALUKA,55,1106,617,1723
UMER KOT DISTRICT,UMER KOT TALUKA,56,1183,608,1791
UMER KOT DISTRICT,UMER KOT TALUKA,57,1574,753,2327
UMER KOT DISTRICT,UMER KOT TALUKA,58,1252,625,1877
UMER KOT DISTRICT,UMER KOT TALUKA,59,1397,687,2084
UMER KOT DISTRICT,UMER KOT TALUKA,60,1016,419,1435
UMER KOT DISTRICT,UMER KOT TALUKA,61,1272,621,1893
UMER KOT DISTRICT,UMER KOT TALUKA,62,1237,602,1839
UMER KOT DISTRICT,UMER KOT TALUKA,63,1222,607,1829
UMER KOT DISTRICT,UMER KOT TALUKA,64,1276,656,1932
UMER KOT DISTRICT,UMER KOT TALUKA,65,872,412,1284
UMER KOT DISTRICT,UMER KOT TALUKA,66,923,453,1376
UMER KOT DISTRICT,UMER KOT TALUKA,67,950,408,1358
UMER KOT DISTRICT,UMER KOT TALUKA,68,978,419,1397
UMER KOT DISTRICT,UMER KOT TALUKA,69,996,411,1407
UMER KOT DISTRICT,UMER KOT TALUKA,70,596,284,880
UMER KOT DISTRICT,UMER KOT TALUKA,71,773,353,1126
UMER KOT DISTRICT,UMER KOT TALUKA,72,662,291,953
UMER KOT DISTRICT,UMER KOT TALUKA,73,639,314,953
UMER KOT DISTRICT,UMER KOT TALUKA,74,590,244,834
UMER KOT DISTRICT,UMER KOT TALUKA,>=75,4414,1824,6238
UPPER DIR DISTRICT,DIR SUB-DIVISION,<1,11674,1112,12786
UPPER DIR DISTRICT,DIR SUB-DIVISION,1,13647,1260,14907
UPPER DIR DISTRICT,DIR SUB-DIVISION,2,15227,1424,16651
UPPER DIR DISTRICT,DIR SUB-DIVISION,3,14961,1525,16486
UPPER DIR DISTRICT,DIR SUB-DIVISION,4,16583,1489,18072
UPPER DIR DISTRICT,DIR SUB-DIVISION,5,14338,1453,15791
UPPER DIR DISTRICT,DIR SUB-DIVISION,6,15389,1516,16905
UPPER DIR DISTRICT,DIR SUB-DIVISION,7,13417,1389,14806
UPPER DIR DISTRICT,DIR SUB-DIVISION,8,15286,1428,16714
UPPER DIR DISTRICT,DIR SUB-DIVISION,9,13670,1378,15048
UPPER DIR DISTRICT,DIR SUB-DIVISION,10,13444,1325,14769
UPPER DIR DISTRICT,DIR SUB-DIVISION,11,11675,1152,12827
UPPER DIR DISTRICT,DIR SUB-DIVISION,12,11521,1144,12665
UPPER DIR DISTRICT,DIR SUB-DIVISION,13,10075,1133,11208
UPPER DIR DISTRICT,DIR SUB-DIVISION,14,10204,1175,11379
UPPER DIR DISTRICT,DIR SUB-DIVISION,15,9618,1116,10734
UPPER DIR DISTRICT,DIR SUB-DIVISION,16,8837,975,9812
UPPER DIR DISTRICT,DIR SUB-DIVISION,17,7968,953,8921
UPPER DIR DISTRICT,DIR SUB-DIVISION,18,8116,966,9082
UPPER DIR DISTRICT,DIR SUB-DIVISION,19,7155,830,7985
UPPER DIR DISTRICT,DIR SUB-DIVISION,20,7618,900,8518
UPPER DIR DISTRICT,DIR SUB-DIVISION,21,6158,811,6969
UPPER DIR DISTRICT,DIR SUB-DIVISION,22,6532,779,7311
UPPER DIR DISTRICT,DIR SUB-DIVISION,23,6204,734,6938
UPPER DIR DISTRICT,DIR SUB-DIVISION,24,5514,709,6223
UPPER DIR DISTRICT,DIR SUB-DIVISION,25,6059,785,6844
UPPER DIR DISTRICT,DIR SUB-DIVISION,26,5440,700,6140
UPPER DIR DISTRICT,DIR SUB-DIVISION,27,5813,701,6514
UPPER DIR DISTRICT,DIR SUB-DIVISION,28,4896,701,5597
UPPER DIR DISTRICT,DIR SUB-DIVISION,29,5075,619,5694
UPPER DIR DISTRICT,DIR SUB-DIVISION,30,4643,645,5288
UPPER DIR DISTRICT,DIR SUB-DIVISION,31,4505,522,5027
UPPER DIR DISTRICT,DIR SUB-DIVISION,32,4025,543,4568
UPPER DIR DISTRICT,DIR SUB-DIVISION,33,3626,538,4164
UPPER DIR DISTRICT,DIR SUB-DIVISION,34,3201,425,3626
UPPER DIR DISTRICT,DIR SUB-DIVISION,35,3297,450,3747
UPPER DIR DISTRICT,DIR SUB-DIVISION,36,3296,360,3656
UPPER DIR DISTRICT,DIR SUB-DIVISION,37,3946,420,4366
UPPER DIR DISTRICT,DIR SUB-DIVISION,38,3207,450,3657
UPPER DIR DISTRICT,DIR SUB-DIVISION,39,3402,388,3790
UPPER DIR DISTRICT,DIR SUB-DIVISION,40,3143,489,3632
UPPER DIR DISTRICT,DIR SUB-DIVISION,41,2912,353,3265
UPPER DIR DISTRICT,DIR SUB-DIVISION,42,2746,323,3069
UPPER DIR DISTRICT,DIR SUB-DIVISION,43,2442,391,2833
UPPER DIR DISTRICT,DIR SUB-DIVISION,44,2186,323,2509
UPPER DIR DISTRICT,DIR SUB-DIVISION,45,2239,339,2578
UPPER DIR DISTRICT,DIR SUB-DIVISION,46,2051,246,2297
UPPER DIR DISTRICT,DIR SUB-DIVISION,47,2337,238,2575
UPPER DIR DISTRICT,DIR SUB-DIVISION,48,1861,259,2120
UPPER DIR DISTRICT,DIR SUB-DIVISION,49,2019,270,2289
UPPER DIR DISTRICT,DIR SUB-DIVISION,50,1962,299,2261
UPPER DIR DISTRICT,DIR SUB-DIVISION,51,1807,242,2049
UPPER DIR DISTRICT,DIR SUB-DIVISION,52,1539,195,1734
UPPER DIR DISTRICT,DIR SUB-DIVISION,53,1383,200,1583
UPPER DIR DISTRICT,DIR SUB-DIVISION,54,1272,205,1477
UPPER DIR DISTRICT,DIR SUB-DIVISION,55,1362,241,1603
UPPER DIR DISTRICT,DIR SUB-DIVISION,56,1099,132,1231
UPPER DIR DISTRICT,DIR SUB-DIVISION,57,1205,131,1336
UPPER DIR DISTRICT,DIR SUB-DIVISION,58,1089,146,1235
UPPER DIR DISTRICT,DIR SUB-DIVISION,59,1285,168,1453
UPPER DIR DISTRICT,DIR SUB-DIVISION,60,1392,234,1626
UPPER DIR DISTRICT,DIR SUB-DIVISION,61,1349,158,1507
UPPER DIR DISTRICT,DIR SUB-DIVISION,62,1183,151,1334
UPPER DIR DISTRICT,DIR SUB-DIVISION,63,1061,124,1185
UPPER DIR DISTRICT,DIR SUB-DIVISION,64,1080,120,1200
UPPER DIR DISTRICT,DIR SUB-DIVISION,65,938,144,1082
UPPER DIR DISTRICT,DIR SUB-DIVISION,66,989,68,1057
UPPER DIR DISTRICT,DIR SUB-DIVISION,67,922,120,1042
UPPER DIR DISTRICT,DIR SUB-DIVISION,68,746,74,820
UPPER DIR DISTRICT,DIR SUB-DIVISION,69,816,65,881
UPPER DIR DISTRICT,DIR SUB-DIVISION,70,852,92,944
UPPER DIR DISTRICT,DIR SUB-DIVISION,71,849,66,915
UPPER DIR DISTRICT,DIR SUB-DIVISION,72,711,71,782
UPPER DIR DISTRICT,DIR SUB-DIVISION,73,546,69,615
UPPER DIR DISTRICT,DIR SUB-DIVISION,74,522,45,567
UPPER DIR DISTRICT,DIR SUB-DIVISION,>=75,4268,386,4654
UPPER DIR DISTRICT,SHARINGAL SUB-DIVISION,<1,6791,0,6791
UPPER DIR DISTRICT,SHARINGAL SUB-DIVISION,1,7250,0,7250
UPPER DIR DISTRICT,SHARINGAL SUB-DIVISION,2,8958,0,8958
UPPER DIR DISTRICT,SHARINGAL SUB-DIVISION,3,8397,0,8397
UPPER DIR DISTRICT,SHARINGAL SUB-DIVISION,4,8668,0,8668
UPPER DIR DISTRICT,SHARINGAL SUB-DIVISION,5,7585,0,7585
UPPER DIR DISTRICT,SHARINGAL SUB-DIVISION,6,7479,0,7479
UPPER DIR DISTRICT,SHARINGAL SUB-DIVISION,7,6810,0,6810
UPPER DIR DISTRICT,SHARINGAL SUB-DIVISION,8,6585,0,6585
UPPER DIR DISTRICT,SHARINGAL SUB-DIVISION,9,6635,0,6635
UPPER DIR DISTRICT,SHARINGAL SUB-DIVISION,10,5632,0,5632
UPPER DIR DISTRICT,SHARINGAL SUB-DIVISION,11,5140,0,5140
UPPER DIR DISTRICT,SHARINGAL SUB-DIVISION,12,4822,0,4822
UPPER DIR DISTRICT,SHARINGAL SUB-DIVISION,13,4151,0,4151
UPPER DIR DISTRICT,SHARINGAL SUB-DIVISION,14,4088,0,4088
UPPER DIR DISTRICT,SHARINGAL SUB-DIVISION,15,3624,0,3624
UPPER DIR DISTRICT,SHARINGAL SUB-DIVISION,16,3390,0,3390
UPPER DIR DISTRICT,SHARINGAL SUB-DIVISION,17,2944,0,2944
UPPER DIR DISTRICT,SHARINGAL SUB-DIVISION,18,3232,0,3232
UPPER DIR DISTRICT,SHARINGAL SUB-DIVISION,19,3069,0,3069
UPPER DIR DISTRICT,SHARINGAL SUB-DIVISION,20,3317,0,3317
UPPER DIR DISTRICT,SHARINGAL SUB-DIVISION,21,2811,0,2811
UPPER DIR DISTRICT,SHARINGAL SUB-DIVISION,22,2732,0,2732
UPPER DIR DISTRICT,SHARINGAL SUB-DIVISION,23,2809,0,2809
UPPER DIR DISTRICT,SHARINGAL SUB-DIVISION,24,2486,0,2486
UPPER DIR DISTRICT,SHARINGAL SUB-DIVISION,25,2648,0,2648
UPPER DIR DISTRICT,SHARINGAL SUB-DIVISION,26,2434,0,2434
UPPER DIR DISTRICT,SHARINGAL SUB-DIVISION,27,2500,0,2500
UPPER DIR DISTRICT,SHARINGAL SUB-DIVISION,28,2171,0,2171
UPPER DIR DISTRICT,SHARINGAL SUB-DIVISION,29,2350,0,2350
UPPER DIR DISTRICT,SHARINGAL SUB-DIVISION,30,2100,0,2100
UPPER DIR DISTRICT,SHARINGAL SUB-DIVISION,31,2221,0,2221
UPPER DIR DISTRICT,SHARINGAL SUB-DIVISION,32,1824,0,1824
UPPER DIR DISTRICT,SHARINGAL SUB-DIVISION,33,1651,0,1651
UPPER DIR DISTRICT,SHARINGAL SUB-DIVISION,34,1617,0,1617
UPPER DIR DISTRICT,SHARINGAL SUB-DIVISION,35,1466,0,1466
UPPER DIR DISTRICT,SHARINGAL SUB-DIVISION,36,1734,0,1734
UPPER DIR DISTRICT,SHARINGAL SUB-DIVISION,37,1820,0,1820
UPPER DIR DISTRICT,SHARINGAL SUB-DIVISION,38,1402,0,1402
UPPER DIR DISTRICT,SHARINGAL SUB-DIVISION,39,1463,0,1463
UPPER DIR DISTRICT,SHARINGAL SUB-DIVISION,40,1351,0,1351
UPPER DIR DISTRICT,SHARINGAL SUB-DIVISION,41,1465,0,1465
UPPER DIR DISTRICT,SHARINGAL SUB-DIVISION,42,1310,0,1310
UPPER DIR DISTRICT,SHARINGAL SUB-DIVISION,43,1136,0,1136
UPPER DIR DISTRICT,SHARINGAL SUB-DIVISION,44,999,0,999
UPPER DIR DISTRICT,SHARINGAL SUB-DIVISION,45,889,0,889
UPPER DIR DISTRICT,SHARINGAL SUB-DIVISION,46,1117,0,1117
UPPER DIR DISTRICT,SHARINGAL SUB-DIVISION,47,1067,0,1067
UPPER DIR DISTRICT,SHARINGAL SUB-DIVISION,48,926,0,926
UPPER DIR DISTRICT,SHARINGAL SUB-DIVISION,49,733,0,733
UPPER DIR DISTRICT,SHARINGAL SUB-DIVISION,50,832,0,832
UPPER DIR DISTRICT,SHARINGAL SUB-DIVISION,51,786,0,786
UPPER DIR DISTRICT,SHARINGAL SUB-DIVISION,52,618,0,618
UPPER DIR DISTRICT,SHARINGAL SUB-DIVISION,53,587,0,587
UPPER DIR DISTRICT,SHARINGAL SUB-DIVISION,54,549,0,549
UPPER DIR DISTRICT,SHARINGAL SUB-DIVISION,55,543,0,543
UPPER DIR DISTRICT,SHARINGAL SUB-DIVISION,56,532,0,532
UPPER DIR DISTRICT,SHARINGAL SUB-DIVISION,57,524,0,524
UPPER DIR DISTRICT,SHARINGAL SUB-DIVISION,58,505,0,505
UPPER DIR DISTRICT,SHARINGAL SUB-DIVISION,59,577,0,577
UPPER DIR DISTRICT,SHARINGAL SUB-DIVISION,60,659,0,659
UPPER DIR DISTRICT,SHARINGAL SUB-DIVISION,61,592,0,592
UPPER DIR DISTRICT,SHARINGAL SUB-DIVISION,62,572,0,572
UPPER DIR DISTRICT,SHARINGAL SUB-DIVISION,63,532,0,532
UPPER DIR DISTRICT,SHARINGAL SUB-DIVISION,64,605,0,605
UPPER DIR DISTRICT,SHARINGAL SUB-DIVISION,65,485,0,485
UPPER DIR DISTRICT,SHARINGAL SUB-DIVISION,66,485,0,485
UPPER DIR DISTRICT,SHARINGAL SUB-DIVISION,67,471,0,471
UPPER DIR DISTRICT,SHARINGAL SUB-DIVISION,68,414,0,414
UPPER DIR DISTRICT,SHARINGAL SUB-DIVISION,69,440,0,440
UPPER DIR DISTRICT,SHARINGAL SUB-DIVISION,70,389,0,389
UPPER DIR DISTRICT,SHARINGAL SUB-DIVISION,71,403,0,403
UPPER DIR DISTRICT,SHARINGAL SUB-DIVISION,72,354,0,354
UPPER DIR DISTRICT,SHARINGAL SUB-DIVISION,73,268,0,268
UPPER DIR DISTRICT,SHARINGAL SUB-DIVISION,74,294,0,294
UPPER DIR DISTRICT,SHARINGAL SUB-DIVISION,>=75,2306,0,2306
UPPER DIR DISTRICT,WARI SUB-DIVISION,<1,9657,0,9657
UPPER DIR DISTRICT,WARI SUB-DIVISION,1,11584,0,11584
UPPER DIR DISTRICT,WARI SUB-DIVISION,2,12761,0,12761
UPPER DIR DISTRICT,WARI SUB-DIVISION,3,12488,0,12488
UPPER DIR DISTRICT,WARI SUB-DIVISION,4,13773,0,13773
UPPER DIR DISTRICT,WARI SUB-DIVISION,5,12292,0,12292
UPPER DIR DISTRICT,WARI SUB-DIVISION,6,12373,0,12373
UPPER DIR DISTRICT,WARI SUB-DIVISION,7,11424,0,11424
UPPER DIR DISTRICT,WARI SUB-DIVISION,8,12117,0,12117
UPPER DIR DISTRICT,WARI SUB-DIVISION,9,11497,0,11497
UPPER DIR DISTRICT,WARI SUB-DIVISION,10,9945,0,9945
UPPER DIR DISTRICT,WARI SUB-DIVISION,11,9594,0,9594
UPPER DIR DISTRICT,WARI SUB-DIVISION,12,9157,0,9157
UPPER DIR DISTRICT,WARI SUB-DIVISION,13,8523,0,8523
UPPER DIR DISTRICT,WARI SUB-DIVISION,14,8454,0,8454
UPPER DIR DISTRICT,WARI SUB-DIVISION,15,8036,0,8036
UPPER DIR DISTRICT,WARI SUB-DIVISION,16,7458,0,7458
UPPER DIR DISTRICT,WARI SUB-DIVISION,17,6331,0,6331
UPPER DIR DISTRICT,WARI SUB-DIVISION,18,6637,0,6637
UPPER DIR DISTRICT,WARI SUB-DIVISION,19,5758,0,5758
UPPER DIR DISTRICT,WARI SUB-DIVISION,20,6330,0,6330
UPPER DIR DISTRICT,WARI SUB-DIVISION,21,5201,0,5201
UPPER DIR DISTRICT,WARI SUB-DIVISION,22,5252,0,5252
UPPER DIR DISTRICT,WARI SUB-DIVISION,23,5106,0,5106
UPPER DIR DISTRICT,WARI SUB-DIVISION,24,4612,0,4612
UPPER DIR DISTRICT,WARI SUB-DIVISION,25,4737,0,4737
UPPER DIR DISTRICT,WARI SUB-DIVISION,26,4420,0,4420
UPPER DIR DISTRICT,WARI SUB-DIVISION,27,4316,0,4316
UPPER DIR DISTRICT,WARI SUB-DIVISION,28,4242,0,4242
UPPER DIR DISTRICT,WARI SUB-DIVISION,29,4059,0,4059
UPPER DIR DISTRICT,WARI SUB-DIVISION,30,3607,0,3607
UPPER DIR DISTRICT,WARI SUB-DIVISION,31,3596,0,3596
UPPER DIR DISTRICT,WARI SUB-DIVISION,32,3230,0,3230
UPPER DIR DISTRICT,WARI SUB-DIVISION,33,2911,0,2911
UPPER DIR DISTRICT,WARI SUB-DIVISION,34,2614,0,2614
UPPER DIR DISTRICT,WARI SUB-DIVISION,35,2560,0,2560
UPPER DIR DISTRICT,WARI SUB-DIVISION,36,2748,0,2748
UPPER DIR DISTRICT,WARI SUB-DIVISION,37,2962,0,2962
UPPER DIR DISTRICT,WARI SUB-DIVISION,38,2620,0,2620
UPPER DIR DISTRICT,WARI SUB-DIVISION,39,2789,0,2789
UPPER DIR DISTRICT,WARI SUB-DIVISION,40,2376,0,2376
UPPER DIR DISTRICT,WARI SUB-DIVISION,41,2300,0,2300
UPPER DIR DISTRICT,WARI SUB-DIVISION,42,2062,0,2062
UPPER DIR DISTRICT,WARI SUB-DIVISION,43,1898,0,1898
UPPER DIR DISTRICT,WARI SUB-DIVISION,44,1719,0,1719
UPPER DIR DISTRICT,WARI SUB-DIVISION,45,1733,0,1733
UPPER DIR DISTRICT,WARI SUB-DIVISION,46,1670,0,1670
UPPER DIR DISTRICT,WARI SUB-DIVISION,47,1732,0,1732
UPPER DIR DISTRICT,WARI SUB-DIVISION,48,1690,0,1690
UPPER DIR DISTRICT,WARI SUB-DIVISION,49,1673,0,1673
UPPER DIR DISTRICT,WARI SUB-DIVISION,50,1511,0,1511
UPPER DIR DISTRICT,WARI SUB-DIVISION,51,1299,0,1299
UPPER DIR DISTRICT,WARI SUB-DIVISION,52,1106,0,1106
UPPER DIR DISTRICT,WARI SUB-DIVISION,53,1157,0,1157
UPPER DIR DISTRICT,WARI SUB-DIVISION,54,1007,0,1007
UPPER DIR DISTRICT,WARI SUB-DIVISION,55,1204,0,1204
UPPER DIR DISTRICT,WARI SUB-DIVISION,56,848,0,848
UPPER DIR DISTRICT,WARI SUB-DIVISION,57,880,0,880
UPPER DIR DISTRICT,WARI SUB-DIVISION,58,1055,0,1055
UPPER DIR DISTRICT,WARI SUB-DIVISION,59,1116,0,1116
UPPER DIR DISTRICT,WARI SUB-DIVISION,60,1199,0,1199
UPPER DIR DISTRICT,WARI SUB-DIVISION,61,1092,0,1092
UPPER DIR DISTRICT,WARI SUB-DIVISION,62,880,0,880
UPPER DIR DISTRICT,WARI SUB-DIVISION,63,989,0,989
UPPER DIR DISTRICT,WARI SUB-DIVISION,64,967,0,967
UPPER DIR DISTRICT,WARI SUB-DIVISION,65,879,0,879
UPPER DIR DISTRICT,WARI SUB-DIVISION,66,745,0,745
UPPER DIR DISTRICT,WARI SUB-DIVISION,67,691,0,691
UPPER DIR DISTRICT,WARI SUB-DIVISION,68,740,0,740
UPPER DIR DISTRICT,WARI SUB-DIVISION,69,794,0,794
UPPER DIR DISTRICT,WARI SUB-DIVISION,70,701,0,701
UPPER DIR DISTRICT,WARI SUB-DIVISION,71,578,0,578
UPPER DIR DISTRICT,WARI SUB-DIVISION,72,449,0,449
UPPER DIR DISTRICT,WARI SUB-DIVISION,73,425,0,425
UPPER DIR DISTRICT,WARI SUB-DIVISION,74,474,0,474
UPPER DIR DISTRICT,WARI SUB-DIVISION,>=75,3345,0,3345
VEHARI DISTRICT,BUREWALA TEHSIL,<1,20633,5372,26005
VEHARI DISTRICT,BUREWALA TEHSIL,1,21866,5914,27780
VEHARI DISTRICT,BUREWALA TEHSIL,2,21268,5590,26858
VEHARI DISTRICT,BUREWALA TEHSIL,3,22733,6175,28908
VEHARI DISTRICT,BUREWALA TEHSIL,4,22751,5865,28616
VEHARI DISTRICT,BUREWALA TEHSIL,5,21951,5804,27755
VEHARI DISTRICT,BUREWALA TEHSIL,6,20806,5673,26479
VEHARI DISTRICT,BUREWALA TEHSIL,7,22596,6008,28604
VEHARI DISTRICT,BUREWALA TEHSIL,8,20407,5091,25498
VEHARI DISTRICT,BUREWALA TEHSIL,9,20691,5844,26535
VEHARI DISTRICT,BUREWALA TEHSIL,10,18646,4805,23451
VEHARI DISTRICT,BUREWALA TEHSIL,11,18631,5791,24422
VEHARI DISTRICT,BUREWALA TEHSIL,12,16862,4509,21371
VEHARI DISTRICT,BUREWALA TEHSIL,13,16612,5185,21797
VEHARI DISTRICT,BUREWALA TEHSIL,14,15904,4753,20657
VEHARI DISTRICT,BUREWALA TEHSIL,15,15865,4798,20663
VEHARI DISTRICT,BUREWALA TEHSIL,16,16096,4917,21013
VEHARI DISTRICT,BUREWALA TEHSIL,17,15933,4975,20908
VEHARI DISTRICT,BUREWALA TEHSIL,18,14549,4405,18954
VEHARI DISTRICT,BUREWALA TEHSIL,19,15399,4967,20366
VEHARI DISTRICT,BUREWALA TEHSIL,20,14955,4371,19326
VEHARI DISTRICT,BUREWALA TEHSIL,21,14816,5126,19942
VEHARI DISTRICT,BUREWALA TEHSIL,22,14230,4455,18685
VEHARI DISTRICT,BUREWALA TEHSIL,23,13137,4539,17676
VEHARI DISTRICT,BUREWALA TEHSIL,24,12696,4222,16918
VEHARI DISTRICT,BUREWALA TEHSIL,25,11972,3558,15530
VEHARI DISTRICT,BUREWALA TEHSIL,26,12502,4252,16754
VEHARI DISTRICT,BUREWALA TEHSIL,27,11500,3992,15492
VEHARI DISTRICT,BUREWALA TEHSIL,28,12143,3905,16048
VEHARI DISTRICT,BUREWALA TEHSIL,29,11996,3821,15817
VEHARI DISTRICT,BUREWALA TEHSIL,30,11259,3568,14827
VEHARI DISTRICT,BUREWALA TEHSIL,31,11838,3618,15456
VEHARI DISTRICT,BUREWALA TEHSIL,32,9997,3364,13361
VEHARI DISTRICT,BUREWALA TEHSIL,33,9827,3508,13335
VEHARI DISTRICT,BUREWALA TEHSIL,34,10127,3265,13392
VEHARI DISTRICT,BUREWALA TEHSIL,35,8775,2749,11524
VEHARI DISTRICT,BUREWALA TEHSIL,36,10928,3038,13966
VEHARI DISTRICT,BUREWALA TEHSIL,37,8671,2731,11402
VEHARI DISTRICT,BUREWALA TEHSIL,38,9097,3063,12160
VEHARI DISTRICT,BUREWALA TEHSIL,39,8820,2823,11643
VEHARI DISTRICT,BUREWALA TEHSIL,40,7764,2609,10373
VEHARI DISTRICT,BUREWALA TEHSIL,41,9613,2645,12258
VEHARI DISTRICT,BUREWALA TEHSIL,42,7249,2378,9627
VEHARI DISTRICT,BUREWALA TEHSIL,43,7264,2407,9671
VEHARI DISTRICT,BUREWALA TEHSIL,44,7421,2268,9689
VEHARI DISTRICT,BUREWALA TEHSIL,45,6066,1933,7999
VEHARI DISTRICT,BUREWALA TEHSIL,46,7990,2201,10191
VEHARI DISTRICT,BUREWALA TEHSIL,47,6353,1953,8306
VEHARI DISTRICT,BUREWALA TEHSIL,48,6640,2143,8783
VEHARI DISTRICT,BUREWALA TEHSIL,49,6850,2107,8957
VEHARI DISTRICT,BUREWALA TEHSIL,50,5803,1863,7666
VEHARI DISTRICT,BUREWALA TEHSIL,51,7422,2130,9552
VEHARI DISTRICT,BUREWALA TEHSIL,52,5806,1860,7666
VEHARI DISTRICT,BUREWALA TEHSIL,53,5765,1829,7594
VEHARI DISTRICT,BUREWALA TEHSIL,54,5480,1742,7222
VEHARI DISTRICT,BUREWALA TEHSIL,55,4166,1357,5523
VEHARI DISTRICT,BUREWALA TEHSIL,56,5587,1378,6965
VEHARI DISTRICT,BUREWALA TEHSIL,57,4340,1267,5607
VEHARI DISTRICT,BUREWALA TEHSIL,58,4496,1288,5784
VEHARI DISTRICT,BUREWALA TEHSIL,59,4195,1170,5365
VEHARI DISTRICT,BUREWALA TEHSIL,60,3293,989,4282
VEHARI DISTRICT,BUREWALA TEHSIL,61,4291,1081,5372
VEHARI DISTRICT,BUREWALA TEHSIL,62,3317,969,4286
VEHARI DISTRICT,BUREWALA TEHSIL,63,3651,1002,4653
VEHARI DISTRICT,BUREWALA TEHSIL,64,3393,912,4305
VEHARI DISTRICT,BUREWALA TEHSIL,65,2447,676,3123
VEHARI DISTRICT,BUREWALA TEHSIL,66,2821,617,3438
VEHARI DISTRICT,BUREWALA TEHSIL,67,2166,565,2731
VEHARI DISTRICT,BUREWALA TEHSIL,68,2417,618,3035
VEHARI DISTRICT,BUREWALA TEHSIL,69,2626,575,3201
VEHARI DISTRICT,BUREWALA TEHSIL,70,1921,512,2433
VEHARI DISTRICT,BUREWALA TEHSIL,71,2250,501,2751
VEHARI DISTRICT,BUREWALA TEHSIL,72,1809,475,2284
VEHARI DISTRICT,BUREWALA TEHSIL,73,1872,472,2344
VEHARI DISTRICT,BUREWALA TEHSIL,74,1855,427,2282
VEHARI DISTRICT,BUREWALA TEHSIL,>=75,11745,2702,14447
VEHARI DISTRICT,MAILSI TEHSIL,<1,21865,3076,24941
VEHARI DISTRICT,MAILSI TEHSIL,1,22736,3677,26413
VEHARI DISTRICT,MAILSI TEHSIL,2,22537,3125,25662
VEHARI DISTRICT,MAILSI TEHSIL,3,24480,3587,28067
VEHARI DISTRICT,MAILSI TEHSIL,4,25777,3420,29197
VEHARI DISTRICT,MAILSI TEHSIL,5,24231,3543,27774
VEHARI DISTRICT,MAILSI TEHSIL,6,23344,3319,26663
VEHARI DISTRICT,MAILSI TEHSIL,7,25203,3560,28763
VEHARI DISTRICT,MAILSI TEHSIL,8,23390,3158,26548
VEHARI DISTRICT,MAILSI TEHSIL,9,23318,3504,26822
VEHARI DISTRICT,MAILSI TEHSIL,10,21831,2944,24775
VEHARI DISTRICT,MAILSI TEHSIL,11,19975,3285,23260
VEHARI DISTRICT,MAILSI TEHSIL,12,19445,2857,22302
VEHARI DISTRICT,MAILSI TEHSIL,13,17363,2992,20355
VEHARI DISTRICT,MAILSI TEHSIL,14,17064,2630,19694
VEHARI DISTRICT,MAILSI TEHSIL,15,16446,2768,19214
VEHARI DISTRICT,MAILSI TEHSIL,16,16523,2787,19310
VEHARI DISTRICT,MAILSI TEHSIL,17,15442,2778,18220
VEHARI DISTRICT,MAILSI TEHSIL,18,16744,2560,19304
VEHARI DISTRICT,MAILSI TEHSIL,19,15280,2660,17940
VEHARI DISTRICT,MAILSI TEHSIL,20,16021,2349,18370
VEHARI DISTRICT,MAILSI TEHSIL,21,14284,2572,16856
VEHARI DISTRICT,MAILSI TEHSIL,22,14565,2278,16843
VEHARI DISTRICT,MAILSI TEHSIL,23,12456,2199,14655
VEHARI DISTRICT,MAILSI TEHSIL,24,12300,2170,14470
VEHARI DISTRICT,MAILSI TEHSIL,25,13250,1972,15222
VEHARI DISTRICT,MAILSI TEHSIL,26,12251,2153,14404
VEHARI DISTRICT,MAILSI TEHSIL,27,11807,2053,13860
VEHARI DISTRICT,MAILSI TEHSIL,28,12444,2127,14571
VEHARI DISTRICT,MAILSI TEHSIL,29,12244,2060,14304
VEHARI DISTRICT,MAILSI TEHSIL,30,11667,1790,13457
VEHARI DISTRICT,MAILSI TEHSIL,31,11826,2041,13867
VEHARI DISTRICT,MAILSI TEHSIL,32,10492,1681,12173
VEHARI DISTRICT,MAILSI TEHSIL,33,9740,1657,11397
VEHARI DISTRICT,MAILSI TEHSIL,34,10171,1712,11883
VEHARI DISTRICT,MAILSI TEHSIL,35,9750,1426,11176
VEHARI DISTRICT,MAILSI TEHSIL,36,11490,1828,13318
VEHARI DISTRICT,MAILSI TEHSIL,37,9439,1379,10818
VEHARI DISTRICT,MAILSI TEHSIL,38,9403,1650,11053
VEHARI DISTRICT,MAILSI TEHSIL,39,9420,1419,10839
VEHARI DISTRICT,MAILSI TEHSIL,40,8227,1281,9508
VEHARI DISTRICT,MAILSI TEHSIL,41,9428,1529,10957
VEHARI DISTRICT,MAILSI TEHSIL,42,7707,1170,8877
VEHARI DISTRICT,MAILSI TEHSIL,43,6911,1272,8183
VEHARI DISTRICT,MAILSI TEHSIL,44,7136,1273,8409
VEHARI DISTRICT,MAILSI TEHSIL,45,6213,975,7188
VEHARI DISTRICT,MAILSI TEHSIL,46,7706,1312,9018
VEHARI DISTRICT,MAILSI TEHSIL,47,6709,982,7691
VEHARI DISTRICT,MAILSI TEHSIL,48,6628,1145,7773
VEHARI DISTRICT,MAILSI TEHSIL,49,6841,1096,7937
VEHARI DISTRICT,MAILSI TEHSIL,50,5962,940,6902
VEHARI DISTRICT,MAILSI TEHSIL,51,7074,1126,8200
VEHARI DISTRICT,MAILSI TEHSIL,52,5923,892,6815
VEHARI DISTRICT,MAILSI TEHSIL,53,5522,970,6492
VEHARI DISTRICT,MAILSI TEHSIL,54,5023,873,5896
VEHARI DISTRICT,MAILSI TEHSIL,55,4252,637,4889
VEHARI DISTRICT,MAILSI TEHSIL,56,4730,779,5509
VEHARI DISTRICT,MAILSI TEHSIL,57,3699,564,4263
VEHARI DISTRICT,MAILSI TEHSIL,58,3593,637,4230
VEHARI DISTRICT,MAILSI TEHSIL,59,3644,615,4259
VEHARI DISTRICT,MAILSI TEHSIL,60,3499,581,4080
VEHARI DISTRICT,MAILSI TEHSIL,61,4401,682,5083
VEHARI DISTRICT,MAILSI TEHSIL,62,3567,534,4101
VEHARI DISTRICT,MAILSI TEHSIL,63,3533,540,4073
VEHARI DISTRICT,MAILSI TEHSIL,64,3232,482,3714
VEHARI DISTRICT,MAILSI TEHSIL,65,2830,353,3183
VEHARI DISTRICT,MAILSI TEHSIL,66,3262,495,3757
VEHARI DISTRICT,MAILSI TEHSIL,67,2841,340,3181
VEHARI DISTRICT,MAILSI TEHSIL,68,2300,323,2623
VEHARI DISTRICT,MAILSI TEHSIL,69,2372,352,2724
VEHARI DISTRICT,MAILSI TEHSIL,70,2218,291,2509
VEHARI DISTRICT,MAILSI TEHSIL,71,2592,375,2967
VEHARI DISTRICT,MAILSI TEHSIL,72,2166,281,2447
VEHARI DISTRICT,MAILSI TEHSIL,73,1650,258,1908
VEHARI DISTRICT,MAILSI TEHSIL,74,1618,195,1813
VEHARI DISTRICT,MAILSI TEHSIL,>=75,12135,1556,13691
VEHARI DISTRICT,VEHARI TEHSIL,<1,21425,3617,25042
VEHARI DISTRICT,VEHARI TEHSIL,1,22466,3895,26361
VEHARI DISTRICT,VEHARI TEHSIL,2,21214,3528,24742
VEHARI DISTRICT,VEHARI TEHSIL,3,23308,3835,27143
VEHARI DISTRICT,VEHARI TEHSIL,4,23735,3681,27416
VEHARI DISTRICT,VEHARI TEHSIL,5,22790,3613,26403
VEHARI DISTRICT,VEHARI TEHSIL,6,21936,3553,25489
VEHARI DISTRICT,VEHARI TEHSIL,7,23072,3636,26708
VEHARI DISTRICT,VEHARI TEHSIL,8,21693,3294,24987
VEHARI DISTRICT,VEHARI TEHSIL,9,21029,3673,24702
VEHARI DISTRICT,VEHARI TEHSIL,10,20076,3164,23240
VEHARI DISTRICT,VEHARI TEHSIL,11,18225,3714,21939
VEHARI DISTRICT,VEHARI TEHSIL,12,17333,2928,20261
VEHARI DISTRICT,VEHARI TEHSIL,13,16357,3249,19606
VEHARI DISTRICT,VEHARI TEHSIL,14,15662,3043,18705
VEHARI DISTRICT,VEHARI TEHSIL,15,15882,2924,18806
VEHARI DISTRICT,VEHARI TEHSIL,16,15738,3195,18933
VEHARI DISTRICT,VEHARI TEHSIL,17,16386,3154,19540
VEHARI DISTRICT,VEHARI TEHSIL,18,14319,2761,17080
VEHARI DISTRICT,VEHARI TEHSIL,19,14690,3052,17742
VEHARI DISTRICT,VEHARI TEHSIL,20,14783,2550,17333
VEHARI DISTRICT,VEHARI TEHSIL,21,14091,3192,17283
VEHARI DISTRICT,VEHARI TEHSIL,22,13841,2602,16443
VEHARI DISTRICT,VEHARI TEHSIL,23,12722,2829,15551
VEHARI DISTRICT,VEHARI TEHSIL,24,12275,2782,15057
VEHARI DISTRICT,VEHARI TEHSIL,25,11693,2053,13746
VEHARI DISTRICT,VEHARI TEHSIL,26,11849,2670,14519
VEHARI DISTRICT,VEHARI TEHSIL,27,11641,2529,14170
VEHARI DISTRICT,VEHARI TEHSIL,28,12209,2562,14771
VEHARI DISTRICT,VEHARI TEHSIL,29,12720,2618,15338
VEHARI DISTRICT,VEHARI TEHSIL,30,11042,1943,12985
VEHARI DISTRICT,VEHARI TEHSIL,31,11754,2537,14291
VEHARI DISTRICT,VEHARI TEHSIL,32,10219,2091,12310
VEHARI DISTRICT,VEHARI TEHSIL,33,9880,2067,11947
VEHARI DISTRICT,VEHARI TEHSIL,34,10462,2230,12692
VEHARI DISTRICT,VEHARI TEHSIL,35,8645,1527,10172
VEHARI DISTRICT,VEHARI TEHSIL,36,10583,2136,12719
VEHARI DISTRICT,VEHARI TEHSIL,37,9166,1733,10899
VEHARI DISTRICT,VEHARI TEHSIL,38,8920,1784,10704
VEHARI DISTRICT,VEHARI TEHSIL,39,9152,1777,10929
VEHARI DISTRICT,VEHARI TEHSIL,40,7143,1298,8441
VEHARI DISTRICT,VEHARI TEHSIL,41,8990,1907,10897
VEHARI DISTRICT,VEHARI TEHSIL,42,7409,1386,8795
VEHARI DISTRICT,VEHARI TEHSIL,43,6947,1479,8426
VEHARI DISTRICT,VEHARI TEHSIL,44,7061,1505,8566
VEHARI DISTRICT,VEHARI TEHSIL,45,5386,969,6355
VEHARI DISTRICT,VEHARI TEHSIL,46,7590,1547,9137
VEHARI DISTRICT,VEHARI TEHSIL,47,6534,1220,7754
VEHARI DISTRICT,VEHARI TEHSIL,48,6421,1314,7735
VEHARI DISTRICT,VEHARI TEHSIL,49,6682,1310,7992
VEHARI DISTRICT,VEHARI TEHSIL,50,5193,975,6168
VEHARI DISTRICT,VEHARI TEHSIL,51,7028,1450,8478
VEHARI DISTRICT,VEHARI TEHSIL,52,5928,1203,7131
VEHARI DISTRICT,VEHARI TEHSIL,53,5269,1156,6425
VEHARI DISTRICT,VEHARI TEHSIL,54,4875,1107,5982
VEHARI DISTRICT,VEHARI TEHSIL,55,3550,686,4236
VEHARI DISTRICT,VEHARI TEHSIL,56,4936,976,5912
VEHARI DISTRICT,VEHARI TEHSIL,57,3979,784,4763
VEHARI DISTRICT,VEHARI TEHSIL,58,3971,839,4810
VEHARI DISTRICT,VEHARI TEHSIL,59,3990,771,4761
VEHARI DISTRICT,VEHARI TEHSIL,60,3155,513,3668
VEHARI DISTRICT,VEHARI TEHSIL,61,4066,764,4830
VEHARI DISTRICT,VEHARI TEHSIL,62,3459,650,4109
VEHARI DISTRICT,VEHARI TEHSIL,63,3356,655,4011
VEHARI DISTRICT,VEHARI TEHSIL,64,3421,582,4003
VEHARI DISTRICT,VEHARI TEHSIL,65,2339,380,2719
VEHARI DISTRICT,VEHARI TEHSIL,66,2888,500,3388
VEHARI DISTRICT,VEHARI TEHSIL,67,2298,339,2637
VEHARI DISTRICT,VEHARI TEHSIL,68,2247,337,2584
VEHARI DISTRICT,VEHARI TEHSIL,69,2454,362,2816
VEHARI DISTRICT,VEHARI TEHSIL,70,1834,256,2090
VEHARI DISTRICT,VEHARI TEHSIL,71,2202,372,2574
VEHARI DISTRICT,VEHARI TEHSIL,72,1702,305,2007
VEHARI DISTRICT,VEHARI TEHSIL,73,1648,283,1931
VEHARI DISTRICT,VEHARI TEHSIL,74,1618,255,1873
VEHARI DISTRICT,VEHARI TEHSIL,>=75,10613,1491,12104
WASHUK DISTRICT,BESIMA SUB-TEHSIL,<1,2601,0,2601
WASHUK DISTRICT,BESIMA SUB-TEHSIL,1,1888,0,1888
WASHUK DISTRICT,BESIMA SUB-TEHSIL,2,2378,0,2378
WASHUK DISTRICT,BESIMA SUB-TEHSIL,3,1837,0,1837
WASHUK DISTRICT,BESIMA SUB-TEHSIL,4,2272,0,2272
WASHUK DISTRICT,BESIMA SUB-TEHSIL,5,1604,0,1604
WASHUK DISTRICT,BESIMA SUB-TEHSIL,6,2119,0,2119
WASHUK DISTRICT,BESIMA SUB-TEHSIL,7,1434,0,1434
WASHUK DISTRICT,BESIMA SUB-TEHSIL,8,1690,0,1690
WASHUK DISTRICT,BESIMA SUB-TEHSIL,9,1595,0,1595
WASHUK DISTRICT,BESIMA SUB-TEHSIL,10,1419,0,1419
WASHUK DISTRICT,BESIMA SUB-TEHSIL,11,1028,0,1028
WASHUK DISTRICT,BESIMA SUB-TEHSIL,12,1156,0,1156
WASHUK DISTRICT,BESIMA SUB-TEHSIL,13,747,0,747
WASHUK DISTRICT,BESIMA SUB-TEHSIL,14,879,0,879
WASHUK DISTRICT,BESIMA SUB-TEHSIL,15,668,0,668
WASHUK DISTRICT,BESIMA SUB-TEHSIL,16,607,0,607
WASHUK DISTRICT,BESIMA SUB-TEHSIL,17,515,0,515
WASHUK DISTRICT,BESIMA SUB-TEHSIL,18,578,0,578
WASHUK DISTRICT,BESIMA SUB-TEHSIL,19,506,0,506
WASHUK DISTRICT,BESIMA SUB-TEHSIL,20,638,0,638
WASHUK DISTRICT,BESIMA SUB-TEHSIL,21,475,0,475
WASHUK DISTRICT,BESIMA SUB-TEHSIL,22,470,0,470
WASHUK DISTRICT,BESIMA SUB-TEHSIL,23,408,0,408
WASHUK DISTRICT,BESIMA SUB-TEHSIL,24,382,0,382
WASHUK DISTRICT,BESIMA SUB-TEHSIL,25,646,0,646
WASHUK DISTRICT,BESIMA SUB-TEHSIL,26,407,0,407
WASHUK DISTRICT,BESIMA SUB-TEHSIL,27,495,0,495
WASHUK DISTRICT,BESIMA SUB-TEHSIL,28,619,0,619
WASHUK DISTRICT,BESIMA SUB-TEHSIL,29,540,0,540
WASHUK DISTRICT,BESIMA SUB-TEHSIL,30,618,0,618
WASHUK DISTRICT,BESIMA SUB-TEHSIL,31,430,0,430
WASHUK DISTRICT,BESIMA SUB-TEHSIL,32,317,0,317
WASHUK DISTRICT,BESIMA SUB-TEHSIL,33,390,0,390
WASHUK DISTRICT,BESIMA SUB-TEHSIL,34,264,0,264
WASHUK DISTRICT,BESIMA SUB-TEHSIL,35,448,0,448
WASHUK DISTRICT,BESIMA SUB-TEHSIL,36,224,0,224
WASHUK DISTRICT,BESIMA SUB-TEHSIL,37,282,0,282
WASHUK DISTRICT,BESIMA SUB-TEHSIL,38,365,0,365
WASHUK DISTRICT,BESIMA SUB-TEHSIL,39,317,0,317
WASHUK DISTRICT,BESIMA SUB-TEHSIL,40,400,0,400
WASHUK DISTRICT,BESIMA SUB-TEHSIL,41,270,0,270
WASHUK DISTRICT,BESIMA SUB-TEHSIL,42,175,0,175
WASHUK DISTRICT,BESIMA SUB-TEHSIL,43,214,0,214
WASHUK DISTRICT,BESIMA SUB-TEHSIL,44,160,0,160
WASHUK DISTRICT,BESIMA SUB-TEHSIL,45,261,0,261
WASHUK DISTRICT,BESIMA SUB-TEHSIL,46,79,0,79
WASHUK DISTRICT,BESIMA SUB-TEHSIL,47,161,0,161
WASHUK DISTRICT,BESIMA SUB-TEHSIL,48,127,0,127
WASHUK DISTRICT,BESIMA SUB-TEHSIL,49,170,0,170
WASHUK DISTRICT,BESIMA SUB-TEHSIL,50,220,0,220
WASHUK DISTRICT,BESIMA SUB-TEHSIL,51,107,0,107
WASHUK DISTRICT,BESIMA SUB-TEHSIL,52,79,0,79
WASHUK DISTRICT,BESIMA SUB-TEHSIL,53,109,0,109
WASHUK DISTRICT,BESIMA SUB-TEHSIL,54,90,0,90
WASHUK DISTRICT,BESIMA SUB-TEHSIL,55,121,0,121
WASHUK DISTRICT,BESIMA SUB-TEHSIL,56,76,0,76
WASHUK DISTRICT,BESIMA SUB-TEHSIL,57,101,0,101
WASHUK DISTRICT,BESIMA SUB-TEHSIL,58,73,0,73
WASHUK DISTRICT,BESIMA SUB-TEHSIL,59,83,0,83
WASHUK DISTRICT,BESIMA SUB-TEHSIL,60,108,0,108
WASHUK DISTRICT,BESIMA SUB-TEHSIL,61,60,0,60
WASHUK DISTRICT,BESIMA SUB-TEHSIL,62,61,0,61
WASHUK DISTRICT,BESIMA SUB-TEHSIL,63,46,0,46
WASHUK DISTRICT,BESIMA SUB-TEHSIL,64,53,0,53
WASHUK DISTRICT,BESIMA SUB-TEHSIL,65,51,0,51
WASHUK DISTRICT,BESIMA SUB-TEHSIL,66,29,0,29
WASHUK DISTRICT,BESIMA SUB-TEHSIL,67,39,0,39
WASHUK DISTRICT,BESIMA SUB-TEHSIL,68,43,0,43
WASHUK DISTRICT,BESIMA SUB-TEHSIL,69,45,0,45
WASHUK DISTRICT,BESIMA SUB-TEHSIL,70,65,0,65
WASHUK DISTRICT,BESIMA SUB-TEHSIL,71,27,0,27
WASHUK DISTRICT,BESIMA SUB-TEHSIL,72,28,0,28
WASHUK DISTRICT,BESIMA SUB-TEHSIL,73,30,0,30
WASHUK DISTRICT,BESIMA SUB-TEHSIL,74,32,0,32
WASHUK DISTRICT,BESIMA SUB-TEHSIL,>=75,217,0,217
WASHUK DISTRICT,MASHKHEL SUB-TEHSIL,<1,1024,0,1024
WASHUK DISTRICT,MASHKHEL SUB-TEHSIL,1,1291,0,1291
WASHUK DISTRICT,MASHKHEL SUB-TEHSIL,2,1573,0,1573
WASHUK DISTRICT,MASHKHEL SUB-TEHSIL,3,1358,0,1358
WASHUK DISTRICT,MASHKHEL SUB-TEHSIL,4,1526,0,1526
WASHUK DISTRICT,MASHKHEL SUB-TEHSIL,5,1278,0,1278
WASHUK DISTRICT,MASHKHEL SUB-TEHSIL,6,1341,0,1341
WASHUK DISTRICT,MASHKHEL SUB-TEHSIL,7,1233,0,1233
WASHUK DISTRICT,MASHKHEL SUB-TEHSIL,8,1459,0,1459
WASHUK DISTRICT,MASHKHEL SUB-TEHSIL,9,1214,0,1214
WASHUK DISTRICT,MASHKHEL SUB-TEHSIL,10,1325,0,1325
WASHUK DISTRICT,MASHKHEL SUB-TEHSIL,11,940,0,940
WASHUK DISTRICT,MASHKHEL SUB-TEHSIL,12,994,0,994
WASHUK DISTRICT,MASHKHEL SUB-TEHSIL,13,805,0,805
WASHUK DISTRICT,MASHKHEL SUB-TEHSIL,14,755,0,755
WASHUK DISTRICT,MASHKHEL SUB-TEHSIL,15,725,0,725
WASHUK DISTRICT,MASHKHEL SUB-TEHSIL,16,687,0,687
WASHUK DISTRICT,MASHKHEL SUB-TEHSIL,17,709,0,709
WASHUK DISTRICT,MASHKHEL SUB-TEHSIL,18,820,0,820
WASHUK DISTRICT,MASHKHEL SUB-TEHSIL,19,739,0,739
WASHUK DISTRICT,MASHKHEL SUB-TEHSIL,20,952,0,952
WASHUK DISTRICT,MASHKHEL SUB-TEHSIL,21,785,0,785
WASHUK DISTRICT,MASHKHEL SUB-TEHSIL,22,551,0,551
WASHUK DISTRICT,MASHKHEL SUB-TEHSIL,23,558,0,558
WASHUK DISTRICT,MASHKHEL SUB-TEHSIL,24,477,0,477
WASHUK DISTRICT,MASHKHEL SUB-TEHSIL,25,730,0,730
WASHUK DISTRICT,MASHKHEL SUB-TEHSIL,26,404,0,404
WASHUK DISTRICT,MASHKHEL SUB-TEHSIL,27,623,0,623
WASHUK DISTRICT,MASHKHEL SUB-TEHSIL,28,534,0,534
WASHUK DISTRICT,MASHKHEL SUB-TEHSIL,29,595,0,595
WASHUK DISTRICT,MASHKHEL SUB-TEHSIL,30,755,0,755
WASHUK DISTRICT,MASHKHEL SUB-TEHSIL,31,549,0,549
WASHUK DISTRICT,MASHKHEL SUB-TEHSIL,32,378,0,378
WASHUK DISTRICT,MASHKHEL SUB-TEHSIL,33,516,0,516
WASHUK DISTRICT,MASHKHEL SUB-TEHSIL,34,424,0,424
WASHUK DISTRICT,MASHKHEL SUB-TEHSIL,35,591,0,591
WASHUK DISTRICT,MASHKHEL SUB-TEHSIL,36,259,0,259
WASHUK DISTRICT,MASHKHEL SUB-TEHSIL,37,488,0,488
WASHUK DISTRICT,MASHKHEL SUB-TEHSIL,38,453,0,453
WASHUK DISTRICT,MASHKHEL SUB-TEHSIL,39,405,0,405
WASHUK DISTRICT,MASHKHEL SUB-TEHSIL,40,539,0,539
WASHUK DISTRICT,MASHKHEL SUB-TEHSIL,41,313,0,313
WASHUK DISTRICT,MASHKHEL SUB-TEHSIL,42,213,0,213
WASHUK DISTRICT,MASHKHEL SUB-TEHSIL,43,271,0,271
WASHUK DISTRICT,MASHKHEL SUB-TEHSIL,44,193,0,193
WASHUK DISTRICT,MASHKHEL SUB-TEHSIL,45,284,0,284
WASHUK DISTRICT,MASHKHEL SUB-TEHSIL,46,155,0,155
WASHUK DISTRICT,MASHKHEL SUB-TEHSIL,47,206,0,206
WASHUK DISTRICT,MASHKHEL SUB-TEHSIL,48,215,0,215
WASHUK DISTRICT,MASHKHEL SUB-TEHSIL,49,207,0,207
WASHUK DISTRICT,MASHKHEL SUB-TEHSIL,50,301,0,301
WASHUK DISTRICT,MASHKHEL SUB-TEHSIL,51,171,0,171
WASHUK DISTRICT,MASHKHEL SUB-TEHSIL,52,158,0,158
WASHUK DISTRICT,MASHKHEL SUB-TEHSIL,53,162,0,162
WASHUK DISTRICT,MASHKHEL SUB-TEHSIL,54,162,0,162
WASHUK DISTRICT,MASHKHEL SUB-TEHSIL,55,154,0,154
WASHUK DISTRICT,MASHKHEL SUB-TEHSIL,56,100,0,100
WASHUK DISTRICT,MASHKHEL SUB-TEHSIL,57,124,0,124
WASHUK DISTRICT,MASHKHEL SUB-TEHSIL,58,88,0,88
WASHUK DISTRICT,MASHKHEL SUB-TEHSIL,59,133,0,133
WASHUK DISTRICT,MASHKHEL SUB-TEHSIL,60,187,0,187
WASHUK DISTRICT,MASHKHEL SUB-TEHSIL,61,98,0,98
WASHUK DISTRICT,MASHKHEL SUB-TEHSIL,62,83,0,83
WASHUK DISTRICT,MASHKHEL SUB-TEHSIL,63,121,0,121
WASHUK DISTRICT,MASHKHEL SUB-TEHSIL,64,111,0,111
WASHUK DISTRICT,MASHKHEL SUB-TEHSIL,65,98,0,98
WASHUK DISTRICT,MASHKHEL SUB-TEHSIL,66,64,0,64
WASHUK DISTRICT,MASHKHEL SUB-TEHSIL,67,63,0,63
WASHUK DISTRICT,MASHKHEL SUB-TEHSIL,68,76,0,76
WASHUK DISTRICT,MASHKHEL SUB-TEHSIL,69,99,0,99
WASHUK DISTRICT,MASHKHEL SUB-TEHSIL,70,103,0,103
WASHUK DISTRICT,MASHKHEL SUB-TEHSIL,71,42,0,42
WASHUK DISTRICT,MASHKHEL SUB-TEHSIL,72,43,0,43
WASHUK DISTRICT,MASHKHEL SUB-TEHSIL,73,47,0,47
WASHUK DISTRICT,MASHKHEL SUB-TEHSIL,74,61,0,61
WASHUK DISTRICT,MASHKHEL SUB-TEHSIL,>=75,366,0,366
WASHUK DISTRICT,NAG SUB-TEHSIL,<1,984,0,984
WASHUK DISTRICT,NAG SUB-TEHSIL,1,1108,0,1108
WASHUK DISTRICT,NAG SUB-TEHSIL,2,1222,0,1222
WASHUK DISTRICT,NAG SUB-TEHSIL,3,1058,0,1058
WASHUK DISTRICT,NAG SUB-TEHSIL,4,1334,0,1334
WASHUK DISTRICT,NAG SUB-TEHSIL,5,1190,0,1190
WASHUK DISTRICT,NAG SUB-TEHSIL,6,1415,0,1415
WASHUK DISTRICT,NAG SUB-TEHSIL,7,1178,0,1178
WASHUK DISTRICT,NAG SUB-TEHSIL,8,1573,0,1573
WASHUK DISTRICT,NAG SUB-TEHSIL,9,1335,0,1335
WASHUK DISTRICT,NAG SUB-TEHSIL,10,1662,0,1662
WASHUK DISTRICT,NAG SUB-TEHSIL,11,1284,0,1284
WASHUK DISTRICT,NAG SUB-TEHSIL,12,1109,0,1109
WASHUK DISTRICT,NAG SUB-TEHSIL,13,892,0,892
WASHUK DISTRICT,NAG SUB-TEHSIL,14,1088,0,1088
WASHUK DISTRICT,NAG SUB-TEHSIL,15,815,0,815
WASHUK DISTRICT,NAG SUB-TEHSIL,16,851,0,851
WASHUK DISTRICT,NAG SUB-TEHSIL,17,942,0,942
WASHUK DISTRICT,NAG SUB-TEHSIL,18,579,0,579
WASHUK DISTRICT,NAG SUB-TEHSIL,19,491,0,491
WASHUK DISTRICT,NAG SUB-TEHSIL,20,707,0,707
WASHUK DISTRICT,NAG SUB-TEHSIL,21,341,0,341
WASHUK DISTRICT,NAG SUB-TEHSIL,22,299,0,299
WASHUK DISTRICT,NAG SUB-TEHSIL,23,303,0,303
WASHUK DISTRICT,NAG SUB-TEHSIL,24,233,0,233
WASHUK DISTRICT,NAG SUB-TEHSIL,25,495,0,495
WASHUK DISTRICT,NAG SUB-TEHSIL,26,275,0,275
WASHUK DISTRICT,NAG SUB-TEHSIL,27,321,0,321
WASHUK DISTRICT,NAG SUB-TEHSIL,28,397,0,397
WASHUK DISTRICT,NAG SUB-TEHSIL,29,403,0,403
WASHUK DISTRICT,NAG SUB-TEHSIL,30,648,0,648
WASHUK DISTRICT,NAG SUB-TEHSIL,31,352,0,352
WASHUK DISTRICT,NAG SUB-TEHSIL,32,313,0,313
WASHUK DISTRICT,NAG SUB-TEHSIL,33,372,0,372
WASHUK DISTRICT,NAG SUB-TEHSIL,34,272,0,272
WASHUK DISTRICT,NAG SUB-TEHSIL,35,411,0,411
WASHUK DISTRICT,NAG SUB-TEHSIL,36,225,0,225
WASHUK DISTRICT,NAG SUB-TEHSIL,37,312,0,312
WASHUK DISTRICT,NAG SUB-TEHSIL,38,390,0,390
WASHUK DISTRICT,NAG SUB-TEHSIL,39,308,0,308
WASHUK DISTRICT,NAG SUB-TEHSIL,40,631,0,631
WASHUK DISTRICT,NAG SUB-TEHSIL,41,337,0,337
WASHUK DISTRICT,NAG SUB-TEHSIL,42,202,0,202
WASHUK DISTRICT,NAG SUB-TEHSIL,43,277,0,277
WASHUK DISTRICT,NAG SUB-TEHSIL,44,216,0,216
WASHUK DISTRICT,NAG SUB-TEHSIL,45,297,0,297
WASHUK DISTRICT,NAG SUB-TEHSIL,46,95,0,95
WASHUK DISTRICT,NAG SUB-TEHSIL,47,147,0,147
WASHUK DISTRICT,NAG SUB-TEHSIL,48,157,0,157
WASHUK DISTRICT,NAG SUB-TEHSIL,49,191,0,191
WASHUK DISTRICT,NAG SUB-TEHSIL,50,288,0,288
WASHUK DISTRICT,NAG SUB-TEHSIL,51,134,0,134
WASHUK DISTRICT,NAG SUB-TEHSIL,52,118,0,118
WASHUK DISTRICT,NAG SUB-TEHSIL,53,142,0,142
WASHUK DISTRICT,NAG SUB-TEHSIL,54,154,0,154
WASHUK DISTRICT,NAG SUB-TEHSIL,55,144,0,144
WASHUK DISTRICT,NAG SUB-TEHSIL,56,74,0,74
WASHUK DISTRICT,NAG SUB-TEHSIL,57,77,0,77
WASHUK DISTRICT,NAG SUB-TEHSIL,58,92,0,92
WASHUK DISTRICT,NAG SUB-TEHSIL,59,85,0,85
WASHUK DISTRICT,NAG SUB-TEHSIL,60,175,0,175
WASHUK DISTRICT,NAG SUB-TEHSIL,61,76,0,76
WASHUK DISTRICT,NAG SUB-TEHSIL,62,81,0,81
WASHUK DISTRICT,NAG SUB-TEHSIL,63,80,0,80
WASHUK DISTRICT,NAG SUB-TEHSIL,64,70,0,70
WASHUK DISTRICT,NAG SUB-TEHSIL,65,73,0,73
WASHUK DISTRICT,NAG SUB-TEHSIL,66,30,0,30
WASHUK DISTRICT,NAG SUB-TEHSIL,67,38,0,38
WASHUK DISTRICT,NAG SUB-TEHSIL,68,37,0,37
WASHUK DISTRICT,NAG SUB-TEHSIL,69,54,0,54
WASHUK DISTRICT,NAG SUB-TEHSIL,70,66,0,66
WASHUK DISTRICT,NAG SUB-TEHSIL,71,31,0,31
WASHUK DISTRICT,NAG SUB-TEHSIL,72,44,0,44
WASHUK DISTRICT,NAG SUB-TEHSIL,73,42,0,42
WASHUK DISTRICT,NAG SUB-TEHSIL,74,34,0,34
WASHUK DISTRICT,NAG SUB-TEHSIL,>=75,201,0,201
WASHUK DISTRICT,SHAHGORI SUB-TEHSIL,<1,1029,0,1029
WASHUK DISTRICT,SHAHGORI SUB-TEHSIL,1,968,0,968
WASHUK DISTRICT,SHAHGORI SUB-TEHSIL,2,1123,0,1123
WASHUK DISTRICT,SHAHGORI SUB-TEHSIL,3,1108,0,1108
WASHUK DISTRICT,SHAHGORI SUB-TEHSIL,4,1138,0,1138
WASHUK DISTRICT,SHAHGORI SUB-TEHSIL,5,1034,0,1034
WASHUK DISTRICT,SHAHGORI SUB-TEHSIL,6,1061,0,1061
WASHUK DISTRICT,SHAHGORI SUB-TEHSIL,7,934,0,934
WASHUK DISTRICT,SHAHGORI SUB-TEHSIL,8,1149,0,1149
WASHUK DISTRICT,SHAHGORI SUB-TEHSIL,9,801,0,801
WASHUK DISTRICT,SHAHGORI SUB-TEHSIL,10,1055,0,1055
WASHUK DISTRICT,SHAHGORI SUB-TEHSIL,11,617,0,617
WASHUK DISTRICT,SHAHGORI SUB-TEHSIL,12,654,0,654
WASHUK DISTRICT,SHAHGORI SUB-TEHSIL,13,576,0,576
WASHUK DISTRICT,SHAHGORI SUB-TEHSIL,14,516,0,516
WASHUK DISTRICT,SHAHGORI SUB-TEHSIL,15,653,0,653
WASHUK DISTRICT,SHAHGORI SUB-TEHSIL,16,492,0,492
WASHUK DISTRICT,SHAHGORI SUB-TEHSIL,17,523,0,523
WASHUK DISTRICT,SHAHGORI SUB-TEHSIL,18,563,0,563
WASHUK DISTRICT,SHAHGORI SUB-TEHSIL,19,533,0,533
WASHUK DISTRICT,SHAHGORI SUB-TEHSIL,20,651,0,651
WASHUK DISTRICT,SHAHGORI SUB-TEHSIL,21,426,0,426
WASHUK DISTRICT,SHAHGORI SUB-TEHSIL,22,335,0,335
WASHUK DISTRICT,SHAHGORI SUB-TEHSIL,23,281,0,281
WASHUK DISTRICT,SHAHGORI SUB-TEHSIL,24,230,0,230
WASHUK DISTRICT,SHAHGORI SUB-TEHSIL,25,515,0,515
WASHUK DISTRICT,SHAHGORI SUB-TEHSIL,26,309,0,309
WASHUK DISTRICT,SHAHGORI SUB-TEHSIL,27,477,0,477
WASHUK DISTRICT,SHAHGORI SUB-TEHSIL,28,387,0,387
WASHUK DISTRICT,SHAHGORI SUB-TEHSIL,29,434,0,434
WASHUK DISTRICT,SHAHGORI SUB-TEHSIL,30,487,0,487
WASHUK DISTRICT,SHAHGORI SUB-TEHSIL,31,351,0,351
WASHUK DISTRICT,SHAHGORI SUB-TEHSIL,32,249,0,249
WASHUK DISTRICT,SHAHGORI SUB-TEHSIL,33,319,0,319
WASHUK DISTRICT,SHAHGORI SUB-TEHSIL,34,246,0,246
WASHUK DISTRICT,SHAHGORI SUB-TEHSIL,35,347,0,347
WASHUK DISTRICT,SHAHGORI SUB-TEHSIL,36,203,0,203
WASHUK DISTRICT,SHAHGORI SUB-TEHSIL,37,304,0,304
WASHUK DISTRICT,SHAHGORI SUB-TEHSIL,38,203,0,203
WASHUK DISTRICT,SHAHGORI SUB-TEHSIL,39,253,0,253
WASHUK DISTRICT,SHAHGORI SUB-TEHSIL,40,314,0,314
WASHUK DISTRICT,SHAHGORI SUB-TEHSIL,41,197,0,197
WASHUK DISTRICT,SHAHGORI SUB-TEHSIL,42,155,0,155
WASHUK DISTRICT,SHAHGORI SUB-TEHSIL,43,152,0,152
WASHUK DISTRICT,SHAHGORI SUB-TEHSIL,44,125,0,125
WASHUK DISTRICT,SHAHGORI SUB-TEHSIL,45,170,0,170
WASHUK DISTRICT,SHAHGORI SUB-TEHSIL,46,107,0,107
WASHUK DISTRICT,SHAHGORI SUB-TEHSIL,47,160,0,160
WASHUK DISTRICT,SHAHGORI SUB-TEHSIL,48,167,0,167
WASHUK DISTRICT,SHAHGORI SUB-TEHSIL,49,186,0,186
WASHUK DISTRICT,SHAHGORI SUB-TEHSIL,50,198,0,198
WASHUK DISTRICT,SHAHGORI SUB-TEHSIL,51,139,0,139
WASHUK DISTRICT,SHAHGORI SUB-TEHSIL,52,108,0,108
WASHUK DISTRICT,SHAHGORI SUB-TEHSIL,53,134,0,134
WASHUK DISTRICT,SHAHGORI SUB-TEHSIL,54,109,0,109
WASHUK DISTRICT,SHAHGORI SUB-TEHSIL,55,110,0,110
WASHUK DISTRICT,SHAHGORI SUB-TEHSIL,56,70,0,70
WASHUK DISTRICT,SHAHGORI SUB-TEHSIL,57,103,0,103
WASHUK DISTRICT,SHAHGORI SUB-TEHSIL,58,67,0,67
WASHUK DISTRICT,SHAHGORI SUB-TEHSIL,59,75,0,75
WASHUK DISTRICT,SHAHGORI SUB-TEHSIL,60,91,0,91
WASHUK DISTRICT,SHAHGORI SUB-TEHSIL,61,79,0,79
WASHUK DISTRICT,SHAHGORI SUB-TEHSIL,62,56,0,56
WASHUK DISTRICT,SHAHGORI SUB-TEHSIL,63,62,0,62
WASHUK DISTRICT,SHAHGORI SUB-TEHSIL,64,79,0,79
WASHUK DISTRICT,SHAHGORI SUB-TEHSIL,65,57,0,57
WASHUK DISTRICT,SHAHGORI SUB-TEHSIL,66,49,0,49
WASHUK DISTRICT,SHAHGORI SUB-TEHSIL,67,67,0,67
WASHUK DISTRICT,SHAHGORI SUB-TEHSIL,68,43,0,43
WASHUK DISTRICT,SHAHGORI SUB-TEHSIL,69,82,0,82
WASHUK DISTRICT,SHAHGORI SUB-TEHSIL,70,58,0,58
WASHUK DISTRICT,SHAHGORI SUB-TEHSIL,71,50,0,50
WASHUK DISTRICT,SHAHGORI SUB-TEHSIL,72,27,0,27
WASHUK DISTRICT,SHAHGORI SUB-TEHSIL,73,39,0,39
WASHUK DISTRICT,SHAHGORI SUB-TEHSIL,74,49,0,49
WASHUK DISTRICT,SHAHGORI SUB-TEHSIL,>=75,280,0,280
WASHUK DISTRICT,WASHUK SUB-TEHSIL,<1,603,1279,1882
WASHUK DISTRICT,WASHUK SUB-TEHSIL,1,402,926,1328
WASHUK DISTRICT,WASHUK SUB-TEHSIL,2,526,1164,1690
WASHUK DISTRICT,WASHUK SUB-TEHSIL,3,492,993,1485
WASHUK DISTRICT,WASHUK SUB-TEHSIL,4,529,1170,1699
WASHUK DISTRICT,WASHUK SUB-TEHSIL,5,560,728,1288
WASHUK DISTRICT,WASHUK SUB-TEHSIL,6,485,845,1330
WASHUK DISTRICT,WASHUK SUB-TEHSIL,7,546,650,1196
WASHUK DISTRICT,WASHUK SUB-TEHSIL,8,477,839,1316
WASHUK DISTRICT,WASHUK SUB-TEHSIL,9,646,709,1355
WASHUK DISTRICT,WASHUK SUB-TEHSIL,10,474,732,1206
WASHUK DISTRICT,WASHUK SUB-TEHSIL,11,404,535,939
WASHUK DISTRICT,WASHUK SUB-TEHSIL,12,302,466,768
WASHUK DISTRICT,WASHUK SUB-TEHSIL,13,402,434,836
WASHUK DISTRICT,WASHUK SUB-TEHSIL,14,227,509,736
WASHUK DISTRICT,WASHUK SUB-TEHSIL,15,377,380,757
WASHUK DISTRICT,WASHUK SUB-TEHSIL,16,177,433,610
WASHUK DISTRICT,WASHUK SUB-TEHSIL,17,366,421,787
WASHUK DISTRICT,WASHUK SUB-TEHSIL,18,197,380,577
WASHUK DISTRICT,WASHUK SUB-TEHSIL,19,238,401,639
WASHUK DISTRICT,WASHUK SUB-TEHSIL,20,270,428,698
WASHUK DISTRICT,WASHUK SUB-TEHSIL,21,205,341,546
WASHUK DISTRICT,WASHUK SUB-TEHSIL,22,130,244,374
WASHUK DISTRICT,WASHUK SUB-TEHSIL,23,153,271,424
WASHUK DISTRICT,WASHUK SUB-TEHSIL,24,126,189,315
WASHUK DISTRICT,WASHUK SUB-TEHSIL,25,169,349,518
WASHUK DISTRICT,WASHUK SUB-TEHSIL,26,137,284,421
WASHUK DISTRICT,WASHUK SUB-TEHSIL,27,141,278,419
WASHUK DISTRICT,WASHUK SUB-TEHSIL,28,192,278,470
WASHUK DISTRICT,WASHUK SUB-TEHSIL,29,201,298,499
WASHUK DISTRICT,WASHUK SUB-TEHSIL,30,227,290,517
WASHUK DISTRICT,WASHUK SUB-TEHSIL,31,119,245,364
WASHUK DISTRICT,WASHUK SUB-TEHSIL,32,105,187,292
WASHUK DISTRICT,WASHUK SUB-TEHSIL,33,127,205,332
WASHUK DISTRICT,WASHUK SUB-TEHSIL,34,83,152,235
WASHUK DISTRICT,WASHUK SUB-TEHSIL,35,149,206,355
WASHUK DISTRICT,WASHUK SUB-TEHSIL,36,67,141,208
WASHUK DISTRICT,WASHUK SUB-TEHSIL,37,68,195,263
WASHUK DISTRICT,WASHUK SUB-TEHSIL,38,76,166,242
WASHUK DISTRICT,WASHUK SUB-TEHSIL,39,102,176,278
WASHUK DISTRICT,WASHUK SUB-TEHSIL,40,196,205,401
WASHUK DISTRICT,WASHUK SUB-TEHSIL,41,83,144,227
WASHUK DISTRICT,WASHUK SUB-TEHSIL,42,64,138,202
WASHUK DISTRICT,WASHUK SUB-TEHSIL,43,94,136,230
WASHUK DISTRICT,WASHUK SUB-TEHSIL,44,60,98,158
WASHUK DISTRICT,WASHUK SUB-TEHSIL,45,90,125,215
WASHUK DISTRICT,WASHUK SUB-TEHSIL,46,60,102,162
WASHUK DISTRICT,WASHUK SUB-TEHSIL,47,52,133,185
WASHUK DISTRICT,WASHUK SUB-TEHSIL,48,56,104,160
WASHUK DISTRICT,WASHUK SUB-TEHSIL,49,77,118,195
WASHUK DISTRICT,WASHUK SUB-TEHSIL,50,74,119,193
WASHUK DISTRICT,WASHUK SUB-TEHSIL,51,47,94,141
WASHUK DISTRICT,WASHUK SUB-TEHSIL,52,30,73,103
WASHUK DISTRICT,WASHUK SUB-TEHSIL,53,34,66,100
WASHUK DISTRICT,WASHUK SUB-TEHSIL,54,35,68,103
WASHUK DISTRICT,WASHUK SUB-TEHSIL,55,53,49,102
WASHUK DISTRICT,WASHUK SUB-TEHSIL,56,24,51,75
WASHUK DISTRICT,WASHUK SUB-TEHSIL,57,38,71,109
WASHUK DISTRICT,WASHUK SUB-TEHSIL,58,23,49,72
WASHUK DISTRICT,WASHUK SUB-TEHSIL,59,46,74,120
WASHUK DISTRICT,WASHUK SUB-TEHSIL,60,48,84,132
WASHUK DISTRICT,WASHUK SUB-TEHSIL,61,31,54,85
WASHUK DISTRICT,WASHUK SUB-TEHSIL,62,24,59,83
WASHUK DISTRICT,WASHUK SUB-TEHSIL,63,27,37,64
WASHUK DISTRICT,WASHUK SUB-TEHSIL,64,30,42,72
WASHUK DISTRICT,WASHUK SUB-TEHSIL,65,22,62,84
WASHUK DISTRICT,WASHUK SUB-TEHSIL,66,22,37,59
WASHUK DISTRICT,WASHUK SUB-TEHSIL,67,12,40,52
WASHUK DISTRICT,WASHUK SUB-TEHSIL,68,22,55,77
WASHUK DISTRICT,WASHUK SUB-TEHSIL,69,29,58,87
WASHUK DISTRICT,WASHUK SUB-TEHSIL,70,23,53,76
WASHUK DISTRICT,WASHUK SUB-TEHSIL,71,10,37,47
WASHUK DISTRICT,WASHUK SUB-TEHSIL,72,17,26,43
WASHUK DISTRICT,WASHUK SUB-TEHSIL,73,13,35,48
WASHUK DISTRICT,WASHUK SUB-TEHSIL,74,12,25,37
WASHUK DISTRICT,WASHUK SUB-TEHSIL,>=75,97,197,294
ZHOB DISTRICT,ASHWAT SUB-TEHSIL,<1,859,0,859
ZHOB DISTRICT,ASHWAT SUB-TEHSIL,1,615,0,615
ZHOB DISTRICT,ASHWAT SUB-TEHSIL,2,870,0,870
ZHOB DISTRICT,ASHWAT SUB-TEHSIL,3,852,0,852
ZHOB DISTRICT,ASHWAT SUB-TEHSIL,4,860,0,860
ZHOB DISTRICT,ASHWAT SUB-TEHSIL,5,794,0,794
ZHOB DISTRICT,ASHWAT SUB-TEHSIL,6,875,0,875
ZHOB DISTRICT,ASHWAT SUB-TEHSIL,7,783,0,783
ZHOB DISTRICT,ASHWAT SUB-TEHSIL,8,896,0,896
ZHOB DISTRICT,ASHWAT SUB-TEHSIL,9,794,0,794
ZHOB DISTRICT,ASHWAT SUB-TEHSIL,10,847,0,847
ZHOB DISTRICT,ASHWAT SUB-TEHSIL,11,805,0,805
ZHOB DISTRICT,ASHWAT SUB-TEHSIL,12,646,0,646
ZHOB DISTRICT,ASHWAT SUB-TEHSIL,13,730,0,730
ZHOB DISTRICT,ASHWAT SUB-TEHSIL,14,561,0,561
ZHOB DISTRICT,ASHWAT SUB-TEHSIL,15,543,0,543
ZHOB DISTRICT,ASHWAT SUB-TEHSIL,16,483,0,483
ZHOB DISTRICT,ASHWAT SUB-TEHSIL,17,411,0,411
ZHOB DISTRICT,ASHWAT SUB-TEHSIL,18,391,0,391
ZHOB DISTRICT,ASHWAT SUB-TEHSIL,19,394,0,394
ZHOB DISTRICT,ASHWAT SUB-TEHSIL,20,406,0,406
ZHOB DISTRICT,ASHWAT SUB-TEHSIL,21,306,0,306
ZHOB DISTRICT,ASHWAT SUB-TEHSIL,22,241,0,241
ZHOB DISTRICT,ASHWAT SUB-TEHSIL,23,247,0,247
ZHOB DISTRICT,ASHWAT SUB-TEHSIL,24,220,0,220
ZHOB DISTRICT,ASHWAT SUB-TEHSIL,25,287,0,287
ZHOB DISTRICT,ASHWAT SUB-TEHSIL,26,162,0,162
ZHOB DISTRICT,ASHWAT SUB-TEHSIL,27,239,0,239
ZHOB DISTRICT,ASHWAT SUB-TEHSIL,28,180,0,180
ZHOB DISTRICT,ASHWAT SUB-TEHSIL,29,212,0,212
ZHOB DISTRICT,ASHWAT SUB-TEHSIL,30,235,0,235
ZHOB DISTRICT,ASHWAT SUB-TEHSIL,31,229,0,229
ZHOB DISTRICT,ASHWAT SUB-TEHSIL,32,181,0,181
ZHOB DISTRICT,ASHWAT SUB-TEHSIL,33,178,0,178
ZHOB DISTRICT,ASHWAT SUB-TEHSIL,34,130,0,130
ZHOB DISTRICT,ASHWAT SUB-TEHSIL,35,150,0,150
ZHOB DISTRICT,ASHWAT SUB-TEHSIL,36,103,0,103
ZHOB DISTRICT,ASHWAT SUB-TEHSIL,37,188,0,188
ZHOB DISTRICT,ASHWAT SUB-TEHSIL,38,150,0,150
ZHOB DISTRICT,ASHWAT SUB-TEHSIL,39,142,0,142
ZHOB DISTRICT,ASHWAT SUB-TEHSIL,40,171,0,171
ZHOB DISTRICT,ASHWAT SUB-TEHSIL,41,125,0,125
ZHOB DISTRICT,ASHWAT SUB-TEHSIL,42,108,0,108
ZHOB DISTRICT,ASHWAT SUB-TEHSIL,43,98,0,98
ZHOB DISTRICT,ASHWAT SUB-TEHSIL,44,71,0,71
ZHOB DISTRICT,ASHWAT SUB-TEHSIL,45,101,0,101
ZHOB DISTRICT,ASHWAT SUB-TEHSIL,46,60,0,60
ZHOB DISTRICT,ASHWAT SUB-TEHSIL,47,139,0,139
ZHOB DISTRICT,ASHWAT SUB-TEHSIL,48,103,0,103
ZHOB DISTRICT,ASHWAT SUB-TEHSIL,49,108,0,108
ZHOB DISTRICT,ASHWAT SUB-TEHSIL,50,119,0,119
ZHOB DISTRICT,ASHWAT SUB-TEHSIL,51,97,0,97
ZHOB DISTRICT,ASHWAT SUB-TEHSIL,52,63,0,63
ZHOB DISTRICT,ASHWAT SUB-TEHSIL,53,67,0,67
ZHOB DISTRICT,ASHWAT SUB-TEHSIL,54,60,0,60
ZHOB DISTRICT,ASHWAT SUB-TEHSIL,55,67,0,67
ZHOB DISTRICT,ASHWAT SUB-TEHSIL,56,55,0,55
ZHOB DISTRICT,ASHWAT SUB-TEHSIL,57,78,0,78
ZHOB DISTRICT,ASHWAT SUB-TEHSIL,58,48,0,48
ZHOB DISTRICT,ASHWAT SUB-TEHSIL,59,52,0,52
ZHOB DISTRICT,ASHWAT SUB-TEHSIL,60,61,0,61
ZHOB DISTRICT,ASHWAT SUB-TEHSIL,61,54,0,54
ZHOB DISTRICT,ASHWAT SUB-TEHSIL,62,54,0,54
ZHOB DISTRICT,ASHWAT SUB-TEHSIL,63,44,0,44
ZHOB DISTRICT,ASHWAT SUB-TEHSIL,64,54,0,54
ZHOB DISTRICT,ASHWAT SUB-TEHSIL,65,39,0,39
ZHOB DISTRICT,ASHWAT SUB-TEHSIL,66,28,0,28
ZHOB DISTRICT,ASHWAT SUB-TEHSIL,67,43,0,43
ZHOB DISTRICT,ASHWAT SUB-TEHSIL,68,35,0,35
ZHOB DISTRICT,ASHWAT SUB-TEHSIL,69,56,0,56
ZHOB DISTRICT,ASHWAT SUB-TEHSIL,70,28,0,28
ZHOB DISTRICT,ASHWAT SUB-TEHSIL,71,16,0,16
ZHOB DISTRICT,ASHWAT SUB-TEHSIL,72,32,0,32
ZHOB DISTRICT,ASHWAT SUB-TEHSIL,73,24,0,24
ZHOB DISTRICT,ASHWAT SUB-TEHSIL,74,43,0,43
ZHOB DISTRICT,ASHWAT SUB-TEHSIL,>=75,172,0,172
ZHOB DISTRICT,KASHATOO SUB-TEHSIL,<1,227,0,227
ZHOB DISTRICT,KASHATOO SUB-TEHSIL,1,216,0,216
ZHOB DISTRICT,KASHATOO SUB-TEHSIL,2,318,0,318
ZHOB DISTRICT,KASHATOO SUB-TEHSIL,3,227,0,227
ZHOB DISTRICT,KASHATOO SUB-TEHSIL,4,257,0,257
ZHOB DISTRICT,KASHATOO SUB-TEHSIL,5,221,0,221
ZHOB DISTRICT,KASHATOO SUB-TEHSIL,6,227,0,227
ZHOB DISTRICT,KASHATOO SUB-TEHSIL,7,187,0,187
ZHOB DISTRICT,KASHATOO SUB-TEHSIL,8,215,0,215
ZHOB DISTRICT,KASHATOO SUB-TEHSIL,9,164,0,164
ZHOB DISTRICT,KASHATOO SUB-TEHSIL,10,186,0,186
ZHOB DISTRICT,KASHATOO SUB-TEHSIL,11,130,0,130
ZHOB DISTRICT,KASHATOO SUB-TEHSIL,12,126,0,126
ZHOB DISTRICT,KASHATOO SUB-TEHSIL,13,108,0,108
ZHOB DISTRICT,KASHATOO SUB-TEHSIL,14,105,0,105
ZHOB DISTRICT,KASHATOO SUB-TEHSIL,15,103,0,103
ZHOB DISTRICT,KASHATOO SUB-TEHSIL,16,70,0,70
ZHOB DISTRICT,KASHATOO SUB-TEHSIL,17,63,0,63
ZHOB DISTRICT,KASHATOO SUB-TEHSIL,18,98,0,98
ZHOB DISTRICT,KASHATOO SUB-TEHSIL,19,84,0,84
ZHOB DISTRICT,KASHATOO SUB-TEHSIL,20,110,0,110
ZHOB DISTRICT,KASHATOO SUB-TEHSIL,21,79,0,79
ZHOB DISTRICT,KASHATOO SUB-TEHSIL,22,82,0,82
ZHOB DISTRICT,KASHATOO SUB-TEHSIL,23,44,0,44
ZHOB DISTRICT,KASHATOO SUB-TEHSIL,24,61,0,61
ZHOB DISTRICT,KASHATOO SUB-TEHSIL,25,84,0,84
ZHOB DISTRICT,KASHATOO SUB-TEHSIL,26,55,0,55
ZHOB DISTRICT,KASHATOO SUB-TEHSIL,27,71,0,71
ZHOB DISTRICT,KASHATOO SUB-TEHSIL,28,65,0,65
ZHOB DISTRICT,KASHATOO SUB-TEHSIL,29,66,0,66
ZHOB DISTRICT,KASHATOO SUB-TEHSIL,30,52,0,52
ZHOB DISTRICT,KASHATOO SUB-TEHSIL,31,60,0,60
ZHOB DISTRICT,KASHATOO SUB-TEHSIL,32,48,0,48
ZHOB DISTRICT,KASHATOO SUB-TEHSIL,33,43,0,43
ZHOB DISTRICT,KASHATOO SUB-TEHSIL,34,35,0,35
ZHOB DISTRICT,KASHATOO SUB-TEHSIL,35,44,0,44
ZHOB DISTRICT,KASHATOO SUB-TEHSIL,36,25,0,25
ZHOB DISTRICT,KASHATOO SUB-TEHSIL,37,57,0,57
ZHOB DISTRICT,KASHATOO SUB-TEHSIL,38,34,0,34
ZHOB DISTRICT,KASHATOO SUB-TEHSIL,39,35,0,35
ZHOB DISTRICT,KASHATOO SUB-TEHSIL,40,32,0,32
ZHOB DISTRICT,KASHATOO SUB-TEHSIL,41,34,0,34
ZHOB DISTRICT,KASHATOO SUB-TEHSIL,42,32,0,32
ZHOB DISTRICT,KASHATOO SUB-TEHSIL,43,32,0,32
ZHOB DISTRICT,KASHATOO SUB-TEHSIL,44,16,0,16
ZHOB DISTRICT,KASHATOO SUB-TEHSIL,45,19,0,19
ZHOB DISTRICT,KASHATOO SUB-TEHSIL,46,24,0,24
ZHOB DISTRICT,KASHATOO SUB-TEHSIL,47,41,0,41
ZHOB DISTRICT,KASHATOO SUB-TEHSIL,48,33,0,33
ZHOB DISTRICT,KASHATOO SUB-TEHSIL,49,26,0,26
ZHOB DISTRICT,KASHATOO SUB-TEHSIL,50,20,0,20
ZHOB DISTRICT,KASHATOO SUB-TEHSIL,51,23,0,23
ZHOB DISTRICT,KASHATOO SUB-TEHSIL,52,24,0,24
ZHOB DISTRICT,KASHATOO SUB-TEHSIL,53,25,0,25
ZHOB DISTRICT,KASHATOO SUB-TEHSIL,54,15,0,15
ZHOB DISTRICT,KASHATOO SUB-TEHSIL,55,15,0,15
ZHOB DISTRICT,KASHATOO SUB-TEHSIL,56,16,0,16
ZHOB DISTRICT,KASHATOO SUB-TEHSIL,57,23,0,23
ZHOB DISTRICT,KASHATOO SUB-TEHSIL,58,12,0,12
ZHOB DISTRICT,KASHATOO SUB-TEHSIL,59,15,0,15
ZHOB DISTRICT,KASHATOO SUB-TEHSIL,60,10,0,10
ZHOB DISTRICT,KASHATOO SUB-TEHSIL,61,12,0,12
ZHOB DISTRICT,KASHATOO SUB-TEHSIL,62,10,0,10
ZHOB DISTRICT,KASHATOO SUB-TEHSIL,63,17,0,17
ZHOB DISTRICT,KASHATOO SUB-TEHSIL,64,26,0,26
ZHOB DISTRICT,KASHATOO SUB-TEHSIL,65,17,0,17
ZHOB DISTRICT,KASHATOO SUB-TEHSIL,66,6,0,6
ZHOB DISTRICT,KASHATOO SUB-TEHSIL,67,15,0,15
ZHOB DISTRICT,KASHATOO SUB-TEHSIL,68,5,0,5
ZHOB DISTRICT,KASHATOO SUB-TEHSIL,69,24,0,24
ZHOB DISTRICT,KASHATOO SUB-TEHSIL,70,4,0,4
ZHOB DISTRICT,KASHATOO SUB-TEHSIL,71,2,0,2
ZHOB DISTRICT,KASHATOO SUB-TEHSIL,72,9,0,9
ZHOB DISTRICT,KASHATOO SUB-TEHSIL,73,5,0,5
ZHOB DISTRICT,KASHATOO SUB-TEHSIL,74,13,0,13
ZHOB DISTRICT,KASHATOO SUB-TEHSIL,>=75,50,0,50
ZHOB DISTRICT,QAMAR DIN KAREZ TEHSIL,<1,485,0,485
ZHOB DISTRICT,QAMAR DIN KAREZ TEHSIL,1,428,0,428
ZHOB DISTRICT,QAMAR DIN KAREZ TEHSIL,2,648,0,648
ZHOB DISTRICT,QAMAR DIN KAREZ TEHSIL,3,612,0,612
ZHOB DISTRICT,QAMAR DIN KAREZ TEHSIL,4,634,0,634
ZHOB DISTRICT,QAMAR DIN KAREZ TEHSIL,5,651,0,651
ZHOB DISTRICT,QAMAR DIN KAREZ TEHSIL,6,541,0,541
ZHOB DISTRICT,QAMAR DIN KAREZ TEHSIL,7,533,0,533
ZHOB DISTRICT,QAMAR DIN KAREZ TEHSIL,8,564,0,564
ZHOB DISTRICT,QAMAR DIN KAREZ TEHSIL,9,457,0,457
ZHOB DISTRICT,QAMAR DIN KAREZ TEHSIL,10,491,0,491
ZHOB DISTRICT,QAMAR DIN KAREZ TEHSIL,11,320,0,320
ZHOB DISTRICT,QAMAR DIN KAREZ TEHSIL,12,324,0,324
ZHOB DISTRICT,QAMAR DIN KAREZ TEHSIL,13,275,0,275
ZHOB DISTRICT,QAMAR DIN KAREZ TEHSIL,14,248,0,248
ZHOB DISTRICT,QAMAR DIN KAREZ TEHSIL,15,277,0,277
ZHOB DISTRICT,QAMAR DIN KAREZ TEHSIL,16,197,0,197
ZHOB DISTRICT,QAMAR DIN KAREZ TEHSIL,17,162,0,162
ZHOB DISTRICT,QAMAR DIN KAREZ TEHSIL,18,267,0,267
ZHOB DISTRICT,QAMAR DIN KAREZ TEHSIL,19,144,0,144
ZHOB DISTRICT,QAMAR DIN KAREZ TEHSIL,20,288,0,288
ZHOB DISTRICT,QAMAR DIN KAREZ TEHSIL,21,192,0,192
ZHOB DISTRICT,QAMAR DIN KAREZ TEHSIL,22,123,0,123
ZHOB DISTRICT,QAMAR DIN KAREZ TEHSIL,23,143,0,143
ZHOB DISTRICT,QAMAR DIN KAREZ TEHSIL,24,122,0,122
ZHOB DISTRICT,QAMAR DIN KAREZ TEHSIL,25,357,0,357
ZHOB DISTRICT,QAMAR DIN KAREZ TEHSIL,26,117,0,117
ZHOB DISTRICT,QAMAR DIN KAREZ TEHSIL,27,185,0,185
ZHOB DISTRICT,QAMAR DIN KAREZ TEHSIL,28,174,0,174
ZHOB DISTRICT,QAMAR DIN KAREZ TEHSIL,29,197,0,197
ZHOB DISTRICT,QAMAR DIN KAREZ TEHSIL,30,329,0,329
ZHOB DISTRICT,QAMAR DIN KAREZ TEHSIL,31,171,0,171
ZHOB DISTRICT,QAMAR DIN KAREZ TEHSIL,32,115,0,115
ZHOB DISTRICT,QAMAR DIN KAREZ TEHSIL,33,136,0,136
ZHOB DISTRICT,QAMAR DIN KAREZ TEHSIL,34,131,0,131
ZHOB DISTRICT,QAMAR DIN KAREZ TEHSIL,35,241,0,241
ZHOB DISTRICT,QAMAR DIN KAREZ TEHSIL,36,86,0,86
ZHOB DISTRICT,QAMAR DIN KAREZ TEHSIL,37,93,0,93
ZHOB DISTRICT,QAMAR DIN KAREZ TEHSIL,38,122,0,122
ZHOB DISTRICT,QAMAR DIN KAREZ TEHSIL,39,135,0,135
ZHOB DISTRICT,QAMAR DIN KAREZ TEHSIL,40,225,0,225
ZHOB DISTRICT,QAMAR DIN KAREZ TEHSIL,41,117,0,117
ZHOB DISTRICT,QAMAR DIN KAREZ TEHSIL,42,71,0,71
ZHOB DISTRICT,QAMAR DIN KAREZ TEHSIL,43,113,0,113
ZHOB DISTRICT,QAMAR DIN KAREZ TEHSIL,44,83,0,83
ZHOB DISTRICT,QAMAR DIN KAREZ TEHSIL,45,130,0,130
ZHOB DISTRICT,QAMAR DIN KAREZ TEHSIL,46,61,0,61
ZHOB DISTRICT,QAMAR DIN KAREZ TEHSIL,47,75,0,75
ZHOB DISTRICT,QAMAR DIN KAREZ TEHSIL,48,41,0,41
ZHOB DISTRICT,QAMAR DIN KAREZ TEHSIL,49,77,0,77
ZHOB DISTRICT,QAMAR DIN KAREZ TEHSIL,50,135,0,135
ZHOB DISTRICT,QAMAR DIN KAREZ TEHSIL,51,60,0,60
ZHOB DISTRICT,QAMAR DIN KAREZ TEHSIL,52,35,0,35
ZHOB DISTRICT,QAMAR DIN KAREZ TEHSIL,53,53,0,53
ZHOB DISTRICT,QAMAR DIN KAREZ TEHSIL,54,56,0,56
ZHOB DISTRICT,QAMAR DIN KAREZ TEHSIL,55,76,0,76
ZHOB DISTRICT,QAMAR DIN KAREZ TEHSIL,56,29,0,29
ZHOB DISTRICT,QAMAR DIN KAREZ TEHSIL,57,35,0,35
ZHOB DISTRICT,QAMAR DIN KAREZ TEHSIL,58,26,0,26
ZHOB DISTRICT,QAMAR DIN KAREZ TEHSIL,59,44,0,44
ZHOB DISTRICT,QAMAR DIN KAREZ TEHSIL,60,82,0,82
ZHOB DISTRICT,QAMAR DIN KAREZ TEHSIL,61,38,0,38
ZHOB DISTRICT,QAMAR DIN KAREZ TEHSIL,62,29,0,29
ZHOB DISTRICT,QAMAR DIN KAREZ TEHSIL,63,38,0,38
ZHOB DISTRICT,QAMAR DIN KAREZ TEHSIL,64,46,0,46
ZHOB DISTRICT,QAMAR DIN KAREZ TEHSIL,65,29,0,29
ZHOB DISTRICT,QAMAR DIN KAREZ TEHSIL,66,17,0,17
ZHOB DISTRICT,QAMAR DIN KAREZ TEHSIL,67,20,0,20
ZHOB DISTRICT,QAMAR DIN KAREZ TEHSIL,68,23,0,23
ZHOB DISTRICT,QAMAR DIN KAREZ TEHSIL,69,47,0,47
ZHOB DISTRICT,QAMAR DIN KAREZ TEHSIL,70,24,0,24
ZHOB DISTRICT,QAMAR DIN KAREZ TEHSIL,71,18,0,18
ZHOB DISTRICT,QAMAR DIN KAREZ TEHSIL,72,13,0,13
ZHOB DISTRICT,QAMAR DIN KAREZ TEHSIL,73,12,0,12
ZHOB DISTRICT,QAMAR DIN KAREZ TEHSIL,74,20,0,20
ZHOB DISTRICT,QAMAR DIN KAREZ TEHSIL,>=75,118,0,118
ZHOB DISTRICT,SAMBAZA SUB-TEHSIL,<1,378,0,378
ZHOB DISTRICT,SAMBAZA SUB-TEHSIL,1,728,0,728
ZHOB DISTRICT,SAMBAZA SUB-TEHSIL,2,767,0,767
ZHOB DISTRICT,SAMBAZA SUB-TEHSIL,3,659,0,659
ZHOB DISTRICT,SAMBAZA SUB-TEHSIL,4,812,0,812
ZHOB DISTRICT,SAMBAZA SUB-TEHSIL,5,611,0,611
ZHOB DISTRICT,SAMBAZA SUB-TEHSIL,6,784,0,784
ZHOB DISTRICT,SAMBAZA SUB-TEHSIL,7,565,0,565
ZHOB DISTRICT,SAMBAZA SUB-TEHSIL,8,792,0,792
ZHOB DISTRICT,SAMBAZA SUB-TEHSIL,9,645,0,645
ZHOB DISTRICT,SAMBAZA SUB-TEHSIL,10,716,0,716
ZHOB DISTRICT,SAMBAZA SUB-TEHSIL,11,467,0,467
ZHOB DISTRICT,SAMBAZA SUB-TEHSIL,12,603,0,603
ZHOB DISTRICT,SAMBAZA SUB-TEHSIL,13,357,0,357
ZHOB DISTRICT,SAMBAZA SUB-TEHSIL,14,502,0,502
ZHOB DISTRICT,SAMBAZA SUB-TEHSIL,15,379,0,379
ZHOB DISTRICT,SAMBAZA SUB-TEHSIL,16,383,0,383
ZHOB DISTRICT,SAMBAZA SUB-TEHSIL,17,274,0,274
ZHOB DISTRICT,SAMBAZA SUB-TEHSIL,18,343,0,343
ZHOB DISTRICT,SAMBAZA SUB-TEHSIL,19,255,0,255
ZHOB DISTRICT,SAMBAZA SUB-TEHSIL,20,346,0,346
ZHOB DISTRICT,SAMBAZA SUB-TEHSIL,21,227,0,227
ZHOB DISTRICT,SAMBAZA SUB-TEHSIL,22,229,0,229
ZHOB DISTRICT,SAMBAZA SUB-TEHSIL,23,225,0,225
ZHOB DISTRICT,SAMBAZA SUB-TEHSIL,24,187,0,187
ZHOB DISTRICT,SAMBAZA SUB-TEHSIL,25,303,0,303
ZHOB DISTRICT,SAMBAZA SUB-TEHSIL,26,201,0,201
ZHOB DISTRICT,SAMBAZA SUB-TEHSIL,27,201,0,201
ZHOB DISTRICT,SAMBAZA SUB-TEHSIL,28,255,0,255
ZHOB DISTRICT,SAMBAZA SUB-TEHSIL,29,217,0,217
ZHOB DISTRICT,SAMBAZA SUB-TEHSIL,30,253,0,253
ZHOB DISTRICT,SAMBAZA SUB-TEHSIL,31,179,0,179
ZHOB DISTRICT,SAMBAZA SUB-TEHSIL,32,159,0,159
ZHOB DISTRICT,SAMBAZA SUB-TEHSIL,33,185,0,185
ZHOB DISTRICT,SAMBAZA SUB-TEHSIL,34,124,0,124
ZHOB DISTRICT,SAMBAZA SUB-TEHSIL,35,192,0,192
ZHOB DISTRICT,SAMBAZA SUB-TEHSIL,36,103,0,103
ZHOB DISTRICT,SAMBAZA SUB-TEHSIL,37,134,0,134
ZHOB DISTRICT,SAMBAZA SUB-TEHSIL,38,146,0,146
ZHOB DISTRICT,SAMBAZA SUB-TEHSIL,39,137,0,137
ZHOB DISTRICT,SAMBAZA SUB-TEHSIL,40,179,0,179
ZHOB DISTRICT,SAMBAZA SUB-TEHSIL,41,110,0,110
ZHOB DISTRICT,SAMBAZA SUB-TEHSIL,42,111,0,111
ZHOB DISTRICT,SAMBAZA SUB-TEHSIL,43,97,0,97
ZHOB DISTRICT,SAMBAZA SUB-TEHSIL,44,86,0,86
ZHOB DISTRICT,SAMBAZA SUB-TEHSIL,45,150,0,150
ZHOB DISTRICT,SAMBAZA SUB-TEHSIL,46,68,0,68
ZHOB DISTRICT,SAMBAZA SUB-TEHSIL,47,85,0,85
ZHOB DISTRICT,SAMBAZA SUB-TEHSIL,48,112,0,112
ZHOB DISTRICT,SAMBAZA SUB-TEHSIL,49,125,0,125
ZHOB DISTRICT,SAMBAZA SUB-TEHSIL,50,125,0,125
ZHOB DISTRICT,SAMBAZA SUB-TEHSIL,51,60,0,60
ZHOB DISTRICT,SAMBAZA SUB-TEHSIL,52,69,0,69
ZHOB DISTRICT,SAMBAZA SUB-TEHSIL,53,74,0,74
ZHOB DISTRICT,SAMBAZA SUB-TEHSIL,54,65,0,65
ZHOB DISTRICT,SAMBAZA SUB-TEHSIL,55,76,0,76
ZHOB DISTRICT,SAMBAZA SUB-TEHSIL,56,38,0,38
ZHOB DISTRICT,SAMBAZA SUB-TEHSIL,57,51,0,51
ZHOB DISTRICT,SAMBAZA SUB-TEHSIL,58,51,0,51
ZHOB DISTRICT,SAMBAZA SUB-TEHSIL,59,50,0,50
ZHOB DISTRICT,SAMBAZA SUB-TEHSIL,60,69,0,69
ZHOB DISTRICT,SAMBAZA SUB-TEHSIL,61,43,0,43
ZHOB DISTRICT,SAMBAZA SUB-TEHSIL,62,36,0,36
ZHOB DISTRICT,SAMBAZA SUB-TEHSIL,63,27,0,27
ZHOB DISTRICT,SAMBAZA SUB-TEHSIL,64,51,0,51
ZHOB DISTRICT,SAMBAZA SUB-TEHSIL,65,46,0,46
ZHOB DISTRICT,SAMBAZA SUB-TEHSIL,66,25,0,25
ZHOB DISTRICT,SAMBAZA SUB-TEHSIL,67,39,0,39
ZHOB DISTRICT,SAMBAZA SUB-TEHSIL,68,14,0,14
ZHOB DISTRICT,SAMBAZA SUB-TEHSIL,69,44,0,44
ZHOB DISTRICT,SAMBAZA SUB-TEHSIL,70,35,0,35
ZHOB DISTRICT,SAMBAZA SUB-TEHSIL,71,20,0,20
ZHOB DISTRICT,SAMBAZA SUB-TEHSIL,72,14,0,14
ZHOB DISTRICT,SAMBAZA SUB-TEHSIL,73,31,0,31
ZHOB DISTRICT,SAMBAZA SUB-TEHSIL,74,23,0,23
ZHOB DISTRICT,SAMBAZA SUB-TEHSIL,>=75,143,0,143
ZHOB DISTRICT,ZHOB TEHSIL,<1,6817,1063,7880
ZHOB DISTRICT,ZHOB TEHSIL,1,8393,1362,9755
ZHOB DISTRICT,ZHOB TEHSIL,2,9403,1514,10917
ZHOB DISTRICT,ZHOB TEHSIL,3,8973,1580,10553
ZHOB DISTRICT,ZHOB TEHSIL,4,8876,1481,10357
ZHOB DISTRICT,ZHOB TEHSIL,5,8314,1447,9761
ZHOB DISTRICT,ZHOB TEHSIL,6,8545,1401,9946
ZHOB DISTRICT,ZHOB TEHSIL,7,7781,1459,9240
ZHOB DISTRICT,ZHOB TEHSIL,8,7980,1315,9295
ZHOB DISTRICT,ZHOB TEHSIL,9,7155,1376,8531
ZHOB DISTRICT,ZHOB TEHSIL,10,6581,1236,7817
ZHOB DISTRICT,ZHOB TEHSIL,11,5449,1189,6638
ZHOB DISTRICT,ZHOB TEHSIL,12,5125,1034,6159
ZHOB DISTRICT,ZHOB TEHSIL,13,4631,1087,5718
ZHOB DISTRICT,ZHOB TEHSIL,14,4239,1010,5249
ZHOB DISTRICT,ZHOB TEHSIL,15,4213,988,5201
ZHOB DISTRICT,ZHOB TEHSIL,16,3601,890,4491
ZHOB DISTRICT,ZHOB TEHSIL,17,3480,966,4446
ZHOB DISTRICT,ZHOB TEHSIL,18,3883,914,4797
ZHOB DISTRICT,ZHOB TEHSIL,19,3562,988,4550
ZHOB DISTRICT,ZHOB TEHSIL,20,3750,859,4609
ZHOB DISTRICT,ZHOB TEHSIL,21,3362,1017,4379
ZHOB DISTRICT,ZHOB TEHSIL,22,2754,829,3583
ZHOB DISTRICT,ZHOB TEHSIL,23,2698,902,3600
ZHOB DISTRICT,ZHOB TEHSIL,24,2827,821,3648
ZHOB DISTRICT,ZHOB TEHSIL,25,3300,857,4157
ZHOB DISTRICT,ZHOB TEHSIL,26,3082,764,3846
ZHOB DISTRICT,ZHOB TEHSIL,27,3358,881,4239
ZHOB DISTRICT,ZHOB TEHSIL,28,2847,832,3679
ZHOB DISTRICT,ZHOB TEHSIL,29,3129,830,3959
ZHOB DISTRICT,ZHOB TEHSIL,30,2705,718,3423
ZHOB DISTRICT,ZHOB TEHSIL,31,2632,693,3325
ZHOB DISTRICT,ZHOB TEHSIL,32,2327,641,2968
ZHOB DISTRICT,ZHOB TEHSIL,33,1917,672,2589
ZHOB DISTRICT,ZHOB TEHSIL,34,1593,582,2175
ZHOB DISTRICT,ZHOB TEHSIL,35,1795,460,2255
ZHOB DISTRICT,ZHOB TEHSIL,36,1581,491,2072
ZHOB DISTRICT,ZHOB TEHSIL,37,1875,573,2448
ZHOB DISTRICT,ZHOB TEHSIL,38,1605,525,2130
ZHOB DISTRICT,ZHOB TEHSIL,39,1522,485,2007
ZHOB DISTRICT,ZHOB TEHSIL,40,1620,450,2070
ZHOB DISTRICT,ZHOB TEHSIL,41,1391,408,1799
ZHOB DISTRICT,ZHOB TEHSIL,42,1236,302,1538
ZHOB DISTRICT,ZHOB TEHSIL,43,1099,337,1436
ZHOB DISTRICT,ZHOB TEHSIL,44,1060,286,1346
ZHOB DISTRICT,ZHOB TEHSIL,45,1131,292,1423
ZHOB DISTRICT,ZHOB TEHSIL,46,1153,276,1429
ZHOB DISTRICT,ZHOB TEHSIL,47,1377,342,1719
ZHOB DISTRICT,ZHOB TEHSIL,48,1166,281,1447
ZHOB DISTRICT,ZHOB TEHSIL,49,1105,338,1443
ZHOB DISTRICT,ZHOB TEHSIL,50,1084,303,1387
ZHOB DISTRICT,ZHOB TEHSIL,51,991,277,1268
ZHOB DISTRICT,ZHOB TEHSIL,52,895,233,1128
ZHOB DISTRICT,ZHOB TEHSIL,53,872,253,1125
ZHOB DISTRICT,ZHOB TEHSIL,54,756,229,985
ZHOB DISTRICT,ZHOB TEHSIL,55,696,177,873
ZHOB DISTRICT,ZHOB TEHSIL,56,706,201,907
ZHOB DISTRICT,ZHOB TEHSIL,57,845,233,1078
ZHOB DISTRICT,ZHOB TEHSIL,58,647,156,803
ZHOB DISTRICT,ZHOB TEHSIL,59,715,182,897
ZHOB DISTRICT,ZHOB TEHSIL,60,631,145,776
ZHOB DISTRICT,ZHOB TEHSIL,61,591,145,736
ZHOB DISTRICT,ZHOB TEHSIL,62,523,127,650
ZHOB DISTRICT,ZHOB TEHSIL,63,546,110,656
ZHOB DISTRICT,ZHOB TEHSIL,64,638,137,775
ZHOB DISTRICT,ZHOB TEHSIL,65,468,92,560
ZHOB DISTRICT,ZHOB TEHSIL,66,444,80,524
ZHOB DISTRICT,ZHOB TEHSIL,67,518,115,633
ZHOB DISTRICT,ZHOB TEHSIL,68,418,75,493
ZHOB DISTRICT,ZHOB TEHSIL,69,597,110,707
ZHOB DISTRICT,ZHOB TEHSIL,70,327,67,394
ZHOB DISTRICT,ZHOB TEHSIL,71,330,74,404
ZHOB DISTRICT,ZHOB TEHSIL,72,294,60,354
ZHOB DISTRICT,ZHOB TEHSIL,73,239,48,287
ZHOB DISTRICT,ZHOB TEHSIL,74,341,74,415
ZHOB DISTRICT,ZHOB TEHSIL,>=75,1832,417,2249
ZIARAT DISTRICT,SINJAWI SUB-TEHSIL,<1,2556,0,2556
ZIARAT DISTRICT,SINJAWI SUB-TEHSIL,1,3160,0,3160
ZIARAT DISTRICT,SINJAWI SUB-TEHSIL,2,3429,0,3429
ZIARAT DISTRICT,SINJAWI SUB-TEHSIL,3,3575,0,3575
ZIARAT DISTRICT,SINJAWI SUB-TEHSIL,4,3507,0,3507
ZIARAT DISTRICT,SINJAWI SUB-TEHSIL,5,3604,0,3604
ZIARAT DISTRICT,SINJAWI SUB-TEHSIL,6,3437,0,3437
ZIARAT DISTRICT,SINJAWI SUB-TEHSIL,7,3604,0,3604
ZIARAT DISTRICT,SINJAWI SUB-TEHSIL,8,3248,0,3248
ZIARAT DISTRICT,SINJAWI SUB-TEHSIL,9,3246,0,3246
ZIARAT DISTRICT,SINJAWI SUB-TEHSIL,10,2764,0,2764
ZIARAT DISTRICT,SINJAWI SUB-TEHSIL,11,2389,0,2389
ZIARAT DISTRICT,SINJAWI SUB-TEHSIL,12,2029,0,2029
ZIARAT DISTRICT,SINJAWI SUB-TEHSIL,13,1912,0,1912
ZIARAT DISTRICT,SINJAWI SUB-TEHSIL,14,1637,0,1637
ZIARAT DISTRICT,SINJAWI SUB-TEHSIL,15,1695,0,1695
ZIARAT DISTRICT,SINJAWI SUB-TEHSIL,16,1469,0,1469
ZIARAT DISTRICT,SINJAWI SUB-TEHSIL,17,1349,0,1349
ZIARAT DISTRICT,SINJAWI SUB-TEHSIL,18,1511,0,1511
ZIARAT DISTRICT,SINJAWI SUB-TEHSIL,19,1539,0,1539
ZIARAT DISTRICT,SINJAWI SUB-TEHSIL,20,1676,0,1676
ZIARAT DISTRICT,SINJAWI SUB-TEHSIL,21,1759,0,1759
ZIARAT DISTRICT,SINJAWI SUB-TEHSIL,22,1245,0,1245
ZIARAT DISTRICT,SINJAWI SUB-TEHSIL,23,1409,0,1409
ZIARAT DISTRICT,SINJAWI SUB-TEHSIL,24,1297,0,1297
ZIARAT DISTRICT,SINJAWI SUB-TEHSIL,25,1613,0,1613
ZIARAT DISTRICT,SINJAWI SUB-TEHSIL,26,1433,0,1433
ZIARAT DISTRICT,SINJAWI SUB-TEHSIL,27,1735,0,1735
ZIARAT DISTRICT,SINJAWI SUB-TEHSIL,28,1263,0,1263
ZIARAT DISTRICT,SINJAWI SUB-TEHSIL,29,1559,0,1559
ZIARAT DISTRICT,SINJAWI SUB-TEHSIL,30,1290,0,1290
ZIARAT DISTRICT,SINJAWI SUB-TEHSIL,31,1438,0,1438
ZIARAT DISTRICT,SINJAWI SUB-TEHSIL,32,1154,0,1154
ZIARAT DISTRICT,SINJAWI SUB-TEHSIL,33,1124,0,1124
ZIARAT DISTRICT,SINJAWI SUB-TEHSIL,34,1024,0,1024
ZIARAT DISTRICT,SINJAWI SUB-TEHSIL,35,923,0,923
ZIARAT DISTRICT,SINJAWI SUB-TEHSIL,36,918,0,918
ZIARAT DISTRICT,SINJAWI SUB-TEHSIL,37,1255,0,1255
ZIARAT DISTRICT,SINJAWI SUB-TEHSIL,38,829,0,829
ZIARAT DISTRICT,SINJAWI SUB-TEHSIL,39,912,0,912
ZIARAT DISTRICT,SINJAWI SUB-TEHSIL,40,700,0,700
ZIARAT DISTRICT,SINJAWI SUB-TEHSIL,41,797,0,797
ZIARAT DISTRICT,SINJAWI SUB-TEHSIL,42,634,0,634
ZIARAT DISTRICT,SINJAWI SUB-TEHSIL,43,548,0,548
ZIARAT DISTRICT,SINJAWI SUB-TEHSIL,44,542,0,542
ZIARAT DISTRICT,SINJAWI SUB-TEHSIL,45,528,0,528
ZIARAT DISTRICT,SINJAWI SUB-TEHSIL,46,593,0,593
ZIARAT DISTRICT,SINJAWI SUB-TEHSIL,47,769,0,769
ZIARAT DISTRICT,SINJAWI SUB-TEHSIL,48,602,0,602
ZIARAT DISTRICT,SINJAWI SUB-TEHSIL,49,618,0,618
ZIARAT DISTRICT,SINJAWI SUB-TEHSIL,50,524,0,524
ZIARAT DISTRICT,SINJAWI SUB-TEHSIL,51,605,0,605
ZIARAT DISTRICT,SINJAWI SUB-TEHSIL,52,483,0,483
ZIARAT DISTRICT,SINJAWI SUB-TEHSIL,53,418,0,418
ZIARAT DISTRICT,SINJAWI SUB-TEHSIL,54,403,0,403
ZIARAT DISTRICT,SINJAWI SUB-TEHSIL,55,330,0,330
ZIARAT DISTRICT,SINJAWI SUB-TEHSIL,56,349,0,349
ZIARAT DISTRICT,SINJAWI SUB-TEHSIL,57,460,0,460
ZIARAT DISTRICT,SINJAWI SUB-TEHSIL,58,309,0,309
ZIARAT DISTRICT,SINJAWI SUB-TEHSIL,59,359,0,359
ZIARAT DISTRICT,SINJAWI SUB-TEHSIL,60,328,0,328
ZIARAT DISTRICT,SINJAWI SUB-TEHSIL,61,353,0,353
ZIARAT DISTRICT,SINJAWI SUB-TEHSIL,62,303,0,303
ZIARAT DISTRICT,SINJAWI SUB-TEHSIL,63,344,0,344
ZIARAT DISTRICT,SINJAWI SUB-TEHSIL,64,334,0,334
ZIARAT DISTRICT,SINJAWI SUB-TEHSIL,65,207,0,207
ZIARAT DISTRICT,SINJAWI SUB-TEHSIL,66,247,0,247
ZIARAT DISTRICT,SINJAWI SUB-TEHSIL,67,268,0,268
ZIARAT DISTRICT,SINJAWI SUB-TEHSIL,68,217,0,217
ZIARAT DISTRICT,SINJAWI SUB-TEHSIL,69,223,0,223
ZIARAT DISTRICT,SINJAWI SUB-TEHSIL,70,151,0,151
ZIARAT DISTRICT,SINJAWI SUB-TEHSIL,71,183,0,183
ZIARAT DISTRICT,SINJAWI SUB-TEHSIL,72,167,0,167
ZIARAT DISTRICT,SINJAWI SUB-TEHSIL,73,116,0,116
ZIARAT DISTRICT,SINJAWI SUB-TEHSIL,74,112,0,112
ZIARAT DISTRICT,SINJAWI SUB-TEHSIL,>=75,857,0,857
ZIARAT DISTRICT,ZIARAT TEHSIL,<1,2037,73,2110
ZIARAT DISTRICT,ZIARAT TEHSIL,1,2123,131,2254
ZIARAT DISTRICT,ZIARAT TEHSIL,2,2179,93,2272
ZIARAT DISTRICT,ZIARAT TEHSIL,3,2130,108,2238
ZIARAT DISTRICT,ZIARAT TEHSIL,4,2021,112,2133
ZIARAT DISTRICT,ZIARAT TEHSIL,5,2038,113,2151
ZIARAT DISTRICT,ZIARAT TEHSIL,6,2064,104,2168
ZIARAT DISTRICT,ZIARAT TEHSIL,7,2036,119,2155
ZIARAT DISTRICT,ZIARAT TEHSIL,8,1931,79,2010
ZIARAT DISTRICT,ZIARAT TEHSIL,9,2005,105,2110
ZIARAT DISTRICT,ZIARAT TEHSIL,10,1624,83,1707
ZIARAT DISTRICT,ZIARAT TEHSIL,11,1560,80,1640
ZIARAT DISTRICT,ZIARAT TEHSIL,12,1430,72,1502
ZIARAT DISTRICT,ZIARAT TEHSIL,13,1440,93,1533
ZIARAT DISTRICT,ZIARAT TEHSIL,14,1382,64,1446
ZIARAT DISTRICT,ZIARAT TEHSIL,15,1388,76,1464
ZIARAT DISTRICT,ZIARAT TEHSIL,16,1379,57,1436
ZIARAT DISTRICT,ZIARAT TEHSIL,17,1378,82,1460
ZIARAT DISTRICT,ZIARAT TEHSIL,18,1568,63,1631
ZIARAT DISTRICT,ZIARAT TEHSIL,19,1471,63,1534
ZIARAT DISTRICT,ZIARAT TEHSIL,20,1251,69,1320
ZIARAT DISTRICT,ZIARAT TEHSIL,21,1257,75,1332
ZIARAT DISTRICT,ZIARAT TEHSIL,22,1030,37,1067
ZIARAT DISTRICT,ZIARAT TEHSIL,23,1023,55,1078
ZIARAT DISTRICT,ZIARAT TEHSIL,24,876,46,922
ZIARAT DISTRICT,ZIARAT TEHSIL,25,1027,61,1088
ZIARAT DISTRICT,ZIARAT TEHSIL,26,942,40,982
ZIARAT DISTRICT,ZIARAT TEHSIL,27,1245,53,1298
ZIARAT DISTRICT,ZIARAT TEHSIL,28,962,43,1005
ZIARAT DISTRICT,ZIARAT TEHSIL,29,1133,46,1179
ZIARAT DISTRICT,ZIARAT TEHSIL,30,927,60,987
ZIARAT DISTRICT,ZIARAT TEHSIL,31,943,46,989
ZIARAT DISTRICT,ZIARAT TEHSIL,32,777,42,819
ZIARAT DISTRICT,ZIARAT TEHSIL,33,767,46,813
ZIARAT DISTRICT,ZIARAT TEHSIL,34,694,40,734
ZIARAT DISTRICT,ZIARAT TEHSIL,35,724,58,782
ZIARAT DISTRICT,ZIARAT TEHSIL,36,783,36,819
ZIARAT DISTRICT,ZIARAT TEHSIL,37,852,68,920
ZIARAT DISTRICT,ZIARAT TEHSIL,38,712,48,760
ZIARAT DISTRICT,ZIARAT TEHSIL,39,729,40,769
ZIARAT DISTRICT,ZIARAT TEHSIL,40,528,33,561
ZIARAT DISTRICT,ZIARAT TEHSIL,41,587,37,624
ZIARAT DISTRICT,ZIARAT TEHSIL,42,455,44,499
ZIARAT DISTRICT,ZIARAT TEHSIL,43,485,26,511
ZIARAT DISTRICT,ZIARAT TEHSIL,44,391,26,417
ZIARAT DISTRICT,ZIARAT TEHSIL,45,420,25,445
ZIARAT DISTRICT,ZIARAT TEHSIL,46,392,17,409
ZIARAT DISTRICT,ZIARAT TEHSIL,47,488,30,518
ZIARAT DISTRICT,ZIARAT TEHSIL,48,399,25,424
ZIARAT DISTRICT,ZIARAT TEHSIL,49,398,27,425
ZIARAT DISTRICT,ZIARAT TEHSIL,50,384,13,397
ZIARAT DISTRICT,ZIARAT TEHSIL,51,323,26,349
ZIARAT DISTRICT,ZIARAT TEHSIL,52,340,27,367
ZIARAT DISTRICT,ZIARAT TEHSIL,53,292,24,316
ZIARAT DISTRICT,ZIARAT TEHSIL,54,238,12,250
ZIARAT DISTRICT,ZIARAT TEHSIL,55,279,18,297
ZIARAT DISTRICT,ZIARAT TEHSIL,56,227,15,242
ZIARAT DISTRICT,ZIARAT TEHSIL,57,237,20,257
ZIARAT DISTRICT,ZIARAT TEHSIL,58,217,17,234
ZIARAT DISTRICT,ZIARAT TEHSIL,59,245,18,263
ZIARAT DISTRICT,ZIARAT TEHSIL,60,270,7,277
ZIARAT DISTRICT,ZIARAT TEHSIL,61,259,11,270
ZIARAT DISTRICT,ZIARAT TEHSIL,62,211,15,226
ZIARAT DISTRICT,ZIARAT TEHSIL,63,184,9,193
ZIARAT DISTRICT,ZIARAT TEHSIL,64,225,13,238
ZIARAT DISTRICT,ZIARAT TEHSIL,65,186,6,192
ZIARAT DISTRICT,ZIARAT TEHSIL,66,153,3,156
ZIARAT DISTRICT,ZIARAT TEHSIL,67,167,12,179
ZIARAT DISTRICT,ZIARAT TEHSIL,68,128,3,131
ZIARAT DISTRICT,ZIARAT TEHSIL,69,147,8,155
ZIARAT DISTRICT,ZIARAT TEHSIL,70,126,5,131
ZIARAT DISTRICT,ZIARAT TEHSIL,71,129,9,138
ZIARAT DISTRICT,ZIARAT TEHSIL,72,101,4,105
ZIARAT DISTRICT,ZIARAT TEHSIL,73,84,5,89
ZIARAT DISTRICT,ZIARAT TEHSIL,74,98,2,100
ZIARAT DISTRICT,ZIARAT TEHSIL,>=75,575,21,596
KOHAT DISTRICT,TRIBAL AREA ADJ. KOHAT DISTRICT,<1,2823,0,2823
KOHAT DISTRICT,TRIBAL AREA ADJ. KOHAT DISTRICT,1,3700,0,3700
KOHAT DISTRICT,TRIBAL AREA ADJ. KOHAT DISTRICT,2,3533,0,3533
KOHAT DISTRICT,TRIBAL AREA ADJ. KOHAT DISTRICT,3,3779,0,3779
KOHAT DISTRICT,TRIBAL AREA ADJ. KOHAT DISTRICT,4,3619,0,3619
KOHAT DISTRICT,TRIBAL AREA ADJ. KOHAT DISTRICT,5,3624,0,3624
KOHAT DISTRICT,TRIBAL AREA ADJ. KOHAT DISTRICT,6,3493,0,3493
KOHAT DISTRICT,TRIBAL AREA ADJ. KOHAT DISTRICT,7,3638,0,3638
KOHAT DISTRICT,TRIBAL AREA ADJ. KOHAT DISTRICT,8,3248,0,3248
KOHAT DISTRICT,TRIBAL AREA ADJ. KOHAT DISTRICT,9,3508,0,3508
KOHAT DISTRICT,TRIBAL AREA ADJ. KOHAT DISTRICT,10,2959,0,2959
KOHAT DISTRICT,TRIBAL AREA ADJ. KOHAT DISTRICT,11,3392,0,3392
KOHAT DISTRICT,TRIBAL AREA ADJ. KOHAT DISTRICT,12,2690,0,2690
KOHAT DISTRICT,TRIBAL AREA ADJ. KOHAT DISTRICT,13,3016,0,3016
KOHAT DISTRICT,TRIBAL AREA ADJ. KOHAT DISTRICT,14,2629,0,2629
KOHAT DISTRICT,TRIBAL AREA ADJ. KOHAT DISTRICT,15,2629,0,2629
KOHAT DISTRICT,TRIBAL AREA ADJ. KOHAT DISTRICT,16,2674,0,2674
KOHAT DISTRICT,TRIBAL AREA ADJ. KOHAT DISTRICT,17,2660,0,2660
KOHAT DISTRICT,TRIBAL AREA ADJ. KOHAT DISTRICT,18,2342,0,2342
KOHAT DISTRICT,TRIBAL AREA ADJ. KOHAT DISTRICT,19,2478,0,2478
KOHAT DISTRICT,TRIBAL AREA ADJ. KOHAT DISTRICT,20,2213,0,2213
KOHAT DISTRICT,TRIBAL AREA ADJ. KOHAT DISTRICT,21,2370,0,2370
KOHAT DISTRICT,TRIBAL AREA ADJ. KOHAT DISTRICT,22,2067,0,2067
KOHAT DISTRICT,TRIBAL AREA ADJ. KOHAT DISTRICT,23,2328,0,2328
KOHAT DISTRICT,TRIBAL AREA ADJ. KOHAT DISTRICT,24,2085,0,2085
KOHAT DISTRICT,TRIBAL AREA ADJ. KOHAT DISTRICT,25,1981,0,1981
KOHAT DISTRICT,TRIBAL AREA ADJ. KOHAT DISTRICT,26,2102,0,2102
KOHAT DISTRICT,TRIBAL AREA ADJ. KOHAT DISTRICT,27,2221,0,2221
KOHAT DISTRICT,TRIBAL AREA ADJ. KOHAT DISTRICT,28,1923,0,1923
KOHAT DISTRICT,TRIBAL AREA ADJ. KOHAT DISTRICT,29,1927,0,1927
KOHAT DISTRICT,TRIBAL AREA ADJ. KOHAT DISTRICT,30,1637,0,1637
KOHAT DISTRICT,TRIBAL AREA ADJ. KOHAT DISTRICT,31,1722,0,1722
KOHAT DISTRICT,TRIBAL AREA ADJ. KOHAT DISTRICT,32,1501,0,1501
KOHAT DISTRICT,TRIBAL AREA ADJ. KOHAT DISTRICT,33,1650,0,1650
KOHAT DISTRICT,TRIBAL AREA ADJ. KOHAT DISTRICT,34,1385,0,1385
KOHAT DISTRICT,TRIBAL AREA ADJ. KOHAT DISTRICT,35,1193,0,1193
KOHAT DISTRICT,TRIBAL AREA ADJ. KOHAT DISTRICT,36,1157,0,1157
KOHAT DISTRICT,TRIBAL AREA ADJ. KOHAT DISTRICT,37,1182,0,1182
KOHAT DISTRICT,TRIBAL AREA ADJ. KOHAT DISTRICT,38,1163,0,1163
KOHAT DISTRICT,TRIBAL AREA ADJ. KOHAT DISTRICT,39,1128,0,1128
KOHAT DISTRICT,TRIBAL AREA ADJ. KOHAT DISTRICT,40,1037,0,1037
KOHAT DISTRICT,TRIBAL AREA ADJ. KOHAT DISTRICT,41,973,0,973
KOHAT DISTRICT,TRIBAL AREA ADJ. KOHAT DISTRICT,42,918,0,918
KOHAT DISTRICT,TRIBAL AREA ADJ. KOHAT DISTRICT,43,887,0,887
KOHAT DISTRICT,TRIBAL AREA ADJ. KOHAT DISTRICT,44,797,0,797
KOHAT DISTRICT,TRIBAL AREA ADJ. KOHAT DISTRICT,45,804,0,804
KOHAT DISTRICT,TRIBAL AREA ADJ. KOHAT DISTRICT,46,801,0,801
KOHAT DISTRICT,TRIBAL AREA ADJ. KOHAT DISTRICT,47,798,0,798
KOHAT DISTRICT,TRIBAL AREA ADJ. KOHAT DISTRICT,48,682,0,682
KOHAT DISTRICT,TRIBAL AREA ADJ. KOHAT DISTRICT,49,676,0,676
KOHAT DISTRICT,TRIBAL AREA ADJ. KOHAT DISTRICT,50,721,0,721
KOHAT DISTRICT,TRIBAL AREA ADJ. KOHAT DISTRICT,51,649,0,649
KOHAT DISTRICT,TRIBAL AREA ADJ. KOHAT DISTRICT,52,618,0,618
KOHAT DISTRICT,TRIBAL AREA ADJ. KOHAT DISTRICT,53,603,0,603
KOHAT DISTRICT,TRIBAL AREA ADJ. KOHAT DISTRICT,54,569,0,569
KOHAT DISTRICT,TRIBAL AREA ADJ. KOHAT DISTRICT,55,558,0,558
KOHAT DISTRICT,TRIBAL AREA ADJ. KOHAT DISTRICT,56,548,0,548
KOHAT DISTRICT,TRIBAL AREA ADJ. KOHAT DISTRICT,57,607,0,607
KOHAT DISTRICT,TRIBAL AREA ADJ. KOHAT DISTRICT,58,541,0,541
KOHAT DISTRICT,TRIBAL AREA ADJ. KOHAT DISTRICT,59,545,0,545
KOHAT DISTRICT,TRIBAL AREA ADJ. KOHAT DISTRICT,60,466,0,466
KOHAT DISTRICT,TRIBAL AREA ADJ. KOHAT DISTRICT,61,489,0,489
KOHAT DISTRICT,TRIBAL AREA ADJ. KOHAT DISTRICT,62,469,0,469
KOHAT DISTRICT,TRIBAL AREA ADJ. KOHAT DISTRICT,63,418,0,418
KOHAT DISTRICT,TRIBAL AREA ADJ. KOHAT DISTRICT,64,398,0,398
KOHAT DISTRICT,TRIBAL AREA ADJ. KOHAT DISTRICT,65,370,0,370
KOHAT DISTRICT,TRIBAL AREA ADJ. KOHAT DISTRICT,66,339,0,339
KOHAT DISTRICT,TRIBAL AREA ADJ. KOHAT DISTRICT,67,353,0,353
KOHAT DISTRICT,TRIBAL AREA ADJ. KOHAT DISTRICT,68,292,0,292
KOHAT DISTRICT,TRIBAL AREA ADJ. KOHAT DISTRICT,69,293,0,293
KOHAT DISTRICT,TRIBAL AREA ADJ. KOHAT DISTRICT,70,265,0,265
KOHAT DISTRICT,TRIBAL AREA ADJ. KOHAT DISTRICT,71,233,0,233
KOHAT DISTRICT,TRIBAL AREA ADJ. KOHAT DISTRICT,72,219,0,219
KOHAT DISTRICT,TRIBAL AREA ADJ. KOHAT DISTRICT,73,204,0,204
KOHAT DISTRICT,TRIBAL AREA ADJ. KOHAT DISTRICT,74,229,0,229
KOHAT DISTRICT,TRIBAL AREA ADJ. KOHAT DISTRICT,>=75,2101,0,2101
